Entidad,Municipio,Habitantes,Mujeres,Hombres,Viviendas,ViviendasConLavadora,PorcentajeVivLavadora
Aguascalientes,Aguascalientes,948990,486917,462073,313256,234193,0.7476089843450724
Aguascalientes,Asientos,51536,26275,25261,15353,10306,0.6712694587377059
Aguascalientes,Calvillo,58250,29687,28563,20842,13560,0.6506093465118511
Aguascalientes,Cosío,17000,8708,8292,4845,3203,0.66109391124871
Aguascalientes,Jesús María,129929,65710,64219,41550,29188,0.7024789410348977
Aguascalientes,Pabellón de Arteaga,47646,24269,23377,13541,9958,0.7353962041208183
Aguascalientes,Rincón de Romos,57369,29268,28101,16527,11214,0.6785260482846251
Aguascalientes,San José de Gracia,9552,5020,4532,3410,1977,0.5797653958944281
Aguascalientes,Tepezalá,22485,11371,11114,6592,4547,0.6897754854368932
Aguascalientes,El Llano,20853,10407,10446,6598,4159,0.6303425280387996
Aguascalientes,San Francisco de los Romo,61997,31292,30705,21458,13405,0.624708733339547
Baja California,Ensenada,443807,222500,221307,171203,111627,0.6520154436546088
Baja California,Mexicali,1049792,520544,529248,385642,289682,0.7511681818889021
Baja California,Tecate,108440,51310,57130,42401,26554,0.6262588146505979
Baja California,Tijuana,1922523,953783,968740,636034,471155,0.7407701475078377
Baja California,Playas de Rosarito,126890,62504,64386,49770,28797,0.5786015672091621
Baja California,San Quintín,117568,57790,59778,40899,18832,0.4604513557788699
Baja California Sur,Comondú,73021,36217,36804,27446,15934,0.5805581869853531
Baja California Sur,Mulegé,64022,30951,33071,26741,12895,0.48221831644291535
Baja California Sur,La Paz,292241,146438,145803,116231,68316,0.5877605802238646
Baja California Sur,Los Cabos,351111,170167,180944,121645,62788,0.5161576719141765
Baja California Sur,Loreto,18052,8795,9257,7810,4101,0.5250960307298336
Campeche,Calkiní,59232,30062,29170,19433,10900,0.5609015592034169
Campeche,Campeche,294077,152522,141555,101576,69521,0.6844234858628022
Campeche,Carmen,248845,125802,123043,88379,59061,0.6682696115593071
Campeche,Champotón,78170,39140,39030,26787,15932,0.5947661178930078
Campeche,Hecelchakán,31917,16204,15713,10058,6164,0.6128454961224895
Campeche,Hopelchén,42140,20812,21328,12573,7394,0.5880855802115644
Campeche,Palizada,8683,4260,4423,3349,1847,0.5515079128097939
Campeche,Tenabo,11452,5655,5797,3921,2302,0.5870951287936751
Campeche,Escárcega,59923,30455,29468,22289,11675,0.523800978060927
Campeche,Calakmul,31714,15613,16101,10343,4890,0.47278352508943244
Campeche,Candelaria,46913,23239,23674,17817,8027,0.45052477970477633
Campeche,Seybaplaya,15297,7660,7637,5109,3493,0.6836954394206303
Coahuila de Zaragoza,Abasolo,1022,487,535,696,313,0.44971264367816094
Coahuila de Zaragoza,Acuña,163058,81115,81943,56926,39721,0.6977655201489653
Coahuila de Zaragoza,Allende,23056,11610,11446,8907,6178,0.6936117660267206
Coahuila de Zaragoza,Arteaga,29578,14623,14955,14621,7506,0.513371178441967
Coahuila de Zaragoza,Candela,1643,800,843,1028,412,0.40077821011673154
Coahuila de Zaragoza,Castaños,29128,14532,14596,10691,7085,0.6627069497708353
Coahuila de Zaragoza,Cuatro Ciénegas,12715,6350,6365,5275,3067,0.5814218009478673
Coahuila de Zaragoza,Escobedo,3047,1518,1529,1322,770,0.5824508320726173
Coahuila de Zaragoza,Francisco I. Madero,59035,29818,29217,20022,12725,0.6355508940165817
Coahuila de Zaragoza,Frontera,82409,41200,41209,26600,20478,0.7698496240601503
Coahuila de Zaragoza,General Cepeda,11898,5807,6091,4992,2753,0.5514823717948718
Coahuila de Zaragoza,Guerrero,1643,760,883,961,439,0.45681581685744016
Coahuila de Zaragoza,Hidalgo,1735,839,896,787,388,0.49301143583227447
Coahuila de Zaragoza,Jiménez,9502,4645,4857,4192,2272,0.5419847328244275
Coahuila de Zaragoza,Juárez,1584,798,786,973,419,0.4306269270298047
Coahuila de Zaragoza,Lamadrid,1764,836,928,1021,485,0.47502448579823703
Coahuila de Zaragoza,Matamoros,118337,59645,58692,37230,24606,0.6609186140209509
Coahuila de Zaragoza,Monclova,237951,119893,118058,78416,61597,0.7855157110793716
Coahuila de Zaragoza,Morelos,7928,3993,3935,3299,2151,0.6520157623522279
Coahuila de Zaragoza,Múzquiz,71627,35771,35856,25010,18112,0.7241903238704518
Coahuila de Zaragoza,Nadadores,6539,3296,3243,2787,1677,0.6017222820236814
Coahuila de Zaragoza,Nava,33129,16530,16599,11129,8463,0.7604456824512534
Coahuila de Zaragoza,Ocampo,9642,4650,4992,4111,1993,0.4847968864023352
Coahuila de Zaragoza,Parras,44472,21938,22534,17265,10187,0.5900376484216623
Coahuila de Zaragoza,Piedras Negras,176327,87616,88711,62631,46257,0.7385639699190497
Coahuila de Zaragoza,Progreso,3239,1605,1634,1557,820,0.5266538214515093
Coahuila de Zaragoza,Ramos Arizpe,122243,59521,62722,40038,28646,0.7154703032119486
Coahuila de Zaragoza,Sabinas,64811,32574,32237,24744,18309,0.7399369544131911
Coahuila de Zaragoza,Sacramento,2471,1229,1242,1035,615,0.5942028985507246
Coahuila de Zaragoza,Saltillo,879958,442166,437792,271428,218550,0.8051859056545382
Coahuila de Zaragoza,San Buenaventura,24759,12484,12275,9640,6778,0.7031120331950207
Coahuila de Zaragoza,San Juan de Sabinas,42260,21338,20922,15777,12147,0.7699182354059707
Coahuila de Zaragoza,San Pedro,101041,51092,49949,33186,20970,0.6318929669137588
Coahuila de Zaragoza,Sierra Mojada,6744,3217,3527,2629,1611,0.6127805249144161
Coahuila de Zaragoza,Torreón,720848,369095,351753,261544,182594,0.6981387452971584
Coahuila de Zaragoza,Viesca,20305,10075,10230,6880,3917,0.5693313953488373
Coahuila de Zaragoza,Villa Unión,6188,3058,3130,2917,1581,0.5419952005485087
Coahuila de Zaragoza,Zaragoza,13135,6578,6557,5781,3422,0.5919391108804705
Colima,Armería,27626,13686,13940,11236,5859,0.5214489142043431
Colima,Colima,157048,80893,76155,65375,39506,0.6042982791586998
Colima,Comala,21661,10768,10893,8056,4045,0.5021102284011917
Colima,Coquimatlán,20837,10353,10484,7954,4107,0.5163439778727684
Colima,Cuauhtémoc,31267,15538,15729,11645,7167,0.6154572778016316
Colima,Ixtlahuacán,5623,2736,2887,2418,1099,0.4545078577336642
Colima,Manzanillo,191031,95914,95117,76583,45860,0.5988274160061633
Colima,Minatitlán,10231,4997,5234,3753,2049,0.5459632294164668
Colima,Tecomán,116305,58476,57829,40114,21169,0.5277209951637832
Colima,Villa de Álvarez,149762,77408,72354,61844,39519,0.6390110600866696
Chiapas,Acacoyagua,17994,8997,8997,5459,1910,0.3498809305733651
Chiapas,Acala,21187,10773,10414,7179,3056,0.42568602869480426
Chiapas,Acapetahua,26899,13714,13185,9482,4555,0.48038388525627507
Chiapas,Altamirano,36160,18128,18032,10020,1254,0.1251497005988024
Chiapas,Amatán,24512,12184,12328,6597,966,0.14643019554342884
Chiapas,Amatenango de la Frontera,31735,16307,15428,9806,3514,0.3583520293697736
Chiapas,Amatenango del Valle,11283,5910,5373,2919,85,0.029119561493662214
Chiapas,Angel Albino Corzo,31947,16042,15905,9702,3050,0.31436817151102864
Chiapas,Arriaga,41135,21181,19954,15702,7653,0.48739014138326325
Chiapas,Bejucal de Ocampo,7365,3713,3652,1962,585,0.2981651376146789
Chiapas,Bella Vista,20157,10155,10002,6160,1602,0.26006493506493505
Chiapas,Berriozábal,64632,32718,31914,23549,9342,0.39670474330120176
Chiapas,Bochil,37263,19055,18208,10230,1948,0.19042033235581624
Chiapas,El Bosque,24273,12562,11711,5701,562,0.0985791966321698
Chiapas,Cacahoatán,50112,25685,24427,15017,4877,0.3247652660318306
Chiapas,Catazajá,17619,8737,8882,5888,2893,0.4913383152173913
Chiapas,Cintalapa,88106,44429,43677,27322,11444,0.41885659907766637
Chiapas,Coapilla,9900,5027,4873,3101,930,0.2999032570138665
Chiapas,Comitán de Domínguez,166178,86738,79440,56783,26526,0.46714685733406125
Chiapas,La Concordia,49920,24787,25133,15492,5870,0.3789052414149238
Chiapas,Copainalá,22192,11346,10846,7830,2292,0.29272030651340997
Chiapas,Chalchihuitán,21915,11042,10873,7135,18,0.0025227750525578137
Chiapas,Chamula,101967,55019,46948,29553,913,0.030893648698947652
Chiapas,Chanal,13678,6944,6734,3046,27,0.00886408404464872
Chiapas,Chapultenango,7472,3737,3735,2094,391,0.18672397325692455
Chiapas,Chenalhó,47371,24177,23194,11570,206,0.01780466724286949
Chiapas,Chiapa de Corzo,112075,56909,55166,39208,17164,0.4377678024892879
Chiapas,Chiapilla,6156,3050,3106,2089,973,0.46577309717568216
Chiapas,Chicoasén,5402,2701,2701,1972,706,0.3580121703853955
Chiapas,Chicomuselo,36785,18646,18139,11400,4130,0.362280701754386
Chiapas,Chilón,137262,69945,67317,31087,1177,0.037861485508411875
Chiapas,Escuintla,30896,15682,15214,10147,3399,0.3349758549324924
Chiapas,Francisco León,7245,3572,3673,1804,384,0.21286031042128603
Chiapas,Frontera Comalapa,80897,41738,39159,27745,11425,0.4117859073706974
Chiapas,Frontera Hidalgo,14556,7380,7176,4447,1797,0.40409264672813133
Chiapas,La Grandeza,7701,3936,3765,1968,626,0.31808943089430897
Chiapas,Huehuetán,36333,18622,17711,11713,3914,0.3341586271663963
Chiapas,Huixtán,22975,11711,11264,5654,193,0.03413512557481429
Chiapas,Huitiupán,27893,13898,13995,7082,591,0.0834510025416549
Chiapas,Huixtla,53242,27163,26079,17713,7461,0.4212160560040648
Chiapas,La Independencia,46409,23832,22577,12735,5507,0.43243031016882605
Chiapas,Ixhuatán,11377,5838,5539,3234,667,0.20624613481756338
Chiapas,Ixtacomitán,10961,5542,5419,3245,1021,0.31463790446841294
Chiapas,Ixtapa,28999,14713,14286,7258,1465,0.20184623863323228
Chiapas,Ixtapangajoya,6284,3162,3122,1810,569,0.3143646408839779
Chiapas,Jiquipilas,41063,20693,20370,14323,5984,0.41778956922432453
Chiapas,Jitotol,24966,12539,12427,6627,876,0.13218650973291082
Chiapas,Juárez,21807,11035,10772,7500,4068,0.5424
Chiapas,Larráinzar,31259,16055,15204,7419,253,0.03410163094756706
Chiapas,La Libertad,5232,2625,2607,1994,864,0.43329989969909727
Chiapas,Mapastepec,46130,23349,22781,16797,7248,0.4315056260046437
Chiapas,Las Margaritas,141027,72136,68891,33663,5771,0.1714345126696967
Chiapas,Mazapa de Madero,7901,4006,3895,2202,625,0.28383287920072664
Chiapas,Mazatán,28250,14233,14017,9529,4391,0.46080386189526706
Chiapas,Metapa,5876,3120,2756,1944,780,0.4012345679012346
Chiapas,Mitontic,13755,7022,6733,3500,11,0.003142857142857143
Chiapas,Motozintla,76398,38973,37425,21794,5245,0.24066256767917776
Chiapas,Nicolás Ruíz,4765,2325,2440,1246,277,0.22231139646869985
Chiapas,Ocosingo,234661,118892,115769,57036,7120,0.1248334385300512
Chiapas,Ocotepec,14088,7209,6879,3899,209,0.05360348807386509
Chiapas,Ocozocoautla de Espinosa,97397,49327,48070,30125,11907,0.395253112033195
Chiapas,Ostuacán,18469,9281,9188,5566,2370,0.425799496945742
Chiapas,Osumacinta,3983,2004,1979,1351,508,0.3760177646188009
Chiapas,Oxchuc,54932,27418,27514,12795,242,0.0189136381398984
Chiapas,Palenque,132265,67189,65076,43025,14050,0.32655432887855895
Chiapas,Pantelhó,26391,13441,12950,5973,206,0.034488531726100786
Chiapas,Pantepec,12266,6212,6054,3674,423,0.11513336962438758
Chiapas,Pichucalco,31919,16267,15652,10578,4274,0.4040461334845907
Chiapas,Pijijiapan,51193,26082,25111,19104,9276,0.48555276381909546
Chiapas,El Porvenir,12263,6159,6104,3129,772,0.24672419303291787
Chiapas,Villa Comaltitlán,30297,14719,15578,9572,3975,0.4152737150020894
Chiapas,Pueblo Nuevo Solistahuacán,29636,15204,14432,7551,1479,0.19586809694080254
Chiapas,Rayón,10866,5518,5348,3037,604,0.19888047415212382
Chiapas,Reforma,44829,22921,21908,16258,9549,0.5873416164349858
Chiapas,Las Rosas,28829,14695,14134,8989,3425,0.38102124819223493
Chiapas,Sabanilla,29889,14968,14921,8244,264,0.03202328966521106
Chiapas,Salto de Agua,64251,32405,31846,17284,2166,0.1253182133765332
Chiapas,San Cristóbal de las Casas,215874,113582,102292,65980,25350,0.38420733555622916
Chiapas,San Fernando,41793,20921,20872,13024,5479,0.4206848894348894
Chiapas,Siltepec,25937,12911,13026,6667,1916,0.28738563071846407
Chiapas,Simojovel,52935,27047,25888,12472,1154,0.09252726106478512
Chiapas,Sitalá,15518,7894,7624,4008,146,0.03642714570858283
Chiapas,Socoltenango,19092,9679,9413,6390,3038,0.4754303599374022
Chiapas,Solosuchiapa,8561,4217,4344,2533,710,0.2803000394788788
Chiapas,Soyaló,10890,5425,5465,3246,749,0.23074553296364755
Chiapas,Suchiapa,25627,12871,12756,8237,3202,0.38873376229209666
Chiapas,Suchiate,41672,21191,20481,13591,4482,0.3297770583474358
Chiapas,Sunuapa,2308,1133,1175,724,221,0.3052486187845304
Chiapas,Tapachula,353706,182096,171610,121813,52498,0.43097206373703956
Chiapas,Tapalapa,4547,2338,2209,1554,260,0.16731016731016732
Chiapas,Tapilula,13592,7030,6562,4389,1397,0.3182957393483709
Chiapas,Tecpatán,21426,10762,10664,7408,2350,0.3172246220302376
Chiapas,Tenejapa,48162,24854,23308,11209,140,0.012489963422249978
Chiapas,Teopisca,49499,25555,23944,14858,3698,0.24888948714497242
Chiapas,Tila,83505,41804,41701,20775,765,0.0368231046931408
Chiapas,Tonalá,91913,46632,45281,31835,17113,0.5375530076959322
Chiapas,Totolapa,7211,3571,3640,2258,489,0.21656333038086803
Chiapas,La Trinitaria,83111,42999,40112,26435,10701,0.4048042368072631
Chiapas,Tumbalá,38025,19518,18507,9535,331,0.03471421080230729
Chiapas,Tuxtla Gutiérrez,604147,316623,287524,208847,120942,0.5790937863603499
Chiapas,Tuxtla Chico,41024,21247,19777,13413,4503,0.3357190785059271
Chiapas,Tuzantán,30302,15402,14900,9553,2960,0.3098503088035172
Chiapas,Tzimol,16560,8442,8118,5774,2685,0.4650155871146519
Chiapas,Unión Juárez,16008,8161,7847,4962,1534,0.3091495364772269
Chiapas,Venustiano Carranza,67292,33793,33499,22524,8702,0.38634345586929497
Chiapas,Villa Corzo,65643,33298,32345,20951,9213,0.439740346522839
Chiapas,Villaflores,109536,55728,53808,36061,17594,0.48789551038518064
Chiapas,Yajalón,40285,20695,19590,10465,1877,0.17935977066411848
Chiapas,San Lucas,7526,3734,3792,2492,585,0.23475120385232745
Chiapas,Zinacantán,45373,24258,21115,10955,669,0.06106800547695116
Chiapas,San Juan Cancuc,37948,19431,18517,8207,25,0.0030461800901669307
Chiapas,Aldama,8480,4440,4040,1939,17,0.008767405879319236
Chiapas,Benemérito de las Américas,23603,11789,11814,6950,2810,0.40431654676258993
Chiapas,Maravilla Tenejapa,14714,7382,7332,3702,693,0.18719611021069693
Chiapas,Marqués de Comillas,12892,6394,6498,3626,1217,0.3356315499172642
Chiapas,Montecristo de Guerrero,8412,4197,4215,2430,800,0.3292181069958848
Chiapas,San Andrés Duraznal,6047,3119,2928,1589,42,0.02643171806167401
Chiapas,Santiago el Pinar,4959,2508,2451,1101,10,0.009082652134423252
Chiapas,Capitán Luis Ángel Vidal,4315,2041,2274,1045,262,0.2507177033492823
Chiapas,Rincón Chamula San Pedro,8718,4691,4027,2294,99,0.043156059285091544
Chiapas,El Parral,15587,7996,7591,5371,2773,0.5162911934462856
Chiapas,Emiliano Zapata,10783,5412,5371,3604,1517,0.4209211986681465
Chiapas,Mezcalapa,23847,12148,11699,7300,2966,0.4063013698630137
Chiapas,Honduras de la Sierra,11650,5753,5897,2971,663,0.2231571861326153
Chihuahua,Ahumada,14635,7258,7377,5407,3766,0.6965045311633068
Chihuahua,Aldama,26047,13205,12842,11514,7512,0.6524231370505471
Chihuahua,Allende,8487,4231,4256,4242,2369,0.5584629891560584
Chihuahua,Aquiles Serdán,24344,10850,13494,9277,5764,0.6213215479141964
Chihuahua,Ascensión,26093,12862,13231,10891,6542,0.6006794601046735
Chihuahua,Bachíniva,5807,2865,2942,2978,1780,0.5977165883143049
Chihuahua,Balleza,16440,8298,8142,6731,1352,0.2008616847422374
Chihuahua,Batopilas de Manuel Gómez Morín,11270,5673,5597,4399,238,0.05410320527392589
Chihuahua,Bocoyna,23351,12373,10978,11789,3569,0.3027398422258037
Chihuahua,Buenaventura,25146,12637,12509,10641,6973,0.655295554929048
Chihuahua,Camargo,49499,25052,24447,19467,14149,0.726819746237222
Chihuahua,Carichí,8113,4117,3996,3849,945,0.24551831644583008
Chihuahua,Casas Grandes,11815,5790,6025,5427,3159,0.582089552238806
Chihuahua,Coronado,2034,975,1059,1046,587,0.5611854684512428
Chihuahua,Coyame del Sotol,1230,597,633,926,397,0.4287257019438445
Chihuahua,La Cruz,3704,1823,1881,1674,1070,0.6391875746714456
Chihuahua,Cuauhtémoc,180638,92221,88417,68221,50834,0.7451371278638542
Chihuahua,Cusihuiriachi,5099,2439,2660,2824,1441,0.5102691218130312
Chihuahua,Chihuahua,937674,480434,457240,350905,274022,0.7809008136105213
Chihuahua,Chínipas,6222,3066,3156,2682,660,0.24608501118568232
Chihuahua,Delicias,150506,76679,73827,57503,42878,0.7456654435420761
Chihuahua,Dr. Belisario Domínguez,2456,1212,1244,2033,835,0.4107230693556321
Chihuahua,Galeana,6656,3357,3299,2306,1525,0.6613183000867303
Chihuahua,Santa Isabel,3791,1927,1864,2523,1153,0.456995640110979
Chihuahua,Gómez Farías,7023,3558,3465,4196,2352,0.5605338417540515
Chihuahua,Gran Morelos,2448,1197,1251,1771,831,0.46922642574816487
Chihuahua,Guachochi,50180,25882,24298,20136,3996,0.19845053635280097
Chihuahua,Guadalupe,4237,2104,2133,2917,1180,0.4045251971203291
Chihuahua,Guadalupe y Calvo,50514,25336,25178,17442,2720,0.15594541910331383
Chihuahua,Guazapares,8196,4091,4105,3075,1065,0.3463414634146341
Chihuahua,Guerrero,35473,17771,17702,17065,9245,0.5417521242308819
Chihuahua,Hidalgo del Parral,116662,60415,56247,41166,29741,0.7224651411358889
Chihuahua,Huejotitán,824,413,411,444,220,0.4954954954954955
Chihuahua,Ignacio Zaragoza,5196,2591,2605,3330,1818,0.5459459459459459
Chihuahua,Janos,11005,5245,5760,4576,2835,0.6195367132867133
Chihuahua,Jiménez,40859,20671,20188,14624,10041,0.6866110503282276
Chihuahua,Juárez,1512450,755473,756977,520392,395092,0.7592199726360128
Chihuahua,Julimes,4980,2463,2517,2467,1483,0.6011349817592218
Chihuahua,López,4122,2005,2117,1939,1124,0.5796802475502837
Chihuahua,Madera,25144,12738,12406,12350,7057,0.571417004048583
Chihuahua,Maguarichi,1302,681,621,723,99,0.13692946058091288
Chihuahua,Manuel Benavides,1178,552,626,918,374,0.4074074074074074
Chihuahua,Matachí,2742,1328,1414,1508,851,0.5643236074270557
Chihuahua,Matamoros,4314,2151,2163,2153,1157,0.5373896888063168
Chihuahua,Meoqui,44853,22472,22381,17420,12438,0.7140068886337543
Chihuahua,Morelos,7266,3601,3665,2771,320,0.11548177553229881
Chihuahua,Moris,4447,2113,2334,2038,611,0.2998037291462218
Chihuahua,Namiquipa,22712,11322,11390,11141,7128,0.6397989408491159
Chihuahua,Nonoava,2757,1380,1377,1348,506,0.37537091988130566
Chihuahua,Nuevo Casas Grandes,65753,33614,32139,25184,18852,0.7485705209656925
Chihuahua,Ocampo,8127,4017,4110,3612,1410,0.3903654485049834
Chihuahua,Ojinaga,24534,12341,12193,11727,7535,0.6425343225036241
Chihuahua,Praxedis G. Guerrero,5111,2512,2599,3209,1471,0.45839825490807107
Chihuahua,Riva Palacio,7695,3802,3893,3121,2074,0.6645305991669337
Chihuahua,Rosales,16776,8361,8415,6959,4755,0.6832878287110217
Chihuahua,Rosario,2079,997,1082,1091,531,0.4867094408799267
Chihuahua,San Francisco de Borja,2197,1045,1152,1342,625,0.46572280178837555
Chihuahua,San Francisco de Conchos,2696,1295,1401,1422,828,0.5822784810126582
Chihuahua,San Francisco del Oro,5004,2520,2484,2212,1357,0.6134719710669078
Chihuahua,Santa Bárbara,11582,5765,5817,4388,3000,0.6836827711941659
Chihuahua,Satevó,3414,1609,1805,2139,1051,0.49135109864422627
Chihuahua,Saucillo,29862,15034,14828,11575,8295,0.7166306695464363
Chihuahua,Temósachic,5320,2654,2666,2862,1219,0.42592592592592593
Chihuahua,El Tule,1448,722,726,779,356,0.45699614890885754
Chihuahua,Urique,17043,8685,8358,7180,1193,0.16615598885793872
Chihuahua,Uruachi,6512,3224,3288,2884,413,0.14320388349514562
Chihuahua,Valle de Zaragoza,4775,2356,2419,2914,1463,0.5020590253946465
Ciudad de México,Azcapotzalco,432205,227255,204950,149381,115721,0.7746701387726685
Ciudad de México,Coyoacán,614447,325337,289110,208024,167211,0.8038062915817406
Ciudad de México,Cuajimalpa de Morelos,217686,113537,104149,65831,51099,0.7762148531846699
Ciudad de México,Gustavo A. Madero,1173351,609477,563874,370297,276870,0.7476971187992342
Ciudad de México,Iztacalco,404695,212343,192352,130175,97981,0.75268676781256
Ciudad de México,Iztapalapa,1835486,947835,887651,537596,397599,0.7395869760935722
Ciudad de México,La Magdalena Contreras,247622,129335,118287,71545,56903,0.7953455866936893
Ciudad de México,Milpa Alta,152685,78314,74371,44823,26378,0.588492515003458
Ciudad de México,Álvaro Obregón,759137,398130,361007,236129,187834,0.795471966594531
Ciudad de México,Tláhuac,392313,202123,190190,118983,82512,0.6934772194347092
Ciudad de México,Tlalpan,699928,365051,334877,224761,167823,0.7466731327943905
Ciudad de México,Xochimilco,442178,226726,215452,131035,88997,0.6791849505857214
Ciudad de México,Benito Juárez,434153,232032,202121,199993,157519,0.7876225667898377
Ciudad de México,Cuauhtémoc,545884,284933,260951,227906,163848,0.718927979079094
Ciudad de México,Miguel Hidalgo,414470,219003,195467,168191,128315,0.7629124031606923
Ciudad de México,Venustiano Carranza,443704,233586,210118,151569,112817,0.7443276659475222
Durango,Canatlán,31454,15803,15651,11723,6751,0.5758764821291479
Durango,Canelas,4321,2111,2210,1684,547,0.3248218527315915
Durango,Coneto de Comonfort,4084,2020,2064,1665,787,0.47267267267267266
Durango,Cuencamé,34955,17440,17515,12922,7468,0.5779291131403808
Durango,Durango,688697,353285,335412,224232,149114,0.6649987512933033
Durango,General Simón Bolívar,10038,5057,4981,4021,2039,0.5070877891071872
Durango,Gómez Palacio,372750,188213,184537,123433,84591,0.6853191610023252
Durango,Guadalupe Victoria,36695,18635,18060,13775,8515,0.6181488203266787
Durango,Guanaceví,9869,4716,5153,4361,1505,0.3451043338683788
Durango,Hidalgo,3843,1907,1936,1957,981,0.5012774655084312
Durango,Indé,4748,2374,2374,2822,1238,0.43869596031183555
Durango,Lerdo,163313,82457,80856,54303,36962,0.6806622101909655
Durango,Mapimí,26932,13462,13470,9307,5612,0.6029869990329859
Durango,Mezquital,48583,24725,23858,12726,995,0.07818639006757819
Durango,Nazas,12894,6369,6525,5233,2965,0.5665965985094592
Durango,Nombre de Dios,19060,9552,9508,7638,3958,0.5181984812778214
Durango,Ocampo,8003,3911,4092,4099,2047,0.49939009514515736
Durango,El Oro,10384,5201,5183,6229,2687,0.43136940118799166
Durango,Otáez,4924,2332,2592,1749,442,0.252715837621498
Durango,Pánuco de Coronado,12656,6353,6303,5315,3042,0.5723424270931327
Durango,Peñón Blanco,11118,5506,5612,4304,2211,0.5137081784386617
Durango,Poanas,25623,13004,12619,9498,5315,0.5595914929458834
Durango,Pueblo Nuevo,51269,25887,25382,16103,6241,0.3875675339998758
Durango,Rodeo,12818,6314,6504,5190,2773,0.5342967244701349
Durango,San Bernardo,2837,1308,1529,1747,722,0.41327990841442475
Durango,San Dimas,17333,8462,8871,6742,2341,0.34722634233165234
Durango,San Juan de Guadalupe,5251,2630,2621,2540,1179,0.4641732283464567
Durango,San Juan del Río,12013,6092,5921,4863,2474,0.508739461237919
Durango,San Luis del Cordero,2103,1037,1066,1039,524,0.5043310875842156
Durango,San Pedro del Gallo,1633,782,851,840,420,0.5
Durango,Santa Clara,6727,3373,3354,2812,1534,0.5455192034139402
Durango,Santiago Papasquiaro,49207,24260,24947,19868,10040,0.5053352124018522
Durango,Súchil,6917,3524,3393,2681,1293,0.4822827303245058
Durango,Tamazula,26300,12794,13506,8761,2644,0.3017920328729597
Durango,Tepehuanes,11378,5629,5749,6981,2066,0.2959461395215585
Durango,Tlahualilo,21143,10606,10537,7555,4701,0.6222369291859695
Durango,Topia,9320,4561,4759,3018,1294,0.42876076872100727
Durango,Vicente Guerrero,23476,11996,11480,8612,5086,0.5905712958662331
Durango,Nuevo Ideal,27981,14096,13885,10627,6212,0.5845487908158464
Guanajuato,Abasolo,92040,47187,44853,27505,15732,0.571968732957644
Guanajuato,Acámbaro,108697,56489,52208,45739,24443,0.5344017140733291
Guanajuato,San Miguel de Allende,174615,91538,83077,61035,31961,0.5236503645449332
Guanajuato,Apaseo el Alto,63392,32842,30550,22999,11730,0.5100221748771686
Guanajuato,Apaseo el Grande,117883,60630,57253,40881,22143,0.5416452630806488
Guanajuato,Atarjea,5296,2713,2583,2232,650,0.29121863799283154
Guanajuato,Celaya,521169,268124,253045,180622,119273,0.6603459157799161
Guanajuato,Manuel Doblado,41240,21463,19777,15891,9085,0.5717072556793154
Guanajuato,Comonfort,82216,43483,38733,24694,12261,0.4965173726411274
Guanajuato,Coroneo,11083,5813,5270,5070,2067,0.4076923076923077
Guanajuato,Cortazar,97928,50393,47535,31346,21142,0.674472021948574
Guanajuato,Cuerámaro,30857,15990,14867,11338,6052,0.5337802081495855
Guanajuato,Doctor Mora,27390,14257,13133,8464,4555,0.5381616257088847
Guanajuato,Dolores Hidalgo Cuna de la Independencia Nacional,163038,86327,76711,50340,29591,0.5878228049264999
Guanajuato,Guanajuato,194500,100462,94038,63114,42650,0.6757613207846119
Guanajuato,Huanímaro,21128,11137,9991,7390,4027,0.5449255751014885
Guanajuato,Irapuato,592953,302183,290770,179354,126016,0.702610479833179
Guanajuato,Jaral del Progreso,38782,19935,18847,13077,8151,0.6233080981876578
Guanajuato,Jerécuaro,49517,25903,23614,21773,9253,0.42497588756717036
Guanajuato,León,1721215,874542,846673,511648,374781,0.7324977328163113
Guanajuato,Moroleón,47261,24559,22702,19856,12107,0.6097401289282837
Guanajuato,Ocampo,26383,12881,13502,8897,4725,0.5310778914240756
Guanajuato,Pénjamo,154960,80543,74417,52573,28317,0.5386224868278394
Guanajuato,Pueblo Nuevo,12403,6482,5921,4511,2714,0.6016404344934604
Guanajuato,Purísima del Rincón,83842,42508,41334,23696,16822,0.7099088453747467
Guanajuato,Romita,65766,33513,32253,20510,12741,0.6212091662603608
Guanajuato,Salamanca,273417,141139,132278,93638,65559,0.700132424870245
Guanajuato,Salvatierra,94126,48679,45447,38171,21178,0.5548191035078986
Guanajuato,San Diego de la Unión,41054,21809,19245,13180,7463,0.566236722306525
Guanajuato,San Felipe,119793,61706,58087,36661,18977,0.5176345435203622
Guanajuato,San Francisco del Rincón,130871,66889,63982,38921,27534,0.7074330053184656
Guanajuato,San José Iturbide,89558,46139,43419,28189,17368,0.616126857994253
Guanajuato,San Luis de la Paz,128536,67884,60652,38180,22021,0.5767679413305395
Guanajuato,Santa Catarina,5723,3030,2693,2384,722,0.3028523489932886
Guanajuato,Santa Cruz de Juventino Rosas,82340,43178,39162,23941,15054,0.6287957896495552
Guanajuato,Santiago Maravatío,6714,3495,3219,3383,1690,0.4995566065622229
Guanajuato,Silao de la Victoria,203556,103483,100073,57175,36517,0.6386882378662002
Guanajuato,Tarandacuao,11304,5810,5494,5199,2386,0.45893441046355066
Guanajuato,Tarimoro,35905,18505,17400,15897,8118,0.5106623891300245
Guanajuato,Tierra Blanca,20007,10347,9660,6623,1728,0.26090895364638383
Guanajuato,Uriangato,61494,31862,29632,22919,14568,0.6356298267812732
Guanajuato,Valle de Santiago,150054,77750,72304,49543,30874,0.6231758270593222
Guanajuato,Victoria,21253,11318,9935,7422,2581,0.34774993263271353
Guanajuato,Villagrán,65791,33804,31987,22120,13553,0.6127034358047017
Guanajuato,Xichú,11143,5873,5270,4304,1601,0.37197955390334575
Guanajuato,Yuriria,68741,35883,32858,30247,14911,0.4929745098687473
Guerrero,Acapulco de Juárez,779566,407772,371794,331319,130559,0.39405829427228745
Guerrero,Ahuacuotzingo,25205,13443,11762,7971,1598,0.2004767281395057
Guerrero,Ajuchitlán del Progreso,37655,19277,18378,13201,3493,0.2646011665782895
Guerrero,Alcozauca de Guerrero,21225,11330,9895,6695,1006,0.15026138909634054
Guerrero,Alpoyeca,7813,4111,3702,3082,1142,0.3705386112913692
Guerrero,Apaxtla,11112,5709,5403,4110,1471,0.3579075425790754
Guerrero,Arcelia,33267,17208,16059,12492,5481,0.4387608069164265
Guerrero,Atenango del Río,9147,4735,4412,3299,1214,0.36799030009093664
Guerrero,Atlamajalcingo del Monte,5811,3096,2715,2100,52,0.024761904761904763
Guerrero,Atlixtac,28491,14985,13506,9861,696,0.07058107696988135
Guerrero,Atoyac de Álvarez,60680,31201,29479,22620,7229,0.3195844385499558
Guerrero,Ayutla de los Libres,69123,35645,33478,19262,2937,0.15247637836154085
Guerrero,Azoyú,15099,7712,7387,5543,1405,0.2534728486379217
Guerrero,Benito Juárez,15442,7874,7568,6610,2738,0.41422087745839636
Guerrero,Buenavista de Cuéllar,12982,6732,6250,5507,2612,0.4743054294534229
Guerrero,Coahuayutla de José María Izazaga,12408,6149,6259,4593,1981,0.43130851295449596
Guerrero,Cocula,15579,7948,7631,6586,2426,0.3683571211661099
Guerrero,Copala,14463,7479,6984,5782,2269,0.3924247665167762
Guerrero,Copalillo,15598,8122,7476,4774,576,0.12065354000837872
Guerrero,Copanatoyac,21648,11618,10030,6490,356,0.054853620955315874
Guerrero,Coyuca de Benítez,73056,37541,35515,26843,9342,0.3480236933278695
Guerrero,Coyuca de Catalán,38554,19529,19025,16272,5984,0.36774827925270404
Guerrero,Cuajinicuilapa,26627,13443,13184,10144,4302,0.4240930599369085
Guerrero,Cualác,7874,4098,3776,2796,739,0.26430615164520743
Guerrero,Cuautepec,17024,8755,8269,5353,1077,0.20119559125723893
Guerrero,Cuetzala del Progreso,8272,4180,4092,3976,780,0.19617706237424548
Guerrero,Cutzamala de Pinzón,20537,10349,10188,9624,4340,0.45095594347464674
Guerrero,Chilapa de Álvarez,123722,65981,57741,40126,6331,0.15777799930219807
Guerrero,Chilpancingo de los Bravo,283354,148857,134497,94480,39564,0.41875529212531754
Guerrero,Florencio Villarreal,22250,11343,10907,7536,3166,0.4201167728237792
Guerrero,General Canuto A. Neri,6278,3223,3055,2221,712,0.32057631697433586
Guerrero,General Heliodoro Castillo,37254,19000,18254,10259,2211,0.2155180816843747
Guerrero,Huamuxtitlán,17488,9196,8292,6863,3014,0.4391665452426053
Guerrero,Huitzuco de los Figueroa,36593,19084,17509,14667,5293,0.36087816185995775
Guerrero,Iguala de la Independencia,154173,80237,73936,58634,24195,0.41264454071016815
Guerrero,Igualapa,11739,6140,5599,3821,705,0.1845066736456425
Guerrero,Ixcateopan de Cuauhtémoc,6138,3140,2998,3322,662,0.19927754364840458
Guerrero,Zihuatanejo de Azueta,126001,64564,61437,53085,25950,0.48883865498728457
Guerrero,Juan R. Escudero,26093,13332,12761,9376,3015,0.3215656996587031
Guerrero,Leonardo Bravo,26357,13560,12797,7876,2042,0.2592686642965973
Guerrero,Malinaltepec,29625,15738,13887,11238,617,0.05490300765260723
Guerrero,Mártir de Cuilapan,18613,9926,8687,6750,1135,0.16814814814814816
Guerrero,Metlatónoc,18859,10084,8775,8906,291,0.032674601392319785
Guerrero,Mochitlán,12402,6378,6024,4320,1281,0.2965277777777778
Guerrero,Olinalá,28446,14937,13509,8934,2292,0.25654801880456685
Guerrero,Ometepec,68207,35166,33041,22794,4889,0.21448626831622356
Guerrero,Pedro Ascencio Alquisiras,7076,3724,3352,2449,565,0.23070641077991016
Guerrero,Petatlán,44583,22691,21892,17214,8738,0.5076100848146857
Guerrero,Pilcaya,12753,6510,6243,4883,1954,0.4001638337087856
Guerrero,Pungarabato,38482,19693,18789,14382,5884,0.40912251425392854
Guerrero,Quechultenango,36143,18795,17348,12056,2519,0.20894160583941607
Guerrero,San Luis Acatlán,46270,23627,22643,13989,1360,0.09721924369147188
Guerrero,San Marcos,50124,25550,24574,19480,5237,0.26883983572895276
Guerrero,San Miguel Totolapan,24139,12272,11867,7357,1907,0.25920891667799373
Guerrero,Taxco de Alarcón,105586,55221,50365,37922,13829,0.3646695849375033
Guerrero,Tecoanapa,46063,23475,22588,14195,2317,0.16322648820007044
Guerrero,Técpan de Galeana,65237,32836,32401,24982,11105,0.44452005443919623
Guerrero,Teloloapan,53817,28132,25685,20872,6526,0.3126676887696435
Guerrero,Tepecoacuilco de Trujano,30806,15966,14840,13299,3715,0.2793443116023761
Guerrero,Tetipac,13552,6954,6598,5159,1692,0.3279705369257608
Guerrero,Tixtla de Guerrero,43171,22564,20607,14357,3852,0.26830117712614054
Guerrero,Tlacoachistlahuaca,22781,12170,10611,6823,733,0.10743074893741755
Guerrero,Tlacoapa,10092,5359,4733,3660,237,0.06475409836065574
Guerrero,Tlalchapa,11681,5861,5820,4964,2416,0.48670427074939565
Guerrero,Tlalixtaquilla de Maldonado,7602,3902,3700,3166,1022,0.3228048010107391
Guerrero,Tlapa de Comonfort,96125,51104,45021,32358,6826,0.21095246925026268
Guerrero,Tlapehuala,22209,11334,10875,8498,2587,0.3044245704871735
Guerrero,La Unión de Isidoro Montes de Oca,26349,12988,13361,9736,5512,0.5661462612982745
Guerrero,Xalpatláhuac,11966,6545,5421,4061,424,0.10440778133464663
Guerrero,Xochihuehuetlán,7862,4122,3740,3461,1188,0.3432533949725513
Guerrero,Xochistlahuaca,29891,15631,14260,9870,690,0.06990881458966565
Guerrero,Zapotitlán Tablas,12004,6175,5829,4186,168,0.04013377926421405
Guerrero,Zirándaro,18031,8952,9079,7288,3128,0.429198682766191
Guerrero,Zitlala,21977,11926,10051,7630,555,0.0727391874180865
Guerrero,Eduardo Neri,53126,27401,25725,16461,5628,0.34189903408055405
Guerrero,Acatepec,40197,20657,19540,12386,120,0.009688357823348943
Guerrero,Marquelia,14280,7253,7027,4853,1499,0.30888110447146094
Guerrero,Cochoapa el Grande,21241,11312,9929,10060,118,0.01172962226640159
Guerrero,José Joaquín de Herrera,18381,9590,8791,5136,101,0.01966510903426791
Guerrero,Juchitán,7559,3741,3818,3048,1035,0.3395669291338583
Guerrero,Iliatenco,11679,6113,5566,3909,226,0.05781529803018675
Hidalgo,Acatlán,22268,11563,10705,8021,3752,0.46777209824211446
Hidalgo,Acaxochitlán,46065,24348,21717,14516,3535,0.24352438688343897
Hidalgo,Actopan,61002,31925,29077,20899,9978,0.4774391119192306
Hidalgo,Agua Blanca de Iturbide,10313,5400,4913,4170,1291,0.3095923261390887
Hidalgo,Ajacuba,18872,9764,9108,7146,2880,0.40302267002518893
Hidalgo,Alfajayucan,19162,9964,9198,8104,2759,0.3404491609081935
Hidalgo,Almoloya,12546,6476,6070,4559,2022,0.44351831542004827
Hidalgo,Apan,46681,24393,22288,16113,8863,0.5500527524359213
Hidalgo,El Arenal,19836,10261,9575,6789,2934,0.4321696862571807
Hidalgo,Atitalaquia,31525,16044,15481,10764,6197,0.5757153474544779
Hidalgo,Atlapexco,19812,10301,9511,6528,963,0.14751838235294118
Hidalgo,Atotonilco el Grande,30135,15874,14261,12095,4782,0.3953699875981811
Hidalgo,Atotonilco de Tula,62470,32056,30414,36898,13102,0.3550869965851808
Hidalgo,Calnali,16150,8406,7744,7011,1480,0.21109684781058338
Hidalgo,Cardonal,19431,10123,9308,7531,2196,0.29159474173416544
Hidalgo,Cuautepec de Hinojosa,60421,31555,28866,21130,9144,0.432749645054425
Hidalgo,Chapantongo,12967,6690,6277,6109,1737,0.28433458831232605
Hidalgo,Chapulhuacán,22903,11641,11262,8362,3498,0.41832097584309974
Hidalgo,Chilcuautla,18909,9719,9190,7355,2252,0.3061862678450034
Hidalgo,Eloxochitlán,2593,1354,1239,1455,450,0.30927835051546393
Hidalgo,Emiliano Zapata,15175,7837,7338,5026,3067,0.6102268205332272
Hidalgo,Epazoyucan,16285,8406,7879,6663,3130,0.46975836710190605
Hidalgo,Francisco I. Madero,36248,18952,17296,12629,5862,0.4641697679942988
Hidalgo,Huasca de Ocampo,17607,9288,8319,6724,2985,0.44393218322427125
Hidalgo,Huautla,20673,10812,9861,7118,890,0.1250351222253442
Hidalgo,Huazalingo,12766,6571,6195,3577,376,0.10511601901034387
Hidalgo,Huehuetla,22846,11830,11016,8538,1199,0.14043101428906066
Hidalgo,Huejutla de Reyes,126781,65460,61321,41088,9713,0.23639505451713397
Hidalgo,Huichapan,47425,24645,22780,17933,7978,0.44487815758657223
Hidalgo,Ixmiquilpan,98654,52214,46440,36676,13780,0.37572254335260113
Hidalgo,Jacala de Ledezma,12290,6430,5860,5881,2656,0.4516238734909029
Hidalgo,Jaltocán,10523,5385,5138,3584,548,0.15290178571428573
Hidalgo,Juárez Hidalgo,2895,1525,1370,1472,513,0.3485054347826087
Hidalgo,Lolotla,9474,4897,4577,3491,941,0.26955027212833
Hidalgo,Metepec,13078,6893,6185,4265,2039,0.4780773739742087
Hidalgo,San Agustín Metzquititlán,9449,4867,4582,3906,1767,0.4523809523809524
Hidalgo,Metztitlán,20962,10888,10074,9490,3279,0.3455216016859852
Hidalgo,Mineral del Chico,8878,4577,4301,3657,1379,0.37708504238446816
Hidalgo,Mineral del Monte,14324,7507,6817,4815,2613,0.5426791277258567
Hidalgo,La Misión,9819,5062,4757,4256,1698,0.39896616541353386
Hidalgo,Mixquiahuala de Juárez,47222,24597,22625,15631,7745,0.4954897319429339
Hidalgo,Molango de Escamilla,11578,5893,5685,4870,1700,0.3490759753593429
Hidalgo,Nicolás Flores,6265,3229,3036,2624,605,0.2305640243902439
Hidalgo,Nopala de Villagrán,16948,8711,8237,7434,3054,0.41081517352703795
Hidalgo,Omitlán de Juárez,9295,4873,4422,3415,1598,0.4679355783308931
Hidalgo,San Felipe Orizatlán,38492,19764,18728,13448,2912,0.2165377751338489
Hidalgo,Pacula,4748,2518,2230,2474,970,0.3920776071139854
Hidalgo,Pachuca de Soto,314331,164772,149559,124339,70678,0.5684298570842615
Hidalgo,Pisaflores,18723,9614,9109,6267,2613,0.4169459071325993
Hidalgo,Progreso de Obregón,23641,12476,11165,8031,3988,0.49657576889552985
Hidalgo,Mineral de la Reforma,202749,106490,96259,97588,48522,0.49721277206213876
Hidalgo,San Agustín Tlaxiaca,38891,19941,18950,14153,6614,0.46732141595421467
Hidalgo,San Bartolo Tutotepec,17699,8962,8737,6739,1121,0.16634515506751743
Hidalgo,San Salvador,36796,18927,17869,12948,5206,0.40206981773246836
Hidalgo,Santiago de Anaya,18329,9383,8946,7041,2585,0.36713535009231646
Hidalgo,Santiago Tulantepec de Lugo Guerrero,39561,20915,18646,14169,7623,0.538005504975651
Hidalgo,Singuilucan,15142,7763,7379,5367,2404,0.44792248928637973
Hidalgo,Tasquillo,17441,9295,8146,7953,2726,0.3427637369546083
Hidalgo,Tecozautla,38010,19873,18137,14162,5094,0.3596949583392176
Hidalgo,Tenango de Doria,17503,9108,8395,6462,1921,0.2972763850201176
Hidalgo,Tepeapulco,56245,29305,26940,20610,12829,0.6224648229015042
Hidalgo,Tepehuacán de Guerrero,31235,15667,15568,9235,1881,0.2036816459122902
Hidalgo,Tepeji del Río de Ocampo,90546,46484,44062,30537,16211,0.5308641975308642
Hidalgo,Tepetitlán,10830,5575,5255,4771,1752,0.3672186124502201
Hidalgo,Tetepango,11768,6028,5740,3960,1951,0.49267676767676766
Hidalgo,Villa de Tezontepec,13032,6706,6326,4484,2364,0.5272078501338091
Hidalgo,Tezontepec de Aldama,55134,28045,27089,18452,7232,0.3919358335139822
Hidalgo,Tianguistengo,14340,7322,7018,5842,988,0.1691201643272852
Hidalgo,Tizayuca,168302,86255,82047,87237,36156,0.4144571684033151
Hidalgo,Tlahuelilpan,19067,9763,9304,5936,3060,0.5154986522911051
Hidalgo,Tlahuiltepa,9086,4675,4411,4274,1648,0.38558727187646236
Hidalgo,Tlanalapa,11113,5747,5366,3982,2444,0.6137619286790558
Hidalgo,Tlanchinol,37722,19245,18477,11663,2451,0.21015176198233732
Hidalgo,Tlaxcoapan,28626,14720,13906,8012,4116,0.5137294058911632
Hidalgo,Tolcayuca,21362,11058,10304,9940,4335,0.43611670020120724
Hidalgo,Tula de Allende,115107,59519,55588,43010,23279,0.5412462218088816
Hidalgo,Tulancingo de Bravo,168369,88602,79767,59262,30547,0.515456785123688
Hidalgo,Xochiatipan,18260,9417,8843,5501,160,0.029085620796218868
Hidalgo,Xochicoatlán,7015,3561,3454,3339,813,0.24348607367475292
Hidalgo,Yahualica,24674,12614,12060,7743,467,0.06031254035903397
Hidalgo,Zacualtipán de Ángeles,38155,20018,18137,13346,5800,0.43458714221489586
Hidalgo,Zapotlán de Juárez,21443,11101,10342,7808,4018,0.5146004098360656
Hidalgo,Zempoala,57906,30000,27906,31807,13001,0.4087465023422517
Hidalgo,Zimapán,39927,21028,18899,15807,6698,0.42373631935218575
Jalisco,Acatic,23175,11792,11383,8750,5811,0.6641142857142858
Jalisco,Acatlán de Juárez,25250,12006,13244,7997,5254,0.6569963736401151
Jalisco,Ahualulco de Mercado,23630,11846,11784,8386,5569,0.6640829954686382
Jalisco,Amacueca,5743,2967,2776,2284,1327,0.5809982486865148
Jalisco,Amatitán,16490,8306,8184,5097,3644,0.7149303511869727
Jalisco,Ameca,60386,30822,29564,23046,14754,0.6401978651392867
Jalisco,San Juanito de Escobedo,9433,4713,4720,3718,2244,0.6035502958579881
Jalisco,Arandas,80609,41117,39492,29956,20236,0.6755241020162905
Jalisco,El Arenal,21115,10770,10345,8977,4722,0.5260109167873455
Jalisco,Atemajac de Brizuela,7758,3911,3847,2641,1182,0.44755774327906095
Jalisco,Atengo,5599,2766,2833,2314,1167,0.5043215211754538
Jalisco,Atenguillo,4176,2121,2055,1903,1164,0.6116657908565423
Jalisco,Atotonilco el Alto,64009,32438,31571,21920,14785,0.6744981751824818
Jalisco,Atoyac,8689,4475,4214,3585,2124,0.5924686192468619
Jalisco,Autlán de Navarro,64931,33045,31886,24636,15590,0.6328137684689072
Jalisco,Ayotlán,41552,21188,20364,14392,8701,0.6045719844357976
Jalisco,Ayutla,12880,6466,6414,5338,2915,0.54608467590858
Jalisco,La Barca,67937,35086,32851,23597,14009,0.5936771623511463
Jalisco,Bolaños,7043,3541,3502,2419,638,0.26374534931789995
Jalisco,Cabo Corrientes,10940,5296,5644,4674,2192,0.4689773213521609
Jalisco,Casimiro Castillo,20548,10354,10194,8239,5171,0.6276247117368613
Jalisco,Cihuatlán,40139,20160,19979,16334,8201,0.5020815476919309
Jalisco,Zapotlán el Grande,115141,58953,56188,38063,26340,0.6920106139820823
Jalisco,Cocula,29267,14872,14395,11676,6706,0.5743405275779376
Jalisco,Colotlán,19689,10207,9482,8356,4688,0.5610339875538535
Jalisco,Concepción de Buenos Aires,6334,3136,3198,2916,1590,0.5452674897119342
Jalisco,Cuautitlán de García Barragán,18370,9023,9347,6586,2446,0.37139386577588823
Jalisco,Cuautla,2166,1109,1057,1246,574,0.4606741573033708
Jalisco,Cuquío,17820,9165,8655,7329,4075,0.5560103697639515
Jalisco,Chapala,55196,28381,26815,22868,13701,0.5991341612733951
Jalisco,Chimaltitán,3270,1646,1624,1332,432,0.32432432432432434
Jalisco,Chiquilistlán,5983,3008,2975,2187,1027,0.4695930498399634
Jalisco,Degollado,21226,10963,10263,9462,5131,0.5422743606002959
Jalisco,Ejutla,1981,974,1007,1100,552,0.5018181818181818
Jalisco,Encarnación de Díaz,53039,27472,25567,19519,13066,0.66939904708233
Jalisco,Etzatlán,20011,10227,9784,6910,4638,0.6712011577424023
Jalisco,El Grullo,25920,13294,12626,9594,6184,0.6445695226183031
Jalisco,Guachinango,4199,2045,2154,2035,1041,0.5115479115479116
Jalisco,Guadalajara,1385629,718632,666997,454874,345498,0.759546599717724
Jalisco,Hostotipaquillo,8732,4364,4368,3209,1725,0.5375506388282955
Jalisco,Huejúcar,5920,3013,2907,3106,1571,0.5057952350289762
Jalisco,Huejuquilla el Alto,10015,5177,4838,4341,1868,0.43031559548491133
Jalisco,La Huerta,23258,11632,11626,10270,5685,0.5535540408958131
Jalisco,Ixtlahuacán de los Membrillos,67969,34547,33422,34492,13994,0.40571726777223704
Jalisco,Ixtlahuacán del Río,20465,10489,9976,8208,4785,0.58296783625731
Jalisco,Jalostotitlán,32678,16666,16012,12314,8018,0.651128796491798
Jalisco,Jamay,24894,12430,12464,8321,5179,0.622401153707487
Jalisco,Jesús María,18982,10108,8874,9309,4719,0.5069287786013535
Jalisco,Jilotlán de los Dolores,9425,4372,5053,3638,2074,0.5700934579439252
Jalisco,Jocotepec,47105,23876,23229,16899,8545,0.5056512219657968
Jalisco,Juanacatlán,30855,15596,15259,12428,6832,0.5497264242034117
Jalisco,Juchitlán,5534,2865,2669,2627,1350,0.5138941758660068
Jalisco,Lagos de Moreno,172403,88426,83977,59151,36823,0.6225254010921202
Jalisco,El Limón,5368,2698,2670,3033,1581,0.5212660731948566
Jalisco,Magdalena,21781,11192,10589,7377,4856,0.6582621661922191
Jalisco,Santa María del Oro,1815,901,914,890,427,0.4797752808988764
Jalisco,La Manzanilla de la Paz,4099,2097,2002,1924,1088,0.5654885654885655
Jalisco,Mascota,14451,7412,7039,6179,3771,0.6102929276581971
Jalisco,Mazamitla,14043,7283,6760,7270,2975,0.4092159559834938
Jalisco,Mexticacán,5307,2860,2447,3159,1413,0.4472934472934473
Jalisco,Mezquitic,22083,11468,10615,6767,1067,0.15767696172602336
Jalisco,Mixtlán,3638,1821,1817,1718,938,0.5459837019790454
Jalisco,Ocotlán,106050,54275,51775,35689,23652,0.6627252094482894
Jalisco,Ojuelos de Jalisco,33588,17330,16258,10804,6395,0.5919104035542392
Jalisco,Pihuamo,11386,5712,5674,5191,2866,0.5521094201502601
Jalisco,Poncitlán,53659,27279,26380,16457,8578,0.5212371635170444
Jalisco,Puerto Vallarta,291839,145652,146187,118295,66093,0.5587133860264593
Jalisco,Villa Purificación,11303,5608,5695,5333,2683,0.5030939433714607
Jalisco,Quitupan,7734,4057,3677,4818,1969,0.408675799086758
Jalisco,El Salto,232852,111162,121690,80505,43778,0.5437923110365815
Jalisco,San Cristóbal de la Barranca,2924,1459,1465,1214,586,0.4827018121911038
Jalisco,San Diego de Alejandría,7609,3870,3739,2767,1741,0.6292013010480665
Jalisco,San Juan de los Lagos,72230,36502,35728,23848,16815,0.7050905736330091
Jalisco,San Julián,16792,8741,8051,6311,4282,0.6784978608778324
Jalisco,San Marcos,3791,1898,1893,1524,856,0.5616797900262467
Jalisco,San Martín de Bolaños,3095,1585,1510,1341,581,0.4332587621178225
Jalisco,San Martín Hidalgo,28102,14301,13801,11909,6837,0.5741036191115962
Jalisco,San Miguel el Alto,31965,16416,15549,11707,7909,0.6755787135901598
Jalisco,Gómez Farías,16431,8353,8078,5089,3154,0.6197681273334643
Jalisco,San Sebastián del Oeste,5086,2451,2635,2482,1280,0.515713134568896
Jalisco,Santa María de los Ángeles,3515,1799,1716,1829,907,0.49589939857845816
Jalisco,Sayula,37186,19202,17984,11563,7834,0.6775058375854017
Jalisco,Tala,87690,44173,43517,36348,19185,0.5278144602178937
Jalisco,Talpa de Allende,14997,7503,7494,5748,3278,0.570285316631872
Jalisco,Tamazula de Gordiano,38955,19835,19120,15963,10064,0.630457933972311
Jalisco,Tapalpa,21245,10684,10561,7764,3788,0.487892838742916
Jalisco,Tecalitlán,16705,8449,8256,6462,3947,0.6108016094088518
Jalisco,Tecolotlán,16603,8372,8231,7419,4274,0.5760884216201645
Jalisco,Techaluta de Montenegro,4072,2061,2011,1511,887,0.587028457974851
Jalisco,Tenamaxtlán,7302,3728,3574,3374,1865,0.552756372258447
Jalisco,Teocaltiche,39839,20680,19159,15816,9694,0.6129236216489631
Jalisco,Teocuitatlán de Corona,11039,5544,5495,5081,2708,0.5329659515843338
Jalisco,Tepatitlán de Morelos,150190,76480,73710,52997,37708,0.7115119723757949
Jalisco,Tequila,44353,22462,21891,13555,9046,0.667355219476208
Jalisco,Teuchitlán,9647,4938,4709,3822,2323,0.607796964939822
Jalisco,Tizapán el Alto,22758,11579,11179,8971,4917,0.5480994315015049
Jalisco,Tlajomulco de Zúñiga,727750,367408,360342,304504,165461,0.5433787405091559
Jalisco,San Pedro Tlaquepaque,687127,348283,338844,209978,155087,0.738586899579956
Jalisco,Tolimán,11219,5654,5565,3415,1810,0.5300146412884333
Jalisco,Tomatlán,36316,17872,18444,13759,7631,0.5546187949705648
Jalisco,Tonalá,569913,288218,281695,175986,124424,0.7070107849488028
Jalisco,Tonaya,5961,3063,2898,2619,1636,0.6246659030164184
Jalisco,Tonila,7565,3796,3769,3058,1733,0.5667102681491171
Jalisco,Totatiche,4180,2065,2115,2343,1057,0.45113102859581733
Jalisco,Tototlán,23573,12011,11562,8528,5606,0.6573639774859287
Jalisco,Tuxcacuesco,5482,2698,2784,1876,1017,0.5421108742004265
Jalisco,Tuxcueca,6702,3455,3247,2832,1399,0.4939971751412429
Jalisco,Tuxpan,37518,19166,18352,11978,7152,0.5970946735682083
Jalisco,Unión de San Antonio,19069,9746,9323,6996,4229,0.6044882790165809
Jalisco,Unión de Tula,13799,7115,6684,6050,3534,0.5841322314049586
Jalisco,Valle de Guadalupe,6627,3358,3269,2644,1750,0.6618759455370651
Jalisco,Valle de Juárez,6151,3161,2990,3012,1583,0.5255644090305445
Jalisco,San Gabriel,16548,8351,8197,5615,3373,0.6007123775601069
Jalisco,Villa Corona,19063,9573,9490,7463,4095,0.548706954307919
Jalisco,Villa Guerrero,5525,2763,2762,2501,1148,0.45901639344262296
Jalisco,Villa Hidalgo,20088,10418,9670,7962,5242,0.6583772921376538
Jalisco,Cañadas de Obregón,4388,2197,2191,2402,1240,0.5162364696086594
Jalisco,Yahualica de González Gallo,22394,11681,10713,11251,6033,0.5362190027553106
Jalisco,Zacoalco de Torres,30472,15110,15362,10268,5959,0.5803467082197117
Jalisco,Zapopan,1476491,755899,720592,494654,365461,0.7388214792562073
Jalisco,Zapotiltic,33713,17086,16627,11584,7432,0.6415745856353591
Jalisco,Zapotitlán de Vadillo,7466,3692,3774,2790,1216,0.43584229390681006
Jalisco,Zapotlán del Rey,19279,9780,9499,6798,4200,0.617828773168579
Jalisco,Zapotlanejo,64806,32924,31882,24167,15645,0.6473703810981918
Jalisco,San Ignacio Cerro Gordo,18341,9427,8914,6732,4454,0.6616161616161617
México,Acambay de Ruíz Castañeda,67872,35255,32617,23788,6403,0.26916932907348246
México,Acolman,171507,85279,86228,52865,34365,0.6500520192944292
México,Aculco,49266,25177,24089,16288,5801,0.356151768172888
México,Almoloya de Alquisiras,15333,8052,7281,6755,2303,0.34093264248704663
México,Almoloya de Juárez,174587,87457,87130,58495,17375,0.2970339345243183
México,Almoloya del Río,12694,6544,6150,3555,2009,0.5651195499296765
México,Amanalco,23675,12141,11534,7334,2156,0.29397327515680394
México,Amatepec,25244,12997,12247,9878,4253,0.4305527434703381
México,Amecameca,53441,28001,25440,15555,8780,0.5644487303117969
México,Apaxco,31898,16265,15633,9367,5846,0.6241059037044945
México,Atenco,75489,38437,37052,21508,12647,0.5880137623209969
México,Atizapán,12984,6697,6287,3459,1768,0.511130384504192
México,Atizapán de Zaragoza,523674,270245,253429,160533,128554,0.8007948521487793
México,Atlacomulco,109384,57166,52218,37399,13235,0.3538864675526084
México,Atlautla,31900,16315,15585,9831,4066,0.413589665344319
México,Axapusco,29128,14841,14287,10139,4842,0.47756188973271524
México,Ayapango,10053,5243,4810,3230,1763,0.5458204334365325
México,Calimaya,68489,35101,33388,22881,12608,0.5510248677942398
México,Capulhuac,36921,19143,17778,9940,5883,0.5918511066398391
México,Coacalco de Berriozábal,293444,152337,141107,102024,79063,0.7749451109542853
México,Coatepec Harinas,38643,20083,18560,12675,5667,0.4471005917159763
México,Cocotitlán,15107,7757,7350,4686,2746,0.5860008536064875
México,Coyotepec,40885,20893,19992,11026,6740,0.6112824233629602
México,Cuautitlán,178847,91181,87666,64044,45120,0.704515645493723
México,Chalco,400057,206928,193129,137236,75753,0.5519907312949954
México,Chapa de Mota,31737,16213,15524,10152,3442,0.33904649330181247
México,Chapultepec,12772,6607,6165,5198,2458,0.4728741823778376
México,Chiautla,30045,15377,14668,8755,5367,0.61302113078241
México,Chicoloapan,200750,103555,97195,65368,42759,0.654127401786807
México,Chiconcuac,27692,14144,13548,6789,3924,0.5779938135218736
México,Chimalhuacán,705193,360622,344571,198918,122533,0.6159975467277974
México,Donato Guerra,37436,19045,18391,11189,2378,0.21253016355349003
México,Ecatepec de Morelos,1645352,846803,798549,502825,359273,0.7145090240143191
México,Ecatzingo,10827,5506,5321,3205,1179,0.3678627145085803
México,Huehuetoca,163244,83228,80016,84565,34982,0.41366995802045764
México,Hueypoxtla,46757,23649,23108,13575,6697,0.49333333333333335
México,Huixquilucan,284965,148499,136466,91871,68299,0.7434228428992827
México,Isidro Fabela,11929,6112,5817,3706,2014,0.5434430652995142
México,Ixtapaluca,542211,279128,263083,176264,113775,0.645480642672355
México,Ixtapan de la Sal,36911,19235,17676,14175,5683,0.40091710758377425
México,Ixtapan del Oro,6475,3260,3215,2391,777,0.32496863237139273
México,Ixtlahuaca,160139,83364,76775,45753,12175,0.26610276921731907
México,Xalatlaco,30687,15735,14952,8373,3938,0.47032127075122415
México,Jaltenco,28217,14572,13645,8627,6008,0.6964182218615973
México,Jilotepec,87671,44861,42810,28175,12184,0.4324401064773736
México,Jilotzingo,19877,10158,9719,6079,3606,0.5931896693535121
México,Jiquipilco,76826,40362,36464,23486,5939,0.252874052627097
México,Jocotitlán,69264,36019,33245,22268,8621,0.38714747619903
México,Joquicingo,15428,7885,7543,4763,1946,0.408566029813143
México,Juchitepec,27116,13973,13143,7597,3928,0.5170462024483349
México,Lerma,170327,86359,83968,53035,30564,0.5762986706891675
México,Malinalco,28155,14322,13833,10171,3347,0.3290728541932947
México,Melchor Ocampo,61220,31313,29907,17925,11819,0.6593584379358438
México,Metepec,242307,126310,115997,75715,56106,0.7410156507957472
México,Mexicaltzingo,13807,7054,6753,4046,2353,0.5815620365793376
México,Morelos,33164,17194,15970,12141,2570,0.21167943332509678
México,Naucalpan de Juárez,834434,431939,402495,257677,193456,0.7507693740613248
México,Nezahualcóyotl,1077208,557286,519922,318867,233703,0.7329168587530224
México,Nextlalpan,57082,29094,27988,23391,11652,0.49814031037578554
México,Nicolás Romero,430601,220827,209774,132142,86782,0.6567329085377851
México,Nopaltepec,10351,5261,5090,3612,1992,0.5514950166112956
México,Ocoyoacac,72103,36882,35221,20844,11996,0.5755133371713682
México,Ocuilan,36223,18578,17645,11440,4355,0.3806818181818182
México,El Oro,36937,19019,17918,12777,4158,0.32542850434374265
México,Otumba,36331,18134,18197,11152,6112,0.5480631276901005
México,Otzoloapan,4891,2494,2397,1873,884,0.4719701014415376
México,Otzolotepec,88783,45336,43447,24650,11065,0.44888438133874237
México,Ozumba,30785,16033,14752,8575,3994,0.4657725947521866
México,Papalotla,4862,2524,2338,1428,940,0.6582633053221288
México,La Paz,304088,155886,148202,86503,55162,0.6376888662820943
México,Polotitlán,14985,7656,7329,5016,2568,0.5119617224880383
México,Rayón,15972,8223,7749,4398,2623,0.5964074579354252
México,San Antonio la Isla,31962,16541,15421,11587,6376,0.5502718563907828
México,San Felipe del Progreso,144924,75596,69328,40532,5640,0.13914931412217507
México,San Martín de las Pirámides,29182,14914,14268,8923,5120,0.5737980499831895
México,San Mateo Atenco,97418,49937,47481,26738,15926,0.5956316852419777
México,San Simón de Guerrero,6692,3439,3253,2494,1048,0.4202085004009623
México,Santo Tomás,9729,4893,4836,3387,1705,0.5033953351048125
México,Soyaniquilpan de Juárez,14323,7220,7103,5140,2261,0.43988326848249026
México,Sultepec,24145,12707,11438,8798,2505,0.2847238008638327
México,Tecámac,547503,281983,265520,207283,137545,0.6635614112107602
México,Tejupilco,79282,41274,38008,28505,11777,0.4131555867391686
México,Temamatla,14130,7202,6928,4542,2655,0.5845442536327609
México,Temascalapa,43593,22219,21374,14977,7397,0.4938906323028644
México,Temascalcingo,66414,34517,31897,24684,7070,0.28642035326527304
México,Temascaltepec,35014,17825,17189,11918,4125,0.3461151199865749
México,Temoaya,105766,54234,51532,31886,9370,0.29385937401994605
México,Tenancingo,104677,53450,51227,30960,14497,0.468249354005168
México,Tenango del Aire,11359,5807,5552,3447,2105,0.6106759501015375
México,Tenango del Valle,90518,46028,44490,25398,12911,0.50834711394598
México,Teoloyucan,65459,33520,31939,17975,12124,0.6744923504867872
México,Teotihuacán,58507,30312,28195,18092,11574,0.6397302675215565
México,Tepetlaoxtoc,32564,16658,15906,9984,5697,0.5706129807692307
México,Tepetlixpa,20500,10554,9946,6192,2639,0.4261950904392765
México,Tepotzotlán,103696,52988,50708,31708,20839,0.657215844581809
México,Tequixquiac,39489,20160,19329,12484,7107,0.5692886895225889
México,Texcaltitlán,18482,9537,8945,6195,2206,0.3560936238902341
México,Texcalyacac,5736,2915,2821,1836,925,0.5038126361655774
México,Texcoco,277562,142622,134940,85020,51545,0.6062691131498471
México,Tezoyuca,47044,23807,23237,15099,8711,0.5769256242135241
México,Tianguistenco,84259,43412,40847,24026,11974,0.4983767585116124
México,Timilpan,16414,8553,7861,6444,2572,0.399130974549969
México,Tlalmanalco,49196,25622,23574,15481,9915,0.6404625024223242
México,Tlalnepantla de Baz,672202,345185,327017,217152,165802,0.76352969348659
México,Tlatlaya,31762,16136,15626,12388,5009,0.4043429124959638
México,Toluca,910608,471435,439173,286955,164962,0.5748706243139168
México,Tonatico,12912,6677,6235,5325,2401,0.4508920187793427
México,Tultepec,157645,80513,77132,49974,35459,0.7095489654620403
México,Tultitlán,516341,264703,251638,160156,120936,0.755113764080022
México,Valle de Bravo,61590,31514,30076,25258,10417,0.4124237865230818
México,Villa de Allende,53275,27381,25894,15472,3517,0.22731385729058945
México,Villa del Carbón,51498,25931,25567,17185,6185,0.3599068955484434
México,Villa Guerrero,69086,35227,33859,20882,10675,0.5112058231970118
México,Villa Victoria,108196,55057,53139,29980,5866,0.19566377585056705
México,Xonacatlán,54633,27875,26758,15926,7993,0.5018837121687806
México,Zacazonapan,5109,2533,2576,1858,1032,0.5554359526372443
México,Zacualpan,13522,7066,6456,5056,1591,0.3146756329113924
México,Zinacantepec,203872,104366,99506,59909,28042,0.4680765828172729
México,Zumpahuacán,18833,9745,9088,5984,1338,0.22359625668449198
México,Zumpango,280455,143484,136971,134610,54721,0.40651511774756705
México,Cuautitlán Izcalli,555163,286207,268956,179015,141346,0.7895762924894562
México,Valle de Chalco Solidaridad,391731,201057,190674,111077,69600,0.6265923638557037
México,Luvianos,28822,14735,14087,10310,4370,0.4238603297769156
México,San José del Rincón,100082,51049,49033,26351,4571,0.17346590262229136
México,Tonanitla,14883,7630,7253,4998,3103,0.6208483393357342
Michoacán de Ocampo,Acuitzio,11301,5808,5493,4013,2212,0.5512085721405432
Michoacán de Ocampo,Aguililla,14754,7419,7335,6329,3326,0.5255174593142676
Michoacán de Ocampo,Álvaro Obregón,23000,11776,11224,7844,4077,0.5197603263641
Michoacán de Ocampo,Angamacutiro,14943,7748,7195,6297,2855,0.4533905034143243
Michoacán de Ocampo,Angangueo,10892,5618,5274,3707,1398,0.377124359320205
Michoacán de Ocampo,Apatzingán,126191,64038,62153,42788,25850,0.604141348041507
Michoacán de Ocampo,Aporo,3529,1862,1667,1269,609,0.4799054373522459
Michoacán de Ocampo,Aquila,24676,12247,12429,7540,2624,0.3480106100795756
Michoacán de Ocampo,Ario,36268,18436,17832,11548,7388,0.6397644613785937
Michoacán de Ocampo,Arteaga,20332,10274,10058,7680,4104,0.534375
Michoacán de Ocampo,Briseñas,11681,6011,5670,4178,2428,0.5811393011010053
Michoacán de Ocampo,Buenavista,45538,22531,23007,15923,9848,0.6184764177604722
Michoacán de Ocampo,Carácuaro,9176,4565,4611,3513,1796,0.511243951038998
Michoacán de Ocampo,Coahuayana,17022,8298,8724,5890,3630,0.6162988115449916
Michoacán de Ocampo,Coalcomán de Vázquez Pallares,19633,9843,9790,7308,4224,0.5779967159277504
Michoacán de Ocampo,Coeneo,20965,11042,9923,10367,3894,0.37561493199575574
Michoacán de Ocampo,Contepec,35070,18126,16944,12432,5428,0.4366151866151866
Michoacán de Ocampo,Copándaro,9484,4891,4593,3572,1593,0.44596864501679734
Michoacán de Ocampo,Cotija,20198,10418,9780,9212,4842,0.5256187581415545
Michoacán de Ocampo,Cuitzeo,29910,15606,14304,10299,4659,0.45237401689484413
Michoacán de Ocampo,Charapan,13539,7103,6436,4804,1501,0.3124479600333056
Michoacán de Ocampo,Charo,25138,11516,13622,7695,4117,0.5350227420402859
Michoacán de Ocampo,Chavinda,10417,5349,5068,4915,2578,0.5245167853509665
Michoacán de Ocampo,Cherán,20586,10633,9953,6786,3095,0.4560860595343354
Michoacán de Ocampo,Chilchota,40560,20897,19663,12093,3503,0.28967171090713634
Michoacán de Ocampo,Chinicuila,4773,2289,2484,1904,1046,0.5493697478991597
Michoacán de Ocampo,Chucándiro,4944,2557,2387,2850,969,0.34
Michoacán de Ocampo,Churintzio,5233,2706,2527,3788,1422,0.3753959873284055
Michoacán de Ocampo,Churumuco,12342,6328,6014,4352,2155,0.4951746323529412
Michoacán de Ocampo,Ecuandureo,11850,6299,5551,6358,2836,0.4460522176785153
Michoacán de Ocampo,Epitacio Huerta,16112,8343,7769,6764,3042,0.4497338852749852
Michoacán de Ocampo,Erongarícuaro,15715,8085,7630,5461,2218,0.4061527192821828
Michoacán de Ocampo,Gabriel Zamora,21466,10875,10591,7773,4750,0.6110896693683262
Michoacán de Ocampo,Hidalgo,125712,65098,60614,40435,20602,0.5095090886608137
Michoacán de Ocampo,La Huacana,30627,15454,15173,10868,6306,0.5802355539197644
Michoacán de Ocampo,Huandacareo,11644,6070,5574,5438,2757,0.5069878631849944
Michoacán de Ocampo,Huaniqueo,7945,4207,3738,4707,1779,0.37794773741236454
Michoacán de Ocampo,Huetamo,41973,21309,20664,18486,9201,0.49772801038623826
Michoacán de Ocampo,Huiramba,9015,4671,4344,2795,1532,0.5481216457960644
Michoacán de Ocampo,Indaparapeo,18385,9387,8998,6087,2778,0.4563824544110399
Michoacán de Ocampo,Irimbo,16043,8372,7671,5876,2939,0.5001701837985024
Michoacán de Ocampo,Ixtlán,14302,7285,7017,5915,3025,0.5114116652578191
Michoacán de Ocampo,Jacona,68781,35442,33339,21981,13609,0.6191256084800509
Michoacán de Ocampo,Jiménez,12946,6665,6281,7070,3009,0.4256011315417256
Michoacán de Ocampo,Jiquilpan,36158,18922,17236,16295,8037,0.4932187787664928
Michoacán de Ocampo,Juárez,14936,7620,7316,5245,3160,0.6024785510009533
Michoacán de Ocampo,Jungapeo,19834,10002,9832,6690,3648,0.5452914798206278
Michoacán de Ocampo,Lagunillas,5745,2932,2813,2166,1068,0.4930747922437673
Michoacán de Ocampo,Madero,19086,9457,9629,5917,3132,0.529322291701876
Michoacán de Ocampo,Maravatío,89311,46120,43191,31171,14489,0.464823072727856
Michoacán de Ocampo,Marcos Castellanos,13983,7241,6742,5524,3525,0.638124547429399
Michoacán de Ocampo,Lázaro Cárdenas,196003,98519,97484,67340,44102,0.6549153549153549
Michoacán de Ocampo,Morelia,849053,441924,407129,326420,196901,0.6032136511243184
Michoacán de Ocampo,Morelos,7983,4196,3787,4223,1834,0.43428842055410843
Michoacán de Ocampo,Múgica,45732,23329,22403,15785,8520,0.5397529299968324
Michoacán de Ocampo,Nahuatzen,32598,16636,15962,9641,3372,0.349756249351727
Michoacán de Ocampo,Nocupétaro,8196,4165,4031,3096,1446,0.46705426356589147
Michoacán de Ocampo,Nuevo Parangaricutiro,20981,10668,10313,5959,4034,0.6769592213458634
Michoacán de Ocampo,Nuevo Urecho,9027,4471,4556,3211,2024,0.6303332295235129
Michoacán de Ocampo,Numarán,9437,4841,4596,3467,1928,0.5561003749639458
Michoacán de Ocampo,Ocampo,24774,12572,12202,7538,2494,0.3308569912443619
Michoacán de Ocampo,Pajacuarán,21028,10818,10210,8320,3952,0.475
Michoacán de Ocampo,Panindícuaro,14889,7713,7176,7105,2627,0.3697396199859254
Michoacán de Ocampo,Parácuaro,26832,13360,13472,8978,5173,0.5761862330140343
Michoacán de Ocampo,Paracho,39657,20402,19255,12771,5796,0.45384073291050037
Michoacán de Ocampo,Pátzcuaro,98382,51162,47220,30495,16100,0.5279554025250041
Michoacán de Ocampo,Penjamillo,16621,8761,7860,8357,3502,0.41904989828885963
Michoacán de Ocampo,Peribán,29389,14616,14773,8577,6306,0.7352221056313396
Michoacán de Ocampo,La Piedad,106490,55009,51481,41237,25276,0.6129446855978854
Michoacán de Ocampo,Purépero,15503,7910,7593,7042,4087,0.5803748934961659
Michoacán de Ocampo,Puruándiro,69260,35949,33311,28959,14450,0.49898131841569116
Michoacán de Ocampo,Queréndaro,13961,7151,6810,5294,2748,0.5190782017378164
Michoacán de Ocampo,Quiroga,27176,14253,12923,9985,4488,0.44947421131697546
Michoacán de Ocampo,Cojumatlán de Régules,10553,5232,5321,4326,2397,0.5540915395284327
Michoacán de Ocampo,Los Reyes,78935,40177,38758,27442,14714,0.5361854092267327
Michoacán de Ocampo,Sahuayo,78477,40580,37897,26416,17178,0.6502877044215627
Michoacán de Ocampo,San Lucas,17677,8927,8750,8151,3714,0.4556496135443504
Michoacán de Ocampo,Santa Ana Maya,12812,6695,6117,5945,2570,0.432296047098402
Michoacán de Ocampo,Salvador Escalante,49896,25494,24402,13855,6888,0.4971490436665464
Michoacán de Ocampo,Senguio,19833,10408,9425,6927,2991,0.4317886530965786
Michoacán de Ocampo,Susupuato,9076,4617,4459,3414,1433,0.4197422378441711
Michoacán de Ocampo,Tacámbaro,79540,40574,38966,24322,15904,0.6538935942767864
Michoacán de Ocampo,Tancítaro,33453,16717,16736,9907,6570,0.6631674573533864
Michoacán de Ocampo,Tangamandapio,31716,16230,15486,9589,4673,0.48732923141099177
Michoacán de Ocampo,Tangancícuaro,35256,18074,17182,14575,7468,0.5123842195540309
Michoacán de Ocampo,Tanhuato,15534,8031,7503,5667,3469,0.6121404623257456
Michoacán de Ocampo,Taretan,15589,7913,7676,5112,3424,0.6697965571205008
Michoacán de Ocampo,Tarímbaro,114513,58764,55749,46207,24465,0.5294652325405241
Michoacán de Ocampo,Tepalcatepec,24074,12064,12010,9714,6071,0.6249742639489396
Michoacán de Ocampo,Tingambato,16325,8389,7936,4968,2187,0.44021739130434784
Michoacán de Ocampo,Tingüindín,14934,7759,7175,5785,3448,0.5960242005185825
Michoacán de Ocampo,Tiquicheo de Nicolás Romero,12836,6544,6292,4827,2427,0.5027967681789932
Michoacán de Ocampo,Tlalpujahua,28556,15143,13413,10457,4223,0.4038443148130439
Michoacán de Ocampo,Tlazazalca,6420,3308,3112,5003,1722,0.3441934839096542
Michoacán de Ocampo,Tocumbo,12325,6250,6075,5461,2971,0.5440395531953854
Michoacán de Ocampo,Tumbiscatío,5971,2958,3013,2404,1238,0.5149750415973378
Michoacán de Ocampo,Turicato,29056,14913,14143,10105,5435,0.5378525482434439
Michoacán de Ocampo,Tuxpan,25757,13264,12493,9319,4885,0.5241978753085095
Michoacán de Ocampo,Tuzantla,14329,7285,7044,5555,2939,0.5290729072907291
Michoacán de Ocampo,Tzintzuntzan,14911,7778,7133,5942,2010,0.33826994278020867
Michoacán de Ocampo,Tzitzio,8855,4428,4427,3132,1191,0.38026819923371646
Michoacán de Ocampo,Uruapan,356786,184476,172310,111839,73127,0.6538595659832438
Michoacán de Ocampo,Venustiano Carranza,23469,12228,11241,9038,5202,0.5755698163310466
Michoacán de Ocampo,Villamar,15864,8233,7631,8632,3518,0.40755329008341057
Michoacán de Ocampo,Vista Hermosa,20982,10623,10359,7622,4334,0.5686171608501706
Michoacán de Ocampo,Yurécuaro,32303,16632,15671,11481,6082,0.5297447957494992
Michoacán de Ocampo,Zacapu,76829,39943,36886,27018,16710,0.6184765711747724
Michoacán de Ocampo,Zamora,204860,106041,98819,75529,45140,0.5976512333011161
Michoacán de Ocampo,Zináparo,3232,1679,1553,2065,813,0.3937046004842615
Michoacán de Ocampo,Zinapécuaro,49005,25345,23660,20745,10059,0.4848879248011569
Michoacán de Ocampo,Ziracuaretiro,18402,9341,9061,5029,3120,0.6204016703121893
Michoacán de Ocampo,Zitácuaro,157056,81603,75453,50337,24258,0.4819119137016509
Michoacán de Ocampo,José Sixto Verduzco,26213,13629,12584,9998,5457,0.5458091618323665
Morelos,Amacuzac,17598,9149,8449,7050,2910,0.4127659574468085
Morelos,Atlatlahucan,25232,12966,12266,14904,4277,0.2869699409554482
Morelos,Axochiapan,39174,19886,19288,12614,6383,0.506025051530046
Morelos,Ayala,89834,46292,43542,43023,15621,0.3630848615856635
Morelos,Coatlán del Río,10520,5782,4738,4548,1645,0.36169744942832016
Morelos,Cuautla,187118,97335,89783,69767,35668,0.5112445712156177
Morelos,Cuernavaca,378476,199747,178729,148249,85934,0.5796598965254403
Morelos,Emiliano Zapata,107053,55045,52008,58108,21074,0.362669511943278
Morelos,Huitzilac,24515,12539,11976,9647,4028,0.41753913133616666
Morelos,Jantetelco,18402,9404,8998,6971,3044,0.4366661884951944
Morelos,Jiutepec,215357,112238,103119,73832,45630,0.6180247047350742
Morelos,Jojutla,57682,29862,27820,26540,11520,0.43406179351921625
Morelos,Jonacatepec de Leandro Valle,16694,8618,8076,6035,2722,0.45103562551781273
Morelos,Mazatepec,9653,5050,4603,4168,1887,0.45273512476007677
Morelos,Miacatlán,15802,8041,7761,7032,2751,0.39121160409556316
Morelos,Ocuituco,19219,9794,9425,6631,2670,0.40265419996983864
Morelos,Puente de Ixtla,40018,20948,19070,15533,7272,0.468164552887401
Morelos,Temixco,122263,63277,58986,57988,20753,0.357884389873767
Morelos,Tepalcingo,28122,14281,13841,10726,4898,0.45664739884393063
Morelos,Tepoztlán,54987,28145,26842,21741,9063,0.41686214985511244
Morelos,Tetecala,7617,3924,3693,3543,1534,0.4329664126446514
Morelos,Tetela del Volcán,14853,7549,7304,4678,2092,0.4471996579734929
Morelos,Tlalnepantla,7943,3962,3981,2703,1272,0.47058823529411764
Morelos,Tlaltizapán de Zapata,52399,26874,25525,22928,9381,0.4091503838101884
Morelos,Tlaquiltenango,33789,17329,16460,14057,6409,0.45592943017713594
Morelos,Tlayacapan,19408,9779,9629,8002,2992,0.3739065233691577
Morelos,Totolapan,12750,6548,6202,4924,1896,0.3850528025995126
Morelos,Xochitepec,73539,36629,36910,41685,11544,0.27693414897445123
Morelos,Yautepec,105780,54681,51099,54477,19459,0.35719661508526535
Morelos,Yecapixtla,56083,28433,27650,20630,8318,0.4031992244304411
Morelos,Zacatepec,36094,18862,17232,13819,7687,0.5562631159997106
Morelos,Zacualpan de Amilpas,9965,5108,4857,4082,1720,0.42136207741303283
Morelos,Temoac,16574,8664,7910,5222,2238,0.42857142857142855
Morelos,Coatetelco,11347,5877,5470,3566,747,0.20947840717891195
Morelos,Xoxocotla,27805,13924,13881,7495,1958,0.26124082721814545
Morelos,Hueyapan,7855,4131,3724,2583,828,0.3205574912891986
Nayarit,Acaponeta,37232,18617,18615,14060,7421,0.5278093883357041
Nayarit,Ahuacatlán,15393,7754,7639,6691,3831,0.5725601554326708
Nayarit,Amatlán de Cañas,11536,5668,5868,5592,3030,0.5418454935622318
Nayarit,Compostela,77436,38866,38570,33497,17917,0.5348837209302325
Nayarit,Huajicori,12230,5998,6232,3760,861,0.22898936170212766
Nayarit,Ixtlán del Río,29299,15155,14144,11336,6852,0.6044460127028934
Nayarit,Jala,19321,9768,9553,7128,2312,0.32435465768799104
Nayarit,Xalisco,65229,33507,31722,23408,14923,0.6375170881749829
Nayarit,Del Nayar,47550,24089,23461,12905,619,0.04796590468810539
Nayarit,Rosamorada,33567,16484,17083,13891,7396,0.5324310704772874
Nayarit,Ruíz,24096,11977,12119,9124,4408,0.4831214379658045
Nayarit,San Blas,41518,20241,21277,18861,9151,0.485181061449552
Nayarit,San Pedro Lagunillas,7683,3761,3922,3605,1955,0.5423023578363384
Nayarit,Santa María del Oro,24911,12362,12549,9736,5202,0.5343056696795399
Nayarit,Santiago Ixcuintla,93981,46515,47466,37459,22542,0.6017779438853146
Nayarit,Tecuala,37135,18293,18842,16434,8863,0.5393087501521237
Nayarit,Tepic,425924,218832,207092,156934,97968,0.6242624287917213
Nayarit,Tuxpan,30064,15092,14972,11978,7792,0.6505259642678244
Nayarit,La Yesca,13719,6861,6858,4881,1344,0.27535341118623236
Nayarit,Bahía de Banderas,187632,93338,94294,81630,40291,0.4935807913757197
Nuevo León,Abasolo,2974,1532,1442,1194,691,0.5787269681742043
Nuevo León,Agualeguas,3382,1692,1690,2971,1124,0.37832379670144733
Nuevo León,Los Aldamas,1407,708,699,1623,479,0.2951324707332101
Nuevo León,Allende,35289,17460,17829,13785,9947,0.7215814290895901
Nuevo León,Anáhuac,18030,9178,8852,8119,4563,0.5620150264810937
Nuevo León,Apodaca,656464,324951,331513,212801,166892,0.784263231845715
Nuevo León,Aramberri,14992,7325,7667,6145,3127,0.5088689991863303
Nuevo León,Bustamante,3661,1837,1824,2389,980,0.4102134784428631
Nuevo León,Cadereyta Jiménez,122337,59960,62377,55231,30703,0.5559015770129094
Nuevo León,El Carmen,104478,51595,52883,38780,22514,0.5805569881382155
Nuevo León,Cerralvo,7340,3633,3707,4283,2158,0.5038524398785897
Nuevo León,Ciénega de Flores,68747,33541,35206,31005,15187,0.4898242218996936
Nuevo León,China,9930,4969,4961,5543,2816,0.5080281436045463
Nuevo León,Doctor Arroyo,36088,18028,18060,13349,7014,0.5254326166754064
Nuevo León,Doctor Coss,1360,703,657,1246,440,0.35313001605136435
Nuevo León,Doctor González,3256,1584,1672,2106,851,0.40408357075023743
Nuevo León,Galeana,40903,20459,20444,16424,8796,0.5355577204091573
Nuevo León,García,397205,196497,200708,157779,92249,0.5846722314122919
Nuevo León,San Pedro Garza García,132169,69583,62586,41237,34393,0.8340325435894949
Nuevo León,General Bravo,5506,2710,2796,3397,1489,0.43832793641448337
Nuevo León,General Escobedo,481213,239052,242161,154216,115007,0.7457527104839965
Nuevo León,General Terán,14109,6994,7115,7473,4069,0.5444935099692225
Nuevo León,General Treviño,1808,918,890,1096,554,0.5054744525547445
Nuevo León,General Zaragoza,6282,3058,3224,2437,1116,0.4579400902749282
Nuevo León,General Zuazua,102149,50305,51844,42305,23639,0.5587755584446283
Nuevo León,Guadalupe,643143,324150,318993,207183,167190,0.8069677531457696
Nuevo León,Los Herreras,1959,970,989,1899,637,0.33543970510795157
Nuevo León,Higueras,1386,662,724,835,341,0.40838323353293415
Nuevo León,Hualahuises,7026,3546,3480,3361,1885,0.5608449866111277
Nuevo León,Iturbide,3298,1582,1716,1454,723,0.4972489683631362
Nuevo León,Juárez,471523,233806,237717,181463,110626,0.6096339198624513
Nuevo León,Lampazos de Naranjo,5351,2694,2657,3014,1448,0.4804246848042468
Nuevo León,Linares,84666,42788,41878,31978,20765,0.6493526799674776
Nuevo León,Marín,5119,2480,2639,2215,1254,0.5661399548532732
Nuevo León,Melchor Ocampo,1483,719,764,921,421,0.4571118349619978
Nuevo León,Mier y Noriega,7652,3857,3795,2662,1393,0.523290758827949
Nuevo León,Mina,6048,2992,3056,2727,1357,0.4976164283094976
Nuevo León,Montemorelos,67428,33859,33569,30139,18376,0.6097083513056173
Nuevo León,Monterrey,1142994,578189,564805,368796,293322,0.7953502749487521
Nuevo León,Parás,906,449,457,830,288,0.3469879518072289
Nuevo León,Pesquería,147624,71620,76004,57402,31898,0.5556949235218285
Nuevo León,Los Ramones,5389,2613,2776,4610,1613,0.34989154013015183
Nuevo León,Rayones,2377,1147,1230,1675,600,0.3582089552238806
Nuevo León,Sabinas Hidalgo,34709,17674,17035,16128,9656,0.5987103174603174
Nuevo León,Salinas Victoria,86766,42631,44135,36175,19244,0.531969592259848
Nuevo León,San Nicolás de los Garza,412199,209241,202958,133725,113650,0.8498784819592448
Nuevo León,Hidalgo,16086,8004,8082,5900,4051,0.6866101694915254
Nuevo León,Santa Catarina,306322,153705,152617,90966,74103,0.8146230459732208
Nuevo León,Santiago,46784,23324,23460,20785,13019,0.6263651671878758
Nuevo León,Vallecillo,1552,732,820,1315,474,0.36045627376425854
Nuevo León,Villaldama,3573,1786,1787,2603,1082,0.4156742220514791
Oaxaca,Abejones,841,481,360,412,48,0.11650485436893204
Oaxaca,Acatlán de Pérez Figueroa,45167,23187,21980,16098,7918,0.4918623431482172
Oaxaca,Asunción Cacalotepec,2547,1318,1229,1282,41,0.031981279251170044
Oaxaca,Asunción Cuyotepeji,1107,584,523,535,163,0.30467289719626167
Oaxaca,Asunción Ixtaltepec,15261,7711,7550,6429,3296,0.5126769326489345
Oaxaca,Asunción Nochixtlán,20464,10887,9577,8377,2990,0.35692968843261313
Oaxaca,Asunción Ocotlán,2395,1304,1091,1686,243,0.14412811387900357
Oaxaca,Asunción Tlacolulita,734,379,355,428,108,0.2523364485981308
Oaxaca,Ayotzintepec,6857,3574,3283,2557,578,0.22604614782948768
Oaxaca,El Barrio de la Soledad,13474,6972,6502,5798,3332,0.5746809244567093
Oaxaca,Calihualá,1402,712,690,595,149,0.2504201680672269
Oaxaca,Candelaria Loxicha,11166,5716,5450,3205,324,0.10109204368174728
Oaxaca,Ciénega de Zimatlán,3043,1579,1464,1438,740,0.5146036161335188
Oaxaca,Ciudad Ixtepec,28082,14783,13299,11683,5604,0.47967131729863904
Oaxaca,Coatecas Altas,5356,2829,2527,1939,218,0.11242908715832904
Oaxaca,Coicoyán de las Flores,9563,5103,4460,2651,130,0.04903809883062995
Oaxaca,La Compañía,3607,1906,1701,1377,408,0.2962962962962963
Oaxaca,Concepción Buenavista,752,377,375,632,126,0.19936708860759494
Oaxaca,Concepción Pápalo,2754,1378,1376,1395,386,0.27670250896057347
Oaxaca,Constancia del Rosario,4847,2672,2175,1484,407,0.2742587601078167
Oaxaca,Cosolapa,14488,7642,6846,5365,2626,0.48946877912395154
Oaxaca,Cosoltepec,803,418,385,644,124,0.19254658385093168
Oaxaca,Cuilápam de Guerrero,26882,14019,12863,8935,3779,0.42294348069390036
Oaxaca,Cuyamecalco Villa de Zaragoza,3644,1797,1847,1701,245,0.1440329218106996
Oaxaca,Chahuites,11356,5787,5569,3939,2162,0.5488702716425489
Oaxaca,Chalcatongo de Hidalgo,9035,4798,4237,5916,1151,0.19455713319810683
Oaxaca,Chiquihuitlán de Benito Juárez,2179,1185,994,1265,121,0.09565217391304348
Oaxaca,Heroica Ciudad de Ejutla de Crespo,23148,12069,11079,8726,3156,0.36167774467109787
Oaxaca,Eloxochitlán de Flores Magón,4215,2220,1995,1568,82,0.05229591836734694
Oaxaca,El Espinal,8730,4491,4239,3244,2054,0.6331689272503083
Oaxaca,Tamazulápam del Espíritu Santo,7185,3981,3204,3676,328,0.08922742110990206
Oaxaca,Fresnillo de Trujano,1077,539,538,590,221,0.37457627118644066
Oaxaca,Guadalupe Etla,2929,1532,1397,966,549,0.5683229813664596
Oaxaca,Guadalupe de Ramírez,1288,674,614,964,259,0.26867219917012447
Oaxaca,Guelatao de Juárez,657,332,325,297,120,0.40404040404040403
Oaxaca,Guevea de Humboldt,5256,2771,2485,1955,321,0.16419437340153453
Oaxaca,Mesones Hidalgo,4424,2373,2051,1851,332,0.17936250675310642
Oaxaca,Villa Hidalgo,1885,985,900,818,149,0.1821515892420538
Oaxaca,Heroica Ciudad de Huajuapan de León,78313,41151,37162,30379,13969,0.45982422067875833
Oaxaca,Huautepec,6385,3408,2977,2257,61,0.02702702702702703
Oaxaca,Huautla de Jiménez,31710,17082,14628,12911,1593,0.12338316164510882
Oaxaca,Ixtlán de Juárez,8385,4349,4036,3192,1078,0.33771929824561403
Oaxaca,Juchitán de Zaragoza,113570,58954,54616,33849,18874,0.5575940205028214
Oaxaca,Loma Bonita,40934,21441,19493,17018,8411,0.49424139146785756
Oaxaca,Magdalena Apasco,7888,4148,3740,3263,1606,0.49218510573092245
Oaxaca,Magdalena Jaltepec,2943,1604,1339,1865,465,0.24932975871313673
Oaxaca,Santa Magdalena Jicotlán,81,40,41,120,12,0.1
Oaxaca,Magdalena Mixtepec,1433,741,692,381,46,0.12073490813648294
Oaxaca,Magdalena Ocotlán,1184,599,585,396,157,0.39646464646464646
Oaxaca,Magdalena Peñasco,3750,1980,1770,1949,362,0.18573627501282708
Oaxaca,Magdalena Teitipac,4764,2543,2221,1280,329,0.25703125
Oaxaca,Magdalena Tequisistlán,5996,3057,2939,2832,856,0.3022598870056497
Oaxaca,Magdalena Tlacotepec,1297,675,622,608,234,0.3848684210526316
Oaxaca,Magdalena Zahuatlán,404,215,189,307,62,0.20195439739413681
Oaxaca,Mariscala de Juárez,3739,1952,1787,1763,825,0.4679523539421441
Oaxaca,Mártires de Tacubaya,1446,736,710,547,192,0.3510054844606947
Oaxaca,Matías Romero Avendaño,38183,20007,18176,14772,6949,0.47041700514486867
Oaxaca,Mazatlán Villa de Flores,12722,6489,6233,5757,273,0.047420531526836895
Oaxaca,Miahuatlán de Porfirio Díaz,50375,25772,24603,17942,5095,0.28397057184260394
Oaxaca,Mixistlán de la Reforma,2487,1345,1142,1089,55,0.050505050505050504
Oaxaca,Monjas,2893,1562,1331,1339,290,0.21657953696788648
Oaxaca,Natividad,498,276,222,249,97,0.3895582329317269
Oaxaca,Nazareno Etla,4293,2237,2056,1326,834,0.6289592760180995
Oaxaca,Nejapa de Madero,8494,4327,4167,3196,1100,0.344180225281602
Oaxaca,Ixpantepec Nieves,1079,592,487,882,162,0.1836734693877551
Oaxaca,Santiago Niltepec,5342,2727,2615,2505,1079,0.4307385229540918
Oaxaca,Oaxaca de Juárez,270955,145103,125852,90433,48796,0.5395817898333573
Oaxaca,Ocotlán de Morelos,23751,12414,11337,8032,3459,0.430652390438247
Oaxaca,La Pe,3052,1537,1515,878,286,0.32574031890660593
Oaxaca,Pinotepa de Don Luis,6416,3254,3162,2168,231,0.10654981549815498
Oaxaca,Pluma Hidalgo,3255,1675,1580,1049,151,0.14394661582459486
Oaxaca,San José del Progreso,8059,4206,3853,2565,980,0.3820662768031189
Oaxaca,Putla Villa de Guerrero,34652,18463,16189,13683,3911,0.2858291310385149
Oaxaca,Santa Catarina Quioquitani,456,225,231,208,21,0.10096153846153846
Oaxaca,Reforma de Pineda,2660,1378,1282,1363,653,0.47909024211298606
Oaxaca,La Reforma,3411,1736,1675,1296,463,0.35725308641975306
Oaxaca,Reyes Etla,4370,2265,2105,1399,630,0.4503216583273767
Oaxaca,Rojas de Cuauhtémoc,1301,668,633,475,288,0.6063157894736843
Oaxaca,Salina Cruz,84438,43995,40443,32822,18395,0.5604472609834867
Oaxaca,San Agustín Amatengo,1593,810,783,834,235,0.28177458033573144
Oaxaca,San Agustín Atenango,1871,963,908,1295,338,0.261003861003861
Oaxaca,San Agustín Chayuco,4163,2140,2023,1498,252,0.16822429906542055
Oaxaca,San Agustín de las Juntas,11391,5884,5507,3755,1701,0.4529960053262317
Oaxaca,San Agustín Etla,4168,2184,1984,1607,993,0.6179215930304915
Oaxaca,San Agustín Loxicha,26194,13416,12778,7445,374,0.05023505708529214
Oaxaca,San Agustín Tlacotepec,1032,576,456,1003,86,0.08574277168494517
Oaxaca,San Agustín Yatareni,5521,2931,2590,1878,814,0.4334398296059638
Oaxaca,San Andrés Cabecera Nueva,2881,1486,1395,1291,310,0.24012393493415957
Oaxaca,San Andrés Dinicuiti,2308,1185,1123,1005,236,0.23482587064676616
Oaxaca,San Andrés Huaxpaltepec,6234,3240,2994,2476,673,0.2718093699515347
Oaxaca,San Andrés Huayápam,6279,3279,3000,2278,1427,0.6264266900790166
Oaxaca,San Andrés Ixtlahuaca,1776,931,845,671,254,0.37853949329359166
Oaxaca,San Andrés Lagunas,518,271,247,482,70,0.14522821576763487
Oaxaca,San Andrés Nuxiño,1850,968,882,884,81,0.0916289592760181
Oaxaca,San Andrés Paxtlán,4562,2267,2295,1372,74,0.05393586005830904
Oaxaca,San Andrés Sinaxtla,756,402,354,427,142,0.3325526932084309
Oaxaca,San Andrés Solaga,1771,914,857,874,84,0.09610983981693363
Oaxaca,San Andrés Teotilálpam,4233,2239,1994,1332,363,0.2725225225225225
Oaxaca,San Andrés Tepetlapa,381,198,183,216,21,0.09722222222222222
Oaxaca,San Andrés Yaá,393,209,184,310,21,0.06774193548387097
Oaxaca,San Andrés Zabache,748,411,337,345,97,0.2811594202898551
Oaxaca,San Andrés Zautla,5326,2771,2555,2111,761,0.3604926575082899
Oaxaca,San Antonino Castillo Velasco,6064,3182,2882,2017,888,0.4402578086266733
Oaxaca,San Antonino el Alto,2705,1359,1346,1198,278,0.23205342237061768
Oaxaca,San Antonino Monte Verde,7678,4146,3532,2643,938,0.3548997351494514
Oaxaca,San Antonio Acutla,249,123,126,168,21,0.125
Oaxaca,San Antonio de la Cal,26282,13890,12392,7634,3542,0.46397694524495675
Oaxaca,San Antonio Huitepec,2936,1582,1354,1924,315,0.16372141372141372
Oaxaca,San Antonio Nanahuatípam,1232,627,605,438,187,0.4269406392694064
Oaxaca,San Antonio Sinicahua,1668,928,740,934,41,0.043897216274089934
Oaxaca,San Antonio Tepetlapa,4873,2557,2316,1428,85,0.05952380952380952
Oaxaca,San Baltazar Chichicápam,2576,1351,1225,1376,175,0.12718023255813954
Oaxaca,San Baltazar Loxicha,3169,1644,1525,1157,204,0.1763180639585134
Oaxaca,San Baltazar Yatzachi el Bajo,674,349,325,570,82,0.14385964912280702
Oaxaca,San Bartolo Coyotepec,10391,5393,4998,3809,1868,0.49041743239695457
Oaxaca,San Bartolomé Ayautla,4131,2180,1951,1361,36,0.02645113886847906
Oaxaca,San Bartolomé Loxicha,2213,1143,1070,918,65,0.07080610021786492
Oaxaca,San Bartolomé Quialana,2389,1395,994,1274,342,0.2684458398744113
Oaxaca,San Bartolomé Yucuañe,735,410,325,385,52,0.13506493506493505
Oaxaca,San Bartolomé Zoogocho,449,207,242,246,34,0.13821138211382114
Oaxaca,San Bartolo Soyaltepec,596,307,289,559,73,0.13059033989266547
Oaxaca,San Bartolo Yautepec,653,332,321,317,110,0.3470031545741325
Oaxaca,San Bernardo Mixtepec,2829,1474,1355,1294,327,0.2527047913446677
Oaxaca,San Blas Atempa,19696,9925,9771,6237,2272,0.36427769761103096
Oaxaca,San Carlos Yautepec,11662,5796,5866,3763,629,0.16715386659580123
Oaxaca,San Cristóbal Amatlán,5396,2818,2578,2051,60,0.02925402242808386
Oaxaca,San Cristóbal Amoltepec,1252,676,576,662,101,0.15256797583081572
Oaxaca,San Cristóbal Lachirioag,1342,706,636,827,153,0.18500604594921402
Oaxaca,San Cristóbal Suchixtlahuaca,356,181,175,266,83,0.31203007518796994
Oaxaca,San Dionisio del Mar,5180,2593,2587,2213,602,0.272028920018075
Oaxaca,San Dionisio Ocotepec,11411,5998,5413,3801,744,0.1957379636937648
Oaxaca,San Dionisio Ocotlán,1380,714,666,494,221,0.4473684210526316
Oaxaca,San Esteban Atatlahuca,3934,2056,1878,2437,258,0.10586787033237587
Oaxaca,San Felipe Jalapa de Díaz,28500,15095,13405,8458,897,0.10605344052967605
Oaxaca,San Felipe Tejalápam,8231,4291,3940,2588,623,0.24072642967542504
Oaxaca,San Felipe Usila,12191,6343,5848,3526,503,0.14265456608054453
Oaxaca,San Francisco Cahuacuá,3450,1753,1697,1374,209,0.15211062590975255
Oaxaca,San Francisco Cajonos,451,239,212,343,63,0.1836734693877551
Oaxaca,San Francisco Chapulapa,2195,1134,1061,756,111,0.14682539682539683
Oaxaca,San Francisco Chindúa,812,415,397,382,100,0.2617801047120419
Oaxaca,San Francisco del Mar,8710,4336,4374,3119,1360,0.4360371914075024
Oaxaca,San Francisco Huehuetlán,842,464,378,526,29,0.055133079847908745
Oaxaca,San Francisco Ixhuatán,9461,4695,4766,3959,1991,0.5029047739328113
Oaxaca,San Francisco Jaltepetongo,1075,561,514,691,118,0.170767004341534
Oaxaca,San Francisco Lachigoló,5215,2713,2502,2260,991,0.43849557522123894
Oaxaca,San Francisco Logueche,2803,1479,1324,1013,18,0.017769002961500493
Oaxaca,San Francisco Nuxaño,376,183,193,252,56,0.2222222222222222
Oaxaca,San Francisco Ozolotepec,2182,1142,1040,692,122,0.17630057803468208
Oaxaca,San Francisco Sola,2019,1072,947,683,260,0.3806734992679356
Oaxaca,San Francisco Telixtlahuaca,13856,7182,6674,4198,2098,0.4997617913292044
Oaxaca,San Francisco Teopan,312,151,161,238,57,0.23949579831932774
Oaxaca,San Francisco Tlapancingo,2472,1328,1144,878,131,0.1492027334851936
Oaxaca,San Gabriel Mixtepec,4910,2515,2395,1654,446,0.26964933494558646
Oaxaca,San Ildefonso Amatlán,2329,1250,1079,1017,192,0.1887905604719764
Oaxaca,San Ildefonso Sola,1060,547,513,349,80,0.22922636103151864
Oaxaca,San Ildefonso Villa Alta,3677,1898,1779,1607,420,0.2613565650280025
Oaxaca,San Jacinto Amilpas,16827,8838,7989,6479,3403,0.5252353758296033
Oaxaca,San Jacinto Tlacotepec,2233,1158,1075,833,307,0.368547418967587
Oaxaca,San Jerónimo Coatlán,5537,2836,2701,1662,377,0.22683513838748495
Oaxaca,San Jerónimo Silacayoapilla,1429,730,699,841,320,0.380499405469679
Oaxaca,San Jerónimo Sosola,2730,1425,1305,1498,294,0.19626168224299065
Oaxaca,San Jerónimo Taviche,2046,1059,987,655,93,0.14198473282442747
Oaxaca,San Jerónimo Tecóatl,1577,845,732,726,51,0.07024793388429752
Oaxaca,San Jorge Nuchita,2881,1540,1341,1731,388,0.2241478913922588
Oaxaca,San José Ayuquila,1629,864,765,730,230,0.3150684931506849
Oaxaca,San José Chiltepec,11310,5849,5461,3828,1730,0.45193312434691746
Oaxaca,San José del Peñasco,2149,1127,1022,706,78,0.11048158640226628
Oaxaca,San José Estancia Grande,938,481,457,428,116,0.27102803738317754
Oaxaca,San José Independencia,4251,2198,2053,1479,115,0.0777552400270453
Oaxaca,San José Lachiguiri,3700,1948,1752,1648,13,0.007888349514563107
Oaxaca,San José Tenango,18102,9536,8566,6444,350,0.05431409062693979
Oaxaca,San Juan Achiutla,408,205,203,430,77,0.17906976744186046
Oaxaca,San Juan Atepec,1457,752,705,948,288,0.3037974683544304
Oaxaca,Ánimas Trujano,4564,2394,2170,1503,805,0.5355954757152362
Oaxaca,San Juan Bautista Atatlahuca,1424,744,680,515,257,0.49902912621359224
Oaxaca,San Juan Bautista Coixtlahuaca,2725,1411,1314,1714,348,0.20303383897316218
Oaxaca,San Juan Bautista Cuicatlán,10365,5224,5141,4638,1422,0.30659767141009053
Oaxaca,San Juan Bautista Guelache,6692,3525,3167,2683,1172,0.4368244502422661
Oaxaca,San Juan Bautista Jayacatlán,1447,744,703,558,272,0.4874551971326165
Oaxaca,San Juan Bautista Lo de Soto,2344,1167,1177,1128,447,0.3962765957446808
Oaxaca,San Juan Bautista Suchitepec,453,231,222,421,67,0.15914489311163896
Oaxaca,San Juan Bautista Tlacoatzintepec,2181,1175,1006,650,70,0.1076923076923077
Oaxaca,San Juan Bautista Tlachichilco,1475,786,689,561,209,0.37254901960784315
Oaxaca,San Juan Bautista Tuxtepec,159452,83485,75967,59441,33119,0.55717434094312
Oaxaca,San Juan Cacahuatepec,8939,4642,4297,3220,1058,0.32857142857142857
Oaxaca,San Juan Cieneguilla,524,253,271,326,125,0.3834355828220859
Oaxaca,San Juan Coatzóspam,1808,934,874,901,106,0.11764705882352941
Oaxaca,San Juan Colorado,9609,4941,4668,3300,339,0.10272727272727272
Oaxaca,San Juan Comaltepec,3116,1593,1523,882,88,0.09977324263038549
Oaxaca,San Juan Cotzocón,22444,11601,10843,8151,2781,0.3411851306588149
Oaxaca,San Juan Chicomezúchil,296,163,133,207,47,0.22705314009661837
Oaxaca,San Juan Chilateca,1522,825,697,638,319,0.5
Oaxaca,San Juan del Estado,2807,1465,1342,925,533,0.5762162162162162
Oaxaca,San Juan del Río,1372,721,651,733,237,0.32332878581173263
Oaxaca,San Juan Diuxi,1056,559,497,841,83,0.09869203329369798
Oaxaca,San Juan Evangelista Analco,407,215,192,308,88,0.2857142857142857
Oaxaca,San Juan Guelavía,3288,1671,1617,1456,384,0.26373626373626374
Oaxaca,San Juan Guichicovi,29802,15841,13961,12512,2446,0.1954923273657289
Oaxaca,San Juan Ihualtepec,494,268,226,362,68,0.1878453038674033
Oaxaca,San Juan Juquila Mixes,3703,1939,1764,1523,125,0.08207485226526592
Oaxaca,San Juan Juquila Vijanos,1880,996,884,907,88,0.0970231532524807
Oaxaca,San Juan Lachao,4577,2382,2195,1378,298,0.216255442670537
Oaxaca,San Juan Lachigalla,3538,1798,1740,1269,272,0.21434200157604413
Oaxaca,San Juan Lajarcia,634,342,292,341,91,0.2668621700879765
Oaxaca,San Juan Lalana,16989,8745,8244,5409,745,0.13773340728415603
Oaxaca,San Juan de los Cués,2421,1237,1184,932,258,0.27682403433476394
Oaxaca,San Juan Mazatlán,19032,9665,9367,6276,1766,0.28138942001274697
Oaxaca,San Juan Mixtepec,6941,3632,3309,5783,760,0.13141967836762924
Oaxaca,San Juan Mixtepec,607,362,245,356,6,0.016853932584269662
Oaxaca,San Juan Ñumí,5773,3155,2618,3219,298,0.0925753339546443
Oaxaca,San Juan Ozolotepec,3411,1703,1708,1106,88,0.07956600361663653
Oaxaca,San Juan Petlapa,3117,1633,1484,1070,20,0.018691588785046728
Oaxaca,San Juan Quiahije,4203,2291,1912,1462,293,0.20041039671682626
Oaxaca,San Juan Quiotepec,2033,1026,1007,1050,328,0.31238095238095237
Oaxaca,San Juan Sayultepec,879,475,404,403,142,0.3523573200992556
Oaxaca,San Juan Tabaá,1241,646,595,473,33,0.06976744186046512
Oaxaca,San Juan Tamazola,3325,1709,1616,1799,181,0.10061145080600334
Oaxaca,San Juan Teita,544,284,260,283,52,0.18374558303886926
Oaxaca,San Juan Teitipac,2668,1392,1276,1271,263,0.2069236821400472
Oaxaca,San Juan Tepeuxila,2692,1304,1388,1365,231,0.16923076923076924
Oaxaca,San Juan Teposcolula,1494,771,723,824,141,0.17111650485436894
Oaxaca,San Juan Yaeé,1426,739,687,787,55,0.0698856416772554
Oaxaca,San Juan Yatzona,440,243,197,189,38,0.20105820105820105
Oaxaca,San Juan Yucuita,643,338,305,352,123,0.3494318181818182
Oaxaca,San Lorenzo,5903,3101,2802,2099,159,0.0757503573130062
Oaxaca,San Lorenzo Albarradas,2971,1466,1505,1261,372,0.2950039651070579
Oaxaca,San Lorenzo Cacaotepec,18339,9480,8859,6479,3532,0.545145855841951
Oaxaca,San Lorenzo Cuaunecuiltitla,833,402,431,329,11,0.03343465045592705
Oaxaca,San Lorenzo Texmelúcan,9148,5031,4117,2025,163,0.08049382716049383
Oaxaca,San Lorenzo Victoria,932,454,478,597,212,0.35510887772194305
Oaxaca,San Lucas Camotlán,3187,1648,1539,964,6,0.006224066390041493
Oaxaca,San Lucas Ojitlán,22185,11569,10616,6085,1208,0.19852095316351684
Oaxaca,San Lucas Quiaviní,1720,992,728,725,94,0.1296551724137931
Oaxaca,San Lucas Zoquiápam,7163,3720,3443,3070,91,0.02964169381107492
Oaxaca,San Luis Amatlán,3829,2036,1793,1817,312,0.1717116125481563
Oaxaca,San Marcial Ozolotepec,1372,742,630,642,17,0.0264797507788162
Oaxaca,San Marcos Arteaga,1568,834,734,911,331,0.3633369923161361
Oaxaca,San Martín de los Cansecos,994,522,472,356,114,0.3202247191011236
Oaxaca,San Martín Huamelúlpam,1000,532,468,664,143,0.21536144578313254
Oaxaca,San Martín Itunyoso,2749,1498,1251,969,40,0.0412796697626419
Oaxaca,San Martín Lachilá,1034,569,465,488,145,0.29713114754098363
Oaxaca,San Martín Peras,12436,6582,5854,4678,576,0.12312954253954682
Oaxaca,San Martín Tilcajete,1975,1053,922,670,259,0.38656716417910447
Oaxaca,San Martín Toxpalan,3934,2043,1891,1403,427,0.30434782608695654
Oaxaca,San Martín Zacatepec,1324,660,664,637,242,0.37990580847723704
Oaxaca,San Mateo Cajonos,611,314,297,271,35,0.12915129151291513
Oaxaca,Capulálpam de Méndez,1619,896,723,637,314,0.49293563579277866
Oaxaca,San Mateo del Mar,15571,7780,7791,4386,315,0.07181942544459645
Oaxaca,San Mateo Yoloxochitlán,3831,2026,1805,1383,172,0.12436731742588576
Oaxaca,San Mateo Etlatongo,1239,633,606,680,205,0.3014705882352941
Oaxaca,San Mateo Nejápam,1217,653,564,487,30,0.061601642710472276
Oaxaca,San Mateo Peñasco,2384,1264,1120,1132,88,0.07773851590106007
Oaxaca,San Mateo Piñas,2021,995,1026,1055,48,0.04549763033175355
Oaxaca,San Mateo Río Hondo,3207,1636,1571,1239,238,0.192090395480226
Oaxaca,San Mateo Sindihui,1977,1045,932,776,200,0.25773195876288657
Oaxaca,San Mateo Tlapiltepec,229,118,111,197,41,0.20812182741116753
Oaxaca,San Melchor Betaza,1052,548,504,514,57,0.11089494163424124
Oaxaca,San Miguel Achiutla,698,348,350,583,92,0.15780445969125215
Oaxaca,San Miguel Ahuehuetitlán,2142,1109,1033,1039,165,0.1588065447545717
Oaxaca,San Miguel Aloápam,2191,1193,998,907,384,0.42337375964718854
Oaxaca,San Miguel Amatitlán,6932,3589,3343,2634,823,0.31245254365983294
Oaxaca,San Miguel Amatlán,991,518,473,592,210,0.3547297297297297
Oaxaca,San Miguel Coatlán,3184,1725,1459,1518,150,0.09881422924901186
Oaxaca,San Miguel Chicahua,2169,1198,971,1077,165,0.1532033426183844
Oaxaca,San Miguel Chimalapa,6711,3296,3415,2782,618,0.22214234363767074
Oaxaca,San Miguel del Puerto,8551,4283,4268,3309,640,0.1934119069205198
Oaxaca,San Miguel del Río,245,123,122,160,21,0.13125
Oaxaca,San Miguel Ejutla,1149,613,536,455,180,0.3956043956043956
Oaxaca,San Miguel el Grande,4313,2305,2008,2879,502,0.17436609934004862
Oaxaca,San Miguel Huautla,1311,696,615,758,75,0.09894459102902374
Oaxaca,San Miguel Mixtepec,3194,1612,1582,950,32,0.03368421052631579
Oaxaca,San Miguel Panixtlahuaca,6252,3494,2758,1610,328,0.20372670807453416
Oaxaca,San Miguel Peras,3818,1996,1822,1211,204,0.16845582163501238
Oaxaca,San Miguel Piedras,1328,692,636,541,31,0.05730129390018484
Oaxaca,San Miguel Quetzaltepec,7286,3756,3530,2611,101,0.038682497127537345
Oaxaca,San Miguel Santa Flor,691,330,361,440,46,0.10454545454545454
Oaxaca,Villa Sola de Vega,12350,6395,5955,4337,1256,0.289601106755822
Oaxaca,San Miguel Soyaltepec,38682,20070,18612,12722,3030,0.23817009904103129
Oaxaca,San Miguel Suchixtepec,2932,1531,1401,862,256,0.29698375870069604
Oaxaca,Villa Talea de Castro,2011,1066,945,1242,328,0.2640901771336554
Oaxaca,San Miguel Tecomatlán,305,153,152,289,80,0.2768166089965398
Oaxaca,San Miguel Tenango,653,319,334,320,36,0.1125
Oaxaca,San Miguel Tequixtepec,1044,548,496,914,202,0.2210065645514223
Oaxaca,San Miguel Tilquiápam,3141,1726,1415,1054,72,0.0683111954459203
Oaxaca,San Miguel Tlacamama,3668,1882,1786,1272,346,0.2720125786163522
Oaxaca,San Miguel Tlacotepec,3100,1668,1432,1652,373,0.2257869249394673
Oaxaca,San Miguel Tulancingo,307,173,134,285,51,0.17894736842105263
Oaxaca,San Miguel Yotao,585,313,272,231,15,0.06493506493506493
Oaxaca,San Nicolás,1214,634,580,536,127,0.23694029850746268
Oaxaca,San Nicolás Hidalgo,1043,544,499,453,217,0.47902869757174393
Oaxaca,San Pablo Coatlán,4308,2201,2107,1452,315,0.21694214876033058
Oaxaca,San Pablo Cuatro Venados,1510,792,718,502,45,0.08964143426294821
Oaxaca,San Pablo Etla,17116,9083,8033,7018,3804,0.5420347677400968
Oaxaca,San Pablo Huitzo,7035,3717,3318,2601,1281,0.4925028835063437
Oaxaca,San Pablo Huixtepec,10020,5299,4721,4007,1905,0.47541801846768156
Oaxaca,San Pablo Macuiltianguis,955,477,478,533,189,0.3545966228893058
Oaxaca,San Pablo Tijaltepec,2751,1474,1277,1523,28,0.018384766907419567
Oaxaca,San Pablo Villa de Mitla,13587,7061,6526,4828,1684,0.3487986743993372
Oaxaca,San Pablo Yaganiza,1125,582,543,447,115,0.25727069351230425
Oaxaca,San Pedro Amuzgos,6632,3552,3080,2592,290,0.11188271604938271
Oaxaca,San Pedro Apóstol,1594,847,747,809,254,0.31396786155747836
Oaxaca,San Pedro Atoyac,4559,2446,2113,1411,84,0.059532246633593196
Oaxaca,San Pedro Cajonos,1081,586,495,602,100,0.16611295681063123
Oaxaca,San Pedro Coxcaltepec Cántaros,716,382,334,512,47,0.091796875
Oaxaca,San Pedro Comitancillo,4333,2268,2065,1927,1015,0.5267254800207577
Oaxaca,San Pedro el Alto,4654,2398,2256,1516,97,0.06398416886543536
Oaxaca,San Pedro Huamelula,9735,4933,4802,4181,1012,0.24204735709160488
Oaxaca,San Pedro Huilotepec,3307,1684,1623,992,445,0.4485887096774194
Oaxaca,San Pedro Ixcatlán,10368,5392,4976,3668,432,0.11777535441657579
Oaxaca,San Pedro Ixtlahuaca,14552,7434,7118,5075,1704,0.33576354679802956
Oaxaca,San Pedro Jaltepetongo,483,252,231,355,72,0.2028169014084507
Oaxaca,San Pedro Jicayán,11279,6007,5272,3665,147,0.04010914051841746
Oaxaca,San Pedro Jocotipac,730,389,341,523,64,0.12237093690248566
Oaxaca,San Pedro Juchatengo,1755,913,842,664,220,0.3313253012048193
Oaxaca,San Pedro Mártir,1899,1032,867,705,209,0.29645390070921984
Oaxaca,San Pedro Mártir Quiechapa,738,392,346,375,59,0.15733333333333333
Oaxaca,San Pedro Mártir Yucuxaco,1257,658,599,895,165,0.18435754189944134
Oaxaca,San Pedro Mixtepec,49780,25772,24008,18452,7868,0.4264036418816389
Oaxaca,San Pedro Mixtepec,972,504,468,587,19,0.03236797274275979
Oaxaca,San Pedro Molinos,706,367,339,533,63,0.11819887429643527
Oaxaca,San Pedro Nopala,751,393,358,331,96,0.29003021148036257
Oaxaca,San Pedro Ocopetatillo,786,438,348,390,25,0.0641025641025641
Oaxaca,San Pedro Ocotepec,2404,1208,1196,694,27,0.03890489913544669
Oaxaca,San Pedro Pochutla,48204,24685,23519,16098,5158,0.3204124735992049
Oaxaca,San Pedro Quiatoni,11930,6149,5781,4499,762,0.16937097132696155
Oaxaca,San Pedro Sochiápam,5052,2614,2438,1435,290,0.20209059233449478
Oaxaca,San Pedro Tapanatepec,15479,7865,7614,5905,2760,0.4674005080440305
Oaxaca,San Pedro Taviche,1441,750,691,389,91,0.23393316195372751
Oaxaca,San Pedro Teozacoalco,1153,578,575,654,126,0.1926605504587156
Oaxaca,San Pedro Teutila,4296,2196,2100,1508,389,0.2579575596816976
Oaxaca,San Pedro Tidaá,982,531,451,964,122,0.12655601659751037
Oaxaca,San Pedro Topiltepec,373,190,183,400,67,0.1675
Oaxaca,San Pedro Totolápam,3294,1657,1637,1248,637,0.5104166666666666
Oaxaca,Villa de Tututepec,50541,26008,24533,18875,7454,0.3949139072847682
Oaxaca,San Pedro Yaneri,867,449,418,432,36,0.08333333333333333
Oaxaca,San Pedro Yólox,1697,878,819,825,397,0.4812121212121212
Oaxaca,San Pedro y San Pablo Ayutla,5616,3083,2533,2535,372,0.1467455621301775
Oaxaca,Villa de Etla,10361,5369,4992,3665,1869,0.5099590723055935
Oaxaca,San Pedro y San Pablo Teposcolula,4353,2299,2054,2693,726,0.2695878202747865
Oaxaca,San Pedro y San Pablo Tequixtepec,1747,947,800,1536,268,0.17447916666666666
Oaxaca,San Pedro Yucunama,241,132,109,227,44,0.19383259911894274
Oaxaca,San Raymundo Jalpan,4105,2186,1919,1935,766,0.3958656330749354
Oaxaca,San Sebastián Abasolo,1999,1051,948,782,322,0.4117647058823529
Oaxaca,San Sebastián Coatlán,2809,1450,1359,1116,145,0.12992831541218638
Oaxaca,San Sebastián Ixcapa,4188,2154,2034,1624,555,0.3417487684729064
Oaxaca,San Sebastián Nicananduta,1542,838,704,952,281,0.29516806722689076
Oaxaca,San Sebastián Río Hondo,4202,2102,2100,1413,266,0.18825194621372965
Oaxaca,San Sebastián Tecomaxtlahuaca,8192,4283,3909,4388,835,0.19029170464904285
Oaxaca,San Sebastián Teitipac,2189,1182,1007,912,283,0.31030701754385964
Oaxaca,San Sebastián Tutla,16878,9172,7706,6095,3812,0.6254306808859721
Oaxaca,San Simón Almolongas,2802,1469,1333,1309,238,0.18181818181818182
Oaxaca,San Simón Zahuatlán,4940,2471,2469,827,45,0.05441354292623942
Oaxaca,Santa Ana,2406,1218,1188,862,169,0.19605568445475638
Oaxaca,Santa Ana Ateixtlahuaca,477,239,238,216,6,0.027777777777777776
Oaxaca,Santa Ana Cuauhtémoc,681,339,342,371,45,0.12129380053908356
Oaxaca,Santa Ana del Valle,2179,1103,1076,930,172,0.18494623655913978
Oaxaca,Santa Ana Tavela,848,439,409,429,51,0.11888111888111888
Oaxaca,Santa Ana Tlapacoyan,1958,1033,925,1092,348,0.31868131868131866
Oaxaca,Santa Ana Yareni,637,356,281,491,70,0.1425661914460285
Oaxaca,Santa Ana Zegache,3981,2118,1863,1487,488,0.32817753866846
Oaxaca,Santa Catalina Quierí,825,459,366,418,19,0.045454545454545456
Oaxaca,Santa Catarina Cuixtla,1495,820,675,759,201,0.2648221343873518
Oaxaca,Santa Catarina Ixtepeji,2675,1413,1262,1066,467,0.43808630393996245
Oaxaca,Santa Catarina Juquila,18654,9673,8981,5136,1559,0.3035436137071651
Oaxaca,Santa Catarina Lachatao,1059,574,485,800,227,0.28375
Oaxaca,Santa Catarina Loxicha,3676,1947,1729,1516,184,0.12137203166226913
Oaxaca,Santa Catarina Mechoacán,4582,2344,2238,1430,100,0.06993006993006994
Oaxaca,Santa Catarina Minas,2067,1039,1028,709,261,0.36812411847672777
Oaxaca,Santa Catarina Quiané,2193,1124,1069,896,440,0.49107142857142855
Oaxaca,Santa Catarina Tayata,662,346,316,411,125,0.30413625304136255
Oaxaca,Santa Catarina Ticuá,986,558,428,1027,70,0.06815968841285297
Oaxaca,Santa Catarina Yosonotú,1316,725,591,1258,38,0.030206677265500796
Oaxaca,Santa Catarina Zapoquila,403,202,201,292,72,0.2465753424657534
Oaxaca,Santa Cruz Acatepec,1645,872,773,522,21,0.040229885057471264
Oaxaca,Santa Cruz Amilpas,13200,7010,6190,4275,2257,0.527953216374269
Oaxaca,Santa Cruz de Bravo,365,195,170,244,67,0.27459016393442626
Oaxaca,Santa Cruz Itundujia,10860,5680,5180,4803,1066,0.2219446179471164
Oaxaca,Santa Cruz Mixtepec,3720,1928,1792,1460,409,0.28013698630136985
Oaxaca,Santa Cruz Nundaco,2951,1624,1327,1590,180,0.11320754716981132
Oaxaca,Santa Cruz Papalutla,2242,1148,1094,835,337,0.4035928143712575
Oaxaca,Santa Cruz Tacache de Mina,2940,1552,1388,1350,646,0.4785185185185185
Oaxaca,Santa Cruz Tacahua,1182,621,561,591,79,0.13367174280879865
Oaxaca,Santa Cruz Tayata,595,302,293,303,93,0.3069306930693069
Oaxaca,Santa Cruz Xitla,4794,2513,2281,1558,216,0.1386392811296534
Oaxaca,Santa Cruz Xoxocotlán,100402,53386,47016,36225,16900,0.4665286404416839
Oaxaca,Santa Cruz Zenzontepec,19079,9836,9243,5483,507,0.09246762721138063
Oaxaca,Santa Gertrudis,2891,1505,1386,1250,583,0.4664
Oaxaca,Santa Inés del Monte,2809,1419,1390,914,92,0.10065645514223195
Oaxaca,Santa Inés Yatzeche,908,486,422,370,77,0.20810810810810812
Oaxaca,Santa Lucía del Camino,50362,26191,24171,17626,8760,0.4969930784068989
Oaxaca,Santa Lucía Miahuatlán,3375,1728,1647,1371,12,0.0087527352297593
Oaxaca,Santa Lucía Monteverde,6726,3494,3232,3613,168,0.046498754497647385
Oaxaca,Santa Lucía Ocotlán,4173,2202,1971,1209,437,0.36145574855252277
Oaxaca,Santa María Alotepec,2796,1443,1353,1156,107,0.092560553633218
Oaxaca,Santa María Apazco,1629,889,740,990,144,0.14545454545454545
Oaxaca,Santa María la Asunción,3259,1827,1432,1313,50,0.03808073115003808
Oaxaca,Heroica Ciudad de Tlaxiaco,40123,21521,18602,17230,5356,0.31085316308763783
Oaxaca,Ayoquezco de Aldama,4874,2514,2360,2195,846,0.3854214123006834
Oaxaca,Santa María Atzompa,41921,21973,19948,15282,6710,0.4390786546263578
Oaxaca,Santa María Camotlán,1713,892,821,895,324,0.36201117318435755
Oaxaca,Santa María Colotepec,27046,13805,13241,9019,3497,0.3877369996673689
Oaxaca,Santa María Cortijo,1067,549,518,464,183,0.39439655172413796
Oaxaca,Santa María Coyotepec,3751,1983,1768,1362,568,0.4170337738619677
Oaxaca,Santa María Chachoápam,761,394,367,429,152,0.3543123543123543
Oaxaca,Villa de Chilapa de Díaz,1815,986,829,1235,406,0.3287449392712551
Oaxaca,Santa María Chilchotla,21469,11096,10373,7466,430,0.057594428073935174
Oaxaca,Santa María Chimalapa,9578,4788,4790,3250,659,0.20276923076923076
Oaxaca,Santa María del Rosario,499,253,246,283,57,0.20141342756183744
Oaxaca,Santa María del Tule,8939,4800,4139,3176,1959,0.6168136020151134
Oaxaca,Santa María Ecatepec,3418,1684,1734,1303,315,0.2417498081350729
Oaxaca,Santa María Guelacé,908,479,429,318,127,0.39937106918238996
Oaxaca,Santa María Guienagati,3178,1624,1554,1409,234,0.1660752306600426
Oaxaca,Santa María Huatulco,50862,26008,24854,20147,7965,0.395344219983124
Oaxaca,Santa María Huazolotitlán,11995,6105,5890,4551,1625,0.3570643814546254
Oaxaca,Santa María Ipalapa,4878,2576,2302,1999,587,0.29364682341170584
Oaxaca,Santa María Ixcatlán,461,237,224,339,32,0.0943952802359882
Oaxaca,Santa María Jacatepec,9682,5094,4588,3440,1050,0.30523255813953487
Oaxaca,Santa María Jalapa del Marqués,11735,6075,5660,4778,1867,0.39074926747593136
Oaxaca,Santa María Jaltianguis,592,314,278,391,119,0.30434782608695654
Oaxaca,Santa María Lachixío,1679,919,760,581,95,0.16351118760757316
Oaxaca,Santa María Mixtequilla,4690,2412,2278,2003,982,0.49026460309535697
Oaxaca,Santa María Nativitas,603,327,276,590,61,0.10338983050847457
Oaxaca,Santa María Nduayaco,453,234,219,455,57,0.12527472527472527
Oaxaca,Santa María Ozolotepec,3793,1958,1835,1476,131,0.08875338753387534
Oaxaca,Santa María Pápalo,2058,1030,1028,964,50,0.05186721991701245
Oaxaca,Santa María Peñoles,8967,4644,4323,2676,144,0.053811659192825115
Oaxaca,Santa María Petapa,16706,8626,8080,6121,2327,0.38016663943800033
Oaxaca,Santa María Quiegolani,2224,1090,1134,671,169,0.2518628912071535
Oaxaca,Santa María Sola,1516,780,736,637,194,0.304552590266876
Oaxaca,Santa María Tataltepec,317,163,154,198,33,0.16666666666666666
Oaxaca,Santa María Tecomavaca,1830,939,891,679,258,0.3799705449189985
Oaxaca,Santa María Temaxcalapa,903,460,443,396,64,0.16161616161616163
Oaxaca,Santa María Temaxcaltepec,2694,1472,1222,827,43,0.05199516324062878
Oaxaca,Santa María Teopoxco,3985,2195,1790,1834,102,0.05561613958560523
Oaxaca,Santa María Tepantlali,3576,1839,1737,1367,116,0.08485735186539868
Oaxaca,Santa María Texcatitlán,896,464,432,470,63,0.13404255319148936
Oaxaca,Santa María Tlahuitoltepec,9653,5078,4575,4547,325,0.07147569826259072
Oaxaca,Santa María Tlalixtac,1839,915,924,630,130,0.20634920634920634
Oaxaca,Santa María Tonameca,25347,12983,12364,8197,2089,0.2548493351226058
Oaxaca,Santa María Totolapilla,812,416,396,417,106,0.2541966426858513
Oaxaca,Santa María Xadani,9234,4674,4560,2923,1029,0.35203557988368117
Oaxaca,Santa María Yalina,250,138,112,220,30,0.13636363636363635
Oaxaca,Santa María Yavesía,434,235,199,260,97,0.3730769230769231
Oaxaca,Santa María Yolotepec,481,255,226,303,65,0.2145214521452145
Oaxaca,Santa María Yosoyúa,1699,886,813,668,50,0.0748502994011976
Oaxaca,Santa María Yucuhiti,6008,3158,2850,2390,321,0.13430962343096234
Oaxaca,Santa María Zacatepec,17100,8954,8146,6363,1769,0.278013515637278
Oaxaca,Santa María Zaniza,2469,1279,1190,669,30,0.04484304932735426
Oaxaca,Santa María Zoquitlán,3294,1664,1630,1756,667,0.3798405466970387
Oaxaca,Santiago Amoltepec,13855,7070,6785,3858,164,0.04250907205806117
Oaxaca,Santiago Apoala,1019,550,469,699,46,0.06580829756795423
Oaxaca,Santiago Apóstol,4421,2415,2006,1817,368,0.20253164556962025
Oaxaca,Santiago Astata,3918,1970,1948,1852,533,0.28779697624190065
Oaxaca,Santiago Atitlán,3556,1773,1783,1150,47,0.0408695652173913
Oaxaca,Santiago Ayuquililla,2904,1497,1407,1183,405,0.3423499577345731
Oaxaca,Santiago Cacaloxtepec,1667,865,802,1102,228,0.20689655172413793
Oaxaca,Santiago Camotlán,3346,1715,1631,1150,130,0.11304347826086956
Oaxaca,Santiago Comaltepec,1157,617,540,665,169,0.25413533834586466
Oaxaca,Villa de Santiago Chazumba,4877,2581,2296,3330,723,0.21711711711711712
Oaxaca,Santiago Choápam,5242,2751,2491,1806,201,0.11129568106312292
Oaxaca,Santiago del Río,527,276,251,518,92,0.1776061776061776
Oaxaca,Santiago Huajolotitlán,4600,2387,2213,2046,815,0.39833822091886606
Oaxaca,Santiago Huauclilla,525,280,245,510,66,0.12941176470588237
Oaxaca,Santiago Ihuitlán Plumas,341,186,155,405,52,0.12839506172839507
Oaxaca,Santiago Ixcuintepec,1636,861,775,545,102,0.1871559633027523
Oaxaca,Santiago Ixtayutla,13880,7329,6551,4067,256,0.06294566019178756
Oaxaca,Santiago Jamiltepec,19112,9953,9159,7448,2241,0.30088614393125673
Oaxaca,Santiago Jocotepec,14198,7335,6863,4003,573,0.1431426430177367
Oaxaca,Santiago Juxtlahuaca,34735,18208,16527,12067,2907,0.24090494737714427
Oaxaca,Santiago Lachiguiri,4394,2259,2135,2545,212,0.08330058939096267
Oaxaca,Santiago Lalopa,431,228,203,251,24,0.09561752988047809
Oaxaca,Santiago Laollaga,3361,1732,1629,1579,492,0.311589613679544
Oaxaca,Santiago Laxopa,1291,696,595,597,81,0.135678391959799
Oaxaca,Santiago Llano Grande,3440,1724,1716,1442,545,0.3779472954230236
Oaxaca,Santiago Matatlán,10175,5461,4714,4002,792,0.19790104947526238
Oaxaca,Santiago Miltepec,421,211,210,278,84,0.302158273381295
Oaxaca,Santiago Minas,1327,675,652,539,240,0.4452690166975881
Oaxaca,Santiago Nacaltepec,1599,864,735,1154,240,0.20797227036395147
Oaxaca,Santiago Nejapilla,174,90,84,214,13,0.06074766355140187
Oaxaca,Santiago Nundiche,1351,707,644,828,31,0.03743961352657005
Oaxaca,Santiago Nuyoó,1898,988,910,930,124,0.13333333333333333
Oaxaca,Santiago Pinotepa Nacional,55840,28626,27214,21105,6485,0.3072731580194267
Oaxaca,Santiago Suchilquitongo,10886,5642,5244,3480,1545,0.44396551724137934
Oaxaca,Santiago Tamazola,4458,2356,2102,1980,810,0.4090909090909091
Oaxaca,Santiago Tapextla,3134,1552,1582,1112,437,0.39298561151079137
Oaxaca,Villa Tejúpam de la Unión,2419,1259,1160,1274,358,0.28100470957613816
Oaxaca,Santiago Tenango,1966,997,969,860,166,0.1930232558139535
Oaxaca,Santiago Tepetlapa,130,78,52,146,22,0.1506849315068493
Oaxaca,Santiago Tetepec,4909,2531,2378,1685,323,0.1916913946587537
Oaxaca,Santiago Texcalcingo,2974,1569,1405,1165,71,0.06094420600858369
Oaxaca,Santiago Textitlán,4930,2510,2420,1127,311,0.2759538598047915
Oaxaca,Santiago Tilantongo,2764,1490,1274,2009,249,0.12394225983076157
Oaxaca,Santiago Tillo,545,286,259,379,107,0.28232189973614774
Oaxaca,Santiago Tlazoyaltepec,6300,3394,2906,2174,264,0.12143514259429623
Oaxaca,Santiago Xanica,3029,1491,1538,1231,54,0.043866774979691305
Oaxaca,Santiago Xiacuí,1893,987,906,1018,343,0.3369351669941061
Oaxaca,Santiago Yaitepec,4233,2327,1906,1184,178,0.15033783783783783
Oaxaca,Santiago Yaveo,7593,3806,3787,2685,915,0.3407821229050279
Oaxaca,Santiago Yolomécatl,1922,1038,884,1212,324,0.26732673267326734
Oaxaca,Santiago Yosondúa,7991,4238,3753,4208,884,0.21007604562737642
Oaxaca,Santiago Yucuyachi,998,505,493,806,241,0.2990074441687345
Oaxaca,Santiago Zacatepec,5089,2610,2479,1945,58,0.02982005141388175
Oaxaca,Santiago Zoochila,425,219,206,205,72,0.35121951219512193
Oaxaca,Nuevo Zoquiápam,1590,828,762,562,337,0.599644128113879
Oaxaca,Santo Domingo Ingenio,7681,3916,3765,3163,1819,0.5750869427758457
Oaxaca,Santo Domingo Albarradas,798,421,377,365,71,0.19452054794520549
Oaxaca,Santo Domingo Armenta,3155,1573,1582,1400,472,0.33714285714285713
Oaxaca,Santo Domingo Chihuitán,1618,825,793,834,346,0.4148681055155875
Oaxaca,Santo Domingo de Morelos,11384,5914,5470,3179,252,0.07927021075810003
Oaxaca,Santo Domingo Ixcatlán,760,415,345,513,120,0.23391812865497075
Oaxaca,Santo Domingo Nuxaá,3335,1709,1626,1598,86,0.05381727158948686
Oaxaca,Santo Domingo Ozolotepec,1101,576,525,407,82,0.20147420147420148
Oaxaca,Santo Domingo Petapa,9027,4525,4502,3623,1081,0.2983715153187966
Oaxaca,Santo Domingo Roayaga,941,491,450,408,13,0.031862745098039214
Oaxaca,Santo Domingo Tehuantepec,67739,34914,32825,25746,11670,0.4532742950361221
Oaxaca,Santo Domingo Teojomulco,5260,2684,2576,1645,638,0.3878419452887538
Oaxaca,Santo Domingo Tepuxtepec,6029,3233,2796,2281,144,0.06313020604997809
Oaxaca,Santo Domingo Tlatayápam,113,61,52,141,17,0.12056737588652482
Oaxaca,Santo Domingo Tomaltepec,3386,1735,1651,1193,597,0.5004191114836547
Oaxaca,Santo Domingo Tonalá,7393,3826,3567,3592,1326,0.36915367483296213
Oaxaca,Santo Domingo Tonaltepec,250,133,117,178,18,0.10112359550561797
Oaxaca,Santo Domingo Xagacía,1205,651,554,607,29,0.047775947281713346
Oaxaca,Santo Domingo Yanhuitlán,1633,874,759,859,242,0.2817229336437718
Oaxaca,Santo Domingo Yodohino,327,156,171,221,52,0.23529411764705882
Oaxaca,Santo Domingo Zanatepec,12483,6333,6150,4611,2453,0.5319887226198222
Oaxaca,Santos Reyes Nopala,16688,8791,7897,5629,1325,0.23538816841357257
Oaxaca,Santos Reyes Pápalo,2490,1272,1218,907,61,0.06725468577728776
Oaxaca,Santos Reyes Tepejillo,904,490,414,730,92,0.12602739726027398
Oaxaca,Santos Reyes Yucuná,1474,743,731,438,53,0.12100456621004566
Oaxaca,Santo Tomás Jalieza,3923,2065,1858,1248,409,0.327724358974359
Oaxaca,Santo Tomás Mazaltepec,2612,1349,1263,971,254,0.2615859938208033
Oaxaca,Santo Tomás Ocotepec,4066,2209,1857,1843,163,0.08844275637547477
Oaxaca,Santo Tomás Tamazulapan,2726,1418,1308,1022,304,0.2974559686888454
Oaxaca,San Vicente Coatlán,3512,1895,1617,1377,124,0.09005083514887437
Oaxaca,San Vicente Lachixío,3227,1767,1460,1132,193,0.1704946996466431
Oaxaca,San Vicente Nuñú,449,238,211,450,75,0.16666666666666666
Oaxaca,Silacayoápam,6710,3483,3227,4177,1211,0.28992099593009335
Oaxaca,Sitio de Xitlapehua,713,364,349,307,80,0.26058631921824105
Oaxaca,Soledad Etla,6348,3271,3077,2101,1104,0.5254640647310804
Oaxaca,Villa de Tamazulápam del Progreso,8326,4570,3756,3285,1535,0.4672754946727549
Oaxaca,Tanetze de Zaragoza,1558,812,746,815,100,0.12269938650306748
Oaxaca,Taniche,887,474,413,350,113,0.32285714285714284
Oaxaca,Tataltepec de Valdés,6386,3274,3112,1966,295,0.15005086469989828
Oaxaca,Teococuilco de Marcos Pérez,1032,533,499,723,180,0.24896265560165975
Oaxaca,Teotitlán de Flores Magón,10099,5313,4786,3540,1434,0.40508474576271186
Oaxaca,Teotitlán del Valle,6392,3355,3037,2404,850,0.35357737104825293
Oaxaca,Teotongo,1005,548,457,705,184,0.26099290780141843
Oaxaca,Tepelmeme Villa de Morelos,1960,1044,916,1171,268,0.22886421861656703
Oaxaca,"Heroica Villa Tezoatlán de Segura y Luna, Cuna de",11465,6069,5396,6485,1546,0.23839629915188898
Oaxaca,San Jerónimo Tlacochahuaya,5764,3052,2712,2151,699,0.32496513249651326
Oaxaca,Tlacolula de Matamoros,30254,15869,14385,14770,4733,0.3204468517264726
Oaxaca,Tlacotepec Plumas,410,212,198,407,80,0.19656019656019655
Oaxaca,Tlalixtac de Cabrera,12067,6295,5772,3863,1974,0.5110018120631633
Oaxaca,Totontepec Villa de Morelos,5904,3063,2841,2070,323,0.15603864734299516
Oaxaca,Trinidad Zaachila,3419,1812,1607,1199,551,0.45954962468723937
Oaxaca,La Trinidad Vista Hermosa,306,155,151,178,45,0.25280898876404495
Oaxaca,Unión Hidalgo,14542,7465,7077,5269,2877,0.5460239134560637
Oaxaca,Valerio Trujano,1376,736,640,657,198,0.3013698630136986
Oaxaca,San Juan Bautista Valle Nacional,23067,12081,10986,7982,2302,0.2883988975194187
Oaxaca,Villa Díaz Ordaz,6467,3503,2964,2466,481,0.19505271695052717
Oaxaca,Yaxe,2954,1524,1430,1010,114,0.11287128712871287
Oaxaca,Magdalena Yodocono de Porfirio Díaz,1682,869,813,1002,243,0.24251497005988024
Oaxaca,Yogana,1245,649,596,580,133,0.2293103448275862
Oaxaca,Yutanduchi de Guerrero,1195,618,577,668,47,0.07035928143712575
Oaxaca,Villa de Zaachila,46464,24301,22163,17641,6096,0.34555864180035145
Oaxaca,San Mateo Yucutindoo,3144,1558,1586,1299,233,0.17936874518860663
Oaxaca,Zapotitlán Lagunas,3382,1745,1637,1665,630,0.3783783783783784
Oaxaca,Zapotitlán Palmas,1695,930,765,854,325,0.3805620608899297
Oaxaca,Santa Inés de Zaragoza,1454,760,694,1124,141,0.12544483985765126
Oaxaca,Zimatlán de Álvarez,22093,11663,10430,8352,3311,0.39643199233716475
Puebla,Acajete,72894,37755,35139,18617,7754,0.4165010474297685
Puebla,Acateno,9170,4584,4586,3161,1168,0.3695033217336286
Puebla,Acatlán,37955,20119,17836,15496,6856,0.44243675787299946
Puebla,Acatzingo,63743,32820,30923,15749,7109,0.45139373928503396
Puebla,Acteopan,3070,1624,1446,1147,135,0.11769834350479512
Puebla,Ahuacatlán,14542,7690,6852,4588,562,0.12249346120313863
Puebla,Ahuatlán,3162,1605,1557,1180,413,0.35
Puebla,Ahuazotepec,11439,5890,5549,3771,1861,0.49350304958896846
Puebla,Ahuehuetitla,2207,1154,1053,1256,422,0.3359872611464968
Puebla,Ajalpan,74768,38577,36191,18136,4904,0.27040141155712394
Puebla,Albino Zertuche,1885,999,886,858,303,0.3531468531468531
Puebla,Aljojuca,6591,3491,3100,2333,776,0.33261894556365196
Puebla,Altepexi,22629,11740,10889,5429,2519,0.4639896850248665
Puebla,Amixtlán,4812,2542,2270,1790,282,0.15754189944134078
Puebla,Amozoc,125876,64397,61479,39212,20551,0.5240997653779456
Puebla,Aquixtla,9021,4513,4508,3455,1171,0.33892908827785817
Puebla,Atempan,29742,15463,14279,8512,1816,0.21334586466165414
Puebla,Atexcal,3859,2018,1841,1763,365,0.20703346568349404
Puebla,Atlixco,141793,74931,66862,49457,22826,0.46153224012778776
Puebla,Atoyatempan,7704,3944,3760,2260,914,0.4044247787610619
Puebla,Atzala,1512,783,729,567,288,0.5079365079365079
Puebla,Atzitzihuacán,12857,6832,6025,4504,1268,0.28152753108348133
Puebla,Atzitzintla,9051,4630,4421,2618,1049,0.4006875477463713
Puebla,Axutla,976,510,466,665,265,0.39849624060150374
Puebla,Ayotoxco de Guerrero,8208,4240,3968,2990,794,0.2655518394648829
Puebla,Calpan,15271,7934,7337,4862,1788,0.36774989716166184
Puebla,Caltepec,4128,2205,1923,2339,477,0.2039333048311244
Puebla,Camocuautla,2758,1391,1367,881,22,0.024971623155505107
Puebla,Caxhuacan,3811,1995,1816,1230,204,0.16585365853658537
Puebla,Coatepec,772,400,372,277,66,0.23826714801444043
Puebla,Coatzingo,2820,1457,1363,1485,543,0.3656565656565657
Puebla,Cohetzala,1382,663,719,867,323,0.37254901960784315
Puebla,Cohuecan,5403,2854,2549,1733,459,0.26485862665897286
Puebla,Coronango,46836,23852,22984,14489,7182,0.49568638277313826
Puebla,Coxcatlán,20653,10878,9775,6519,2366,0.3629391010891241
Puebla,Coyomeapan,14806,7863,6943,4870,325,0.06673511293634497
Puebla,Coyotepec,2334,1235,1099,1635,441,0.26972477064220185
Puebla,Cuapiaxtla de Madero,10542,5346,5196,2802,1319,0.4707351891506067
Puebla,Cuautempan,9837,5178,4659,4160,609,0.14639423076923078
Puebla,Cuautinchán,12340,6236,6104,3800,1213,0.3192105263157895
Puebla,Cuautlancingo,137435,70485,66950,53831,30987,0.5756348572383942
Puebla,Cuayuca de Andrade,3315,1686,1629,1546,553,0.3576972833117723
Puebla,Cuetzalan del Progreso,49864,25715,24149,16348,2458,0.15035478345975042
Puebla,Cuyoaco,17139,8913,8226,5434,1980,0.3643724696356275
Puebla,Chalchicomula de Sesma,47410,24622,22788,15135,6303,0.4164519326065411
Puebla,Chapulco,8193,4256,3937,2429,981,0.4038699053108275
Puebla,Chiautla,21699,11027,10672,8310,4278,0.5148014440433213
Puebla,Chiautzingo,22039,11543,10496,6086,2698,0.4433125205389418
Puebla,Chiconcuautla,17382,8918,8464,5198,502,0.09657560600230858
Puebla,Chichiquila,26928,13625,13303,6448,638,0.0989454094292804
Puebla,Chietla,37030,19041,17989,13960,7779,0.5572349570200573
Puebla,Chigmecatitlán,1215,679,536,728,100,0.13736263736263737
Puebla,Chignahuapan,66464,34302,32162,22371,9593,0.4288140896696616
Puebla,Chignautla,35223,18291,16932,9075,2531,0.27889807162534436
Puebla,Chila,5082,2664,2418,2421,860,0.3552251135894259
Puebla,Chila de la Sal,1317,682,635,856,323,0.3773364485981308
Puebla,Honey,6687,3482,3205,2390,715,0.29916317991631797
Puebla,Chilchotla,21002,10595,10407,6217,1486,0.23902203635193822
Puebla,Chinantla,2846,1464,1382,1652,552,0.3341404358353511
Puebla,Domingo Arenas,7982,4150,3832,2626,619,0.2357197258187357
Puebla,Eloxochitlán,14461,7391,7070,3878,176,0.04538421866941723
Puebla,Epatlán,4943,2522,2421,1885,960,0.5092838196286472
Puebla,Esperanza,14766,7675,7091,5021,2169,0.43198566022704643
Puebla,Francisco Z. Mena,17824,8957,8867,6234,2222,0.3564324671158165
Puebla,General Felipe Ángeles,22694,11712,10982,6668,2286,0.34283143371325736
Puebla,Guadalupe,6451,3438,3013,3958,1312,0.3314805457301668
Puebla,Guadalupe Victoria,18784,9575,9209,6071,2160,0.3557898204579147
Puebla,Hermenegildo Galeana,7011,3633,3378,2450,353,0.14408163265306123
Puebla,Huaquechula,29233,15433,13800,9781,3833,0.39188222063183725
Puebla,Huatlatlauca,6111,3327,2784,3786,650,0.1716851558372953
Puebla,Huauchinango,103946,55128,48818,34773,13855,0.39844131941448824
Puebla,Huehuetla,17082,8709,8373,4939,466,0.09435108321522576
Puebla,Huehuetlán el Chico,9760,4968,4792,3534,1682,0.47594793435200905
Puebla,Huejotzingo,90794,46719,44075,36822,14284,0.3879202650589322
Puebla,Hueyapan,13080,6821,6259,4159,449,0.10795864390478481
Puebla,Hueytamalco,27600,14003,13597,9626,2902,0.3014751714107625
Puebla,Hueytlalpan,5951,3027,2924,1745,93,0.05329512893982808
Puebla,Huitzilan de Serdán,15928,7836,8092,4933,314,0.06365294952361646
Puebla,Huitziltepec,5782,2985,2797,2081,749,0.35992311388755405
Puebla,Atlequizayan,2633,1405,1228,962,48,0.0498960498960499
Puebla,Ixcamilpa de Guerrero,4065,2117,1948,1669,777,0.46554823247453564
Puebla,Ixcaquixtla,8804,4611,4193,3245,1486,0.4579352850539291
Puebla,Ixtacamaxtitlán,25319,12831,12488,9508,2192,0.23054270088346657
Puebla,Ixtepec,6950,3580,3370,2195,125,0.05694760820045558
Puebla,Izúcar de Matamoros,82809,43258,39551,28848,15565,0.5395521353300056
Puebla,Jalpan,12050,6333,5717,4203,863,0.20532952652867
Puebla,Jolalpan,13308,6890,6418,4816,1353,0.2809385382059801
Puebla,Jonotla,4457,2285,2172,1707,334,0.19566490919742238
Puebla,Jopala,12131,6314,5817,3950,836,0.21164556962025316
Puebla,Juan C. Bonilla,23783,12308,11475,7439,3655,0.4913294797687861
Puebla,Juan Galindo,9828,5269,4559,3604,1817,0.5041620421753608
Puebla,Juan N. Méndez,5293,2738,2555,2417,740,0.30616466694249067
Puebla,Lafragua,7650,3941,3709,3024,749,0.24768518518518517
Puebla,Libres,37257,19160,18097,11879,4791,0.4033167775065241
Puebla,La Magdalena Tlatlauquitepec,650,326,324,291,110,0.37800687285223367
Puebla,Mazapiltepec de Juárez,3176,1619,1557,1021,379,0.3712047012732615
Puebla,Mixtla,2668,1398,1270,763,307,0.40235910878112713
Puebla,Molcaxac,6668,3495,3173,2662,654,0.24567993989481593
Puebla,Cañada Morelos,20659,10748,9911,6634,3057,0.46080795899909555
Puebla,Naupan,9310,4990,4320,3333,182,0.054605460546054606
Puebla,Nauzontla,3317,1774,1543,1390,282,0.20287769784172663
Puebla,Nealtican,14075,7260,6815,3789,1490,0.39324359989443125
Puebla,Nicolás Bravo,6644,3414,3230,2259,751,0.33244798583444
Puebla,Nopalucan,32772,16881,15891,8776,3731,0.42513673655423884
Puebla,Ocotepec,5077,2644,2433,2035,656,0.32235872235872237
Puebla,Ocoyucan,42669,22249,20420,14069,7450,0.5295330158504513
Puebla,Olintla,11993,6158,5835,3689,186,0.05042016806722689
Puebla,Oriental,19903,10225,9678,5804,2452,0.4224672639558925
Puebla,Pahuatlán,20274,10600,9674,6919,1487,0.21491545020956784
Puebla,Palmar de Bravo,50226,25631,24595,14554,5572,0.3828500755805964
Puebla,Pantepec,18528,9624,8904,6419,1325,0.2064184452406917
Puebla,Petlalcingo,9350,4861,4489,4065,1483,0.36482164821648216
Puebla,Piaxtla,4627,2365,2262,2865,1063,0.37102966841186735
Puebla,Puebla,1692181,882696,809485,570222,356688,0.6255247956059219
Puebla,Quecholac,57992,29625,28367,15842,6926,0.4371922737028153
Puebla,Quimixtlán,22855,11753,11102,6091,1304,0.21408635692004596
Puebla,Rafael Lara Grajales,15952,8327,7625,4284,2351,0.5487861811391224
Puebla,Los Reyes de Juárez,30021,15415,14606,7882,3648,0.4628266937325552
Puebla,San Andrés Cholula,154448,80176,74272,54085,34100,0.6304890450217251
Puebla,San Antonio Cañada,5938,3147,2791,1667,322,0.1931613677264547
Puebla,San Diego la Mesa Tochimiltzingo,1270,644,626,583,162,0.27787307032590053
Puebla,San Felipe Teotlalcingo,11063,5714,5349,3305,1493,0.4517397881996974
Puebla,San Felipe Tepatlán,3793,1964,1829,1317,183,0.13895216400911162
Puebla,San Gabriel Chilac,15954,8385,7569,4904,1789,0.3648042414355628
Puebla,San Gregorio Atzompa,9671,4989,4682,2811,1781,0.6335823550337958
Puebla,San Jerónimo Tecuanipan,6597,3479,3118,1837,672,0.3658138268916712
Puebla,San Jerónimo Xayacatlán,3606,1872,1734,2397,505,0.21068001668752606
Puebla,San José Chiapa,10443,5336,5107,3749,1297,0.34595892237930115
Puebla,San José Miahuatlán,14018,7298,6720,4783,1847,0.386159314237926
Puebla,San Juan Atenco,3604,1944,1660,1417,530,0.374029640084686
Puebla,San Juan Atzompa,975,467,508,492,153,0.31097560975609756
Puebla,San Martín Texmelucan,155738,80816,74922,47306,25260,0.5339703208895278
Puebla,San Martín Totoltepec,692,334,358,298,145,0.4865771812080537
Puebla,San Matías Tlalancaleca,20974,10756,10218,6374,3041,0.4770944461876373
Puebla,San Miguel Ixitlán,526,272,254,428,67,0.15654205607476634
Puebla,San Miguel Xoxtla,12461,6372,6089,3246,1924,0.5927295132470733
Puebla,San Nicolás Buenos Aires,10464,5344,5120,3253,1118,0.3436827543805718
Puebla,San Nicolás de los Ranchos,11780,6043,5737,3811,1126,0.29546050905274207
Puebla,San Pablo Anicano,3759,1968,1791,1660,666,0.40120481927710844
Puebla,San Pedro Cholula,138433,71979,66454,43528,27130,0.6232769711450101
Puebla,San Pedro Yeloixtlahuaca,3488,1803,1685,1882,685,0.36397449521785336
Puebla,San Salvador el Seco,30639,15649,14990,9378,2640,0.28150991682661547
Puebla,San Salvador el Verde,34880,17925,16955,10397,4835,0.46503799172838317
Puebla,San Salvador Huixcolotla,16790,8614,8176,4369,2215,0.5069810025177386
Puebla,San Sebastián Tlacotepec,13189,6703,6486,3954,193,0.04881133029843197
Puebla,Santa Catarina Tlaltempan,749,377,372,590,62,0.10508474576271186
Puebla,Santa Inés Ahuatempan,6341,3303,3038,2890,781,0.27024221453287195
Puebla,Santa Isabel Cholula,11498,5885,5613,3207,1065,0.33208606173994387
Puebla,Santiago Miahuatlán,30309,15636,14673,9078,3739,0.41187486230447234
Puebla,Huehuetlán el Grande,6105,3159,2946,2732,869,0.31808199121522696
Puebla,Santo Tomás Hueyotlipan,9315,4791,4524,2771,1301,0.46950559364850236
Puebla,Soltepec,12631,6528,6103,3894,1585,0.40703646635850027
Puebla,Tecali de Herrera,23625,12131,11494,7510,3083,0.41051930758988014
Puebla,Tecamachalco,80771,41990,38781,25031,11702,0.46750029962846074
Puebla,Tecomatlán,6830,3414,3416,3280,1092,0.3329268292682927
Puebla,Tehuacán,327312,172905,154407,104168,49361,0.47385953459795715
Puebla,Tehuitzingo,12672,6579,6093,5541,2292,0.4136437466161343
Puebla,Tenampulco,6743,3439,3304,2782,660,0.2372393961179008
Puebla,Teopantlán,3836,2124,1712,1882,415,0.22051009564293306
Puebla,Teotlalco,3689,1849,1840,1447,708,0.4892881824464409
Puebla,Tepanco de López,22218,11817,10401,6991,3269,0.46760120154484336
Puebla,Tepango de Rodríguez,4155,2236,1919,1353,83,0.06134515890613452
Puebla,Tepatlaxco de Hidalgo,18854,9734,9120,5007,1978,0.3950469342919912
Puebla,Tepeaca,84270,43761,40509,22184,10914,0.4919761990623873
Puebla,Tepemaxalco,1216,602,614,361,94,0.26038781163434904
Puebla,Tepeojuma,8918,4779,4139,3293,1564,0.47494685696932887
Puebla,Tepetzintla,10373,5458,4915,3444,224,0.06504065040650407
Puebla,Tepexco,7523,3819,3704,2504,640,0.25559105431309903
Puebla,Tepexi de Rodríguez,22331,11137,11194,8473,2946,0.34769267083677563
Puebla,Tepeyahualco,19200,9834,9366,5955,2214,0.3717884130982368
Puebla,Tepeyahualco de Cuauhtémoc,3851,2035,1816,1249,621,0.49719775820656525
Puebla,Tetela de Ocampo,27216,14116,13100,11553,3447,0.2983640612827837
Puebla,Teteles de Avila Castillo,6653,3766,2887,2329,914,0.39244310863031345
Puebla,Teziutlán,103583,54934,48649,34363,16400,0.4772575153508134
Puebla,Tianguismanalco,14432,7442,6990,6248,1489,0.23831626120358515
Puebla,Tilapa,9664,5029,4635,3527,1849,0.5242415650694642
Puebla,Tlacotepec de Benito Juárez,54757,29003,25754,17278,7094,0.41057992823243433
Puebla,Tlacuilotepec,15977,8101,7876,5785,1010,0.17458945548833188
Puebla,Tlachichuca,31639,16141,15498,9245,3063,0.3313142239048134
Puebla,Tlahuapan,41547,21086,20461,12553,5326,0.42428104835497493
Puebla,Tlaltenango,7425,3791,3634,2056,1032,0.5019455252918288
Puebla,Tlanepantla,5390,2808,2582,1349,374,0.27724240177909565
Puebla,Tlaola,20433,10583,9850,6139,732,0.11923766085681707
Puebla,Tlapacoya,6422,3347,3075,1972,497,0.25202839756592293
Puebla,Tlapanalá,10344,5294,5050,3285,1717,0.5226788432267885
Puebla,Tlatlauquitepec,55576,28959,26617,19115,6469,0.3384253204289825
Puebla,Tlaxco,4934,2506,2428,1846,447,0.24214517876489708
Puebla,Tochimilco,19315,10119,9196,6396,1762,0.2754846779237023
Puebla,Tochtepec,22454,11626,10828,6362,2930,0.46054699779943414
Puebla,Totoltepec de Guerrero,1187,634,553,914,142,0.15536105032822758
Puebla,Tulcingo,9871,5230,4641,5010,2030,0.405189620758483
Puebla,Tuzamapan de Galeana,5924,3015,2909,2151,363,0.16875871687587168
Puebla,Tzicatlacoyan,6476,3286,3190,2406,646,0.2684954280964256
Puebla,Venustiano Carranza,28395,14982,13413,9815,4359,0.44411614875191036
Puebla,Vicente Guerrero,26559,14125,12434,8013,1693,0.2112816672906527
Puebla,Xayacatlán de Bravo,1570,844,726,998,240,0.24048096192384769
Puebla,Xicotepec,80591,42143,38448,25690,9161,0.35659789801479175
Puebla,Xicotlán,1312,684,628,554,236,0.4259927797833935
Puebla,Xiutetelco,42943,22264,20679,11906,3669,0.3081639509491013
Puebla,Xochiapulco,3443,1818,1625,1757,301,0.17131474103585656
Puebla,Xochiltepec,3375,1807,1568,1282,642,0.500780031201248
Puebla,Xochitlán de Vicente Suárez,13025,6763,6262,4640,428,0.09224137931034483
Puebla,Xochitlán Todos Santos,7178,3771,3407,2605,1053,0.4042226487523992
Puebla,Yaonáhuac,7926,4243,3683,2504,552,0.22044728434504793
Puebla,Yehualtepec,26392,13683,12709,7936,3757,0.47341229838709675
Puebla,Zacapala,4647,2442,2205,1925,673,0.3496103896103896
Puebla,Zacapoaxtla,57887,30736,27151,19580,5899,0.3012768130745659
Puebla,Zacatlán,87361,45856,41505,29872,12328,0.41269416175682916
Puebla,Zapotitlán,8595,4610,3985,3583,1154,0.3220764722299749
Puebla,Zapotitlán de Méndez,5675,2882,2793,1897,297,0.1565629942013706
Puebla,Zaragoza,16752,8998,7754,5760,2656,0.46111111111111114
Puebla,Zautla,20717,10889,9828,7432,1683,0.22645317545748117
Puebla,Zihuateutla,11967,6193,5774,4070,704,0.17297297297297298
Puebla,Zinacatepec,18359,9578,8781,5215,2387,0.4577181208053691
Puebla,Zongozotla,4539,2322,2217,1394,121,0.08680057388809183
Puebla,Zoquiapan,2452,1314,1138,1091,152,0.13932172318973418
Puebla,Zoquitlán,20335,10630,9705,6682,520,0.07782101167315175
Querétaro,Amealco de Bonfil,66841,34606,32235,24475,7538,0.3079877425944842
Querétaro,Pinal de Amoles,27365,14072,13293,9513,3501,0.3680227057710501
Querétaro,Arroyo Seco,13142,6872,6270,5667,2889,0.509793541556379
Querétaro,Cadereyta de Montes,69075,36082,32993,23061,9389,0.407137591604874
Querétaro,Colón,67121,33910,33211,19056,9574,0.5024139378673383
Querétaro,Corregidora,212567,109535,103032,75308,56195,0.7462022627078132
Querétaro,Ezequiel Montes,45141,23449,21692,13878,6615,0.4766536964980545
Querétaro,Huimilpan,36808,19463,17345,13226,7323,0.5536821412369575
Querétaro,Jalpan de Serra,27343,14307,13036,10747,5359,0.4986507862659347
Querétaro,Landa de Matamoros,18794,9806,8988,8240,3971,0.48191747572815535
Querétaro,El Marqués,231668,116185,115483,90060,50727,0.5632578281145902
Querétaro,Pedro Escobedo,77404,39479,37925,22047,12126,0.5500068036467547
Querétaro,Peñamiller,19141,9789,9352,6824,2377,0.34832942555685814
Querétaro,Querétaro,1049777,535188,514589,358824,248356,0.6921387644081778
Querétaro,San Joaquín,8359,4484,3875,3327,1435,0.4313195070634205
Querétaro,San Juan del Río,297804,152454,145350,107354,60880,0.5670957765896008
Querétaro,Tequisquiapan,72201,37178,35023,25687,11792,0.4590648966403239
Querétaro,Tolimán,27916,14788,13128,9059,2380,0.2627221547632189
Quintana Roo,Cozumel,88626,44211,44415,31078,20033,0.6446038998648562
Quintana Roo,Felipe Carrillo Puerto,83990,42036,41954,27365,14412,0.5266581399598027
Quintana Roo,Isla Mujeres,22686,11144,11542,9557,5076,0.5311290153813958
Quintana Roo,Othón P. Blanco,233648,118552,115096,87728,55794,0.6359885099398139
Quintana Roo,Benito Juárez,911503,452178,459325,336997,221967,0.6586616498069716
Quintana Roo,José María Morelos,39165,19310,19855,13891,6857,0.4936289683968037
Quintana Roo,Lázaro Cárdenas,29171,14327,14844,10413,5612,0.5389417074810333
Quintana Roo,Solidaridad,333800,163324,170476,144680,76377,0.5279029582526956
Quintana Roo,Tulum,46721,22331,24390,21990,9023,0.41032287403365164
Quintana Roo,Bacalar,41754,20703,21051,14266,7541,0.5285994672648254
Quintana Roo,Puerto Morelos,26921,13090,13831,13757,6245,0.45395071599912773
San Luis Potosí,Ahualulco,18974,10029,8945,6251,3181,0.5088785794272916
San Luis Potosí,Alaquines,7785,3998,3787,3430,1555,0.45335276967930027
San Luis Potosí,Aquismón,48359,24346,24013,15234,2995,0.19659971117237757
San Luis Potosí,Armadillo de los Infante,4013,2016,1997,2202,745,0.3383287920072661
San Luis Potosí,Cárdenas,18317,9582,8735,7559,4213,0.5573488556687393
San Luis Potosí,Catorce,9579,4689,4890,4004,1680,0.4195804195804196
San Luis Potosí,Cedral,19840,10164,9676,7442,4132,0.555227089492072
San Luis Potosí,Cerritos,22075,11293,10782,9559,5336,0.5582173867559368
San Luis Potosí,Cerro de San Pedro,5050,2497,2553,2229,1092,0.4899057873485868
San Luis Potosí,Ciudad del Maíz,30320,15325,14995,11543,6414,0.5556614398336654
San Luis Potosí,Ciudad Fernández,48106,24663,23443,16433,10712,0.6518590640783789
San Luis Potosí,Tancanhuitz,20300,10299,10001,6106,1224,0.20045856534556175
San Luis Potosí,Ciudad Valles,179371,93009,86362,65309,40071,0.6135601525057802
San Luis Potosí,Coxcatlán,15660,7897,7763,5015,983,0.19601196410767696
San Luis Potosí,Charcas,21814,11158,10656,8137,4218,0.5183728646921469
San Luis Potosí,Ebano,40899,20968,19931,14706,9005,0.6123351013191894
San Luis Potosí,Guadalcázar,25119,12608,12511,9326,4307,0.4618271499034956
San Luis Potosí,Huehuetlán,15334,7852,7482,5005,1105,0.22077922077922077
San Luis Potosí,Lagunillas,5453,2723,2730,2654,1285,0.4841748304446119
San Luis Potosí,Matehuala,102199,52548,49651,34969,23797,0.6805170293688696
San Luis Potosí,Mexquitic de Carmona,58469,30598,27871,18082,10093,0.5581794049330826
San Luis Potosí,Moctezuma,19036,9955,9081,7463,3754,0.5030148733753182
San Luis Potosí,Rayón,15301,7843,7458,6708,3216,0.47942754919499103
San Luis Potosí,Rioverde,97943,50900,47043,36312,22069,0.6077605199383124
San Luis Potosí,Salinas,31107,16233,14874,10783,6375,0.5912083835667254
San Luis Potosí,San Antonio,9382,4678,4704,2833,341,0.12036710201200142
San Luis Potosí,San Ciro de Acosta,10215,5274,4941,4618,2360,0.5110437418796016
San Luis Potosí,San Luis Potosí,911908,471011,440897,301965,224263,0.7426787872766711
San Luis Potosí,San Martín Chalchicuautla,18468,9361,9107,6602,1550,0.2347773401999394
San Luis Potosí,San Nicolás Tolentino,4779,2408,2371,2682,1154,0.43027591349739003
San Luis Potosí,Santa Catarina,12163,6246,5917,4061,1152,0.2836739719280965
San Luis Potosí,Santa María del Río,39880,20722,19158,14523,6167,0.4246367830338084
San Luis Potosí,Santo Domingo,10785,5506,5279,4531,2351,0.518870006621055
San Luis Potosí,San Vicente Tancuayalab,14945,7534,7411,4987,2328,0.4668137156607179
San Luis Potosí,Soledad de Graciano Sánchez,332072,170195,161877,107614,78755,0.7318285724905681
San Luis Potosí,Tamasopo,29184,14438,14746,11391,5634,0.49460100079009744
San Luis Potosí,Tamazunchale,95037,48828,46209,29991,8994,0.299889966990097
San Luis Potosí,Tampacán,14348,7067,7281,4636,1415,0.3052200172562554
San Luis Potosí,Tampamolón Corona,13603,6848,6755,4294,1001,0.23311597578015836
San Luis Potosí,Tamuín,36968,18859,18109,13111,7378,0.5627335824879872
San Luis Potosí,Tanlajás,18208,9097,9111,5730,792,0.1382198952879581
San Luis Potosí,Tanquián de Escobedo,13448,6875,6573,4441,2261,0.5091195676649404
San Luis Potosí,Tierra Nueva,7966,4246,3720,3773,1286,0.340842830638749
San Luis Potosí,Vanegas,7557,3751,3806,2680,1399,0.5220149253731343
San Luis Potosí,Venado,14188,7172,7016,5790,2714,0.4687392055267703
San Luis Potosí,Villa de Arriaga,18206,9213,8993,5864,3229,0.5506480218281037
San Luis Potosí,Villa de Guadalupe,9277,4646,4631,3842,1856,0.48308172826652784
San Luis Potosí,Villa de la Paz,5298,2664,2634,1801,1129,0.6268739589117157
San Luis Potosí,Villa de Ramos,38389,20122,18267,14084,8000,0.5680204487361545
San Luis Potosí,Villa de Reyes,52912,26749,26163,14523,8540,0.5880327755973284
San Luis Potosí,Villa Hidalgo,15458,7803,7655,6172,3286,0.5324044069993519
San Luis Potosí,Villa Juárez,10304,5169,5135,5268,2303,0.4371678056188307
San Luis Potosí,Axtla de Terrazas,32544,16627,15917,10181,3615,0.3550731755230331
San Luis Potosí,Xilitla,49741,25311,24430,15696,4422,0.28172782874617736
San Luis Potosí,Zaragoza,27386,13904,13482,7986,4900,0.6135737540696219
San Luis Potosí,Villa de Arista,17258,8888,8370,5683,2970,0.5226112968502551
San Luis Potosí,Matlapa,28996,14885,14111,8670,1999,0.23056516724336792
San Luis Potosí,El Naranjo,20959,10514,10445,7882,4816,0.61101243339254
Sinaloa,Ahome,459310,233994,225316,160276,102216,0.637749881454491
Sinaloa,Angostura,44093,21964,22129,16111,10883,0.6755012103531749
Sinaloa,Badiraguato,26542,12873,13669,10547,4556,0.4319711766379065
Sinaloa,Concordia,24899,12360,12539,10903,5038,0.4620746583509126
Sinaloa,Cosalá,17012,8336,8676,5818,2918,0.5015469233413544
Sinaloa,Culiacán,1003530,512484,491046,340656,231364,0.6791719505894509
Sinaloa,Choix,29334,14445,14889,11402,4471,0.39212418873881777
Sinaloa,Elota,55339,26793,28546,15450,8341,0.5398705501618123
Sinaloa,Escuinapa,59988,29887,30101,21321,10901,0.5112799587261385
Sinaloa,El Fuerte,96593,48137,48456,32364,15594,0.4818316648127549
Sinaloa,Guasave,289370,146352,143018,92905,58900,0.6339809482805016
Sinaloa,Mazatlán,501441,256060,245381,196436,120231,0.6120619438392149
Sinaloa,Mocorito,40358,19783,20575,16294,8793,0.5396464956425678
Sinaloa,Rosario,52345,25896,26449,18695,10444,0.5586520460016047
Sinaloa,Salvador Alvarado,79492,41068,38424,29058,19423,0.6684217771353844
Sinaloa,San Ignacio,19505,9223,10282,8278,3806,0.4597728920028992
Sinaloa,Sinaloa,78670,38820,39850,27991,14396,0.5143081704833696
Sinaloa,Navolato,149122,73653,75469,47522,25565,0.5379613652624048
Sonora,Aconchi,2563,1227,1336,1113,639,0.5741239892183289
Sonora,Agua Prieta,91929,46118,45811,33485,21914,0.6544422875914588
Sonora,Alamos,24976,12067,12909,10065,3847,0.38221559860904125
Sonora,Altar,9492,4780,4712,3644,2128,0.58397365532382
Sonora,Arivechi,1177,583,594,684,278,0.4064327485380117
Sonora,Arizpe,2788,1342,1446,1555,797,0.512540192926045
Sonora,Atil,626,316,310,295,169,0.5728813559322034
Sonora,Bacadéhuachi,979,457,522,540,284,0.5259259259259259
Sonora,Bacanora,759,369,390,491,207,0.4215885947046843
Sonora,Bacerac,1221,618,603,636,303,0.47641509433962265
Sonora,Bacoachi,1475,725,750,842,456,0.5415676959619953
Sonora,Bácum,23151,11367,11784,7811,3912,0.5008321597746768
Sonora,Banámichi,1825,901,924,811,487,0.6004932182490752
Sonora,Baviácora,3191,1529,1662,1626,860,0.5289052890528906
Sonora,Bavispe,1169,551,618,624,345,0.5528846153846154
Sonora,Benjamín Hill,4988,2505,2483,2095,1216,0.5804295942720764
Sonora,Caborca,89122,44386,44736,33572,20362,0.606517335875134
Sonora,Cajeme,436484,221883,214601,162966,102037,0.626124467680375
Sonora,Cananea,39451,19841,19610,14538,10556,0.7260971247764479
Sonora,Carbó,4946,2378,2568,1761,897,0.5093696763202725
Sonora,La Colorada,1848,828,1020,1197,438,0.3659147869674185
Sonora,Cucurpe,863,393,470,533,236,0.4427767354596623
Sonora,Cumpas,5829,2864,2965,2851,1630,0.5717292178183093
Sonora,Divisaderos,753,359,394,408,205,0.5024509803921569
Sonora,Empalme,51431,25463,25968,18765,10650,0.5675459632294164
Sonora,Etchojoa,61309,30001,31308,18543,6709,0.3618076902335113
Sonora,Fronteras,9041,4461,4580,3509,2342,0.6674266172698775
Sonora,Granados,1009,485,524,530,303,0.5716981132075472
Sonora,Guaymas,156863,78876,77987,61162,33520,0.5480527124685262
Sonora,Hermosillo,936263,468773,467490,326410,222725,0.6823473545540885
Sonora,Huachinera,1186,579,607,628,318,0.5063694267515924
Sonora,Huásabas,888,421,467,533,260,0.4878048780487805
Sonora,Huatabampo,77682,38265,39417,27486,11253,0.40940842610783673
Sonora,Huépac,943,449,494,608,295,0.48519736842105265
Sonora,Imuris,12536,6135,6401,5104,2918,0.5717084639498433
Sonora,Magdalena,33049,16819,16230,12327,8445,0.6850815283523972
Sonora,Mazatán,1101,507,594,662,302,0.4561933534743202
Sonora,Moctezuma,5173,2630,2543,2367,1399,0.5910435149978877
Sonora,Naco,5774,2877,2897,2496,1423,0.5701121794871795
Sonora,Nácori Chico,1531,723,808,850,359,0.4223529411764706
Sonora,Nacozari de García,14369,7095,7274,5801,3669,0.6324771591104982
Sonora,Navojoa,164387,83123,81264,58284,28504,0.48905359961567496
Sonora,Nogales,264782,132522,132260,90150,65122,0.7223738214087632
Sonora,Onavas,365,181,184,193,92,0.47668393782383417
Sonora,Opodepe,2438,1113,1325,1236,519,0.4199029126213592
Sonora,Oquitoa,496,265,231,216,125,0.5787037037037037
Sonora,Pitiquito,9122,4428,4694,3621,2115,0.584092792046396
Sonora,Puerto Peñasco,62689,31053,31636,29702,14016,0.47188741498888964
Sonora,Quiriego,3090,1472,1618,1435,300,0.20905923344947736
Sonora,Rayón,1496,687,809,917,392,0.42748091603053434
Sonora,Rosario,4830,2346,2484,2264,830,0.3666077738515901
Sonora,Sahuaripa,5257,2538,2719,2752,1312,0.47674418604651164
Sonora,San Felipe de Jesús,369,168,201,290,104,0.3586206896551724
Sonora,San Javier,537,243,294,229,106,0.462882096069869
Sonora,San Luis Río Colorado,199021,98469,100552,72402,49563,0.6845529129029585
Sonora,San Miguel de Horcasitas,10729,5122,5607,3533,947,0.26804415510897256
Sonora,San Pedro de la Cueva,1458,665,793,1267,467,0.3685872138910813
Sonora,Santa Ana,16203,8214,7989,6381,4250,0.666039805673092
Sonora,Santa Cruz,1835,873,962,891,479,0.5375982042648709
Sonora,Sáric,2058,979,1079,1078,530,0.49165120593692024
Sonora,Soyopa,1368,599,769,877,358,0.40820980615735464
Sonora,Suaqui Grande,1114,513,601,543,287,0.5285451197053407
Sonora,Tepache,1178,557,621,778,347,0.44601542416452444
Sonora,Trincheras,1381,642,739,700,358,0.5114285714285715
Sonora,Tubutama,1473,690,783,739,388,0.5250338294993234
Sonora,Ures,8548,4097,4451,4334,2300,0.53068758652515
Sonora,Villa Hidalgo,1429,681,748,865,432,0.49942196531791905
Sonora,Villa Pesqueira,1043,451,592,664,250,0.37650602409638556
Sonora,Yécora,4793,2378,2415,2658,836,0.3145221971407073
Sonora,General Plutarco Elías Calles,13627,6900,6727,6469,3336,0.5156902148709228
Sonora,Benito Juárez,21692,10791,10901,7097,3594,0.5064111596449203
Sonora,San Ignacio Río Muerto,14279,6937,7342,4615,2196,0.47583965330444206
Tabasco,Balancán,58524,29282,29242,22460,11874,0.528673196794301
Tabasco,Cárdenas,243229,124434,118795,84713,50830,0.6000259700400175
Tabasco,Centla,107731,54617,53114,34495,18700,0.5421075518191042
Tabasco,Centro,683607,353527,330080,248143,162781,0.6559967438130433
Tabasco,Comalcalco,214877,109594,105283,70296,42820,0.6091385000569023
Tabasco,Cunduacán,137257,69985,67272,44811,27183,0.6066144473455178
Tabasco,Emiliano Zapata,32181,16728,15453,12252,7051,0.5754978778974861
Tabasco,Huimanguillo,190885,96975,93910,62848,37215,0.5921429480651731
Tabasco,Jalapa,37749,18870,18879,12760,7783,0.6099529780564263
Tabasco,Jalpa de Méndez,91185,46272,44913,27142,17566,0.6471888585955345
Tabasco,Jonuta,30798,15344,15454,10184,5629,0.5527297721916732
Tabasco,Macuspana,158601,81070,77531,52633,28520,0.5418653696350199
Tabasco,Nacajuca,150300,77406,72894,51899,33960,0.6543478679743348
Tabasco,Paraíso,96741,49069,47672,32946,21428,0.650397620348449
Tabasco,Tacotalpa,47905,24151,23754,15924,6537,0.4105124340617935
Tabasco,Teapa,58718,29954,28764,19244,10953,0.5691644148825608
Tabasco,Tenosique,62310,31649,30661,24050,12856,0.5345530145530145
Tamaulipas,Abasolo,9822,4924,4898,4573,2421,0.5294117647058824
Tamaulipas,Aldama,28725,14378,14347,12799,7062,0.5517618563950308
Tamaulipas,Altamira,269790,136484,133306,107981,63553,0.5885572461821987
Tamaulipas,Antiguo Morelos,8850,4463,4387,3569,2246,0.6293079293919865
Tamaulipas,Burgos,4256,2055,2201,2311,1114,0.48204240588489833
Tamaulipas,Bustamante,7542,3689,3853,2450,1242,0.506938775510204
Tamaulipas,Camargo,16546,7926,8620,8440,5136,0.6085308056872037
Tamaulipas,Casas,4143,1965,2178,1685,845,0.5014836795252225
Tamaulipas,Ciudad Madero,205933,107685,98248,75722,55998,0.7395208790047807
Tamaulipas,Cruillas,1671,845,826,1101,401,0.3642143505903724
Tamaulipas,Gómez Farías,8288,4058,4230,3465,1975,0.56998556998557
Tamaulipas,González,41470,21102,20368,15913,9649,0.6063595802174323
Tamaulipas,Güémez,15032,7270,7762,6166,3383,0.548653908530652
Tamaulipas,Guerrero,3803,1688,2115,2062,1386,0.6721629485935985
Tamaulipas,Gustavo Díaz Ordaz,15677,7811,7866,6747,4246,0.6293167333629761
Tamaulipas,Hidalgo,17012,8323,8689,8886,4279,0.4815440018005852
Tamaulipas,Jaumave,15994,8002,7992,5713,3121,0.546297917031332
Tamaulipas,Jiménez,6375,3204,3171,3109,1602,0.5152782245094886
Tamaulipas,Llera,14645,7177,7468,6953,3425,0.49259312526966775
Tamaulipas,Mainero,2048,1027,1021,1175,522,0.4442553191489362
Tamaulipas,El Mante,106144,55225,50919,45162,28320,0.627075860236482
Tamaulipas,Matamoros,541979,274081,267898,195499,110681,0.5661461183944675
Tamaulipas,Méndez,4280,2138,2142,2273,1093,0.4808622965244171
Tamaulipas,Mier,6385,3002,3383,3390,2542,0.7498525073746313
Tamaulipas,Miguel Alemán,26237,12612,13625,12213,10142,0.8304265946122984
Tamaulipas,Miquihuana,3704,1792,1912,1498,653,0.43591455273698265
Tamaulipas,Nuevo Laredo,425058,215616,209442,143080,101964,0.712636287391669
Tamaulipas,Nuevo Morelos,3810,1833,1977,1556,915,0.5880462724935732
Tamaulipas,Ocampo,13190,6460,6730,5260,3168,0.6022813688212928
Tamaulipas,Padilla,13618,6767,6851,5332,3244,0.6084021005251313
Tamaulipas,Palmillas,1917,956,961,966,422,0.43685300207039335
Tamaulipas,Reynosa,704767,354406,350361,275570,172244,0.6250462677359655
Tamaulipas,Río Bravo,132484,66363,66121,47952,31298,0.6526943610276944
Tamaulipas,San Carlos,7411,3556,3855,3444,1587,0.460801393728223
Tamaulipas,San Fernando,51405,25693,25712,21779,11755,0.5397401166261078
Tamaulipas,San Nicolás,926,432,494,490,140,0.2857142857142857
Tamaulipas,Soto la Marina,23673,11570,12103,10465,5107,0.48800764452938367
Tamaulipas,Tampico,297562,155805,141757,109591,78971,0.720597494319789
Tamaulipas,Tula,28230,14220,14010,10749,5563,0.5175365150246535
Tamaulipas,Valle Hermoso,60055,30613,29442,22976,14482,0.6303098885793872
Tamaulipas,Victoria,349688,180459,169229,124897,86659,0.6938437272312385
Tamaulipas,Villagrán,5361,2626,2735,2466,1283,0.5202757502027575
Tamaulipas,Xicoténcatl,22229,11294,10935,9322,5745,0.6162840592147608
Tlaxcala,Amaxac de Guerrero,11403,5849,5554,3767,1805,0.4791611361826387
Tlaxcala,Apetatitlán de Antonio Carvajal,16003,8258,7745,4990,2744,0.5498997995991984
Tlaxcala,Atlangatepec,7087,3629,3458,2541,1100,0.4329004329004329
Tlaxcala,Atltzayanca,18111,9168,8943,5434,2034,0.3743099006256901
Tlaxcala,Apizaco,80725,42258,38467,28836,15722,0.5452212512137605
Tlaxcala,Calpulalpan,51172,26556,24616,15018,8430,0.561326408310028
Tlaxcala,El Carmen Tequexquitla,17332,8927,8405,5235,1260,0.24068767908309455
Tlaxcala,Cuapiaxtla,16222,8250,7972,4619,1976,0.4277982247239662
Tlaxcala,Cuaxomulco,5928,3026,2902,1965,885,0.45038167938931295
Tlaxcala,Chiautempan,73215,37964,35251,22233,10087,0.4536949579453965
Tlaxcala,Muñoz de Domingo Arenas,4755,2464,2291,1603,869,0.5421085464753587
Tlaxcala,Españita,9416,4830,4586,3692,1282,0.34723726977248104
Tlaxcala,Huamantla,98764,51003,47761,28544,11964,0.41914237668161436
Tlaxcala,Hueyotlipan,15190,7764,7426,5322,2320,0.4359263434798948
Tlaxcala,Ixtacuixtla de Mariano Matamoros,38970,20054,18916,13028,6402,0.49140313171630334
Tlaxcala,Ixtenco,7504,3882,3622,2831,1084,0.38290356764394207
Tlaxcala,Mazatecochco de José María Morelos,11592,5773,5819,2967,981,0.3306370070778564
Tlaxcala,Contla de Juan Cuamatzi,38579,19787,18792,10870,3948,0.36320147194112234
Tlaxcala,Tepetitla de Lardizábal,22274,11575,10699,7197,3457,0.480339030151452
Tlaxcala,Sanctórum de Lázaro Cárdenas,9432,4849,4583,2979,1549,0.5199731453507889
Tlaxcala,Nanacamilpa de Mariano Arista,18686,9624,9062,6031,3314,0.5494942795556292
Tlaxcala,Acuamanala de Miguel Hidalgo,6432,3248,3184,1772,851,0.4802483069977427
Tlaxcala,Natívitas,26309,13584,12725,8076,3628,0.4492322932144626
Tlaxcala,Panotla,28357,14938,13419,9860,4854,0.4922920892494929
Tlaxcala,San Pablo del Monte,82688,41886,40802,20708,9017,0.4354355804519992
Tlaxcala,Santa Cruz Tlaxcala,24116,12514,11602,9425,3924,0.4163395225464191
Tlaxcala,Tenancingo,12974,6664,6310,3580,1523,0.4254189944134078
Tlaxcala,Teolocholco,25257,12881,12376,7105,2973,0.41843771991555245
Tlaxcala,Tepeyanco,13328,6970,6358,4074,1858,0.45606283750613646
Tlaxcala,Terrenate,15475,7791,7684,4655,1726,0.3707841031149302
Tlaxcala,Tetla de la Solidaridad,35284,18031,17253,12723,5906,0.46419869527627133
Tlaxcala,Tetlatlahuca,13561,7040,6521,4029,2293,0.5691238520724745
Tlaxcala,Tlaxcala,99896,52644,47252,36702,21402,0.5831289847964689
Tlaxcala,Tlaxco,45438,23361,22077,15301,6368,0.41618194889222926
Tlaxcala,Tocatlán,6294,3175,3119,1724,851,0.49361948955916474
Tlaxcala,Totolac,22529,11801,10728,7134,3859,0.5409307541351276
Tlaxcala,Ziltlaltépec de Trinidad Sánchez Santos,9207,4768,4439,3144,1042,0.33142493638676845
Tlaxcala,Tzompantepec,18006,9270,8736,7222,2924,0.4048739961229576
Tlaxcala,Xaloztoc,25607,12861,12746,7214,3552,0.492375935680621
Tlaxcala,Xaltocan,10601,5588,5013,3994,1626,0.4071106659989985
Tlaxcala,Papalotla de Xicohténcatl,33499,17317,16182,9953,4387,0.4407716266452326
Tlaxcala,Xicohtzinco,14197,7435,6762,4224,2266,0.5364583333333334
Tlaxcala,Yauhquemehcan,42242,21854,20388,15421,8279,0.5368653135334933
Tlaxcala,Zacatelco,45717,23777,21940,14048,6620,0.4712414578587699
Tlaxcala,Benito Juárez,6211,3248,2963,1826,916,0.5016429353778752
Tlaxcala,Emiliano Zapata,4951,2524,2427,1496,593,0.3963903743315508
Tlaxcala,Lázaro Cárdenas,3534,1799,1735,1151,567,0.4926151172893136
Tlaxcala,La Magdalena Tlaltelulco,19036,9596,9440,5279,225,0.042621708656942606
Tlaxcala,San Damián Texóloc,5884,2962,2922,1779,1035,0.581787521079258
Tlaxcala,San Francisco Tetlanohcan,11761,6119,5642,3462,1200,0.3466204506065858
Tlaxcala,San Jerónimo Zacualpan,4092,2152,1940,1265,666,0.5264822134387351
Tlaxcala,San José Teacalco,6436,3279,3157,1752,671,0.3829908675799087
Tlaxcala,San Juan Huactzinco,7688,4011,3677,2016,1112,0.5515873015873016
Tlaxcala,San Lorenzo Axocomanitla,5689,2922,2767,1604,885,0.5517456359102244
Tlaxcala,San Lucas Tecopilco,3077,1536,1541,1025,545,0.5317073170731708
Tlaxcala,Santa Ana Nopalucan,7952,4052,3900,2237,1197,0.535091640590076
Tlaxcala,Santa Apolonia Teacalco,4636,2392,2244,1377,797,0.5787944807552651
Tlaxcala,Santa Catarina Ayometla,9463,4896,4567,2631,1236,0.4697833523375142
Tlaxcala,Santa Cruz Quilehtla,7750,3921,3829,2019,969,0.4799405646359584
Tlaxcala,Santa Isabel Xiloxoxtla,5443,2786,2657,1566,607,0.3876117496807152
Veracruz de Ignacio de la Llave,Acajete,9701,4781,4920,3256,987,0.30313267813267813
Veracruz de Ignacio de la Llave,Acatlán,3441,1775,1666,1164,189,0.16237113402061856
Veracruz de Ignacio de la Llave,Acayucan,80815,42298,38517,29657,15145,0.5106720167245506
Veracruz de Ignacio de la Llave,Actopan,41742,21132,20610,17854,9143,0.5120981292707516
Veracruz de Ignacio de la Llave,Acula,5253,2583,2670,2032,1231,0.6058070866141733
Veracruz de Ignacio de la Llave,Acultzingo,23100,11922,11178,7284,2415,0.3315485996705107
Veracruz de Ignacio de la Llave,Camarón de Tejeda,6538,3343,3195,2267,1121,0.4944861049845611
Veracruz de Ignacio de la Llave,Alpatláhuac,10338,5304,5034,3191,633,0.19837041679724224
Veracruz de Ignacio de la Llave,Alto Lucero de Gutiérrez Barrios,28184,14178,14006,11864,5393,0.4545684423465947
Veracruz de Ignacio de la Llave,Altotonga,64234,33707,30527,21708,5694,0.26229961304588173
Veracruz de Ignacio de la Llave,Alvarado,57035,29097,27938,26243,15443,0.5884616850207675
Veracruz de Ignacio de la Llave,Amatitlán,7866,4018,3848,3349,2025,0.6046581068975814
Veracruz de Ignacio de la Llave,Naranjos Amatlán,26843,14174,12669,10405,5818,0.5591542527630947
Veracruz de Ignacio de la Llave,Amatlán de los Reyes,46955,24181,22774,17602,7682,0.43642767867287807
Veracruz de Ignacio de la Llave,Angel R. Cabada,33839,17325,16514,13994,7085,0.5062884093182792
Veracruz de Ignacio de la Llave,La Antigua,28682,14945,13737,12356,7079,0.5729200388475235
Veracruz de Ignacio de la Llave,Apazapan,4709,2346,2363,1823,916,0.5024684585847504
Veracruz de Ignacio de la Llave,Aquila,1978,1049,929,631,181,0.2868462757527734
Veracruz de Ignacio de la Llave,Astacinga,6909,3708,3201,2241,295,0.13163766175814368
Veracruz de Ignacio de la Llave,Atlahuilco,11577,5983,5594,3284,403,0.12271619975639464
Veracruz de Ignacio de la Llave,Atoyac,23461,12110,11351,8705,4325,0.49684089603676046
Veracruz de Ignacio de la Llave,Atzacan,22651,11526,11125,6731,1791,0.26608230574951713
Veracruz de Ignacio de la Llave,Atzalan,49180,24801,24379,17622,6558,0.3721484508001362
Veracruz de Ignacio de la Llave,Tlaltetela,16485,8167,8318,5023,1956,0.38940871988851283
Veracruz de Ignacio de la Llave,Ayahualulco,27217,13979,13238,8092,1548,0.19130004943153733
Veracruz de Ignacio de la Llave,Banderilla,25993,13772,12221,9351,5162,0.5520265212276761
Veracruz de Ignacio de la Llave,Benito Juárez,16120,8332,7788,5191,466,0.08977075707956078
Veracruz de Ignacio de la Llave,Boca del Río,144550,76565,67985,59184,40591,0.6858441470667748
Veracruz de Ignacio de la Llave,Calcahualco,13701,6939,6762,3930,511,0.13002544529262086
Veracruz de Ignacio de la Llave,Camerino Z. Mendoza,41835,22148,19687,13763,7179,0.521615926760154
Veracruz de Ignacio de la Llave,Carrillo Puerto,18888,9551,9337,6083,2397,0.39404898898569785
Veracruz de Ignacio de la Llave,Catemaco,49451,25852,23599,17215,7686,0.4464711007841998
Veracruz de Ignacio de la Llave,Cazones de Herrera,24421,12575,11846,9247,3594,0.3886665945712123
Veracruz de Ignacio de la Llave,Cerro Azul,25011,13413,11598,9950,5696,0.5724623115577889
Veracruz de Ignacio de la Llave,Citlaltépetl,11165,5687,5478,4184,1067,0.255019120458891
Veracruz de Ignacio de la Llave,Coacoatzintla,11018,5689,5329,3720,1284,0.34516129032258064
Veracruz de Ignacio de la Llave,Coahuitlán,8176,4186,3990,2320,426,0.18362068965517242
Veracruz de Ignacio de la Llave,Coatepec,93911,48815,45096,34938,18495,0.5293663060278208
Veracruz de Ignacio de la Llave,Coatzacoalcos,310698,161559,149139,132369,80428,0.6076044995429444
Veracruz de Ignacio de la Llave,Coatzintla,55016,28724,26292,19211,12050,0.6272448076622769
Veracruz de Ignacio de la Llave,Coetzala,2355,1199,1156,729,209,0.28669410150891633
Veracruz de Ignacio de la Llave,Colipa,5743,2899,2844,2546,830,0.32600157109190886
Veracruz de Ignacio de la Llave,Comapa,19876,9901,9975,6568,2335,0.3555115712545676
Veracruz de Ignacio de la Llave,Córdoba,204721,108761,95960,76962,41855,0.5438398170525715
Veracruz de Ignacio de la Llave,Cosamaloapan de Carpio,54737,28858,25879,24166,13931,0.5764710750641397
Veracruz de Ignacio de la Llave,Cosautlán de Carvajal,16167,8187,7980,5446,1920,0.35255233198677927
Veracruz de Ignacio de la Llave,Coscomatepec,59471,30756,28715,17353,4334,0.2497550855759811
Veracruz de Ignacio de la Llave,Cosoleacaque,130903,68746,62157,51398,30024,0.5841472430833885
Veracruz de Ignacio de la Llave,Cotaxtla,22050,11182,10868,8096,4576,0.5652173913043478
Veracruz de Ignacio de la Llave,Coxquihui,16333,8431,7902,4511,1056,0.23409443582354245
Veracruz de Ignacio de la Llave,Coyutla,23096,11955,11141,7290,2196,0.3012345679012346
Veracruz de Ignacio de la Llave,Cuichapa,11869,6224,5645,4349,1968,0.4525178201885491
Veracruz de Ignacio de la Llave,Cuitláhuac,28075,14565,13510,10188,5510,0.5408323517864154
Veracruz de Ignacio de la Llave,Chacaltianguis,11461,5887,5574,4869,3093,0.6352433764633395
Veracruz de Ignacio de la Llave,Chalma,13527,7006,6521,4830,1152,0.23850931677018633
Veracruz de Ignacio de la Llave,Chiconamel,6610,3467,3143,2081,402,0.19317635752042286
Veracruz de Ignacio de la Llave,Chiconquiaco,13881,6951,6930,4510,548,0.12150776053215077
Veracruz de Ignacio de la Llave,Chicontepec,53858,27644,26214,17301,3275,0.18929541644991618
Veracruz de Ignacio de la Llave,Chinameca,22638,11708,10930,8379,4476,0.5341926244181884
Veracruz de Ignacio de la Llave,Chinampa de Gorostiza,16283,8356,7927,5365,2165,0.40354147250698974
Veracruz de Ignacio de la Llave,Las Choapas,81080,41731,39349,27043,15443,0.5710535073771401
Veracruz de Ignacio de la Llave,Chocamán,20839,10561,10278,6227,1743,0.27991006905411914
Veracruz de Ignacio de la Llave,Chontla,13359,6833,6526,4980,1323,0.2656626506024096
Veracruz de Ignacio de la Llave,Chumatlán,4008,2114,1894,1278,185,0.14475743348982786
Veracruz de Ignacio de la Llave,Emiliano Zapata,85489,44327,41162,36813,19592,0.5322032977480782
Veracruz de Ignacio de la Llave,Espinal,26830,13809,13021,8869,3124,0.35223813282218963
Veracruz de Ignacio de la Llave,Filomeno Mata,19179,9885,9294,3917,263,0.06714322185345928
Veracruz de Ignacio de la Llave,Fortín,66372,35130,31242,24609,14011,0.5693445487423301
Veracruz de Ignacio de la Llave,Gutiérrez Zamora,24085,12897,11188,9813,4868,0.49607663303780697
Veracruz de Ignacio de la Llave,Hidalgotitlán,18275,9127,9148,6146,3531,0.5745200130165962
Veracruz de Ignacio de la Llave,Huatusco,59920,31310,28610,20404,7790,0.38178788472848463
Veracruz de Ignacio de la Llave,Huayacocotla,21796,11329,10467,9109,2504,0.2748929630036228
Veracruz de Ignacio de la Llave,Hueyapan de Ocampo,41670,21469,20201,14907,6189,0.415174079291608
Veracruz de Ignacio de la Llave,Huiloapan de Cuauhtémoc,7293,3836,3457,2428,1240,0.5107084019769358
Veracruz de Ignacio de la Llave,Ignacio de la Llave,16525,8566,7959,7601,3827,0.5034863833706091
Veracruz de Ignacio de la Llave,Ilamatlán,13377,7027,6350,5289,169,0.031953110228776706
Veracruz de Ignacio de la Llave,Isla,42807,22092,20715,16773,9271,0.5527335598879151
Veracruz de Ignacio de la Llave,Ixcatepec,12379,6299,6080,4187,736,0.1757821829472176
Veracruz de Ignacio de la Llave,Ixhuacán de los Reyes,11387,5770,5617,3982,913,0.2292817679558011
Veracruz de Ignacio de la Llave,Ixhuatlán del Café,23132,11672,11460,7079,2186,0.30880067806187317
Veracruz de Ignacio de la Llave,Ixhuatlancillo,27295,14386,12909,9603,4272,0.44486098094345516
Veracruz de Ignacio de la Llave,Ixhuatlán del Sureste,15831,8063,7768,6011,3639,0.6053901181167859
Veracruz de Ignacio de la Llave,Ixhuatlán de Madero,50836,26113,24723,15888,2329,0.14658862034239678
Veracruz de Ignacio de la Llave,Ixmatlahuacan,5574,2862,2712,2541,1348,0.5304998032270759
Veracruz de Ignacio de la Llave,Ixtaczoquitlán,74004,38641,35363,23984,12430,0.5182621747831888
Veracruz de Ignacio de la Llave,Jalacingo,46794,24150,22644,14007,3733,0.2665096023416863
Veracruz de Ignacio de la Llave,Xalapa,488531,261710,226821,195268,111402,0.5705082245938915
Veracruz de Ignacio de la Llave,Jalcomulco,5054,2517,2537,2210,615,0.27828054298642535
Veracruz de Ignacio de la Llave,Jáltipan,38669,20477,18192,14787,8341,0.5640765537296274
Veracruz de Ignacio de la Llave,Jamapa,11132,5712,5420,4551,2697,0.5926170072511536
Veracruz de Ignacio de la Llave,Jesús Carranza,28524,14445,14079,9959,5405,0.5427251732101617
Veracruz de Ignacio de la Llave,Xico,39623,20370,19253,12157,4860,0.3997696800197417
Veracruz de Ignacio de la Llave,Jilotepec,16585,8570,8015,5859,2098,0.3580815838880355
Veracruz de Ignacio de la Llave,Juan Rodríguez Clara,38367,19677,18690,14169,7649,0.5398404968593408
Veracruz de Ignacio de la Llave,Juchique de Ferrer,15059,7581,7478,6527,2002,0.306725907767734
Veracruz de Ignacio de la Llave,Landero y Coss,1543,787,756,751,116,0.15446071904127828
Veracruz de Ignacio de la Llave,Lerdo de Tejada,19123,10139,8984,8540,5127,0.6003512880562061
Veracruz de Ignacio de la Llave,Magdalena,3299,1708,1591,986,91,0.0922920892494929
Veracruz de Ignacio de la Llave,Maltrata,18327,9549,8778,5583,2243,0.4017553286763389
Veracruz de Ignacio de la Llave,Manlio Fabio Altamirano,23918,12181,11737,9290,5479,0.5897739504843919
Veracruz de Ignacio de la Llave,Mariano Escobedo,38670,20150,18520,12041,5267,0.4374221410181879
Veracruz de Ignacio de la Llave,Martínez de la Torre,108842,56666,52176,41943,22412,0.5343442290727892
Veracruz de Ignacio de la Llave,Mecatlán,12799,6503,6296,3756,304,0.08093716719914804
Veracruz de Ignacio de la Llave,Mecayapan,17134,8906,8228,6512,1502,0.23065110565110566
Veracruz de Ignacio de la Llave,Medellín de Bravo,95202,49517,45685,44118,26336,0.5969445577768712
Veracruz de Ignacio de la Llave,Miahuatlán,4841,2435,2406,1754,482,0.2748004561003421
Veracruz de Ignacio de la Llave,Las Minas,2934,1481,1453,903,185,0.20487264673311184
Veracruz de Ignacio de la Llave,Minatitlán,144776,75987,68789,57889,34519,0.5962963602757001
Veracruz de Ignacio de la Llave,Misantla,65761,33731,32030,25367,11288,0.4449875822919541
Veracruz de Ignacio de la Llave,Mixtla de Altamirano,12125,6143,5982,3960,40,0.010101010101010102
Veracruz de Ignacio de la Llave,Moloacán,16493,8540,7953,5765,3682,0.6386816999132697
Veracruz de Ignacio de la Llave,Naolinco,22835,11709,11126,9660,3505,0.36283643892339545
Veracruz de Ignacio de la Llave,Naranjal,4614,2382,2232,1459,352,0.24126113776559288
Veracruz de Ignacio de la Llave,Nautla,10130,5080,5050,4586,2224,0.48495420846053205
Veracruz de Ignacio de la Llave,Nogales,37314,19539,17775,13117,6453,0.4919570023633453
Veracruz de Ignacio de la Llave,Oluta,17027,8849,8178,5831,3275,0.5616532327216601
Veracruz de Ignacio de la Llave,Omealca,23773,12353,11420,8174,3502,0.428431612429655
Veracruz de Ignacio de la Llave,Orizaba,123182,66442,56740,44044,28967,0.657683225865044
Veracruz de Ignacio de la Llave,Otatitlán,5651,2912,2739,2336,1364,0.583904109589041
Veracruz de Ignacio de la Llave,Oteapan,10343,5430,4913,3467,1953,0.5633112200749928
Veracruz de Ignacio de la Llave,Ozuluama de Mascareñas,22756,11144,11612,9091,4935,0.5428445715542844
Veracruz de Ignacio de la Llave,Pajapan,18051,9171,8880,6695,1902,0.2840926064227035
Veracruz de Ignacio de la Llave,Pánuco,96185,48966,47219,34667,22318,0.6437822713243142
Veracruz de Ignacio de la Llave,Papantla,159910,82732,77178,53836,24228,0.45003343487629094
Veracruz de Ignacio de la Llave,Paso del Macho,31894,16277,15617,11328,5665,0.5000882768361582
Veracruz de Ignacio de la Llave,Paso de Ovejas,33442,16911,16531,13295,7449,0.5602858217374953
Veracruz de Ignacio de la Llave,La Perla,28258,14541,13717,7659,760,0.09922966444705575
Veracruz de Ignacio de la Llave,Perote,77432,39137,38295,24493,10661,0.4352672192054873
Veracruz de Ignacio de la Llave,Platón Sánchez,18053,9366,8687,6063,2034,0.33547748639287484
Veracruz de Ignacio de la Llave,Playa Vicente,39327,20483,18844,15633,6705,0.4289004029936672
Veracruz de Ignacio de la Llave,Poza Rica de Hidalgo,189457,101253,88204,70940,45621,0.6430927544403722
Veracruz de Ignacio de la Llave,Las Vigas de Ramírez,20300,10338,9962,6293,2473,0.39297632289845863
Veracruz de Ignacio de la Llave,Pueblo Viejo,57909,29153,28756,19341,12496,0.6460886200299881
Veracruz de Ignacio de la Llave,Puente Nacional,23544,12051,11493,9493,5232,0.5511429474349521
Veracruz de Ignacio de la Llave,Rafael Delgado,24127,12323,11804,7023,2187,0.3114053823152499
Veracruz de Ignacio de la Llave,Rafael Lucio,8343,4319,4024,2682,1029,0.383668903803132
Veracruz de Ignacio de la Llave,Los Reyes,6308,3211,3097,1950,97,0.04974358974358974
Veracruz de Ignacio de la Llave,Río Blanco,41795,22483,19312,14216,9157,0.6441333708497468
Veracruz de Ignacio de la Llave,Saltabarranca,6126,3174,2952,2415,1521,0.6298136645962733
Veracruz de Ignacio de la Llave,San Andrés Tenejapan,3134,1614,1520,832,94,0.11298076923076923
Veracruz de Ignacio de la Llave,San Andrés Tuxtla,162428,85442,76986,55560,20202,0.36360691144708424
Veracruz de Ignacio de la Llave,San Juan Evangelista,32631,16633,15998,11761,5826,0.4953660403026954
Veracruz de Ignacio de la Llave,Santiago Tuxtla,57085,29981,27104,20478,7402,0.36146108018361167
Veracruz de Ignacio de la Llave,Sayula de Alemán,32400,16771,15629,10488,5472,0.5217391304347826
Veracruz de Ignacio de la Llave,Soconusco,16574,8648,7926,5970,3288,0.5507537688442211
Veracruz de Ignacio de la Llave,Sochiapa,3925,1969,1956,1172,459,0.3916382252559727
Veracruz de Ignacio de la Llave,Soledad Atzompa,24578,12577,12001,6352,763,0.12011964735516373
Veracruz de Ignacio de la Llave,Soledad de Doblado,28130,14258,13872,10573,5886,0.5567010309278351
Veracruz de Ignacio de la Llave,Soteapan,34385,17854,16531,11175,1702,0.15230425055928412
Veracruz de Ignacio de la Llave,Tamalín,11631,5810,5821,4145,1766,0.42605548854041014
Veracruz de Ignacio de la Llave,Tamiahua,21902,10910,10992,9368,4267,0.4554867634500427
Veracruz de Ignacio de la Llave,Tampico Alto,11561,5634,5927,5085,2729,0.5366764995083579
Veracruz de Ignacio de la Llave,Tancoco,5795,3010,2785,2292,802,0.349912739965096
Veracruz de Ignacio de la Llave,Tantima,11991,5916,6075,4383,1709,0.3899155829340634
Veracruz de Ignacio de la Llave,Tantoyuca,99959,51826,48133,31722,7399,0.23324506651535212
Veracruz de Ignacio de la Llave,Tatatila,6041,2950,3091,1993,502,0.25188158554942297
Veracruz de Ignacio de la Llave,Castillo de Teayo,20145,10209,9936,6347,3136,0.4940916968646605
Veracruz de Ignacio de la Llave,Tecolutla,24551,12449,12102,11333,4781,0.4218653489808524
Veracruz de Ignacio de la Llave,Tehuipango,29686,15461,14225,6694,20,0.002987750224081267
Veracruz de Ignacio de la Llave,Álamo Temapache,107270,54522,52748,35222,17458,0.4956561240134007
Veracruz de Ignacio de la Llave,Tempoal,34408,17542,16866,11863,4735,0.3991401837646464
Veracruz de Ignacio de la Llave,Tenampa,6448,3223,3225,2082,612,0.29394812680115273
Veracruz de Ignacio de la Llave,Tenochtitlán,5040,2558,2482,1672,563,0.33672248803827753
Veracruz de Ignacio de la Llave,Teocelo,16957,8740,8217,5983,2743,0.4584656526826007
Veracruz de Ignacio de la Llave,Tepatlaxco,8925,4395,4530,2807,830,0.29568934805842534
Veracruz de Ignacio de la Llave,Tepetlán,9405,4598,4807,3698,1040,0.28123309897241755
Veracruz de Ignacio de la Llave,Tepetzintla,14619,7423,7196,4916,1415,0.28783563873067536
Veracruz de Ignacio de la Llave,Tequila,16343,8277,8066,4641,299,0.06442577030812324
Veracruz de Ignacio de la Llave,José Azueta,22709,11573,11136,9500,5062,0.5328421052631579
Veracruz de Ignacio de la Llave,Texcatepec,10824,5550,5274,3640,161,0.04423076923076923
Veracruz de Ignacio de la Llave,Texhuacán,5575,2931,2644,1816,229,0.1261013215859031
Veracruz de Ignacio de la Llave,Texistepec,19925,10124,9801,6817,3153,0.4625201701628282
Veracruz de Ignacio de la Llave,Tezonapa,54537,27726,26811,17868,5637,0.31548018804566824
Veracruz de Ignacio de la Llave,Tierra Blanca,95602,49843,45759,39168,22358,0.5708231209150327
Veracruz de Ignacio de la Llave,Tihuatlán,92726,48069,44657,30625,16904,0.5519673469387755
Veracruz de Ignacio de la Llave,Tlacojalpan,4489,2270,2219,1948,1009,0.5179671457905544
Veracruz de Ignacio de la Llave,Tlacolulan,11685,5934,5751,3508,749,0.21351197263397947
Veracruz de Ignacio de la Llave,Tlacotalpan,12898,6675,6223,5837,3424,0.5866027068699674
Veracruz de Ignacio de la Llave,Tlacotepec de Mejía,4284,2154,2130,1689,675,0.3996447602131439
Veracruz de Ignacio de la Llave,Tlachichilco,10900,5593,5307,3559,440,0.12363023321157629
Veracruz de Ignacio de la Llave,Tlalixcoyan,37795,19415,18380,15889,8870,0.5582478444206684
Veracruz de Ignacio de la Llave,Tlalnelhuayocan,19664,10079,9585,5782,2498,0.4320304392943618
Veracruz de Ignacio de la Llave,Tlapacoyan,61377,31779,29598,21688,10644,0.49077831058649946
Veracruz de Ignacio de la Llave,Tlaquilpa,7933,4222,3711,2251,160,0.07107952021323856
Veracruz de Ignacio de la Llave,Tlilapan,5548,2855,2693,1651,507,0.30708661417322836
Veracruz de Ignacio de la Llave,Tomatlán,7197,3659,3538,2471,1161,0.4698502630513962
Veracruz de Ignacio de la Llave,Tonayán,6105,3149,2956,1738,251,0.14441887226697353
Veracruz de Ignacio de la Llave,Totutla,17217,8692,8525,5416,2143,0.3956794682422452
Veracruz de Ignacio de la Llave,Tuxpan,154600,80405,74195,59430,36403,0.6125357563520107
Veracruz de Ignacio de la Llave,Tuxtilla,2258,1144,1114,1036,614,0.5926640926640927
Veracruz de Ignacio de la Llave,Ursulo Galván,30097,15629,14468,13126,8107,0.6176291330184367
Veracruz de Ignacio de la Llave,Vega de Alatorre,20204,10432,9772,8479,4399,0.5188111805637458
Veracruz de Ignacio de la Llave,Veracruz,607209,319545,287664,280373,163882,0.5845142007254621
Veracruz de Ignacio de la Llave,Villa Aldama,12492,6379,6113,3710,1391,0.37493261455525606
Veracruz de Ignacio de la Llave,Xoxocotla,5900,2939,2961,1716,240,0.13986013986013987
Veracruz de Ignacio de la Llave,Yanga,17902,9477,8425,7240,3596,0.4966850828729282
Veracruz de Ignacio de la Llave,Yecuatla,11205,5662,5543,4249,1392,0.32760649564603433
Veracruz de Ignacio de la Llave,Zacualpan,6788,3550,3238,2771,587,0.21183688199206063
Veracruz de Ignacio de la Llave,Zaragoza,11899,6262,5637,3383,1569,0.46378953591486843
Veracruz de Ignacio de la Llave,Zentla,12581,6293,6288,4462,1949,0.4367996414164052
Veracruz de Ignacio de la Llave,Zongolica,45028,23263,21765,14300,2144,0.14993006993006994
Veracruz de Ignacio de la Llave,Zontecomatlán de López y Fuentes,14644,7490,7154,4602,193,0.04193828770099957
Veracruz de Ignacio de la Llave,Zozocolco de Hidalgo,14524,7504,7020,4307,574,0.1332714186208498
Veracruz de Ignacio de la Llave,Agua Dulce,44104,23040,21064,16762,11162,0.6659109891421071
Veracruz de Ignacio de la Llave,El Higo,19402,9767,9635,6575,4207,0.6398479087452471
Veracruz de Ignacio de la Llave,Nanchital de Lázaro Cárdenas del Río,29209,15322,13887,10543,7732,0.7333775965095324
Veracruz de Ignacio de la Llave,Tres Valles,44978,23279,21699,18864,10257,0.5437340966921119
Veracruz de Ignacio de la Llave,Carlos A. Carrillo,23376,12286,11090,9319,6487,0.6961047322674107
Veracruz de Ignacio de la Llave,Tatahuicapan de Juárez,15044,7861,7183,5156,1477,0.2864623739332816
Veracruz de Ignacio de la Llave,Uxpanapa,30891,15451,15440,9403,4647,0.494203977454004
Veracruz de Ignacio de la Llave,San Rafael,30351,15454,14897,11563,6690,0.5785695753697138
Veracruz de Ignacio de la Llave,Santiago Sochiapan,13062,6747,6315,4511,1370,0.30370206162713365
Yucatán,Abalá,6550,3247,3303,2208,1101,0.4986413043478261
Yucatán,Acanceh,16772,8393,8379,4914,3006,0.6117216117216118
Yucatán,Akil,12285,6185,6100,3874,2187,0.564532782653588
Yucatán,Baca,6195,3152,3043,2213,1369,0.6186172616357886
Yucatán,Bokobá,2167,1078,1089,837,444,0.5304659498207885
Yucatán,Buctzotz,9159,4525,4634,3733,1946,0.5212965443343156
Yucatán,Cacalchén,7490,3721,3769,2502,1538,0.6147082334132694
Yucatán,Calotmul,3949,1962,1987,1613,719,0.44575325480471173
Yucatán,Cansahcab,4466,2278,2188,1853,974,0.5256341068537507
Yucatán,Cantamayec,2755,1332,1423,960,388,0.4041666666666667
Yucatán,Celestún,8389,4154,4235,3101,1599,0.5156401160915833
Yucatán,Cenotillo,3736,1880,1856,2143,831,0.3877741483901073
Yucatán,Conkal,16671,8501,8170,6507,4055,0.6231750422621792
Yucatán,Cuncunul,1714,829,885,582,295,0.506872852233677
Yucatán,Cuzamá,5560,2739,2821,1791,855,0.47738693467336685
Yucatán,Chacsinkín,3104,1516,1588,900,365,0.40555555555555556
Yucatán,Chankom,4686,2327,2359,1770,562,0.31751412429378534
Yucatán,Chapab,3385,1687,1698,1220,617,0.5057377049180328
Yucatán,Chemax,38934,19359,19575,10282,3768,0.3664656681579459
Yucatán,Chicxulub Pueblo,4497,2218,2279,1724,1024,0.5939675174013921
Yucatán,Chichimilá,9406,4631,4775,2675,975,0.3644859813084112
Yucatán,Chikindzonot,4363,2171,2192,1329,496,0.3732129420617005
Yucatán,Chocholá,4863,2373,2490,1878,1115,0.593716719914803
Yucatán,Chumayel,3244,1647,1597,1228,604,0.49185667752442996
Yucatán,Dzán,6003,3064,2939,1844,1169,0.6339479392624728
Yucatán,Dzemul,3622,1825,1797,1842,863,0.46851248642779586
Yucatán,Dzidzantún,8345,4134,4211,3475,1891,0.5441726618705036
Yucatán,Dzilam de Bravo,2936,1462,1474,1244,673,0.5409967845659164
Yucatán,Dzilam González,6240,3067,3173,2584,1408,0.544891640866873
Yucatán,Dzitás,4015,1959,2056,1468,620,0.4223433242506812
Yucatán,Dzoncauich,2818,1396,1422,1161,491,0.42291128337639966
Yucatán,Espita,16779,8267,8512,5561,2034,0.36576155367739616
Yucatán,Halachó,21255,10582,10673,6985,3856,0.5520400858983536
Yucatán,Hocabá,6514,3265,3249,2225,1051,0.47235955056179774
Yucatán,Hoctún,6384,3210,3174,2367,1101,0.46514575411913817
Yucatán,Homún,8090,4021,4069,2755,1369,0.4969147005444646
Yucatán,Huhí,5250,2552,2698,2070,1047,0.5057971014492754
Yucatán,Hunucmá,35137,17680,17457,11953,6542,0.54731029866979
Yucatán,Ixil,4186,2086,2100,1359,908,0.6681383370125092
Yucatán,Izamal,28555,14355,14200,10279,5618,0.5465512209358887
Yucatán,Kanasín,141939,71527,70412,52140,31161,0.5976409666283083
Yucatán,Kantunil,5553,2823,2730,2177,1037,0.4763435920992191
Yucatán,Kaua,3405,1681,1724,1063,510,0.4797742238946378
Yucatán,Kinchil,7530,3738,3792,2402,1496,0.6228143213988343
Yucatán,Kopomá,2677,1290,1387,973,546,0.5611510791366906
Yucatán,Mama,3296,1681,1615,1152,584,0.5069444444444444
Yucatán,Maní,5968,3024,2944,2063,1094,0.5302956858943286
Yucatán,Maxcanú,23991,11883,12108,7366,4275,0.5803692641868042
Yucatán,Mayapán,3965,1896,2069,1188,582,0.4898989898989899
Yucatán,Mérida,995129,515760,479369,371987,247483,0.6653001314562068
Yucatán,Mocochá,3430,1673,1757,1195,806,0.6744769874476988
Yucatán,Motul,37804,19127,18677,12883,7237,0.5617480400527828
Yucatán,Muna,13494,6747,6747,4481,2413,0.538495871457264
Yucatán,Muxupip,2990,1531,1459,1076,615,0.5715613382899628
Yucatán,Opichén,7080,3503,3577,2485,1296,0.5215291750503018
Yucatán,Oxkutzcab,33854,17544,16310,11463,6235,0.5439239291633953
Yucatán,Panabá,7766,3930,3836,2995,1523,0.5085141903171954
Yucatán,Peto,25954,13067,12887,8621,4121,0.4780187913235123
Yucatán,Progreso,66008,33029,32979,28542,15136,0.530306215401864
Yucatán,Quintana Roo,976,496,480,440,198,0.45
Yucatán,Río Lagartos,3974,1941,2033,1495,875,0.5852842809364549
Yucatán,Sacalum,4962,2402,2560,1737,967,0.5567069660333909
Yucatán,Samahil,5631,2796,2835,1667,1003,0.6016796640671865
Yucatán,Sanahcat,1701,843,858,689,298,0.432510885341074
Yucatán,San Felipe,2118,1029,1089,892,516,0.57847533632287
Yucatán,Santa Elena,4220,2118,2102,1468,727,0.4952316076294278
Yucatán,Seyé,10053,4924,5129,3314,1906,0.5751357875678937
Yucatán,Sinanché,3206,1558,1648,1649,731,0.44329896907216493
Yucatán,Sotuta,8967,4385,4582,3271,1516,0.46346682971568326
Yucatán,Sucilá,3971,1990,1981,1588,759,0.47795969773299746
Yucatán,Sudzal,1949,950,999,771,372,0.48249027237354086
Yucatán,Suma,1857,894,963,756,419,0.5542328042328042
Yucatán,Tahdziú,5854,2845,3009,1574,556,0.35324015247776364
Yucatán,Tahmek,3774,1865,1909,1385,726,0.524187725631769
Yucatán,Teabo,6921,3475,3446,2065,1001,0.4847457627118644
Yucatán,Tecoh,17939,8898,9041,5580,2988,0.535483870967742
Yucatán,Tekal de Venegas,2683,1312,1371,1043,500,0.4793863854266539
Yucatán,Tekantó,3747,1863,1884,1535,744,0.48469055374592834
Yucatán,Tekax,45062,22934,22128,14276,7904,0.5536564864107593
Yucatán,Tekit,11020,5434,5586,3245,1910,0.588597842835131
Yucatán,Tekom,3355,1690,1665,1195,393,0.3288702928870293
Yucatán,Telchac Pueblo,3512,1801,1711,1705,894,0.5243401759530791
Yucatán,Telchac Puerto,1915,962,953,2111,451,0.21364282330648982
Yucatán,Temax,7037,3494,3543,2492,1266,0.5080256821829856
Yucatán,Temozón,16680,8260,8420,5401,2555,0.4730605443436401
Yucatán,Tepakán,2133,1065,1068,994,407,0.40945674044265595
Yucatán,Tetiz,5464,2680,2784,1901,980,0.5155181483429774
Yucatán,Teya,1917,962,955,855,353,0.4128654970760234
Yucatán,Ticul,40495,20558,19937,12298,7535,0.6127012522361359
Yucatán,Timucuy,7503,3715,3788,2078,1185,0.5702598652550529
Yucatán,Tinum,12700,6315,6385,4224,1988,0.4706439393939394
Yucatán,Tixcacalcupul,7888,3949,3939,2367,805,0.3400929446556823
Yucatán,Tixkokob,18420,9383,9037,6099,3809,0.6245286112477455
Yucatán,Tixmehuac,5444,2726,2718,1814,781,0.43054024255788315
Yucatán,Tixpéhual,5690,2874,2816,1841,1103,0.5991309071156979
Yucatán,Tizimín,80672,40618,40054,28688,13380,0.4663970998326827
Yucatán,Tunkás,3684,1795,1889,1665,728,0.43723723723723723
Yucatán,Tzucacab,15346,7677,7669,5150,2723,0.5287378640776699
Yucatán,Uayma,4191,2100,2091,1229,484,0.3938161106590724
Yucatán,Ucú,4049,2034,2015,1439,892,0.6198749131341209
Yucatán,Umán,69147,34725,34422,25114,15104,0.6014175360356773
Yucatán,Valladolid,85460,43535,41925,30221,13902,0.46001125045498165
Yucatán,Xocchel,3451,1701,1750,1176,558,0.4744897959183674
Yucatán,Yaxcabá,16350,7994,8356,5280,2102,0.39810606060606063
Yucatán,Yaxkukul,3293,1665,1628,1084,720,0.6642066420664207
Yucatán,Yobaín,2215,1105,1110,1212,502,0.4141914191419142
Zacatecas,Apozol,6260,3219,3041,2943,1570,0.5334692490655794
Zacatecas,Apulco,4942,2603,2339,2091,1092,0.5222381635581061
Zacatecas,Atolinga,2277,1146,1131,1829,638,0.348824494259158
Zacatecas,Benito Juárez,4493,2251,2242,2193,1031,0.47013223894208844
Zacatecas,Calera,45759,23180,22579,14446,10599,0.7336979094559047
Zacatecas,Cañitas de Felipe Pescador,8255,4228,4027,3041,1848,0.6076948372245972
Zacatecas,Concepción del Oro,12115,6050,6065,4347,2840,0.6533241315850011
Zacatecas,Cuauhtémoc,13466,6918,6548,4320,2566,0.5939814814814814
Zacatecas,Chalchihuites,10086,5194,4892,4188,2184,0.5214899713467048
Zacatecas,Fresnillo,240532,122765,117767,79248,54211,0.684067736725217
Zacatecas,Trinidad García de la Cadena,3362,1706,1656,2048,931,0.45458984375
Zacatecas,Genaro Codina,8168,4225,3943,2993,1530,0.5111927831607083
Zacatecas,General Enrique Estrada,6644,3363,3281,2487,1538,0.6184157619622035
Zacatecas,General Francisco R. Murguía,20191,10417,9774,9048,4580,0.5061892130857648
Zacatecas,El Plateado de Joaquín Amaro,1579,798,781,978,443,0.45296523517382414
Zacatecas,General Pánfilo Natera,23526,12085,11441,8498,5116,0.6020240056483879
Zacatecas,Guadalupe,211740,109285,102455,78570,52731,0.6711340206185566
Zacatecas,Huanusco,4547,2290,2257,2391,1176,0.4918444165621079
Zacatecas,Jalpa,25296,12868,12428,10783,6163,0.5715478067328201
Zacatecas,Jerez,59910,30745,29165,27432,15775,0.575058326042578
Zacatecas,Jiménez del Teul,4465,2255,2210,1595,574,0.35987460815047023
Zacatecas,Juan Aldama,19749,10184,9565,8140,4498,0.5525798525798525
Zacatecas,Juchipila,12251,6364,5887,6724,3436,0.5110053539559786
Zacatecas,Loreto,53709,27442,26267,16259,10889,0.6697213850790331
Zacatecas,Luis Moya,13184,6750,6434,4227,2825,0.6683226874852141
Zacatecas,Mazapil,17774,8663,9111,6881,3794,0.5513733468972533
Zacatecas,Melchor Ocampo,2736,1281,1455,1026,545,0.5311890838206628
Zacatecas,Mezquital del Oro,2451,1235,1216,1283,595,0.4637568199532346
Zacatecas,Miguel Auza,23713,12138,11575,7658,5161,0.6739357534604336
Zacatecas,Momax,2446,1261,1185,1550,679,0.43806451612903224
Zacatecas,Monte Escobedo,8683,4399,4284,4740,2368,0.49957805907173
Zacatecas,Morelos,13207,6655,6552,4409,3352,0.7602630982082105
Zacatecas,Moyahua de Estrada,4530,2312,2218,2932,1301,0.4437244201909959
Zacatecas,Nochistlán de Mejía,27945,14463,13482,14165,7349,0.5188139781150723
Zacatecas,Noria de Ángeles,16284,8384,7900,5220,3315,0.6350574712643678
Zacatecas,Ojocaliente,44144,22882,21262,14481,9130,0.6304813203508045
Zacatecas,Pánuco,17577,8797,8780,6036,3951,0.654572564612326
Zacatecas,Pinos,72241,37485,34756,25505,14106,0.553068025877279
Zacatecas,Río Grande,64535,33255,31280,24317,13896,0.5714520705679155
Zacatecas,Sain Alto,21844,11201,10643,7789,4141,0.5316471947618436
Zacatecas,El Salvador,2509,1235,1274,1103,534,0.4841341795104261
Zacatecas,Sombrerete,63665,32198,31467,23785,13955,0.5867143157452176
Zacatecas,Susticacán,1365,701,664,791,301,0.3805309734513274
Zacatecas,Tabasco,16588,8481,8107,6640,3922,0.5906626506024096
Zacatecas,Tepechitlán,8321,4337,3984,4159,2067,0.49699446982447704
Zacatecas,Tepetongo,6490,3284,3206,4169,1790,0.4293595586471576
Zacatecas,Teúl de González Ortega,5356,2744,2612,2627,1387,0.5279786829082603
Zacatecas,Tlaltenango de Sánchez Román,27302,14078,13224,11523,6220,0.5397899852468975
Zacatecas,Valparaíso,32461,16432,16029,15289,7006,0.4582379488521159
Zacatecas,Vetagrande,10276,5271,5005,3226,2264,0.7017978921264724
Zacatecas,Villa de Cos,34623,17368,17255,12024,7513,0.6248336660013307
Zacatecas,Villa García,19525,9898,9627,6251,3950,0.6318988961766118
Zacatecas,Villa González Ortega,13208,6933,6275,4974,2908,0.5846401286690792
Zacatecas,Villa Hidalgo,19446,9942,9504,6445,3977,0.6170674941815361
Zacatecas,Villanueva,31558,15968,15590,14138,7982,0.5645777337671524
Zacatecas,Zacatecas,149607,77635,71972,54825,37822,0.6898677610579116
Zacatecas,Trancoso,20455,10416,10039,5633,3704,0.6575537014024498
Zacatecas,Santa María de la Paz,2767,1417,1350,1415,705,0.49823321554770317
