entidad,localidad,revocacion,continuidad,nulos,totalVotos,listaNominal
Extranjero,-,1915,6324,48,8287,17809
AGUASCALIENTES,JESUS MARIA,22,413,9,444,1824
AGUASCALIENTES,JESUS MARIA,5,343,2,350,1823
AGUASCALIENTES,JESUS MARIA,16,237,1,254,2040
AGUASCALIENTES,JESUS MARIA,17,183,2,202,2040
AGUASCALIENTES,JESUS MARIA,9,147,2,158,1640
AGUASCALIENTES,JESUS MARIA,3,147,6,156,1640
AGUASCALIENTES,JESUS MARIA,8,143,1,152,1640
AGUASCALIENTES,JESUS MARIA,11,133,2,146,1757
AGUASCALIENTES,JESUS MARIA,11,145,4,160,1756
AGUASCALIENTES,JESUS MARIA,6,137,2,145,1715
AGUASCALIENTES,JESUS MARIA,6,154,4,164,1714
AGUASCALIENTES,JESUS MARIA,5,110,2,117,1613
AGUASCALIENTES,JESUS MARIA,3,110,1,114,1613
AGUASCALIENTES,JESUS MARIA,8,114,1,123,1613
AGUASCALIENTES,JESUS MARIA,8,96,1,105,1613
AGUASCALIENTES,JESUS MARIA,9,135,4,148,1817
AGUASCALIENTES,JESUS MARIA,14,148,3,165,1817
AGUASCALIENTES,JESUS MARIA,12,155,3,170,1817
AGUASCALIENTES,JESUS MARIA,6,113,5,124,1592
AGUASCALIENTES,JESUS MARIA,10,101,0,111,1591
AGUASCALIENTES,JESUS MARIA,6,111,2,119,1982
AGUASCALIENTES,JESUS MARIA,9,118,0,127,1982
AGUASCALIENTES,JESUS MARIA,10,75,0,85,1433
AGUASCALIENTES,JESUS MARIA,12,76,0,88,1433
AGUASCALIENTES,JESUS MARIA,12,83,0,95,1433
AGUASCALIENTES,JESUS MARIA,18,131,1,150,1644
AGUASCALIENTES,JESUS MARIA,4,138,3,145,1644
AGUASCALIENTES,JESUS MARIA,15,147,1,163,1643
AGUASCALIENTES,JESUS MARIA,14,129,4,147,1643
AGUASCALIENTES,JESUS MARIA,8,161,1,170,1827
AGUASCALIENTES,JESUS MARIA,15,146,1,162,1826
AGUASCALIENTES,JESUS MARIA,12,108,2,122,1545
AGUASCALIENTES,JESUS MARIA,12,91,3,106,1545
AGUASCALIENTES,JESUS MARIA,14,113,3,130,1545
AGUASCALIENTES,JESUS MARIA,11,189,5,205,1963
AGUASCALIENTES,JESUS MARIA,10,156,5,171,1963
AGUASCALIENTES,JESUS MARIA,8,111,1,120,1440
AGUASCALIENTES,JESUS MARIA,6,122,4,132,1440
AGUASCALIENTES,JESUS MARIA,7,142,4,153,1439
AGUASCALIENTES,JESUS MARIA,15,180,1,196,1944
AGUASCALIENTES,JESUS MARIA,15,150,5,170,1944
AGUASCALIENTES,JESUS MARIA,12,165,4,181,1944
AGUASCALIENTES,JESUS MARIA,13,91,3,107,1528
AGUASCALIENTES,JESUS MARIA,8,125,7,140,1528
AGUASCALIENTES,JESUS MARIA,9,111,1,121,1518
AGUASCALIENTES,JESUS MARIA,7,109,1,117,1517
AGUASCALIENTES,JESUS MARIA,6,169,1,176,2008
AGUASCALIENTES,JESUS MARIA,7,123,3,133,2007
AGUASCALIENTES,JESUS MARIA,14,124,4,142,2007
AGUASCALIENTES,JESUS MARIA,8,85,0,93,1605
AGUASCALIENTES,JESUS MARIA,18,123,4,145,1605
AGUASCALIENTES,JESUS MARIA,11,190,0,201,1644
AGUASCALIENTES,JESUS MARIA,2,164,0,166,1644
AGUASCALIENTES,JESUS MARIA,12,138,5,155,2034
AGUASCALIENTES,JESUS MARIA,8,108,0,116,2033
AGUASCALIENTES,JESUS MARIA,2,125,0,127,1485
AGUASCALIENTES,JESUS MARIA,1,119,2,122,1485
AGUASCALIENTES,JESUS MARIA,3,128,0,131,1485
AGUASCALIENTES,JESUS MARIA,3,93,6,102,1810
AGUASCALIENTES,JESUS MARIA,4,75,1,80,1810
AGUASCALIENTES,JESUS MARIA,4,75,2,81,1810
AGUASCALIENTES,JESUS MARIA,12,76,4,92,1808
AGUASCALIENTES,JESUS MARIA,12,72,1,85,1808
AGUASCALIENTES,JESUS MARIA,11,72,5,88,1808
AGUASCALIENTES,JESUS MARIA,9,73,0,82,1808
AGUASCALIENTES,JESUS MARIA,17,68,0,85,1609
AGUASCALIENTES,JESUS MARIA,9,96,0,105,1609
AGUASCALIENTES,JESUS MARIA,12,97,1,110,1609
AGUASCALIENTES,JESUS MARIA,17,102,2,121,1807
AGUASCALIENTES,JESUS MARIA,19,88,1,108,1806
AGUASCALIENTES,JESUS MARIA,7,101,4,112,1806
AGUASCALIENTES,JESUS MARIA,14,84,1,99,1660
AGUASCALIENTES,JESUS MARIA,21,103,2,126,1660
AGUASCALIENTES,JESUS MARIA,10,96,0,106,1659
AGUASCALIENTES,JESUS MARIA,13,92,0,105,1659
AGUASCALIENTES,JESUS MARIA,34,113,1,148,1659
AGUASCALIENTES,JESUS MARIA,21,167,1,189,2036
AGUASCALIENTES,JESUS MARIA,21,120,1,142,2036
AGUASCALIENTES,JESUS MARIA,24,150,4,178,2036
AGUASCALIENTES,JESUS MARIA,17,148,0,165,2036
AGUASCALIENTES,JESUS MARIA,10,128,3,141,2035
AGUASCALIENTES,JESUS MARIA,8,100,2,110,1870
AGUASCALIENTES,JESUS MARIA,9,87,0,96,1870
AGUASCALIENTES,JESUS MARIA,6,88,1,95,1870
AGUASCALIENTES,JESUS MARIA,8,149,0,157,1442
AGUASCALIENTES,JESUS MARIA,7,151,4,162,1441
AGUASCALIENTES,JESUS MARIA,3,141,0,144,1441
AGUASCALIENTES,JESUS MARIA,17,139,1,157,1542
AGUASCALIENTES,JESUS MARIA,26,161,1,188,1542
AGUASCALIENTES,JESUS MARIA,28,134,3,165,1541
AGUASCALIENTES,JESUS MARIA,41,132,4,177,1908
AGUASCALIENTES,JESUS MARIA,29,140,2,171,1908
AGUASCALIENTES,JESUS MARIA,23,129,1,153,1908
AGUASCALIENTES,JESUS MARIA,33,149,2,184,1908
AGUASCALIENTES,JESUS MARIA,29,140,1,170,1907
AGUASCALIENTES,JESUS MARIA,14,108,3,125,1977
AGUASCALIENTES,JESUS MARIA,17,80,1,98,1977
AGUASCALIENTES,JESUS MARIA,7,51,0,58,1754
AGUASCALIENTES,JESUS MARIA,6,33,0,39,1754
AGUASCALIENTES,JESUS MARIA,17,76,4,97,1754
AGUASCALIENTES,JESUS MARIA,21,86,1,108,1947
AGUASCALIENTES,JESUS MARIA,21,86,1,108,1947
AGUASCALIENTES,JESUS MARIA,16,78,4,98,1946
AGUASCALIENTES,JESUS MARIA,19,95,1,115,1946
AGUASCALIENTES,JESUS MARIA,21,80,0,101,1877
AGUASCALIENTES,JESUS MARIA,19,91,1,111,1876
AGUASCALIENTES,JESUS MARIA,48,112,0,160,1817
AGUASCALIENTES,JESUS MARIA,33,108,0,141,1816
AGUASCALIENTES,JESUS MARIA,46,102,3,151,1816
AGUASCALIENTES,JESUS MARIA,43,124,0,167,1816
AGUASCALIENTES,JESUS MARIA,35,109,0,144,1816
AGUASCALIENTES,JESUS MARIA,35,114,1,150,1816
AGUASCALIENTES,JESUS MARIA,20,216,1,237,1897
AGUASCALIENTES,JESUS MARIA,20,191,4,215,1896
AGUASCALIENTES,JESUS MARIA,20,211,6,237,1896
AGUASCALIENTES,JESUS MARIA,16,172,2,190,1631
AGUASCALIENTES,JESUS MARIA,11,188,2,201,1631
AGUASCALIENTES,JESUS MARIA,7,184,1,192,1630
AGUASCALIENTES,JESUS MARIA,13,191,0,204,1630
AGUASCALIENTES,JESUS MARIA,8,194,3,205,1812
AGUASCALIENTES,JESUS MARIA,14,197,3,214,1812
AGUASCALIENTES,JESUS MARIA,12,178,3,193,1812
AGUASCALIENTES,JESUS MARIA,20,201,0,221,1594
AGUASCALIENTES,JESUS MARIA,16,227,3,246,1594
AGUASCALIENTES,JESUS MARIA,17,207,1,225,1594
AGUASCALIENTES,JESUS MARIA,12,174,1,187,1594
AGUASCALIENTES,JESUS MARIA,15,221,4,240,1988
AGUASCALIENTES,JESUS MARIA,8,203,7,218,1988
AGUASCALIENTES,JESUS MARIA,5,164,1,170,1782
AGUASCALIENTES,JESUS MARIA,10,150,2,162,1781
AGUASCALIENTES,JESUS MARIA,4,74,2,80,1752
AGUASCALIENTES,JESUS MARIA,1,63,0,64,1752
AGUASCALIENTES,JESUS MARIA,14,167,2,183,1723
AGUASCALIENTES,JESUS MARIA,5,164,6,175,1723
AGUASCALIENTES,JESUS MARIA,11,163,1,175,1593
AGUASCALIENTES,JESUS MARIA,3,156,0,159,1593
AGUASCALIENTES,JESUS MARIA,12,151,3,166,1592
AGUASCALIENTES,JESUS MARIA,10,269,3,282,1954
AGUASCALIENTES,JESUS MARIA,14,248,2,264,1954
AGUASCALIENTES,JESUS MARIA,16,253,1,270,1953
AGUASCALIENTES,JESUS MARIA,14,221,1,236,1625
AGUASCALIENTES,JESUS MARIA,9,230,2,241,1624
AGUASCALIENTES,JESUS MARIA,11,183,1,195,1624
AGUASCALIENTES,JESUS MARIA,8,188,2,198,1624
AGUASCALIENTES,JESUS MARIA,9,156,2,167,1956
AGUASCALIENTES,JESUS MARIA,1,115,1,117,1956
AGUASCALIENTES,JESUS MARIA,12,110,3,125,1622
AGUASCALIENTES,JESUS MARIA,4,116,1,121,1622
AGUASCALIENTES,JESUS MARIA,6,154,1,161,1780
AGUASCALIENTES,JESUS MARIA,8,150,0,158,1780
AGUASCALIENTES,JESUS MARIA,11,221,3,235,1478
AGUASCALIENTES,JESUS MARIA,11,278,6,295,1478
AGUASCALIENTES,JESUS MARIA,8,129,4,141,1474
AGUASCALIENTES,JESUS MARIA,5,130,4,139,1473
AGUASCALIENTES,JESUS MARIA,5,156,6,167,1473
AGUASCALIENTES,JESUS MARIA,6,238,1,245,1868
AGUASCALIENTES,JESUS MARIA,13,239,4,256,1868
AGUASCALIENTES,JESUS MARIA,9,140,4,153,1772
AGUASCALIENTES,JESUS MARIA,9,159,2,170,1771
AGUASCALIENTES,JESUS MARIA,11,424,5,440,2069
AGUASCALIENTES,JESUS MARIA,5,293,0,298,2068
AGUASCALIENTES,JESUS MARIA,2,173,1,176,1536
AGUASCALIENTES,JESUS MARIA,3,182,3,188,1535
AGUASCALIENTES,JESUS MARIA,17,237,3,257,1457
AGUASCALIENTES,JESUS MARIA,4,182,3,189,1457
AGUASCALIENTES,JESUS MARIA,19,199,4,222,0
AGUASCALIENTES,JESUS MARIA,13,176,2,191,1518
AGUASCALIENTES,JESUS MARIA,10,188,2,200,1518
AGUASCALIENTES,JESUS MARIA,11,190,1,202,1843
AGUASCALIENTES,JESUS MARIA,10,169,2,181,1843
AGUASCALIENTES,JESUS MARIA,10,178,2,190,1843
AGUASCALIENTES,JESUS MARIA,8,172,0,180,1843
AGUASCALIENTES,JESUS MARIA,3,189,2,194,1842
AGUASCALIENTES,JESUS MARIA,8,64,1,73,1457
AGUASCALIENTES,JESUS MARIA,5,68,2,75,1456
AGUASCALIENTES,JESUS MARIA,5,106,1,112,1705
AGUASCALIENTES,JESUS MARIA,5,113,0,118,1705
AGUASCALIENTES,JESUS MARIA,6,99,2,107,1705
AGUASCALIENTES,JESUS MARIA,10,91,1,102,1705
AGUASCALIENTES,JESUS MARIA,13,115,2,130,1586
AGUASCALIENTES,JESUS MARIA,19,129,3,151,1585
AGUASCALIENTES,JESUS MARIA,15,99,1,115,1585
AGUASCALIENTES,JESUS MARIA,10,99,1,110,1861
AGUASCALIENTES,JESUS MARIA,11,96,2,109,1861
AGUASCALIENTES,JESUS MARIA,9,101,1,111,1860
AGUASCALIENTES,JESUS MARIA,6,93,1,100,1860
AGUASCALIENTES,JESUS MARIA,13,102,5,120,1860
AGUASCALIENTES,JESUS MARIA,9,105,0,114,1860
AGUASCALIENTES,JESUS MARIA,9,212,3,224,1909
AGUASCALIENTES,JESUS MARIA,3,234,4,241,1909
AGUASCALIENTES,JESUS MARIA,12,189,2,203,1909
AGUASCALIENTES,JESUS MARIA,10,228,6,244,1909
AGUASCALIENTES,JESUS MARIA,4,223,1,228,2062
AGUASCALIENTES,JESUS MARIA,7,278,3,288,2061
AGUASCALIENTES,JESUS MARIA,7,149,2,158,1475
AGUASCALIENTES,JESUS MARIA,10,122,0,132,1474
AGUASCALIENTES,JESUS MARIA,12,118,5,135,1474
AGUASCALIENTES,AGUASCALIENTES,18,160,0,178,1427
AGUASCALIENTES,AGUASCALIENTES,31,164,0,195,1427
AGUASCALIENTES,AGUASCALIENTES,16,158,2,176,1887
AGUASCALIENTES,AGUASCALIENTES,25,150,4,179,1887
AGUASCALIENTES,AGUASCALIENTES,17,154,3,174,1886
AGUASCALIENTES,AGUASCALIENTES,28,154,2,184,1886
AGUASCALIENTES,AGUASCALIENTES,27,149,1,177,1898
AGUASCALIENTES,AGUASCALIENTES,25,132,0,157,1898
AGUASCALIENTES,AGUASCALIENTES,21,116,0,137,1898
AGUASCALIENTES,AGUASCALIENTES,27,161,1,189,1898
AGUASCALIENTES,AGUASCALIENTES,17,165,2,184,1897
AGUASCALIENTES,AGUASCALIENTES,30,129,1,160,1897
AGUASCALIENTES,AGUASCALIENTES,4,89,0,93,1979
AGUASCALIENTES,AGUASCALIENTES,8,79,0,87,1979
AGUASCALIENTES,AGUASCALIENTES,6,90,3,99,1979
AGUASCALIENTES,AGUASCALIENTES,8,67,1,76,1978
AGUASCALIENTES,AGUASCALIENTES,5,89,1,95,1978
AGUASCALIENTES,AGUASCALIENTES,3,84,1,88,1978
AGUASCALIENTES,AGUASCALIENTES,6,94,1,101,1978
AGUASCALIENTES,AGUASCALIENTES,4,96,0,100,1978
AGUASCALIENTES,AGUASCALIENTES,6,88,0,94,1075
AGUASCALIENTES,AGUASCALIENTES,3,113,1,117,1074
AGUASCALIENTES,AGUASCALIENTES,8,113,2,123,1406
AGUASCALIENTES,AGUASCALIENTES,8,86,1,95,1405
AGUASCALIENTES,AGUASCALIENTES,13,94,3,110,1405
AGUASCALIENTES,AGUASCALIENTES,11,120,2,133,1803
AGUASCALIENTES,AGUASCALIENTES,17,118,0,135,1803
AGUASCALIENTES,AGUASCALIENTES,15,135,0,150,1803
AGUASCALIENTES,AGUASCALIENTES,9,113,2,124,1803
AGUASCALIENTES,AGUASCALIENTES,19,134,1,154,1803
AGUASCALIENTES,AGUASCALIENTES,12,141,0,153,1803
AGUASCALIENTES,AGUASCALIENTES,20,120,0,140,1803
AGUASCALIENTES,AGUASCALIENTES,18,177,4,199,1986
AGUASCALIENTES,AGUASCALIENTES,17,184,6,207,1985
AGUASCALIENTES,AGUASCALIENTES,28,135,0,163,1740
AGUASCALIENTES,AGUASCALIENTES,25,150,3,178,1739
AGUASCALIENTES,AGUASCALIENTES,27,177,1,205,1739
AGUASCALIENTES,AGUASCALIENTES,10,224,1,235,1976
AGUASCALIENTES,AGUASCALIENTES,14,188,2,204,1976
AGUASCALIENTES,AGUASCALIENTES,21,212,1,234,1976
AGUASCALIENTES,AGUASCALIENTES,13,129,1,143,1572
AGUASCALIENTES,AGUASCALIENTES,12,125,1,138,1572
AGUASCALIENTES,AGUASCALIENTES,30,113,0,143,1572
AGUASCALIENTES,AGUASCALIENTES,12,131,2,145,1572
AGUASCALIENTES,AGUASCALIENTES,32,154,1,187,1689
AGUASCALIENTES,AGUASCALIENTES,11,148,5,164,1689
AGUASCALIENTES,AGUASCALIENTES,18,161,3,182,1688
AGUASCALIENTES,AGUASCALIENTES,29,232,3,264,1983
AGUASCALIENTES,AGUASCALIENTES,30,245,2,277,1982
AGUASCALIENTES,AGUASCALIENTES,12,152,0,164,1811
AGUASCALIENTES,AGUASCALIENTES,17,125,2,144,1811
AGUASCALIENTES,AGUASCALIENTES,25,122,1,148,1811
AGUASCALIENTES,AGUASCALIENTES,17,161,2,180,1881
AGUASCALIENTES,AGUASCALIENTES,14,161,1,176,1881
AGUASCALIENTES,AGUASCALIENTES,13,159,0,172,1881
AGUASCALIENTES,AGUASCALIENTES,12,145,1,158,1881
AGUASCALIENTES,AGUASCALIENTES,16,170,0,186,1881
AGUASCALIENTES,AGUASCALIENTES,31,129,0,160,1641
AGUASCALIENTES,AGUASCALIENTES,20,153,2,175,1641
AGUASCALIENTES,AGUASCALIENTES,20,124,1,145,1640
AGUASCALIENTES,AGUASCALIENTES,7,157,2,166,1640
AGUASCALIENTES,AGUASCALIENTES,35,169,0,204,1512
AGUASCALIENTES,AGUASCALIENTES,37,180,1,218,1512
AGUASCALIENTES,AGUASCALIENTES,33,164,0,197,1511
AGUASCALIENTES,AGUASCALIENTES,16,161,0,177,1722
AGUASCALIENTES,AGUASCALIENTES,19,170,2,191,1722
AGUASCALIENTES,AGUASCALIENTES,10,176,1,187,1721
AGUASCALIENTES,AGUASCALIENTES,19,147,1,167,1721
AGUASCALIENTES,AGUASCALIENTES,15,105,2,122,1035
AGUASCALIENTES,AGUASCALIENTES,18,104,0,122,1035
AGUASCALIENTES,AGUASCALIENTES,71,496,2,569,0
AGUASCALIENTES,AGUASCALIENTES,25,283,3,311,1864
AGUASCALIENTES,AGUASCALIENTES,18,272,2,292,1864
AGUASCALIENTES,AGUASCALIENTES,33,225,6,264,1954
AGUASCALIENTES,AGUASCALIENTES,29,258,1,288,1954
AGUASCALIENTES,AGUASCALIENTES,28,224,7,259,1812
AGUASCALIENTES,AGUASCALIENTES,33,216,5,254,1811
AGUASCALIENTES,AGUASCALIENTES,31,266,1,298,1950
AGUASCALIENTES,AGUASCALIENTES,30,255,0,285,1950
AGUASCALIENTES,AGUASCALIENTES,24,239,1,264,1992
AGUASCALIENTES,AGUASCALIENTES,28,199,2,229,1992
AGUASCALIENTES,AGUASCALIENTES,13,187,1,201,1544
AGUASCALIENTES,AGUASCALIENTES,15,172,0,187,1543
AGUASCALIENTES,AGUASCALIENTES,13,173,2,188,1543
AGUASCALIENTES,AGUASCALIENTES,30,283,4,317,1938
AGUASCALIENTES,AGUASCALIENTES,32,244,1,277,1937
AGUASCALIENTES,AGUASCALIENTES,25,154,0,179,1944
AGUASCALIENTES,AGUASCALIENTES,8,173,2,183,1943
AGUASCALIENTES,AGUASCALIENTES,20,154,2,176,1898
AGUASCALIENTES,AGUASCALIENTES,8,132,2,142,1898
AGUASCALIENTES,AGUASCALIENTES,8,168,3,179,1898
AGUASCALIENTES,AGUASCALIENTES,15,164,2,181,1898
AGUASCALIENTES,AGUASCALIENTES,15,123,0,138,1897
AGUASCALIENTES,AGUASCALIENTES,10,164,0,174,1897
AGUASCALIENTES,AGUASCALIENTES,13,144,1,158,1873
AGUASCALIENTES,AGUASCALIENTES,17,161,1,179,1873
AGUASCALIENTES,AGUASCALIENTES,12,150,0,162,1873
AGUASCALIENTES,AGUASCALIENTES,10,153,0,163,1873
AGUASCALIENTES,AGUASCALIENTES,14,155,3,172,1873
AGUASCALIENTES,AGUASCALIENTES,21,140,1,162,1873
AGUASCALIENTES,AGUASCALIENTES,18,163,1,182,1873
AGUASCALIENTES,AGUASCALIENTES,11,167,3,181,1627
AGUASCALIENTES,AGUASCALIENTES,16,174,4,194,1627
AGUASCALIENTES,AGUASCALIENTES,13,146,1,160,1627
AGUASCALIENTES,AGUASCALIENTES,14,185,1,200,1626
AGUASCALIENTES,AGUASCALIENTES,5,160,2,167,1429
AGUASCALIENTES,AGUASCALIENTES,9,214,1,224,1428
AGUASCALIENTES,AGUASCALIENTES,8,87,0,95,1336
AGUASCALIENTES,AGUASCALIENTES,7,62,4,73,1336
AGUASCALIENTES,AGUASCALIENTES,8,122,0,130,1726
AGUASCALIENTES,AGUASCALIENTES,5,100,1,106,1726
AGUASCALIENTES,AGUASCALIENTES,7,120,0,127,1725
AGUASCALIENTES,AGUASCALIENTES,6,123,2,131,1805
AGUASCALIENTES,AGUASCALIENTES,6,128,1,135,1805
AGUASCALIENTES,AGUASCALIENTES,12,101,1,114,1484
AGUASCALIENTES,AGUASCALIENTES,7,111,1,119,1484
AGUASCALIENTES,AGUASCALIENTES,8,111,1,120,1791
AGUASCALIENTES,AGUASCALIENTES,13,133,2,148,1791
AGUASCALIENTES,AGUASCALIENTES,11,90,0,101,1791
AGUASCALIENTES,AGUASCALIENTES,6,96,1,103,1790
AGUASCALIENTES,AGUASCALIENTES,7,93,0,100,1959
AGUASCALIENTES,AGUASCALIENTES,6,103,0,109,1959
AGUASCALIENTES,AGUASCALIENTES,10,187,1,198,1428
AGUASCALIENTES,AGUASCALIENTES,14,138,0,152,1427
AGUASCALIENTES,AGUASCALIENTES,15,155,0,170,1615
AGUASCALIENTES,AGUASCALIENTES,12,158,1,171,1615
AGUASCALIENTES,AGUASCALIENTES,11,179,1,191,1799
AGUASCALIENTES,AGUASCALIENTES,8,154,0,162,1799
AGUASCALIENTES,AGUASCALIENTES,12,154,1,167,1798
AGUASCALIENTES,AGUASCALIENTES,3,103,1,107,1380
AGUASCALIENTES,AGUASCALIENTES,2,100,0,102,1380
AGUASCALIENTES,AGUASCALIENTES,7,92,1,100,1380
AGUASCALIENTES,AGUASCALIENTES,18,125,1,144,1552
AGUASCALIENTES,AGUASCALIENTES,19,137,0,156,1552
AGUASCALIENTES,AGUASCALIENTES,19,173,0,192,1309
AGUASCALIENTES,AGUASCALIENTES,25,143,0,168,1308
AGUASCALIENTES,AGUASCALIENTES,26,170,0,196,1691
AGUASCALIENTES,AGUASCALIENTES,16,151,1,168,1690
AGUASCALIENTES,AGUASCALIENTES,19,144,0,163,1690
AGUASCALIENTES,AGUASCALIENTES,12,156,1,169,1690
AGUASCALIENTES,AGUASCALIENTES,17,160,0,177,1698
AGUASCALIENTES,AGUASCALIENTES,21,180,0,201,1698
AGUASCALIENTES,AGUASCALIENTES,25,159,2,186,1697
AGUASCALIENTES,AGUASCALIENTES,18,146,0,164,1638
AGUASCALIENTES,AGUASCALIENTES,33,159,2,194,1637
AGUASCALIENTES,AGUASCALIENTES,16,116,2,134,1202
AGUASCALIENTES,AGUASCALIENTES,18,133,3,154,1201
AGUASCALIENTES,AGUASCALIENTES,16,139,0,155,1714
AGUASCALIENTES,AGUASCALIENTES,31,106,2,139,1714
AGUASCALIENTES,AGUASCALIENTES,21,110,6,137,1713
AGUASCALIENTES,AGUASCALIENTES,31,170,1,202,1886
AGUASCALIENTES,AGUASCALIENTES,29,170,1,200,1886
AGUASCALIENTES,AGUASCALIENTES,42,163,0,205,1886
AGUASCALIENTES,AGUASCALIENTES,28,163,1,192,1886
AGUASCALIENTES,AGUASCALIENTES,32,86,1,119,2038
AGUASCALIENTES,AGUASCALIENTES,39,83,2,124,2037
AGUASCALIENTES,AGUASCALIENTES,39,62,0,101,2037
AGUASCALIENTES,AGUASCALIENTES,3,71,1,75,1065
AGUASCALIENTES,AGUASCALIENTES,7,42,0,49,1064
AGUASCALIENTES,AGUASCALIENTES,12,105,1,118,1558
AGUASCALIENTES,AGUASCALIENTES,12,96,0,108,1558
AGUASCALIENTES,AGUASCALIENTES,9,90,0,99,1558
AGUASCALIENTES,AGUASCALIENTES,9,85,0,94,1626
AGUASCALIENTES,AGUASCALIENTES,7,88,2,97,1625
AGUASCALIENTES,AGUASCALIENTES,7,107,0,114,1845
AGUASCALIENTES,AGUASCALIENTES,7,116,0,123,1845
AGUASCALIENTES,AGUASCALIENTES,7,94,2,103,1845
AGUASCALIENTES,AGUASCALIENTES,5,81,1,87,1845
AGUASCALIENTES,AGUASCALIENTES,2,95,0,97,1844
AGUASCALIENTES,AGUASCALIENTES,7,123,1,131,1844
AGUASCALIENTES,AGUASCALIENTES,10,128,0,138,1629
AGUASCALIENTES,AGUASCALIENTES,23,149,1,173,1628
AGUASCALIENTES,AGUASCALIENTES,10,126,1,137,1628
AGUASCALIENTES,AGUASCALIENTES,3,99,1,103,2120
AGUASCALIENTES,AGUASCALIENTES,8,101,0,109,2120
AGUASCALIENTES,AGUASCALIENTES,2,86,0,88,2119
AGUASCALIENTES,AGUASCALIENTES,23,95,1,119,1162
AGUASCALIENTES,AGUASCALIENTES,25,75,1,101,1162
AGUASCALIENTES,AGUASCALIENTES,19,153,0,172,1790
AGUASCALIENTES,AGUASCALIENTES,13,179,1,193,1790
AGUASCALIENTES,AGUASCALIENTES,14,177,0,191,1789
AGUASCALIENTES,AGUASCALIENTES,25,98,0,123,1539
AGUASCALIENTES,AGUASCALIENTES,22,110,0,132,1538
AGUASCALIENTES,AGUASCALIENTES,14,110,2,126,1538
AGUASCALIENTES,AGUASCALIENTES,8,164,1,173,1704
AGUASCALIENTES,AGUASCALIENTES,11,120,2,133,1703
AGUASCALIENTES,AGUASCALIENTES,2,45,1,48,1118
AGUASCALIENTES,AGUASCALIENTES,3,40,0,43,1118
AGUASCALIENTES,AGUASCALIENTES,11,94,1,106,1697
AGUASCALIENTES,AGUASCALIENTES,10,105,0,115,1697
AGUASCALIENTES,AGUASCALIENTES,12,85,1,98,1474
AGUASCALIENTES,AGUASCALIENTES,9,70,0,79,1474
AGUASCALIENTES,AGUASCALIENTES,6,81,0,87,1474
AGUASCALIENTES,AGUASCALIENTES,6,116,0,122,1988
AGUASCALIENTES,AGUASCALIENTES,10,109,1,120,1987
AGUASCALIENTES,AGUASCALIENTES,18,115,1,134,1964
AGUASCALIENTES,AGUASCALIENTES,5,91,0,96,1964
AGUASCALIENTES,AGUASCALIENTES,7,107,0,114,1138
AGUASCALIENTES,AGUASCALIENTES,14,104,0,118,1138
AGUASCALIENTES,AGUASCALIENTES,22,23,0,45,1115
AGUASCALIENTES,AGUASCALIENTES,26,18,0,44,1114
AGUASCALIENTES,AGUASCALIENTES,27,153,4,184,1893
AGUASCALIENTES,AGUASCALIENTES,23,155,4,182,1893
AGUASCALIENTES,AGUASCALIENTES,28,124,2,154,1397
AGUASCALIENTES,AGUASCALIENTES,38,126,1,165,1397
AGUASCALIENTES,AGUASCALIENTES,26,137,1,164,1397
AGUASCALIENTES,AGUASCALIENTES,25,143,1,169,1620
AGUASCALIENTES,AGUASCALIENTES,27,123,1,151,1620
AGUASCALIENTES,AGUASCALIENTES,35,156,2,193,1848
AGUASCALIENTES,AGUASCALIENTES,45,157,1,203,1848
AGUASCALIENTES,AGUASCALIENTES,46,164,2,212,1847
AGUASCALIENTES,AGUASCALIENTES,14,150,3,167,1911
AGUASCALIENTES,AGUASCALIENTES,14,157,3,174,1910
AGUASCALIENTES,AGUASCALIENTES,21,132,0,153,1844
AGUASCALIENTES,AGUASCALIENTES,25,112,1,138,1844
AGUASCALIENTES,AGUASCALIENTES,17,239,1,257,2074
AGUASCALIENTES,AGUASCALIENTES,18,115,3,136,1824
AGUASCALIENTES,AGUASCALIENTES,23,118,0,141,1824
AGUASCALIENTES,AGUASCALIENTES,29,124,2,155,1936
AGUASCALIENTES,AGUASCALIENTES,27,173,0,200,1935
AGUASCALIENTES,AGUASCALIENTES,12,131,2,145,1564
AGUASCALIENTES,AGUASCALIENTES,35,114,1,150,1563
AGUASCALIENTES,AGUASCALIENTES,24,93,2,119,1620
AGUASCALIENTES,AGUASCALIENTES,31,110,0,141,1619
AGUASCALIENTES,AGUASCALIENTES,32,111,1,144,2002
AGUASCALIENTES,AGUASCALIENTES,40,78,2,120,2002
AGUASCALIENTES,AGUASCALIENTES,29,63,1,93,2002
AGUASCALIENTES,AGUASCALIENTES,34,130,3,167,1570
AGUASCALIENTES,AGUASCALIENTES,22,110,2,134,1569
AGUASCALIENTES,AGUASCALIENTES,18,119,1,138,1569
AGUASCALIENTES,AGUASCALIENTES,35,74,1,110,1464
AGUASCALIENTES,AGUASCALIENTES,36,70,2,108,1464
AGUASCALIENTES,AGUASCALIENTES,36,81,1,118,1463
AGUASCALIENTES,AGUASCALIENTES,40,66,0,106,1778
AGUASCALIENTES,AGUASCALIENTES,37,75,2,114,1778
AGUASCALIENTES,AGUASCALIENTES,45,75,3,123,1801
AGUASCALIENTES,AGUASCALIENTES,41,68,3,112,1801
AGUASCALIENTES,AGUASCALIENTES,20,96,1,117,1692
AGUASCALIENTES,AGUASCALIENTES,34,70,3,107,1691
AGUASCALIENTES,AGUASCALIENTES,38,186,3,227,1943
AGUASCALIENTES,AGUASCALIENTES,31,126,1,158,1942
AGUASCALIENTES,AGUASCALIENTES,8,97,2,107,1028
AGUASCALIENTES,AGUASCALIENTES,4,85,1,90,1027
AGUASCALIENTES,AGUASCALIENTES,13,126,3,142,1517
AGUASCALIENTES,AGUASCALIENTES,0,172,1,173,1517
AGUASCALIENTES,AGUASCALIENTES,23,119,2,144,1561
AGUASCALIENTES,AGUASCALIENTES,20,87,2,109,1560
AGUASCALIENTES,AGUASCALIENTES,21,129,0,150,1560
AGUASCALIENTES,AGUASCALIENTES,40,123,1,164,1926
AGUASCALIENTES,AGUASCALIENTES,31,122,3,156,1926
AGUASCALIENTES,AGUASCALIENTES,33,177,0,210,1990
AGUASCALIENTES,AGUASCALIENTES,29,164,3,196,1990
AGUASCALIENTES,AGUASCALIENTES,44,169,1,214,2004
AGUASCALIENTES,AGUASCALIENTES,36,184,1,221,2004
AGUASCALIENTES,AGUASCALIENTES,43,170,0,213,2004
AGUASCALIENTES,AGUASCALIENTES,32,162,1,195,1659
AGUASCALIENTES,AGUASCALIENTES,31,177,1,209,1658
AGUASCALIENTES,AGUASCALIENTES,26,188,0,214,1658
AGUASCALIENTES,AGUASCALIENTES,26,171,1,198,1658
AGUASCALIENTES,AGUASCALIENTES,17,192,3,212,1915
AGUASCALIENTES,AGUASCALIENTES,19,191,2,212,1915
AGUASCALIENTES,AGUASCALIENTES,19,180,2,201,1425
AGUASCALIENTES,AGUASCALIENTES,19,129,0,148,1425
AGUASCALIENTES,AGUASCALIENTES,13,166,0,179,1776
AGUASCALIENTES,AGUASCALIENTES,14,161,1,176,1775
AGUASCALIENTES,AGUASCALIENTES,24,78,0,102,1105
AGUASCALIENTES,AGUASCALIENTES,30,74,2,106,1105
AGUASCALIENTES,AGUASCALIENTES,13,113,0,126,1555
AGUASCALIENTES,AGUASCALIENTES,17,162,0,179,1555
AGUASCALIENTES,AGUASCALIENTES,32,165,2,199,1858
AGUASCALIENTES,AGUASCALIENTES,26,157,1,184,1858
AGUASCALIENTES,AGUASCALIENTES,19,129,26,174,1506
AGUASCALIENTES,AGUASCALIENTES,25,174,4,203,1505
AGUASCALIENTES,AGUASCALIENTES,17,108,1,126,1112
AGUASCALIENTES,AGUASCALIENTES,30,102,1,133,1112
AGUASCALIENTES,AGUASCALIENTES,45,134,0,179,1868
AGUASCALIENTES,AGUASCALIENTES,35,113,3,151,1867
AGUASCALIENTES,AGUASCALIENTES,5,230,0,235,1717
AGUASCALIENTES,AGUASCALIENTES,11,176,0,187,1717
AGUASCALIENTES,AGUASCALIENTES,9,168,5,182,1453
AGUASCALIENTES,AGUASCALIENTES,7,181,2,190,1452
AGUASCALIENTES,AGUASCALIENTES,33,164,1,198,1685
AGUASCALIENTES,AGUASCALIENTES,25,140,2,167,1684
AGUASCALIENTES,AGUASCALIENTES,91,118,1,210,1915
AGUASCALIENTES,AGUASCALIENTES,25,145,1,171,1915
AGUASCALIENTES,AGUASCALIENTES,46,124,0,170,2006
AGUASCALIENTES,AGUASCALIENTES,48,152,3,203,2006
AGUASCALIENTES,AGUASCALIENTES,33,161,0,194,1894
AGUASCALIENTES,AGUASCALIENTES,31,190,1,222,1894
AGUASCALIENTES,AGUASCALIENTES,186,1187,11,1384,0
AGUASCALIENTES,AGUASCALIENTES,34,149,6,189,1936
AGUASCALIENTES,AGUASCALIENTES,46,146,2,194,1935
AGUASCALIENTES,AGUASCALIENTES,37,198,1,236,1905
AGUASCALIENTES,AGUASCALIENTES,41,164,1,206,1904
AGUASCALIENTES,AGUASCALIENTES,37,125,0,162,1835
AGUASCALIENTES,AGUASCALIENTES,49,105,2,156,1834
AGUASCALIENTES,AGUASCALIENTES,18,192,3,213,2075
AGUASCALIENTES,AGUASCALIENTES,28,185,5,218,1931
AGUASCALIENTES,AGUASCALIENTES,20,171,0,191,1930
AGUASCALIENTES,AGUASCALIENTES,7,171,7,185,1636
AGUASCALIENTES,AGUASCALIENTES,13,200,3,216,1635
AGUASCALIENTES,AGUASCALIENTES,3,146,3,152,1608
AGUASCALIENTES,AGUASCALIENTES,3,159,1,163,1608
AGUASCALIENTES,AGUASCALIENTES,2,150,1,153,1607
AGUASCALIENTES,AGUASCALIENTES,3,150,2,155,1686
AGUASCALIENTES,AGUASCALIENTES,3,128,0,131,1686
AGUASCALIENTES,AGUASCALIENTES,19,112,1,132,1665
AGUASCALIENTES,AGUASCALIENTES,11,142,1,154,1664
AGUASCALIENTES,AGUASCALIENTES,6,123,1,130,1799
AGUASCALIENTES,AGUASCALIENTES,10,86,6,102,1799
AGUASCALIENTES,AGUASCALIENTES,22,134,2,158,1939
AGUASCALIENTES,AGUASCALIENTES,16,150,0,166,1939
AGUASCALIENTES,AGUASCALIENTES,11,111,0,122,1398
AGUASCALIENTES,AGUASCALIENTES,6,89,1,96,1398
AGUASCALIENTES,AGUASCALIENTES,18,169,2,189,1800
AGUASCALIENTES,AGUASCALIENTES,22,150,0,172,1799
AGUASCALIENTES,AGUASCALIENTES,16,161,1,178,1719
AGUASCALIENTES,AGUASCALIENTES,13,158,2,173,1718
AGUASCALIENTES,AGUASCALIENTES,9,147,2,158,1718
AGUASCALIENTES,AGUASCALIENTES,20,121,2,143,1692
AGUASCALIENTES,AGUASCALIENTES,14,136,0,150,1692
AGUASCALIENTES,AGUASCALIENTES,16,136,1,153,1691
AGUASCALIENTES,AGUASCALIENTES,18,172,1,191,1691
AGUASCALIENTES,AGUASCALIENTES,18,129,1,148,1691
AGUASCALIENTES,AGUASCALIENTES,23,103,2,128,1167
AGUASCALIENTES,AGUASCALIENTES,20,101,0,121,1167
AGUASCALIENTES,AGUASCALIENTES,23,107,2,132,1359
AGUASCALIENTES,AGUASCALIENTES,22,96,0,118,1358
AGUASCALIENTES,AGUASCALIENTES,23,99,2,124,1358
AGUASCALIENTES,AGUASCALIENTES,13,107,6,126,1660
AGUASCALIENTES,AGUASCALIENTES,25,114,1,140,1660
AGUASCALIENTES,AGUASCALIENTES,20,119,2,141,1659
AGUASCALIENTES,AGUASCALIENTES,14,118,0,132,1657
AGUASCALIENTES,AGUASCALIENTES,7,111,3,121,1656
AGUASCALIENTES,AGUASCALIENTES,5,123,1,129,1656
AGUASCALIENTES,AGUASCALIENTES,23,103,2,128,1178
AGUASCALIENTES,AGUASCALIENTES,12,119,2,133,1178
AGUASCALIENTES,AGUASCALIENTES,39,142,1,182,1572
AGUASCALIENTES,AGUASCALIENTES,39,142,1,182,1572
AGUASCALIENTES,AGUASCALIENTES,38,126,1,165,1572
AGUASCALIENTES,AGUASCALIENTES,42,180,5,227,1572
AGUASCALIENTES,AGUASCALIENTES,24,176,2,202,1984
AGUASCALIENTES,AGUASCALIENTES,32,168,1,201,1983
AGUASCALIENTES,AGUASCALIENTES,14,218,1,233,1685
AGUASCALIENTES,AGUASCALIENTES,15,216,2,233,1684
AGUASCALIENTES,AGUASCALIENTES,30,170,3,203,1497
AGUASCALIENTES,AGUASCALIENTES,16,169,2,187,1496
AGUASCALIENTES,AGUASCALIENTES,13,187,2,202,1756
AGUASCALIENTES,AGUASCALIENTES,15,144,2,161,1756
AGUASCALIENTES,AGUASCALIENTES,6,112,1,119,1630
AGUASCALIENTES,AGUASCALIENTES,9,141,1,151,1630
AGUASCALIENTES,AGUASCALIENTES,10,154,3,167,1999
AGUASCALIENTES,AGUASCALIENTES,17,149,1,167,1999
AGUASCALIENTES,AGUASCALIENTES,33,69,1,103,1825
AGUASCALIENTES,AGUASCALIENTES,15,63,0,78,1825
AGUASCALIENTES,AGUASCALIENTES,22,65,1,88,1824
AGUASCALIENTES,AGUASCALIENTES,13,75,3,91,1706
AGUASCALIENTES,AGUASCALIENTES,15,72,1,88,1706
AGUASCALIENTES,AGUASCALIENTES,28,131,4,163,1671
AGUASCALIENTES,AGUASCALIENTES,20,113,2,135,1671
AGUASCALIENTES,AGUASCALIENTES,20,104,0,124,1671
AGUASCALIENTES,AGUASCALIENTES,25,109,0,134,1671
AGUASCALIENTES,AGUASCALIENTES,27,137,0,164,1671
AGUASCALIENTES,AGUASCALIENTES,29,99,0,128,1671
AGUASCALIENTES,AGUASCALIENTES,5,85,0,90,1582
AGUASCALIENTES,AGUASCALIENTES,5,75,0,80,1582
AGUASCALIENTES,AGUASCALIENTES,7,73,1,81,1581
AGUASCALIENTES,AGUASCALIENTES,9,79,0,88,1581
AGUASCALIENTES,AGUASCALIENTES,33,118,1,152,1685
AGUASCALIENTES,AGUASCALIENTES,29,115,1,145,1684
AGUASCALIENTES,AGUASCALIENTES,40,116,1,157,1684
AGUASCALIENTES,AGUASCALIENTES,48,123,0,171,1684
AGUASCALIENTES,AGUASCALIENTES,30,124,2,156,1684
AGUASCALIENTES,AGUASCALIENTES,36,111,2,149,1876
AGUASCALIENTES,AGUASCALIENTES,17,108,0,125,1876
AGUASCALIENTES,AGUASCALIENTES,44,82,1,127,1875
AGUASCALIENTES,AGUASCALIENTES,9,54,1,64,1874
AGUASCALIENTES,AGUASCALIENTES,7,66,1,74,1873
AGUASCALIENTES,AGUASCALIENTES,11,84,2,97,1422
AGUASCALIENTES,AGUASCALIENTES,16,78,0,94,1421
AGUASCALIENTES,AGUASCALIENTES,8,71,1,80,1421
AGUASCALIENTES,AGUASCALIENTES,4,91,0,95,1919
AGUASCALIENTES,AGUASCALIENTES,9,67,1,77,1919
AGUASCALIENTES,AGUASCALIENTES,10,60,0,70,1919
AGUASCALIENTES,AGUASCALIENTES,3,85,0,88,1137
AGUASCALIENTES,AGUASCALIENTES,6,82,0,88,1137
AGUASCALIENTES,AGUASCALIENTES,7,77,0,84,1375
AGUASCALIENTES,AGUASCALIENTES,3,74,1,78,1375
AGUASCALIENTES,AGUASCALIENTES,7,61,0,68,1273
AGUASCALIENTES,AGUASCALIENTES,4,72,2,78,1273
AGUASCALIENTES,AGUASCALIENTES,8,153,2,163,1886
AGUASCALIENTES,AGUASCALIENTES,10,141,0,151,1885
AGUASCALIENTES,AGUASCALIENTES,14,138,1,153,1885
AGUASCALIENTES,AGUASCALIENTES,12,158,1,171,1870
AGUASCALIENTES,AGUASCALIENTES,15,138,0,153,1869
AGUASCALIENTES,AGUASCALIENTES,1,112,0,113,1875
AGUASCALIENTES,AGUASCALIENTES,7,120,1,128,1875
AGUASCALIENTES,AGUASCALIENTES,37,186,1,224,1909
AGUASCALIENTES,AGUASCALIENTES,44,198,1,243,1908
AGUASCALIENTES,AGUASCALIENTES,23,149,1,173,1364
AGUASCALIENTES,AGUASCALIENTES,15,148,1,164,1363
AGUASCALIENTES,AGUASCALIENTES,18,142,1,161,1363
AGUASCALIENTES,AGUASCALIENTES,13,149,3,165,1871
AGUASCALIENTES,AGUASCALIENTES,5,121,0,126,1870
AGUASCALIENTES,AGUASCALIENTES,9,86,0,95,1399
AGUASCALIENTES,AGUASCALIENTES,10,77,0,87,1398
AGUASCALIENTES,AGUASCALIENTES,10,83,0,93,1398
AGUASCALIENTES,AGUASCALIENTES,18,92,0,110,1130
AGUASCALIENTES,AGUASCALIENTES,16,126,0,142,1130
AGUASCALIENTES,AGUASCALIENTES,12,83,1,96,1324
AGUASCALIENTES,AGUASCALIENTES,11,87,3,101,1324
AGUASCALIENTES,AGUASCALIENTES,10,73,1,84,1725
AGUASCALIENTES,AGUASCALIENTES,8,79,1,88,1725
BAJA CALIFORNIA,MEXICALI,29,195,3,227,1813
BAJA CALIFORNIA,MEXICALI,24,182,2,208,1812
BAJA CALIFORNIA,MEXICALI,14,193,2,209,1725
BAJA CALIFORNIA,MEXICALI,11,173,1,185,1725
BAJA CALIFORNIA,MEXICALI,15,144,2,161,1473
BAJA CALIFORNIA,MEXICALI,12,142,3,157,1473
BAJA CALIFORNIA,MEXICALI,6,177,1,184,1500
BAJA CALIFORNIA,MEXICALI,16,202,4,222,1499
BAJA CALIFORNIA,MEXICALI,14,192,2,208,1499
BAJA CALIFORNIA,MEXICALI,17,155,4,176,1554
BAJA CALIFORNIA,MEXICALI,15,185,2,202,1553
BAJA CALIFORNIA,MEXICALI,23,131,1,155,2111
BAJA CALIFORNIA,MEXICALI,26,121,2,149,2111
BAJA CALIFORNIA,MEXICALI,29,130,1,160,2111
BAJA CALIFORNIA,MEXICALI,36,124,2,162,2111
BAJA CALIFORNIA,MEXICALI,25,115,1,141,2111
BAJA CALIFORNIA,MEXICALI,21,121,0,142,2111
BAJA CALIFORNIA,MEXICALI,34,130,1,165,2110
BAJA CALIFORNIA,MEXICALI,89,695,2,786,0
BAJA CALIFORNIA,MEXICALI,16,181,2,199,1728
BAJA CALIFORNIA,MEXICALI,36,181,0,217,1727
BAJA CALIFORNIA,MEXICALI,25,176,1,202,1889
BAJA CALIFORNIA,MEXICALI,24,179,1,204,1889
BAJA CALIFORNIA,MEXICALI,28,181,5,214,1889
BAJA CALIFORNIA,MEXICALI,26,168,4,198,1889
BAJA CALIFORNIA,MEXICALI,21,163,4,188,1889
BAJA CALIFORNIA,MEXICALI,21,162,2,185,1888
BAJA CALIFORNIA,MEXICALI,29,193,2,224,1938
BAJA CALIFORNIA,MEXICALI,26,188,1,215,1938
BAJA CALIFORNIA,MEXICALI,29,196,0,225,1618
BAJA CALIFORNIA,MEXICALI,11,174,1,186,1618
BAJA CALIFORNIA,MEXICALI,19,158,1,178,1618
BAJA CALIFORNIA,MEXICALI,11,156,0,167,1618
BAJA CALIFORNIA,MEXICALI,7,216,5,228,1710
BAJA CALIFORNIA,MEXICALI,9,178,3,190,1709
BAJA CALIFORNIA,MEXICALI,9,173,1,183,1691
BAJA CALIFORNIA,MEXICALI,12,130,0,142,1690
BAJA CALIFORNIA,MEXICALI,7,132,1,140,1690
BAJA CALIFORNIA,MEXICALI,6,154,2,162,1690
BAJA CALIFORNIA,MEXICALI,18,162,1,181,2104
BAJA CALIFORNIA,MEXICALI,23,160,2,185,2104
BAJA CALIFORNIA,MEXICALI,13,158,0,171,2104
BAJA CALIFORNIA,MEXICALI,21,183,3,207,2104
BAJA CALIFORNIA,MEXICALI,25,178,1,204,2103
BAJA CALIFORNIA,MEXICALI,16,184,0,200,2103
BAJA CALIFORNIA,MEXICALI,28,170,1,199,2103
BAJA CALIFORNIA,MEXICALI,10,190,1,201,1458
BAJA CALIFORNIA,MEXICALI,9,184,4,197,1458
BAJA CALIFORNIA,MEXICALI,12,186,1,199,1457
BAJA CALIFORNIA,MEXICALI,16,213,4,233,1934
BAJA CALIFORNIA,MEXICALI,12,170,4,186,1933
BAJA CALIFORNIA,MEXICALI,20,241,6,267,1735
BAJA CALIFORNIA,MEXICALI,12,197,5,214,1735
BAJA CALIFORNIA,MEXICALI,16,151,1,168,1741
BAJA CALIFORNIA,MEXICALI,14,152,2,168,1740
BAJA CALIFORNIA,MEXICALI,10,202,1,213,1448
BAJA CALIFORNIA,MEXICALI,11,204,5,220,1448
BAJA CALIFORNIA,MEXICALI,14,190,4,208,1448
BAJA CALIFORNIA,MEXICALI,16,194,5,215,1478
BAJA CALIFORNIA,MEXICALI,14,194,0,208,1477
BAJA CALIFORNIA,MEXICALI,14,181,1,196,1477
BAJA CALIFORNIA,MEXICALI,13,216,1,230,2085
BAJA CALIFORNIA,MEXICALI,22,223,7,252,2084
BAJA CALIFORNIA,MEXICALI,296,21,4,321,2084
BAJA CALIFORNIA,MEXICALI,14,214,2,230,2084
BAJA CALIFORNIA,MEXICALI,16,225,1,242,2084
BAJA CALIFORNIA,MEXICALI,17,231,3,251,1808
BAJA CALIFORNIA,MEXICALI,9,270,1,280,1807
BAJA CALIFORNIA,MEXICALI,15,222,1,238,1935
BAJA CALIFORNIA,MEXICALI,19,170,3,192,1934
BAJA CALIFORNIA,MEXICALI,8,231,0,239,1895
BAJA CALIFORNIA,MEXICALI,9,226,3,238,1895
BAJA CALIFORNIA,MEXICALI,28,190,0,218,1782
BAJA CALIFORNIA,MEXICALI,16,209,3,228,1781
BAJA CALIFORNIA,MEXICALI,11,167,0,178,1905
BAJA CALIFORNIA,MEXICALI,14,167,0,181,1905
BAJA CALIFORNIA,MEXICALI,16,175,0,191,1904
BAJA CALIFORNIA,MEXICALI,12,180,1,193,1904
BAJA CALIFORNIA,MEXICALI,12,191,1,204,1904
BAJA CALIFORNIA,MEXICALI,20,172,3,195,1904
BAJA CALIFORNIA,MEXICALI,23,166,0,189,1904
BAJA CALIFORNIA,MEXICALI,13,187,0,200,1904
BAJA CALIFORNIA,MEXICALI,14,206,3,223,2005
BAJA CALIFORNIA,MEXICALI,12,191,0,203,2005
BAJA CALIFORNIA,MEXICALI,17,172,2,191,2004
BAJA CALIFORNIA,MEXICALI,15,184,0,199,2004
BAJA CALIFORNIA,MEXICALI,13,203,0,216,2004
BAJA CALIFORNIA,MEXICALI,10,170,15,195,2004
BAJA CALIFORNIA,MEXICALI,7,180,3,190,1505
BAJA CALIFORNIA,MEXICALI,14,226,5,245,1504
BAJA CALIFORNIA,MEXICALI,15,204,1,220,1504
BAJA CALIFORNIA,MEXICALI,3,294,6,303,1953
BAJA CALIFORNIA,MEXICALI,6,266,2,274,1952
BAJA CALIFORNIA,MEXICALI,16,319,2,337,2005
BAJA CALIFORNIA,MEXICALI,11,249,3,263,2005
BAJA CALIFORNIA,MEXICALI,7,148,2,157,1525
BAJA CALIFORNIA,MEXICALI,5,186,3,194,1525
BAJA CALIFORNIA,MEXICALI,3,154,1,158,1525
BAJA CALIFORNIA,MEXICALI,6,146,3,155,1894
BAJA CALIFORNIA,MEXICALI,13,128,0,141,1894
BAJA CALIFORNIA,MEXICALI,9,170,4,183,1894
BAJA CALIFORNIA,MEXICALI,3,130,7,140,1894
BAJA CALIFORNIA,MEXICALI,7,157,3,167,1847
BAJA CALIFORNIA,MEXICALI,8,172,4,184,1847
BAJA CALIFORNIA,MEXICALI,11,178,3,192,1724
BAJA CALIFORNIA,MEXICALI,11,189,3,203,1724
BAJA CALIFORNIA,MEXICALI,12,123,2,137,1377
BAJA CALIFORNIA,MEXICALI,6,142,4,152,1377
BAJA CALIFORNIA,MEXICALI,17,118,2,137,1752
BAJA CALIFORNIA,MEXICALI,5,149,2,156,1752
BAJA CALIFORNIA,MEXICALI,11,142,1,154,1751
BAJA CALIFORNIA,MEXICALI,11,128,1,140,1508
BAJA CALIFORNIA,MEXICALI,14,128,2,144,1508
BAJA CALIFORNIA,MEXICALI,8,129,3,140,1508
BAJA CALIFORNIA,MEXICALI,7,193,4,204,1675
BAJA CALIFORNIA,MEXICALI,8,186,8,202,1674
BAJA CALIFORNIA,MEXICALI,12,182,3,197,1674
BAJA CALIFORNIA,MEXICALI,12,246,7,265,1802
BAJA CALIFORNIA,MEXICALI,9,211,5,225,1801
BAJA CALIFORNIA,MEXICALI,7,133,2,142,1512
BAJA CALIFORNIA,MEXICALI,12,95,2,109,1511
BAJA CALIFORNIA,MEXICALI,12,122,3,137,1511
BAJA CALIFORNIA,MEXICALI,22,208,9,239,2015
BAJA CALIFORNIA,MEXICALI,21,239,9,269,2015
BAJA CALIFORNIA,MEXICALI,12,173,2,187,1947
BAJA CALIFORNIA,MEXICALI,14,190,4,208,1946
BAJA CALIFORNIA,MEXICALI,9,170,8,187,1451
BAJA CALIFORNIA,MEXICALI,10,165,9,184,1450
BAJA CALIFORNIA,MEXICALI,9,137,0,146,1666
BAJA CALIFORNIA,MEXICALI,9,133,0,142,1666
BAJA CALIFORNIA,MEXICALI,3,135,1,139,1665
BAJA CALIFORNIA,MEXICALI,7,126,0,133,1665
BAJA CALIFORNIA,MEXICALI,1,121,2,124,1746
BAJA CALIFORNIA,MEXICALI,6,165,4,175,1745
BAJA CALIFORNIA,MEXICALI,0,143,0,143,1745
BAJA CALIFORNIA,MEXICALI,6,115,2,123,1745
BAJA CALIFORNIA,MEXICALI,7,133,0,140,1745
BAJA CALIFORNIA,MEXICALI,10,130,6,146,1205
BAJA CALIFORNIA,MEXICALI,15,129,2,146,1204
BAJA CALIFORNIA,MEXICALI,8,258,3,269,1829
BAJA CALIFORNIA,MEXICALI,9,238,5,252,1828
BAJA CALIFORNIA,MEXICALI,9,126,2,137,1398
BAJA CALIFORNIA,MEXICALI,8,124,4,136,1397
BAJA CALIFORNIA,MEXICALI,18,215,3,236,1817
BAJA CALIFORNIA,MEXICALI,18,225,3,246,1816
BAJA CALIFORNIA,MEXICALI,9,218,11,238,1816
BAJA CALIFORNIA,MEXICALI,15,190,7,212,1816
BAJA CALIFORNIA,MEXICALI,10,354,5,369,1850
BAJA CALIFORNIA,MEXICALI,5,333,3,341,1849
BAJA CALIFORNIA,MEXICALI,2,152,9,163,1516
BAJA CALIFORNIA,MEXICALI,11,181,6,198,1516
BAJA CALIFORNIA,MEXICALI,8,135,11,154,1515
BAJA CALIFORNIA,MEXICALI,12,205,4,221,1233
BAJA CALIFORNIA,MEXICALI,10,182,1,193,1233
BAJA CALIFORNIA,MEXICALI,11,227,2,240,1775
BAJA CALIFORNIA,MEXICALI,8,217,4,229,1775
BAJA CALIFORNIA,MEXICALI,7,228,10,245,1775
BAJA CALIFORNIA,MEXICALI,6,164,6,176,1861
BAJA CALIFORNIA,MEXICALI,14,165,6,185,1861
BAJA CALIFORNIA,MEXICALI,12,152,5,169,1677
BAJA CALIFORNIA,MEXICALI,4,154,7,165,1677
BAJA CALIFORNIA,MEXICALI,10,162,5,177,1676
BAJA CALIFORNIA,MEXICALI,8,151,1,160,1686
BAJA CALIFORNIA,MEXICALI,12,229,1,242,1686
BAJA CALIFORNIA,MEXICALI,9,182,2,193,1686
BAJA CALIFORNIA,MEXICALI,11,176,0,187,1685
BAJA CALIFORNIA,MEXICALI,8,178,4,190,1302
BAJA CALIFORNIA,MEXICALI,9,143,0,152,1302
BAJA CALIFORNIA,MEXICALI,2,192,7,201,1525
BAJA CALIFORNIA,MEXICALI,5,176,2,183,1524
BAJA CALIFORNIA,MEXICALI,12,173,3,188,1524
BAJA CALIFORNIA,MEXICALI,15,235,5,255,1864
BAJA CALIFORNIA,MEXICALI,16,225,3,244,1864
BAJA CALIFORNIA,MEXICALI,13,144,7,164,1462
BAJA CALIFORNIA,MEXICALI,10,147,8,165,1462
BAJA CALIFORNIA,MEXICALI,8,152,1,161,1462
BAJA CALIFORNIA,MEXICALI,7,134,3,144,1812
BAJA CALIFORNIA,MEXICALI,18,157,2,177,1812
BAJA CALIFORNIA,MEXICALI,3,113,0,116,1953
BAJA CALIFORNIA,MEXICALI,11,119,2,132,1953
BAJA CALIFORNIA,MEXICALI,10,106,0,116,1952
BAJA CALIFORNIA,MEXICALI,10,103,0,113,1952
BAJA CALIFORNIA,MEXICALI,10,121,0,131,1952
BAJA CALIFORNIA,MEXICALI,6,184,3,193,1886
BAJA CALIFORNIA,MEXICALI,8,208,2,218,1886
BAJA CALIFORNIA,MEXICALI,4,180,0,184,1885
BAJA CALIFORNIA,MEXICALI,3,184,3,190,1885
BAJA CALIFORNIA,MEXICALI,0,107,0,107,1317
BAJA CALIFORNIA,MEXICALI,10,81,1,92,1316
BAJA CALIFORNIA,MEXICALI,3,141,1,145,1720
BAJA CALIFORNIA,MEXICALI,5,163,3,171,1719
BAJA CALIFORNIA,MEXICALI,7,135,0,142,1719
BAJA CALIFORNIA,MEXICALI,1,124,2,127,1719
BAJA CALIFORNIA,MEXICALI,6,141,2,149,1719
BAJA CALIFORNIA,MEXICALI,8,168,3,179,1865
BAJA CALIFORNIA,MEXICALI,7,175,1,183,1865
BAJA CALIFORNIA,MEXICALI,8,155,2,165,1864
BAJA CALIFORNIA,MEXICALI,6,149,0,155,1864
BAJA CALIFORNIA,MEXICALI,8,185,1,194,1664
BAJA CALIFORNIA,MEXICALI,13,178,4,195,1664
BAJA CALIFORNIA,MEXICALI,8,195,1,204,1663
BAJA CALIFORNIA,MEXICALI,7,158,0,165,1869
BAJA CALIFORNIA,MEXICALI,10,151,0,161,1868
BAJA CALIFORNIA,MEXICALI,8,131,1,140,1868
BAJA CALIFORNIA,MEXICALI,8,175,2,185,1943
BAJA CALIFORNIA,MEXICALI,4,180,0,184,1943
BAJA CALIFORNIA,MEXICALI,5,183,1,189,1942
BAJA CALIFORNIA,MEXICALI,27,137,2,166,1732
BAJA CALIFORNIA,MEXICALI,24,155,1,180,1731
BAJA CALIFORNIA,MEXICALI,24,108,0,132,1436
BAJA CALIFORNIA,MEXICALI,15,108,0,123,1435
BAJA CALIFORNIA,MEXICALI,20,80,2,102,1435
BAJA CALIFORNIA,MEXICALI,13,149,1,163,1883
BAJA CALIFORNIA,MEXICALI,3,162,2,167,1883
BAJA CALIFORNIA,MEXICALI,2,156,1,159,1882
BAJA CALIFORNIA,MEXICALI,12,136,3,151,1532
BAJA CALIFORNIA,MEXICALI,11,174,1,186,1532
BAJA CALIFORNIA,MEXICALI,11,159,2,172,1531
BAJA CALIFORNIA,MEXICALI,11,100,1,112,1384
BAJA CALIFORNIA,MEXICALI,6,105,4,115,1383
BAJA CALIFORNIA,MEXICALI,123,1094,19,1236,0
BAJA CALIFORNIA,MEXICALI,11,176,1,188,1725
BAJA CALIFORNIA,MEXICALI,10,171,2,183,1725
BAJA CALIFORNIA,MEXICALI,0,135,13,148,1724
BAJA CALIFORNIA,MEXICALI,8,137,3,148,1312
BAJA CALIFORNIA,MEXICALI,17,136,1,154,1312
BAJA CALIFORNIA,MEXICALI,29,157,2,188,1886
BAJA CALIFORNIA,MEXICALI,25,212,3,240,1886
BAJA CALIFORNIA,MEXICALI,18,209,3,230,1780
BAJA CALIFORNIA,MEXICALI,19,210,2,231,1779
BAJA CALIFORNIA,MEXICALI,29,179,0,208,1847
BAJA CALIFORNIA,MEXICALI,32,184,5,221,1846
BAJA CALIFORNIA,MEXICALI,15,155,0,170,1744
BAJA CALIFORNIA,MEXICALI,17,161,2,180,1744
BAJA CALIFORNIA,MEXICALI,14,188,2,204,1679
BAJA CALIFORNIA,MEXICALI,8,168,1,177,1679
BAJA CALIFORNIA,MEXICALI,9,179,1,189,1709
BAJA CALIFORNIA,MEXICALI,6,172,3,181,1709
BAJA CALIFORNIA,MEXICALI,6,170,2,178,1404
BAJA CALIFORNIA,MEXICALI,11,122,1,134,1404
BAJA CALIFORNIA,MEXICALI,11,129,1,141,1403
BAJA CALIFORNIA,MEXICALI,13,158,4,175,1435
BAJA CALIFORNIA,MEXICALI,11,176,0,187,1435
BAJA CALIFORNIA,MEXICALI,17,195,2,214,1434
BAJA CALIFORNIA,MEXICALI,24,236,3,263,1925
BAJA CALIFORNIA,MEXICALI,15,187,1,203,1925
BAJA CALIFORNIA,MEXICALI,26,187,0,213,1803
BAJA CALIFORNIA,MEXICALI,10,196,0,206,1802
BAJA CALIFORNIA,MEXICALI,18,181,5,204,1802
BAJA CALIFORNIA,MEXICALI,8,240,7,255,1630
BAJA CALIFORNIA,MEXICALI,7,252,0,259,1630
BAJA CALIFORNIA,MEXICALI,5,225,2,232,1630
BAJA CALIFORNIA,MEXICALI,17,177,3,197,1647
BAJA CALIFORNIA,MEXICALI,20,170,0,190,1647
BAJA CALIFORNIA,MEXICALI,19,184,3,206,1463
BAJA CALIFORNIA,MEXICALI,10,177,6,193,1463
BAJA CALIFORNIA,MEXICALI,6,184,4,194,1462
BAJA CALIFORNIA,MEXICALI,18,171,2,191,1825
BAJA CALIFORNIA,MEXICALI,21,175,1,197,1825
BAJA CALIFORNIA,MEXICALI,30,127,1,158,1525
BAJA CALIFORNIA,MEXICALI,19,116,1,136,1525
BAJA CALIFORNIA,MEXICALI,18,102,1,121,1524
BAJA CALIFORNIA,MEXICALI,20,230,8,258,1770
BAJA CALIFORNIA,MEXICALI,12,229,0,241,1769
BAJA CALIFORNIA,MEXICALI,40,138,1,179,1748
BAJA CALIFORNIA,MEXICALI,23,154,3,180,1747
BAJA CALIFORNIA,MEXICALI,34,171,1,206,1363
BAJA CALIFORNIA,MEXICALI,18,130,0,148,1362
BAJA CALIFORNIA,MEXICALI,6,165,4,175,1099
BAJA CALIFORNIA,MEXICALI,12,169,4,185,1099
BAJA CALIFORNIA,MEXICALI,19,276,7,302,1966
BAJA CALIFORNIA,MEXICALI,36,250,2,288,1965
BAJA CALIFORNIA,MEXICALI,16,209,3,228,1296
BAJA CALIFORNIA,MEXICALI,22,198,3,223,1295
BAJA CALIFORNIA,MEXICALI,29,184,1,214,1892
BAJA CALIFORNIA,MEXICALI,19,194,0,213,1892
BAJA CALIFORNIA,MEXICALI,27,174,0,201,1892
BAJA CALIFORNIA,MEXICALI,18,193,0,211,1892
BAJA CALIFORNIA,MEXICALI,22,193,1,216,1892
BAJA CALIFORNIA,MEXICALI,28,133,0,161,1485
BAJA CALIFORNIA,MEXICALI,29,125,3,157,1485
BAJA CALIFORNIA,MEXICALI,25,155,0,180,1485
BAJA CALIFORNIA,MEXICALI,10,197,2,209,1689
BAJA CALIFORNIA,MEXICALI,10,165,2,177,1689
BAJA CALIFORNIA,MEXICALI,7,196,3,206,1420
BAJA CALIFORNIA,MEXICALI,13,193,0,206,1419
BAJA CALIFORNIA,MEXICALI,15,189,2,206,1629
BAJA CALIFORNIA,MEXICALI,18,216,1,235,1629
BAJA CALIFORNIA,MEXICALI,22,186,0,208,1629
BAJA CALIFORNIA,MEXICALI,16,171,1,188,1714
BAJA CALIFORNIA,MEXICALI,24,170,0,194,1714
BAJA CALIFORNIA,MEXICALI,23,196,0,219,1713
BAJA CALIFORNIA,MEXICALI,15,223,3,241,1690
BAJA CALIFORNIA,MEXICALI,17,228,8,253,1689
BAJA CALIFORNIA,MEXICALI,25,255,1,281,1891
BAJA CALIFORNIA,MEXICALI,26,236,2,264,1890
BAJA CALIFORNIA,MEXICALI,17,204,5,226,1768
BAJA CALIFORNIA,MEXICALI,10,186,5,201,1768
BAJA CALIFORNIA,MEXICALI,20,138,2,160,1461
BAJA CALIFORNIA,MEXICALI,10,178,0,188,1460
BAJA CALIFORNIA,MEXICALI,8,161,0,169,1460
BAJA CALIFORNIA,MEXICALI,15,177,3,195,1260
BAJA CALIFORNIA,MEXICALI,11,145,1,157,1260
BAJA CALIFORNIA,MEXICALI,19,151,3,173,1408
BAJA CALIFORNIA,MEXICALI,21,175,1,197,1407
BAJA CALIFORNIA,MEXICALI,20,163,2,185,1407
BAJA CALIFORNIA,MEXICALI,30,156,5,191,1633
BAJA CALIFORNIA,MEXICALI,19,177,7,203,1632
BAJA CALIFORNIA,MEXICALI,24,168,1,193,1632
BAJA CALIFORNIA,MEXICALI,15,130,4,149,1330
BAJA CALIFORNIA,MEXICALI,17,115,4,136,1330
BAJA CALIFORNIA,MEXICALI,20,121,0,141,1330
BAJA CALIFORNIA,MEXICALI,17,138,2,157,1584
BAJA CALIFORNIA,MEXICALI,19,157,1,177,1583
BAJA CALIFORNIA,MEXICALI,19,107,0,126,1489
BAJA CALIFORNIA,MEXICALI,28,106,1,135,1489
BAJA CALIFORNIA,MEXICALI,27,83,3,113,1488
BAJA CALIFORNIA,MEXICALI,27,231,1,259,1901
BAJA CALIFORNIA,MEXICALI,19,222,3,244,1900
BAJA CALIFORNIA,MEXICALI,20,163,5,188,1517
BAJA CALIFORNIA,MEXICALI,20,161,4,185,1517
BAJA CALIFORNIA,MEXICALI,21,180,3,204,1517
BAJA CALIFORNIA,MEXICALI,15,147,3,165,1517
BAJA CALIFORNIA,MEXICALI,14,248,8,270,1795
BAJA CALIFORNIA,MEXICALI,27,251,5,283,1794
BAJA CALIFORNIA,MEXICALI,17,189,4,210,1672
BAJA CALIFORNIA,MEXICALI,23,181,0,204,1672
BAJA CALIFORNIA,MEXICALI,18,133,2,153,1870
BAJA CALIFORNIA,MEXICALI,30,142,2,174,1870
BAJA CALIFORNIA,MEXICALI,23,131,1,155,1870
BAJA CALIFORNIA,MEXICALI,15,239,5,259,1884
BAJA CALIFORNIA,MEXICALI,14,215,0,229,1884
BAJA CALIFORNIA,MEXICALI,34,238,2,274,1660
BAJA CALIFORNIA,MEXICALI,43,178,2,223,1660
BAJA CALIFORNIA,MEXICALI,21,193,1,215,1818
BAJA CALIFORNIA,MEXICALI,18,210,7,235,1818
BAJA CALIFORNIA,MEXICALI,19,176,3,198,1633
BAJA CALIFORNIA,MEXICALI,11,185,6,202,1633
BAJA CALIFORNIA,MEXICALI,15,199,2,216,1632
BAJA CALIFORNIA,MEXICALI,14,157,4,175,1048
BAJA CALIFORNIA,MEXICALI,15,127,1,143,1047
BAJA CALIFORNIA,MEXICALI,18,206,1,225,1973
BAJA CALIFORNIA,MEXICALI,28,209,4,241,1973
BAJA CALIFORNIA,MEXICALI,15,101,2,118,1132
BAJA CALIFORNIA,MEXICALI,17,127,1,145,1132
BAJA CALIFORNIA,MEXICALI,16,158,2,176,1572
BAJA CALIFORNIA,MEXICALI,15,181,1,197,1572
BAJA CALIFORNIA,MEXICALI,17,198,1,216,1880
BAJA CALIFORNIA,MEXICALI,26,188,2,216,1879
BAJA CALIFORNIA,MEXICALI,8,227,1,236,1576
BAJA CALIFORNIA,MEXICALI,20,183,1,204,1576
BAJA CALIFORNIA,MEXICALI,14,184,3,201,1576
BAJA CALIFORNIA,MEXICALI,14,170,1,185,1395
BAJA CALIFORNIA,MEXICALI,17,143,2,162,1395
BAJA CALIFORNIA,MEXICALI,15,163,4,182,1684
BAJA CALIFORNIA,MEXICALI,10,189,7,206,1684
BAJA CALIFORNIA,MEXICALI,8,194,6,208,1684
BAJA CALIFORNIA,MEXICALI,11,236,4,251,1917
BAJA CALIFORNIA,MEXICALI,11,213,0,224,1917
BAJA CALIFORNIA,MEXICALI,14,194,1,209,1917
BAJA CALIFORNIA,MEXICALI,5,160,1,166,1955
BAJA CALIFORNIA,MEXICALI,6,192,0,198,1955
BAJA CALIFORNIA,MEXICALI,5,167,1,173,1954
BAJA CALIFORNIA,MEXICALI,4,153,2,159,1954
BAJA CALIFORNIA,MEXICALI,11,160,1,172,1602
BAJA CALIFORNIA,MEXICALI,6,160,0,166,1602
BAJA CALIFORNIA,MEXICALI,12,156,1,169,1602
BAJA CALIFORNIA,MEXICALI,13,193,4,210,1499
BAJA CALIFORNIA,MEXICALI,10,215,2,227,1498
BAJA CALIFORNIA,MEXICALI,11,216,7,234,1498
BAJA CALIFORNIA,MEXICALI,16,219,3,238,1896
BAJA CALIFORNIA,MEXICALI,8,247,2,257,1896
BAJA CALIFORNIA,MEXICALI,9,183,1,193,1658
BAJA CALIFORNIA,MEXICALI,17,171,6,194,1658
BAJA CALIFORNIA,MEXICALI,6,180,7,193,1834
BAJA CALIFORNIA,MEXICALI,4,173,4,181,1834
BAJA CALIFORNIA,MEXICALI,9,176,2,187,1833
BAJA CALIFORNIA,MEXICALI,15,167,2,184,2001
BAJA CALIFORNIA,MEXICALI,10,153,2,165,2001
BAJA CALIFORNIA,MEXICALI,14,144,1,159,2001
BAJA CALIFORNIA,MEXICALI,22,182,0,204,2001
BAJA CALIFORNIA,MEXICALI,13,152,2,167,2000
BAJA CALIFORNIA,MEXICALI,10,163,5,178,2000
BAJA CALIFORNIA,MEXICALI,6,191,3,200,1445
BAJA CALIFORNIA,MEXICALI,5,207,2,214,1444
BAJA CALIFORNIA,MEXICALI,15,204,2,221,1518
BAJA CALIFORNIA,MEXICALI,16,223,7,246,1518
BAJA CALIFORNIA,MEXICALI,3,209,4,216,1997
BAJA CALIFORNIA,MEXICALI,7,215,3,225,1997
BAJA CALIFORNIA,MEXICALI,14,238,4,256,1997
BAJA CALIFORNIA,MEXICALI,9,227,2,238,1997
BAJA CALIFORNIA,MEXICALI,7,203,4,214,1997
BAJA CALIFORNIA,MEXICALI,8,200,6,214,1997
BAJA CALIFORNIA,MEXICALI,4,210,1,215,1997
BAJA CALIFORNIA,MEXICALI,14,287,1,302,1688
BAJA CALIFORNIA,MEXICALI,16,263,2,281,1688
BAJA CALIFORNIA,MEXICALI,14,202,2,218,1488
BAJA CALIFORNIA,MEXICALI,11,226,7,244,1488
BAJA CALIFORNIA,MEXICALI,18,207,2,227,1487
BAJA CALIFORNIA,MEXICALI,9,164,5,178,1751
BAJA CALIFORNIA,MEXICALI,5,180,2,187,1751
BAJA CALIFORNIA,MEXICALI,5,170,0,175,1751
BAJA CALIFORNIA,MEXICALI,5,179,2,186,1751
BAJA CALIFORNIA,MEXICALI,11,142,0,153,1751
BAJA CALIFORNIA,MEXICALI,32,158,2,192,1631
BAJA CALIFORNIA,MEXICALI,47,158,0,205,1631
BAJA CALIFORNIA,MEXICALI,14,146,0,160,1927
BAJA CALIFORNIA,MEXICALI,8,129,2,139,1927
BAJA CALIFORNIA,MEXICALI,6,162,0,168,1452
BAJA CALIFORNIA,MEXICALI,13,156,2,171,1452
BAJA CALIFORNIA,MEXICALI,7,199,1,207,2001
BAJA CALIFORNIA,MEXICALI,8,209,1,218,2000
BAJA CALIFORNIA,ENSENADA,37,161,2,200,1814
BAJA CALIFORNIA,ENSENADA,29,180,0,209,1814
BAJA CALIFORNIA,ENSENADA,8,284,2,294,1659
BAJA CALIFORNIA,ENSENADA,2,303,2,307,1659
BAJA CALIFORNIA,ENSENADA,15,188,3,206,1237
BAJA CALIFORNIA,ENSENADA,14,193,1,208,1236
BAJA CALIFORNIA,ENSENADA,22,301,4,327,1776
BAJA CALIFORNIA,ENSENADA,17,297,2,316,1776
BAJA CALIFORNIA,ENSENADA,17,161,3,181,1387
BAJA CALIFORNIA,ENSENADA,15,180,1,196,1386
BAJA CALIFORNIA,ENSENADA,19,167,0,186,1386
BAJA CALIFORNIA,ENSENADA,9,250,2,261,1640
BAJA CALIFORNIA,ENSENADA,21,234,4,259,1639
BAJA CALIFORNIA,ENSENADA,18,201,3,222,1269
BAJA CALIFORNIA,ENSENADA,11,195,1,207,1269
BAJA CALIFORNIA,ENSENADA,22,270,7,299,1866
BAJA CALIFORNIA,ENSENADA,21,268,7,296,1865
BAJA CALIFORNIA,ENSENADA,14,234,6,254,1402
BAJA CALIFORNIA,ENSENADA,12,179,1,192,1401
BAJA CALIFORNIA,ENSENADA,27,203,0,230,1401
BAJA CALIFORNIA,ENSENADA,25,168,1,194,1427
BAJA CALIFORNIA,ENSENADA,23,179,0,202,1427
BAJA CALIFORNIA,ENSENADA,21,190,3,214,1427
BAJA CALIFORNIA,ENSENADA,9,128,0,137,1272
BAJA CALIFORNIA,ENSENADA,16,167,0,183,1271
BAJA CALIFORNIA,ENSENADA,23,248,2,273,2008
BAJA CALIFORNIA,ENSENADA,16,219,5,240,1725
BAJA CALIFORNIA,ENSENADA,12,221,3,236,1724
BAJA CALIFORNIA,ENSENADA,6,200,1,207,1329
BAJA CALIFORNIA,ENSENADA,8,169,3,180,1328
BAJA CALIFORNIA,ENSENADA,5,140,0,145,1051
BAJA CALIFORNIA,ENSENADA,8,170,0,178,1051
BAJA CALIFORNIA,ENSENADA,14,221,2,237,1424
BAJA CALIFORNIA,ENSENADA,10,237,2,249,1423
BAJA CALIFORNIA,ENSENADA,6,272,3,281,1674
BAJA CALIFORNIA,ENSENADA,11,234,2,247,1673
BAJA CALIFORNIA,ENSENADA,6,259,1,266,1858
BAJA CALIFORNIA,ENSENADA,16,273,2,291,1857
BAJA CALIFORNIA,ENSENADA,20,220,3,243,1712
BAJA CALIFORNIA,ENSENADA,16,196,1,213,1712
BAJA CALIFORNIA,ENSENADA,29,179,4,212,1712
BAJA CALIFORNIA,ENSENADA,34,131,1,166,1446
BAJA CALIFORNIA,ENSENADA,10,155,1,166,1445
BAJA CALIFORNIA,ENSENADA,27,198,0,225,1705
BAJA CALIFORNIA,ENSENADA,23,209,2,234,1704
BAJA CALIFORNIA,ENSENADA,15,220,1,236,1821
BAJA CALIFORNIA,ENSENADA,24,214,3,241,1820
BAJA CALIFORNIA,ENSENADA,14,181,6,201,1553
BAJA CALIFORNIA,ENSENADA,10,181,1,192,1553
BAJA CALIFORNIA,ENSENADA,20,217,2,239,1819
BAJA CALIFORNIA,ENSENADA,15,233,3,251,1819
BAJA CALIFORNIA,ENSENADA,12,239,6,257,1818
BAJA CALIFORNIA,ENSENADA,17,285,4,306,2016
BAJA CALIFORNIA,ENSENADA,24,132,0,156,1372
BAJA CALIFORNIA,ENSENADA,13,126,1,140,1371
BAJA CALIFORNIA,ENSENADA,18,198,1,217,1534
BAJA CALIFORNIA,ENSENADA,21,237,4,262,1534
BAJA CALIFORNIA,ENSENADA,21,240,3,264,1881
BAJA CALIFORNIA,ENSENADA,24,225,2,251,1880
BAJA CALIFORNIA,ENSENADA,24,240,2,266,1704
BAJA CALIFORNIA,ENSENADA,26,204,1,231,1703
BAJA CALIFORNIA,ENSENADA,27,163,2,192,1570
BAJA CALIFORNIA,ENSENADA,18,163,2,183,1570
BAJA CALIFORNIA,ENSENADA,27,201,4,232,1540
BAJA CALIFORNIA,ENSENADA,21,208,0,229,1540
BAJA CALIFORNIA,ENSENADA,8,199,0,207,1385
BAJA CALIFORNIA,ENSENADA,15,218,1,234,1385
BAJA CALIFORNIA,ENSENADA,19,186,3,208,1384
BAJA CALIFORNIA,ENSENADA,8,195,2,205,1531
BAJA CALIFORNIA,ENSENADA,18,200,2,220,1531
BAJA CALIFORNIA,ENSENADA,13,193,5,211,1530
BAJA CALIFORNIA,ENSENADA,13,216,2,231,1463
BAJA CALIFORNIA,ENSENADA,17,207,2,226,1463
BAJA CALIFORNIA,ENSENADA,13,210,4,227,1462
BAJA CALIFORNIA,ENSENADA,31,328,4,363,1871
BAJA CALIFORNIA,ENSENADA,33,301,1,335,1871
BAJA CALIFORNIA,ENSENADA,21,243,3,267,1673
BAJA CALIFORNIA,ENSENADA,27,246,0,273,1672
BAJA CALIFORNIA,ENSENADA,24,289,3,316,1788
BAJA CALIFORNIA,ENSENADA,31,289,0,320,1787
BAJA CALIFORNIA,ENSENADA,8,174,2,184,1352
BAJA CALIFORNIA,ENSENADA,10,189,2,201,1352
BAJA CALIFORNIA,ENSENADA,12,191,0,203,1351
BAJA CALIFORNIA,ENSENADA,11,234,5,250,1597
BAJA CALIFORNIA,ENSENADA,13,197,4,214,1597
BAJA CALIFORNIA,ENSENADA,18,187,0,205,1578
BAJA CALIFORNIA,ENSENADA,28,208,0,236,1577
BAJA CALIFORNIA,ENSENADA,26,186,2,214,1577
BAJA CALIFORNIA,ENSENADA,32,190,1,223,1577
BAJA CALIFORNIA,ENSENADA,13,164,3,180,1602
BAJA CALIFORNIA,ENSENADA,11,173,2,186,1602
BAJA CALIFORNIA,ENSENADA,11,149,1,161,1602
BAJA CALIFORNIA,ENSENADA,17,200,3,220,1505
BAJA CALIFORNIA,ENSENADA,17,201,8,226,1504
BAJA CALIFORNIA,ENSENADA,14,179,1,194,1504
BAJA CALIFORNIA,ENSENADA,22,190,8,220,1295
BAJA CALIFORNIA,ENSENADA,21,206,4,231,1294
BAJA CALIFORNIA,ENSENADA,16,202,3,221,1294
BAJA CALIFORNIA,ENSENADA,22,224,0,246,1680
BAJA CALIFORNIA,ENSENADA,14,188,2,204,1679
BAJA CALIFORNIA,ENSENADA,9,200,1,210,1093
BAJA CALIFORNIA,ENSENADA,5,167,0,172,1093
BAJA CALIFORNIA,ENSENADA,14,283,3,300,1713
BAJA CALIFORNIA,ENSENADA,21,305,7,333,1713
BAJA CALIFORNIA,ENSENADA,23,289,3,315,1992
BAJA CALIFORNIA,ENSENADA,23,242,1,266,1992
BAJA CALIFORNIA,ENSENADA,14,244,5,263,1874
BAJA CALIFORNIA,ENSENADA,14,271,3,288,1874
BAJA CALIFORNIA,ENSENADA,10,178,4,192,1362
BAJA CALIFORNIA,ENSENADA,9,193,3,205,1361
BAJA CALIFORNIA,ENSENADA,10,227,3,240,1746
BAJA CALIFORNIA,ENSENADA,7,241,1,249,1745
BAJA CALIFORNIA,ENSENADA,8,237,2,247,1968
BAJA CALIFORNIA,ENSENADA,13,243,5,261,1968
BAJA CALIFORNIA,ENSENADA,7,242,1,250,1968
BAJA CALIFORNIA,ENSENADA,8,205,3,216,1892
BAJA CALIFORNIA,ENSENADA,10,234,5,249,1892
BAJA CALIFORNIA,ENSENADA,10,219,8,237,1891
BAJA CALIFORNIA,ENSENADA,8,175,3,186,1061
BAJA CALIFORNIA,ENSENADA,2,168,5,175,1061
BAJA CALIFORNIA,ENSENADA,17,260,4,281,1734
BAJA CALIFORNIA,ENSENADA,10,258,5,273,1734
BAJA CALIFORNIA,ENSENADA,11,253,4,268,1656
BAJA CALIFORNIA,ENSENADA,7,228,9,244,1656
BAJA CALIFORNIA,ENSENADA,18,365,4,387,1712
BAJA CALIFORNIA,ENSENADA,5,359,2,366,1711
BAJA CALIFORNIA,ENSENADA,16,336,7,359,1944
BAJA CALIFORNIA,ENSENADA,23,334,11,368,1944
BAJA CALIFORNIA,ENSENADA,10,250,4,264,1380
BAJA CALIFORNIA,ENSENADA,10,236,2,248,1380
BAJA CALIFORNIA,ENSENADA,14,363,4,381,1802
BAJA CALIFORNIA,ENSENADA,7,389,8,404,1801
BAJA CALIFORNIA,ENSENADA,14,291,4,309,1800
BAJA CALIFORNIA,ENSENADA,14,283,5,302,1800
BAJA CALIFORNIA,ENSENADA,8,210,3,221,1800
BAJA CALIFORNIA,ENSENADA,9,212,6,227,1799
BAJA CALIFORNIA,ENSENADA,17,236,5,258,1799
BAJA CALIFORNIA,ENSENADA,9,196,5,210,1799
BAJA CALIFORNIA,ENSENADA,20,196,4,220,1799
BAJA CALIFORNIA,ENSENADA,10,327,8,345,1877
BAJA CALIFORNIA,ENSENADA,10,357,13,380,1877
BAJA CALIFORNIA,ENSENADA,11,335,9,355,1876
BAJA CALIFORNIA,ENSENADA,17,253,10,280,1692
BAJA CALIFORNIA,ENSENADA,12,148,4,164,1488
BAJA CALIFORNIA,ENSENADA,4,188,2,194,1487
BAJA CALIFORNIA,ENSENADA,14,293,9,316,1763
BAJA CALIFORNIA,ENSENADA,16,324,16,356,1763
BAJA CALIFORNIA,ENSENADA,9,281,11,301,1762
BAJA CALIFORNIA,ENSENADA,8,266,11,285,1789
BAJA CALIFORNIA,ENSENADA,7,289,11,307,1789
BAJA CALIFORNIA,ENSENADA,10,291,9,310,1788
BAJA CALIFORNIA,ENSENADA,15,283,9,307,1877
BAJA CALIFORNIA,ENSENADA,11,315,13,339,1877
BAJA CALIFORNIA,ENSENADA,12,325,5,342,1877
BAJA CALIFORNIA,ENSENADA,306,13,8,327,1446
BAJA CALIFORNIA,ENSENADA,9,358,9,376,1445
BAJA CALIFORNIA,ENSENADA,7,331,10,348,1690
BAJA CALIFORNIA,ENSENADA,13,396,13,422,1689
BAJA CALIFORNIA,ENSENADA,16,388,19,423,1689
BAJA CALIFORNIA,ENSENADA,7,374,11,392,1689
BAJA CALIFORNIA,ENSENADA,10,346,19,375,1689
BAJA CALIFORNIA,ENSENADA,5,272,2,279,1413
BAJA CALIFORNIA,ENSENADA,14,272,4,290,1413
BAJA CALIFORNIA,ENSENADA,10,250,9,269,1412
BAJA CALIFORNIA,ENSENADA,13,286,9,308,1733
BAJA CALIFORNIA,ENSENADA,10,296,2,308,1733
BAJA CALIFORNIA,ENSENADA,12,260,3,275,1732
BAJA CALIFORNIA,ENSENADA,14,284,4,302,1732
BAJA CALIFORNIA,ENSENADA,11,301,11,323,1797
BAJA CALIFORNIA,ENSENADA,4,326,12,342,1797
BAJA CALIFORNIA,ENSENADA,14,350,11,375,1796
BAJA CALIFORNIA,ENSENADA,9,283,10,302,1879
BAJA CALIFORNIA,ENSENADA,10,290,10,310,1879
BAJA CALIFORNIA,ENSENADA,7,341,6,354,1879
BAJA CALIFORNIA,ENSENADA,5,247,8,260,1556
BAJA CALIFORNIA,ENSENADA,7,206,6,219,1556
BAJA CALIFORNIA,ENSENADA,8,236,10,254,1555
BAJA CALIFORNIA,ENSENADA,9,253,4,266,1232
BAJA CALIFORNIA,ENSENADA,9,232,5,246,1231
BAJA CALIFORNIA,ENSENADA,4,95,1,100,1528
BAJA CALIFORNIA,ENSENADA,8,230,2,240,1675
BAJA CALIFORNIA,ENSENADA,22,200,5,227,1675
BAJA CALIFORNIA,ENSENADA,19,212,1,232,1675
BAJA CALIFORNIA,ENSENADA,18,189,0,207,1674
BAJA CALIFORNIA,ENSENADA,18,193,1,212,1674
BAJA CALIFORNIA,ENSENADA,107,1512,16,1635,0
BAJA CALIFORNIA,ENSENADA,18,250,2,270,1837
BAJA CALIFORNIA,ENSENADA,18,226,4,248,1837
BAJA CALIFORNIA,ENSENADA,19,230,2,251,1836
BAJA CALIFORNIA,ENSENADA,22,230,3,255,1791
BAJA CALIFORNIA,ENSENADA,11,231,4,246,1790
BAJA CALIFORNIA,ENSENADA,19,243,1,263,1790
BAJA CALIFORNIA,ENSENADA,16,227,2,245,1790
BAJA CALIFORNIA,ENSENADA,16,208,2,226,1789
BAJA CALIFORNIA,ENSENADA,7,165,2,174,1457
BAJA CALIFORNIA,ENSENADA,11,180,0,191,1456
BAJA CALIFORNIA,ENSENADA,9,188,2,199,1322
BAJA CALIFORNIA,ENSENADA,147,9,4,160,1322
BAJA CALIFORNIA,ENSENADA,16,192,2,210,1674
BAJA CALIFORNIA,ENSENADA,14,180,3,197,1674
BAJA CALIFORNIA,ENSENADA,20,205,1,226,1520
BAJA CALIFORNIA,ENSENADA,9,220,3,232,1520
BAJA CALIFORNIA,ENSENADA,10,189,2,201,1519
BAJA CALIFORNIA,ENSENADA,14,205,5,224,1544
BAJA CALIFORNIA,ENSENADA,9,207,3,219,1544
BAJA CALIFORNIA,ENSENADA,9,214,1,224,1543
BAJA CALIFORNIA,ENSENADA,13,256,0,269,2014
BAJA CALIFORNIA,ENSENADA,17,274,0,291,2014
BAJA CALIFORNIA,ENSENADA,11,205,2,218,1351
BAJA CALIFORNIA,ENSENADA,5,189,3,197,1350
BAJA CALIFORNIA,ENSENADA,27,181,0,208,1377
BAJA CALIFORNIA,ENSENADA,25,152,17,194,1376
BAJA CALIFORNIA,ENSENADA,11,249,4,264,1562
BAJA CALIFORNIA,ENSENADA,10,217,5,232,1561
BAJA CALIFORNIA,TIJUANA,7,311,6,324,2052
BAJA CALIFORNIA,TIJUANA,16,302,5,323,2052
BAJA CALIFORNIA,TIJUANA,13,304,4,321,2052
BAJA CALIFORNIA,TIJUANA,8,303,2,313,2052
BAJA CALIFORNIA,TIJUANA,9,280,1,290,2052
BAJA CALIFORNIA,TIJUANA,5,252,5,262,2051
BAJA CALIFORNIA,TIJUANA,10,295,1,306,2051
BAJA CALIFORNIA,TIJUANA,3,174,2,179,1671
BAJA CALIFORNIA,TIJUANA,9,215,2,226,1671
BAJA CALIFORNIA,TIJUANA,8,216,6,230,1671
BAJA CALIFORNIA,TIJUANA,5,209,3,217,1670
BAJA CALIFORNIA,TIJUANA,6,221,1,228,1670
BAJA CALIFORNIA,TIJUANA,8,250,5,263,1746
BAJA CALIFORNIA,TIJUANA,9,259,0,268,1746
BAJA CALIFORNIA,TIJUANA,11,235,1,247,1755
BAJA CALIFORNIA,TIJUANA,11,200,1,212,1755
BAJA CALIFORNIA,TIJUANA,9,224,0,233,1755
BAJA CALIFORNIA,TIJUANA,6,158,3,167,1377
BAJA CALIFORNIA,TIJUANA,5,171,3,179,1377
BAJA CALIFORNIA,TIJUANA,3,157,1,161,1376
BAJA CALIFORNIA,TIJUANA,8,218,0,226,1495
BAJA CALIFORNIA,TIJUANA,4,235,0,239,1494
BAJA CALIFORNIA,TIJUANA,11,194,4,209,1494
BAJA CALIFORNIA,TIJUANA,21,335,3,359,1878
BAJA CALIFORNIA,TIJUANA,8,275,0,283,1877
BAJA CALIFORNIA,TIJUANA,2,231,0,233,1391
BAJA CALIFORNIA,TIJUANA,4,204,4,212,1391
BAJA CALIFORNIA,TIJUANA,1,214,0,215,1391
BAJA CALIFORNIA,TIJUANA,8,300,5,313,1844
BAJA CALIFORNIA,TIJUANA,8,308,3,319,1843
BAJA CALIFORNIA,TIJUANA,13,308,7,328,1843
BAJA CALIFORNIA,TIJUANA,13,256,1,270,1845
BAJA CALIFORNIA,TIJUANA,5,261,2,268,1845
BAJA CALIFORNIA,TIJUANA,20,197,3,220,1495
BAJA CALIFORNIA,TIJUANA,4,226,4,234,1495
BAJA CALIFORNIA,TIJUANA,5,257,1,263,1801
BAJA CALIFORNIA,TIJUANA,5,252,1,258,1801
BAJA CALIFORNIA,TIJUANA,18,193,0,211,1545
BAJA CALIFORNIA,TIJUANA,23,217,1,241,1545
BAJA CALIFORNIA,TIJUANA,8,215,0,223,1545
BAJA CALIFORNIA,TIJUANA,14,229,6,249,1764
BAJA CALIFORNIA,TIJUANA,18,248,1,267,1763
BAJA CALIFORNIA,TIJUANA,9,191,0,200,1434
BAJA CALIFORNIA,TIJUANA,9,174,0,183,1433
BAJA CALIFORNIA,TIJUANA,13,193,0,206,1433
BAJA CALIFORNIA,TIJUANA,11,228,0,239,1622
BAJA CALIFORNIA,TIJUANA,7,261,0,268,1622
BAJA CALIFORNIA,TIJUANA,7,243,2,252,1476
BAJA CALIFORNIA,TIJUANA,5,251,3,259,1476
BAJA CALIFORNIA,TIJUANA,2,203,0,205,1475
BAJA CALIFORNIA,TIJUANA,4,269,4,277,1718
BAJA CALIFORNIA,TIJUANA,12,290,2,304,1718
BAJA CALIFORNIA,TIJUANA,11,257,3,271,1986
BAJA CALIFORNIA,TIJUANA,1,119,4,124,1986
BAJA CALIFORNIA,TIJUANA,11,262,5,278,1932
BAJA CALIFORNIA,TIJUANA,11,309,1,321,1931
BAJA CALIFORNIA,TIJUANA,5,232,3,240,1940
BAJA CALIFORNIA,TIJUANA,7,251,4,262,1940
BAJA CALIFORNIA,TIJUANA,6,202,2,210,1427
BAJA CALIFORNIA,TIJUANA,12,190,2,204,1427
BAJA CALIFORNIA,TIJUANA,6,189,0,195,1426
BAJA CALIFORNIA,TIJUANA,6,275,2,283,1901
BAJA CALIFORNIA,TIJUANA,7,258,0,265,1900
BAJA CALIFORNIA,TIJUANA,8,213,1,222,1678
BAJA CALIFORNIA,TIJUANA,8,272,0,280,1677
BAJA CALIFORNIA,TIJUANA,11,250,1,262,1820
BAJA CALIFORNIA,TIJUANA,9,251,2,262,1819
BAJA CALIFORNIA,TIJUANA,7,199,0,206,1803
BAJA CALIFORNIA,TIJUANA,11,206,3,220,1802
BAJA CALIFORNIA,TIJUANA,9,226,2,237,1802
BAJA CALIFORNIA,TIJUANA,1,183,1,185,1541
BAJA CALIFORNIA,TIJUANA,3,189,0,192,1540
BAJA CALIFORNIA,TIJUANA,5,181,1,187,1540
BAJA CALIFORNIA,TIJUANA,4,181,0,185,1689
BAJA CALIFORNIA,TIJUANA,5,196,2,203,1688
BAJA CALIFORNIA,TIJUANA,8,200,4,212,1688
BAJA CALIFORNIA,TIJUANA,11,235,0,246,1686
BAJA CALIFORNIA,TIJUANA,5,239,2,246,1686
BAJA CALIFORNIA,TIJUANA,13,289,3,305,1719
BAJA CALIFORNIA,TIJUANA,9,272,1,282,1718
BAJA CALIFORNIA,TIJUANA,1,285,1,287,1973
BAJA CALIFORNIA,TIJUANA,14,234,3,251,1972
BAJA CALIFORNIA,TIJUANA,8,248,4,260,1961
BAJA CALIFORNIA,TIJUANA,10,274,5,289,1960
BAJA CALIFORNIA,TIJUANA,9,264,1,274,1933
BAJA CALIFORNIA,TIJUANA,7,272,3,282,1932
BAJA CALIFORNIA,TIJUANA,6,165,1,172,1357
BAJA CALIFORNIA,TIJUANA,5,194,4,203,1357
BAJA CALIFORNIA,TIJUANA,5,176,2,183,1356
BAJA CALIFORNIA,TIJUANA,6,220,2,228,1462
BAJA CALIFORNIA,TIJUANA,6,222,0,228,1462
BAJA CALIFORNIA,TIJUANA,7,328,4,339,1705
BAJA CALIFORNIA,TIJUANA,295,6,3,304,1705
BAJA CALIFORNIA,TIJUANA,6,259,1,266,1740
BAJA CALIFORNIA,TIJUANA,14,278,1,293,1739
BAJA CALIFORNIA,TIJUANA,28,282,1,311,1933
BAJA CALIFORNIA,TIJUANA,24,277,2,303,1932
BAJA CALIFORNIA,TIJUANA,4,216,1,221,1186
BAJA CALIFORNIA,TIJUANA,6,226,1,233,1186
BAJA CALIFORNIA,TIJUANA,16,266,0,282,1991
BAJA CALIFORNIA,TIJUANA,16,276,6,298,1991
BAJA CALIFORNIA,TIJUANA,26,339,3,368,1853
BAJA CALIFORNIA,TIJUANA,9,323,6,338,1852
BAJA CALIFORNIA,TIJUANA,4,225,4,233,1415
BAJA CALIFORNIA,TIJUANA,4,183,2,189,1414
BAJA CALIFORNIA,TIJUANA,11,230,3,244,1414
BAJA CALIFORNIA,TIJUANA,19,255,0,274,1939
BAJA CALIFORNIA,TIJUANA,12,218,5,235,1939
BAJA CALIFORNIA,TIJUANA,25,345,3,373,1967
BAJA CALIFORNIA,TIJUANA,5,319,4,328,1967
BAJA CALIFORNIA,TIJUANA,9,283,2,294,2021
BAJA CALIFORNIA,TIJUANA,11,296,2,309,2020
BAJA CALIFORNIA,TIJUANA,0,239,1,240,1953
BAJA CALIFORNIA,TIJUANA,17,219,3,239,1952
BAJA CALIFORNIA,TIJUANA,17,180,1,198,1839
BAJA CALIFORNIA,TIJUANA,12,208,18,238,1839
BAJA CALIFORNIA,TIJUANA,16,240,3,259,1440
BAJA CALIFORNIA,TIJUANA,19,213,2,234,1439
BAJA CALIFORNIA,TIJUANA,12,214,1,227,1783
BAJA CALIFORNIA,TIJUANA,14,178,1,193,1782
BAJA CALIFORNIA,TIJUANA,2,253,0,255,1397
BAJA CALIFORNIA,TIJUANA,5,230,0,235,1397
BAJA CALIFORNIA,TIJUANA,2,255,1,258,1397
BAJA CALIFORNIA,TIJUANA,9,208,0,217,1476
BAJA CALIFORNIA,TIJUANA,4,185,0,189,1476
BAJA CALIFORNIA,TIJUANA,13,237,2,252,1731
BAJA CALIFORNIA,TIJUANA,10,251,0,261,1730
BAJA CALIFORNIA,TIJUANA,10,250,4,264,1821
BAJA CALIFORNIA,TIJUANA,9,225,2,236,1820
BAJA CALIFORNIA,TIJUANA,17,333,0,350,1885
BAJA CALIFORNIA,TIJUANA,12,321,1,334,1884
BAJA CALIFORNIA,TIJUANA,6,186,0,192,1505
BAJA CALIFORNIA,TIJUANA,7,208,2,217,1505
BAJA CALIFORNIA,TIJUANA,2,186,1,189,1504
BAJA CALIFORNIA,TIJUANA,16,229,0,245,1307
BAJA CALIFORNIA,TIJUANA,12,258,2,272,1306
BAJA CALIFORNIA,TIJUANA,3,232,2,237,1578
BAJA CALIFORNIA,TIJUANA,6,235,1,242,1578
BAJA CALIFORNIA,TIJUANA,9,240,2,251,1623
BAJA CALIFORNIA,TIJUANA,11,248,8,267,1622
BAJA CALIFORNIA,TIJUANA,10,205,2,217,1463
BAJA CALIFORNIA,TIJUANA,7,202,0,209,1463
BAJA CALIFORNIA,TIJUANA,6,220,1,227,1463
BAJA CALIFORNIA,TIJUANA,13,175,2,190,1364
BAJA CALIFORNIA,TIJUANA,9,195,3,207,1363
BAJA CALIFORNIA,TIJUANA,10,189,1,200,1363
BAJA CALIFORNIA,TIJUANA,68,1842,22,1932,0
BAJA CALIFORNIA,TIJUANA,6,143,0,149,1478
BAJA CALIFORNIA,TIJUANA,7,159,1,167,1478
BAJA CALIFORNIA,TIJUANA,9,272,0,281,1693
BAJA CALIFORNIA,TIJUANA,8,271,1,280,1692
BAJA CALIFORNIA,TIJUANA,4,171,2,177,1438
BAJA CALIFORNIA,TIJUANA,5,153,0,158,1438
BAJA CALIFORNIA,TIJUANA,39,370,2,411,1437
BAJA CALIFORNIA,TIJUANA,9,215,0,224,1438
BAJA CALIFORNIA,TIJUANA,5,215,0,220,1438
BAJA CALIFORNIA,TIJUANA,9,196,3,208,1437
BAJA CALIFORNIA,TIJUANA,16,251,2,269,1666
BAJA CALIFORNIA,TIJUANA,6,252,0,258,1665
BAJA CALIFORNIA,TIJUANA,9,234,0,243,1716
BAJA CALIFORNIA,TIJUANA,3,249,1,253,1715
BAJA CALIFORNIA,TIJUANA,17,410,1,428,1893
BAJA CALIFORNIA,TIJUANA,18,389,1,408,1892
BAJA CALIFORNIA,TIJUANA,10,327,0,337,1724
BAJA CALIFORNIA,TIJUANA,15,301,1,317,1724
BAJA CALIFORNIA,TIJUANA,8,339,1,348,1846
BAJA CALIFORNIA,TIJUANA,15,304,2,321,1846
BAJA CALIFORNIA,TIJUANA,6,189,0,195,1364
BAJA CALIFORNIA,TIJUANA,7,220,2,229,1364
BAJA CALIFORNIA,TIJUANA,4,190,0,194,1363
BAJA CALIFORNIA,TIJUANA,0,271,10,281,1903
BAJA CALIFORNIA,TIJUANA,11,279,3,293,1902
BAJA CALIFORNIA,TIJUANA,11,282,0,293,1950
BAJA CALIFORNIA,TIJUANA,14,240,0,254,1950
BAJA CALIFORNIA,TIJUANA,11,272,1,284,1666
BAJA CALIFORNIA,TIJUANA,9,276,5,290,1666
BAJA CALIFORNIA,TIJUANA,5,255,2,262,1665
BAJA CALIFORNIA,TIJUANA,13,304,0,317,1779
BAJA CALIFORNIA,TIJUANA,7,300,1,308,1778
BAJA CALIFORNIA,TIJUANA,7,269,2,278,1725
BAJA CALIFORNIA,TIJUANA,11,294,0,305,1725
BAJA CALIFORNIA,TIJUANA,11,215,3,229,1442
BAJA CALIFORNIA,TIJUANA,12,233,0,245,1442
BAJA CALIFORNIA,TIJUANA,12,234,1,247,1441
BAJA CALIFORNIA,TIJUANA,22,267,2,291,1620
BAJA CALIFORNIA,TIJUANA,20,286,1,307,1620
BAJA CALIFORNIA,TIJUANA,18,266,0,284,1619
BAJA CALIFORNIA,TIJUANA,9,235,0,244,1612
BAJA CALIFORNIA,TIJUANA,9,212,0,221,1611
BAJA CALIFORNIA,TIJUANA,7,256,1,264,1659
BAJA CALIFORNIA,TIJUANA,9,250,3,262,1659
BAJA CALIFORNIA,TIJUANA,4,195,0,199,2085
BAJA CALIFORNIA,TIJUANA,4,239,0,243,2085
BAJA CALIFORNIA,TIJUANA,3,251,1,255,2085
BAJA CALIFORNIA,TIJUANA,3,198,0,201,2085
BAJA CALIFORNIA,TIJUANA,6,186,0,192,2085
BAJA CALIFORNIA,TIJUANA,4,225,1,230,2085
BAJA CALIFORNIA,TIJUANA,5,171,0,176,2085
BAJA CALIFORNIA,TIJUANA,2,184,0,186,2085
BAJA CALIFORNIA,TIJUANA,5,185,1,191,2085
BAJA CALIFORNIA,TIJUANA,8,178,1,187,2085
BAJA CALIFORNIA,TIJUANA,1,207,0,208,2085
BAJA CALIFORNIA,TIJUANA,5,189,1,195,2084
BAJA CALIFORNIA,TIJUANA,11,151,0,162,1605
BAJA CALIFORNIA,TIJUANA,9,209,1,219,1605
BAJA CALIFORNIA,TIJUANA,10,163,0,173,1604
BAJA CALIFORNIA,TIJUANA,16,228,1,245,1760
BAJA CALIFORNIA,TIJUANA,16,236,1,253,1759
BAJA CALIFORNIA,TIJUANA,12,193,2,207,1309
BAJA CALIFORNIA,TIJUANA,4,180,0,184,1309
BAJA CALIFORNIA,TIJUANA,7,200,1,208,1322
BAJA CALIFORNIA,TIJUANA,7,154,1,162,1322
BAJA CALIFORNIA,TIJUANA,4,239,3,246,1903
BAJA CALIFORNIA,TIJUANA,14,242,5,261,1902
BAJA CALIFORNIA,TIJUANA,2,165,2,169,1729
BAJA CALIFORNIA,TIJUANA,4,158,1,163,1729
BAJA CALIFORNIA,TIJUANA,6,167,3,176,1406
BAJA CALIFORNIA,TIJUANA,0,173,0,173,1406
BAJA CALIFORNIA,TIJUANA,0,153,2,155,1405
BAJA CALIFORNIA,TIJUANA,2,139,2,143,1213
BAJA CALIFORNIA,TIJUANA,6,138,1,145,1213
BAJA CALIFORNIA,TIJUANA,6,219,1,226,2056
BAJA CALIFORNIA,TIJUANA,0,221,5,226,2056
BAJA CALIFORNIA,TIJUANA,3,216,1,220,1270
BAJA CALIFORNIA,TIJUANA,8,223,3,234,1270
BAJA CALIFORNIA,TIJUANA,3,194,1,198,1572
BAJA CALIFORNIA,TIJUANA,4,184,2,190,1572
BAJA CALIFORNIA,TIJUANA,10,269,3,282,1732
BAJA CALIFORNIA,TIJUANA,5,277,0,282,1731
BAJA CALIFORNIA,TIJUANA,14,332,3,349,1876
BAJA CALIFORNIA,TIJUANA,14,364,9,387,1875
BAJA CALIFORNIA,TIJUANA,2,143,1,146,1530
BAJA CALIFORNIA,TIJUANA,5,176,0,181,1530
BAJA CALIFORNIA,TIJUANA,4,160,2,166,1530
BAJA CALIFORNIA,TIJUANA,4,213,4,221,1973
BAJA CALIFORNIA,TIJUANA,7,195,1,203,1973
BAJA CALIFORNIA,TIJUANA,11,260,3,274,2023
BAJA CALIFORNIA,TIJUANA,9,221,2,232,2022
BAJA CALIFORNIA,TIJUANA,9,249,1,259,1841
BAJA CALIFORNIA,TIJUANA,11,232,2,245,1840
BAJA CALIFORNIA,TIJUANA,8,123,0,131,1667
BAJA CALIFORNIA,TIJUANA,13,114,2,129,1667
BAJA CALIFORNIA,TIJUANA,13,114,2,129,1666
BAJA CALIFORNIA,TIJUANA,17,139,1,157,1355
BAJA CALIFORNIA,TIJUANA,13,111,1,125,1355
BAJA CALIFORNIA,TIJUANA,17,116,2,135,1355
BAJA CALIFORNIA,TIJUANA,14,60,1,75,1461
BAJA CALIFORNIA,TIJUANA,10,62,0,72,1460
BAJA CALIFORNIA,TIJUANA,13,67,0,80,1460
BAJA CALIFORNIA,TIJUANA,19,107,0,126,1643
BAJA CALIFORNIA,TIJUANA,27,112,0,139,1643
BAJA CALIFORNIA,TIJUANA,14,120,0,134,1405
BAJA CALIFORNIA,TIJUANA,14,109,2,125,1405
BAJA CALIFORNIA,TIJUANA,17,116,1,134,1404
BAJA CALIFORNIA,TIJUANA,20,48,0,68,1410
BAJA CALIFORNIA,TIJUANA,32,53,0,85,1409
BAJA CALIFORNIA,TIJUANA,27,65,2,94,1409
BAJA CALIFORNIA,TIJUANA,24,104,2,130,1829
BAJA CALIFORNIA,TIJUANA,24,102,1,127,1829
BAJA CALIFORNIA,TIJUANA,30,115,1,146,1806
BAJA CALIFORNIA,TIJUANA,27,109,0,136,1805
BAJA CALIFORNIA,TIJUANA,20,163,1,184,1757
BAJA CALIFORNIA,TIJUANA,23,175,1,199,1757
BAJA CALIFORNIA,TIJUANA,22,167,2,191,1756
BAJA CALIFORNIA,TIJUANA,14,180,1,195,1919
BAJA CALIFORNIA,TIJUANA,163,19,1,183,1918
BAJA CALIFORNIA,TIJUANA,14,134,1,149,1492
BAJA CALIFORNIA,TIJUANA,25,123,1,149,1491
BAJA CALIFORNIA,TIJUANA,17,92,0,109,1486
BAJA CALIFORNIA,TIJUANA,28,139,1,168,1485
BAJA CALIFORNIA,TIJUANA,18,113,0,131,1485
BAJA CALIFORNIA,TIJUANA,15,134,0,149,1742
BAJA CALIFORNIA,TIJUANA,25,152,3,180,1741
BAJA CALIFORNIA,TIJUANA,24,161,3,188,1741
BAJA CALIFORNIA,TIJUANA,28,89,0,117,1645
BAJA CALIFORNIA,TIJUANA,23,98,1,122,1645
BAJA CALIFORNIA,TIJUANA,23,121,1,145,1422
BAJA CALIFORNIA,TIJUANA,32,85,0,117,1421
BAJA CALIFORNIA,TIJUANA,31,94,1,126,1421
BAJA CALIFORNIA,TIJUANA,15,157,1,173,1655
BAJA CALIFORNIA,TIJUANA,18,177,0,195,1655
BAJA CALIFORNIA,TIJUANA,25,147,0,172,1654
BAJA CALIFORNIA,TIJUANA,5,109,0,114,1373
BAJA CALIFORNIA,TIJUANA,12,123,0,135,1372
BAJA CALIFORNIA,TIJUANA,29,191,1,221,1599
BAJA CALIFORNIA,TIJUANA,22,170,0,192,1598
BAJA CALIFORNIA,TIJUANA,26,167,2,195,1598
BAJA CALIFORNIA,TIJUANA,109,985,6,1100,0
BAJA CALIFORNIA,TIJUANA,21,225,3,249,1895
BAJA CALIFORNIA,TIJUANA,23,197,3,223,1895
BAJA CALIFORNIA,TIJUANA,14,243,1,258,1926
BAJA CALIFORNIA,TIJUANA,16,268,2,286,1926
BAJA CALIFORNIA,TIJUANA,3,165,2,170,1089
BAJA CALIFORNIA,TIJUANA,8,171,0,179,1088
BAJA CALIFORNIA,TIJUANA,11,223,4,238,1764
BAJA CALIFORNIA,TIJUANA,6,215,4,225,1763
BAJA CALIFORNIA,TIJUANA,10,230,3,243,1763
BAJA CALIFORNIA,TIJUANA,8,232,2,242,1763
BAJA CALIFORNIA,TIJUANA,8,237,3,248,1763
BAJA CALIFORNIA,TIJUANA,15,220,1,236,1865
BAJA CALIFORNIA,TIJUANA,16,254,0,270,1864
BAJA CALIFORNIA,TIJUANA,26,222,2,250,1690
BAJA CALIFORNIA,TIJUANA,4,242,5,251,1689
BAJA CALIFORNIA,TIJUANA,18,192,0,210,1748
BAJA CALIFORNIA,TIJUANA,16,177,6,199,1748
BAJA CALIFORNIA,TIJUANA,8,176,3,187,1748
BAJA CALIFORNIA,TIJUANA,23,199,0,222,1650
BAJA CALIFORNIA,TIJUANA,16,164,1,181,1649
BAJA CALIFORNIA,TIJUANA,13,179,1,193,1743
BAJA CALIFORNIA,TIJUANA,10,166,3,179,1742
BAJA CALIFORNIA,TIJUANA,11,154,1,166,1742
BAJA CALIFORNIA,TIJUANA,16,159,0,175,1881
BAJA CALIFORNIA,TIJUANA,19,169,1,189,1880
BAJA CALIFORNIA,TIJUANA,13,181,3,197,1880
BAJA CALIFORNIA,TIJUANA,10,156,3,169,1684
BAJA CALIFORNIA,TIJUANA,10,164,2,176,1684
BAJA CALIFORNIA,TIJUANA,20,163,0,183,1683
BAJA CALIFORNIA,TIJUANA,3,154,3,160,1448
BAJA CALIFORNIA,TIJUANA,6,192,2,200,1447
BAJA CALIFORNIA,TIJUANA,8,184,2,194,1447
BAJA CALIFORNIA,TIJUANA,8,216,2,226,1818
BAJA CALIFORNIA,TIJUANA,7,214,3,224,1817
BAJA CALIFORNIA,TIJUANA,31,195,1,227,1443
BAJA CALIFORNIA,TIJUANA,23,201,2,226,1442
BAJA CALIFORNIA,TIJUANA,21,244,2,267,1843
BAJA CALIFORNIA,TIJUANA,8,257,2,267,1843
BAJA CALIFORNIA,TIJUANA,7,229,1,237,1873
BAJA CALIFORNIA,TIJUANA,20,231,3,254,1873
BAJA CALIFORNIA,TIJUANA,10,124,3,137,1443
BAJA CALIFORNIA,TIJUANA,9,131,2,142,1443
BAJA CALIFORNIA,TIJUANA,14,122,0,136,1443
BAJA CALIFORNIA,TIJUANA,12,164,0,176,1545
BAJA CALIFORNIA,TIJUANA,7,149,2,158,1545
BAJA CALIFORNIA,TIJUANA,10,165,1,176,1544
BAJA CALIFORNIA,TIJUANA,31,213,5,249,1581
BAJA CALIFORNIA,TIJUANA,27,236,0,263,1580
BAJA CALIFORNIA,TIJUANA,26,176,0,202,1626
BAJA CALIFORNIA,TIJUANA,30,200,1,231,1625
BAJA CALIFORNIA,TIJUANA,15,192,0,207,1208
BAJA CALIFORNIA,TIJUANA,12,209,0,221,1208
BAJA CALIFORNIA,TIJUANA,17,152,2,171,1337
BAJA CALIFORNIA,TIJUANA,16,136,2,154,1336
BAJA CALIFORNIA,TIJUANA,15,146,1,162,1336
BAJA CALIFORNIA,TIJUANA,6,145,0,151,1184
BAJA CALIFORNIA,TIJUANA,3,142,2,147,1183
BAJA CALIFORNIA,TIJUANA,20,219,3,242,1548
BAJA CALIFORNIA,TIJUANA,15,208,2,225,1547
BAJA CALIFORNIA,TIJUANA,9,188,1,198,1678
BAJA CALIFORNIA,TIJUANA,11,221,1,233,1678
BAJA CALIFORNIA,TIJUANA,13,205,3,221,1678
BAJA CALIFORNIA,TIJUANA,11,180,1,192,1579
BAJA CALIFORNIA,TIJUANA,8,208,2,218,1579
BAJA CALIFORNIA,TIJUANA,16,210,3,229,1579
BAJA CALIFORNIA,TIJUANA,13,179,1,193,1969
BAJA CALIFORNIA,TIJUANA,22,129,1,152,1639
BAJA CALIFORNIA,TIJUANA,18,101,6,125,1639
BAJA CALIFORNIA,TIJUANA,19,174,1,194,1758
BAJA CALIFORNIA,TIJUANA,13,205,0,218,1757
BAJA CALIFORNIA,TIJUANA,5,183,2,190,1931
BAJA CALIFORNIA,TIJUANA,9,196,3,208,1930
BAJA CALIFORNIA,TIJUANA,27,227,1,255,1964
BAJA CALIFORNIA,TIJUANA,22,226,4,252,1964
BAJA CALIFORNIA,TIJUANA,9,144,3,156,1060
BAJA CALIFORNIA,TIJUANA,10,121,1,132,1060
BAJA CALIFORNIA,TIJUANA,9,223,2,234,1610
BAJA CALIFORNIA,TIJUANA,11,232,2,245,1609
BAJA CALIFORNIA,TIJUANA,17,205,0,222,1609
BAJA CALIFORNIA,TIJUANA,16,234,1,251,1698
BAJA CALIFORNIA,TIJUANA,22,242,1,265,1698
BAJA CALIFORNIA,TIJUANA,13,233,2,248,1698
BAJA CALIFORNIA,TIJUANA,19,229,2,250,1698
BAJA CALIFORNIA,TIJUANA,14,246,0,260,1672
BAJA CALIFORNIA,TIJUANA,13,224,1,238,1671
BAJA CALIFORNIA,TIJUANA,12,127,1,140,1152
BAJA CALIFORNIA,TIJUANA,6,175,2,183,1152
BAJA CALIFORNIA,TIJUANA,9,121,1,131,1775
BAJA CALIFORNIA,TIJUANA,17,228,2,247,1775
BAJA CALIFORNIA,TIJUANA,14,245,3,262,1775
BAJA CALIFORNIA,TIJUANA,14,198,3,215,1775
BAJA CALIFORNIA,TIJUANA,13,210,2,225,1775
BAJA CALIFORNIA,TIJUANA,14,243,2,259,1874
BAJA CALIFORNIA,TIJUANA,13,238,5,256,1873
BAJA CALIFORNIA,TIJUANA,10,235,2,247,1791
BAJA CALIFORNIA,TIJUANA,16,249,1,266,1791
BAJA CALIFORNIA,TIJUANA,14,265,2,281,1791
BAJA CALIFORNIA,TIJUANA,12,193,2,207,1532
BAJA CALIFORNIA,TIJUANA,10,159,0,169,1531
BAJA CALIFORNIA,TIJUANA,21,165,3,189,1531
BAJA CALIFORNIA,TIJUANA,25,179,3,207,1559
BAJA CALIFORNIA,TIJUANA,32,181,1,214,1558
BAJA CALIFORNIA,TIJUANA,19,165,1,185,1558
BAJA CALIFORNIA,TIJUANA,14,159,0,173,1585
BAJA CALIFORNIA,TIJUANA,12,202,5,219,1584
BAJA CALIFORNIA,TIJUANA,7,166,1,174,1492
BAJA CALIFORNIA,TIJUANA,3,192,1,196,1491
BAJA CALIFORNIA,TIJUANA,19,223,0,242,1645
BAJA CALIFORNIA,TIJUANA,25,222,2,249,1645
BAJA CALIFORNIA,TIJUANA,17,187,1,205,1645
BAJA CALIFORNIA,TIJUANA,19,290,0,309,1890
BAJA CALIFORNIA,TIJUANA,16,259,1,276,1890
BAJA CALIFORNIA,TIJUANA,23,193,2,218,1387
BAJA CALIFORNIA,TIJUANA,22,196,1,219,1387
BAJA CALIFORNIA,TIJUANA,10,301,3,314,1831
BAJA CALIFORNIA,TIJUANA,22,301,5,328,1831
BAJA CALIFORNIA,TIJUANA,26,296,0,322,1830
BAJA CALIFORNIA,TIJUANA,6,201,1,208,1303
BAJA CALIFORNIA,TIJUANA,14,182,0,196,1302
BAJA CALIFORNIA,TIJUANA,14,201,0,215,1456
BAJA CALIFORNIA,TIJUANA,14,223,1,238,1455
BAJA CALIFORNIA,TIJUANA,18,236,5,259,1742
BAJA CALIFORNIA,TIJUANA,11,230,2,243,1742
BAJA CALIFORNIA,TIJUANA,11,232,1,244,1741
BAJA CALIFORNIA,TIJUANA,9,220,0,229,1741
BAJA CALIFORNIA,TIJUANA,9,214,3,226,1741
BAJA CALIFORNIA,TIJUANA,9,170,0,179,1328
BAJA CALIFORNIA,TIJUANA,19,152,1,172,1328
BAJA CALIFORNIA,TIJUANA,18,160,2,180,1328
BAJA CALIFORNIA,TIJUANA,9,165,1,175,1168
BAJA CALIFORNIA,TIJUANA,8,186,1,195,1168
BAJA CALIFORNIA,TIJUANA,29,261,3,293,1984
BAJA CALIFORNIA,TIJUANA,23,256,3,282,1984
BAJA CALIFORNIA,TIJUANA,9,234,0,243,1656
BAJA CALIFORNIA,TIJUANA,10,242,3,255,1656
BAJA CALIFORNIA,TIJUANA,1,223,0,224,1722
BAJA CALIFORNIA,TIJUANA,8,207,1,216,1722
BAJA CALIFORNIA,TIJUANA,5,135,0,140,1046
BAJA CALIFORNIA,TIJUANA,7,129,1,137,1046
BAJA CALIFORNIA,TIJUANA,12,213,0,225,1610
BAJA CALIFORNIA,TIJUANA,15,218,5,238,1610
BAJA CALIFORNIA,TIJUANA,15,111,1,127,1571
BAJA CALIFORNIA,TIJUANA,14,131,1,146,1571
BAJA CALIFORNIA,TIJUANA,13,223,2,238,1280
BAJA CALIFORNIA,TIJUANA,6,171,0,177,1279
BAJA CALIFORNIA,TIJUANA,3,169,2,174,1001
BAJA CALIFORNIA,TIJUANA,6,156,5,167,1000
BAJA CALIFORNIA,TIJUANA,14,250,6,270,1965
BAJA CALIFORNIA,TIJUANA,13,291,2,306,1964
BAJA CALIFORNIA,TIJUANA,27,173,1,201,1677
BAJA CALIFORNIA,TIJUANA,43,178,1,222,1677
BAJA CALIFORNIA,TIJUANA,29,165,0,194,1676
BAJA CALIFORNIA,TIJUANA,10,228,3,241,1652
BAJA CALIFORNIA,TIJUANA,15,211,1,227,1652
BAJA CALIFORNIA,TIJUANA,7,134,0,141,1014
BAJA CALIFORNIA,TIJUANA,12,138,0,150,1013
BAJA CALIFORNIA,TIJUANA,17,167,2,186,1697
BAJA CALIFORNIA,TIJUANA,14,152,0,166,1697
BAJA CALIFORNIA,TIJUANA,11,156,2,169,1038
BAJA CALIFORNIA,TIJUANA,5,132,0,137,1038
BAJA CALIFORNIA,TIJUANA,21,206,2,229,1763
BAJA CALIFORNIA,TIJUANA,9,266,2,277,1453
BAJA CALIFORNIA,TIJUANA,11,214,2,227,1452
BAJA CALIFORNIA,TIJUANA,10,249,0,259,1452
BAJA CALIFORNIA,TIJUANA,8,159,4,171,1157
BAJA CALIFORNIA,TIJUANA,13,154,4,171,1157
BAJA CALIFORNIA,TIJUANA,25,233,1,259,1893
BAJA CALIFORNIA,TIJUANA,19,210,1,230,1892
BAJA CALIFORNIA,TIJUANA,22,294,3,319,1885
BAJA CALIFORNIA,TIJUANA,14,266,2,282,1885
BAJA CALIFORNIA,TIJUANA,18,258,0,276,1884
BAJA CALIFORNIA,TIJUANA,17,268,3,288,1724
BAJA CALIFORNIA,TIJUANA,14,240,1,255,1724
BAJA CALIFORNIA,TIJUANA,20,236,1,257,1723
BAJA CALIFORNIA,TIJUANA,17,318,3,338,1713
BAJA CALIFORNIA,TIJUANA,1,298,0,299,1713
BAJA CALIFORNIA,TIJUANA,8,224,0,232,1733
BAJA CALIFORNIA,TIJUANA,11,255,7,273,1733
BAJA CALIFORNIA,TIJUANA,6,162,0,168,1324
BAJA CALIFORNIA,TIJUANA,11,134,1,146,1324
BAJA CALIFORNIA,TIJUANA,11,187,2,200,1845
BAJA CALIFORNIA,TIJUANA,9,163,0,172,1845
BAJA CALIFORNIA,TIJUANA,23,166,1,190,1675
BAJA CALIFORNIA,TIJUANA,31,182,2,215,1674
BAJA CALIFORNIA,TIJUANA,15,215,1,231,1826
BAJA CALIFORNIA,TIJUANA,13,165,4,182,1826
BAJA CALIFORNIA,TIJUANA,23,147,2,172,1314
BAJA CALIFORNIA,TIJUANA,28,166,1,195,1313
BAJA CALIFORNIA,TIJUANA,18,170,0,188,1806
BAJA CALIFORNIA,TIJUANA,9,170,1,180,1806
BAJA CALIFORNIA,TIJUANA,17,207,0,224,1805
BAJA CALIFORNIA,TIJUANA,9,103,2,114,1315
BAJA CALIFORNIA,TIJUANA,13,114,0,127,1315
BAJA CALIFORNIA,TIJUANA,9,120,2,131,1409
BAJA CALIFORNIA,TIJUANA,11,149,6,166,1408
BAJA CALIFORNIA,TIJUANA,9,133,0,142,1408
BAJA CALIFORNIA,TIJUANA,7,125,1,133,1591
BAJA CALIFORNIA,TIJUANA,21,164,1,186,1590
BAJA CALIFORNIA,TIJUANA,12,152,2,166,1590
BAJA CALIFORNIA,TIJUANA,12,181,2,195,1756
BAJA CALIFORNIA,TIJUANA,12,172,1,185,1756
BAJA CALIFORNIA,TIJUANA,15,216,3,234,1740
BAJA CALIFORNIA,TIJUANA,9,202,4,215,1739
BAJA CALIFORNIA,TIJUANA,19,258,3,280,1939
BAJA CALIFORNIA,TIJUANA,9,256,1,266,1938
BAJA CALIFORNIA,TIJUANA,14,210,2,226,1348
BAJA CALIFORNIA,TIJUANA,22,198,2,222,1347
BAJA CALIFORNIA,TIJUANA,9,142,2,153,1796
BAJA CALIFORNIA,TIJUANA,15,150,3,168,1795
BAJA CALIFORNIA,TIJUANA,17,144,2,163,1795
BAJA CALIFORNIA,TIJUANA,13,157,2,172,1758
BAJA CALIFORNIA,TIJUANA,17,161,5,183,1758
BAJA CALIFORNIA,TIJUANA,25,227,7,259,1974
BAJA CALIFORNIA,TIJUANA,15,231,0,246,1974
BAJA CALIFORNIA,TIJUANA,16,195,0,211,1683
BAJA CALIFORNIA,TIJUANA,15,213,2,230,1682
BAJA CALIFORNIA,TIJUANA,12,175,0,187,1094
BAJA CALIFORNIA,TIJUANA,14,141,2,157,1094
BAJA CALIFORNIA,TIJUANA,6,136,4,146,1587
BAJA CALIFORNIA,TIJUANA,6,148,156,310,1586
BAJA CALIFORNIA,TIJUANA,12,178,2,192,1604
BAJA CALIFORNIA,TIJUANA,24,174,5,203,1604
BAJA CALIFORNIA,TIJUANA,0,221,2,223,1603
BAJA CALIFORNIA,TIJUANA,14,122,0,136,1421
BAJA CALIFORNIA,TIJUANA,13,137,1,151,1421
BAJA CALIFORNIA,TIJUANA,8,107,3,118,1421
BAJA CALIFORNIA,TIJUANA,16,196,4,216,1895
BAJA CALIFORNIA,TIJUANA,21,193,1,215,1894
BAJA CALIFORNIA,TIJUANA,21,188,5,214,1740
BAJA CALIFORNIA,TIJUANA,19,134,1,154,1740
BAJA CALIFORNIA,TIJUANA,20,188,2,210,1721
BAJA CALIFORNIA,TIJUANA,10,150,0,160,1721
BAJA CALIFORNIA,TIJUANA,28,233,2,263,1832
BAJA CALIFORNIA,TIJUANA,21,207,1,229,1832
BAJA CALIFORNIA,TIJUANA,10,161,1,172,1055
BAJA CALIFORNIA,TIJUANA,3,161,1,165,1055
BAJA CALIFORNIA,TIJUANA,21,179,2,202,1520
BAJA CALIFORNIA,TIJUANA,19,164,4,187,1520
BAJA CALIFORNIA,TIJUANA,13,191,4,208,1710
BAJA CALIFORNIA,TIJUANA,15,167,0,182,1710
BAJA CALIFORNIA,TIJUANA,12,182,1,195,1710
BAJA CALIFORNIA,TIJUANA,18,228,3,249,1939
BAJA CALIFORNIA,TIJUANA,12,224,1,237,1938
BAJA CALIFORNIA,TIJUANA,9,230,7,246,1853
BAJA CALIFORNIA,TIJUANA,11,241,2,254,1853
BAJA CALIFORNIA,TIJUANA,11,164,3,178,1527
BAJA CALIFORNIA,TIJUANA,11,208,2,221,1527
BAJA CALIFORNIA,TIJUANA,10,152,2,164,1526
BAJA CALIFORNIA,TIJUANA,6,264,4,274,1955
BAJA CALIFORNIA,TIJUANA,12,304,0,316,1955
BAJA CALIFORNIA,TIJUANA,13,201,2,216,1934
BAJA CALIFORNIA,TIJUANA,13,195,1,209,1933
BAJA CALIFORNIA,TIJUANA,11,182,1,194,1507
BAJA CALIFORNIA,TIJUANA,4,201,0,205,1506
BAJA CALIFORNIA,TIJUANA,3,220,4,227,1764
BAJA CALIFORNIA,TIJUANA,3,204,2,209,1764
BAJA CALIFORNIA,TIJUANA,8,197,4,209,1764
BAJA CALIFORNIA,TIJUANA,5,146,3,154,1403
BAJA CALIFORNIA,TIJUANA,2,144,1,147,1402
BAJA CALIFORNIA,TIJUANA,11,222,0,233,1699
BAJA CALIFORNIA,TIJUANA,14,235,2,251,1698
BAJA CALIFORNIA,TIJUANA,16,311,2,329,1877
BAJA CALIFORNIA,TIJUANA,10,314,3,327,1876
BAJA CALIFORNIA,TIJUANA,12,155,4,171,1683
BAJA CALIFORNIA,TIJUANA,10,169,1,180,1683
BAJA CALIFORNIA,TIJUANA,12,178,0,190,1682
BAJA CALIFORNIA,TIJUANA,18,167,3,188,1682
BAJA CALIFORNIA,TIJUANA,8,231,0,239,1682
BAJA CALIFORNIA,TIJUANA,12,190,2,204,1657
BAJA CALIFORNIA,TIJUANA,21,202,4,227,1656
BAJA CALIFORNIA,TIJUANA,15,188,3,206,1656
BAJA CALIFORNIA,TIJUANA,11,209,0,220,1656
BAJA CALIFORNIA,TIJUANA,16,220,1,237,1754
BAJA CALIFORNIA,TIJUANA,13,175,0,188,1754
BAJA CALIFORNIA,TIJUANA,10,175,3,188,1753
BAJA CALIFORNIA,TIJUANA,6,138,3,147,1816
BAJA CALIFORNIA,TIJUANA,8,137,3,148,1816
BAJA CALIFORNIA,TIJUANA,9,115,1,125,1356
BAJA CALIFORNIA,TIJUANA,14,105,0,119,1355
BAJA CALIFORNIA,TIJUANA,30,83,0,113,1724
BAJA CALIFORNIA,TIJUANA,22,115,0,137,1724
BAJA CALIFORNIA,TIJUANA,23,96,0,119,1724
BAJA CALIFORNIA,TIJUANA,12,100,1,113,1304
BAJA CALIFORNIA,TIJUANA,10,97,2,109,1304
BAJA CALIFORNIA,TIJUANA,10,113,1,124,1304
BAJA CALIFORNIA,TIJUANA,153,1830,17,2000,0
BAJA CALIFORNIA,TIJUANA,11,139,1,151,1908
BAJA CALIFORNIA,TIJUANA,18,162,2,182,1907
BAJA CALIFORNIA,TIJUANA,14,191,2,207,1745
BAJA CALIFORNIA,TIJUANA,13,182,1,196,1745
BAJA CALIFORNIA,TIJUANA,7,132,0,139,1400
BAJA CALIFORNIA,TIJUANA,6,129,2,137,1399
BAJA CALIFORNIA,TIJUANA,4,140,0,144,1318
BAJA CALIFORNIA,TIJUANA,5,140,2,147,1317
BAJA CALIFORNIA,TIJUANA,15,161,1,177,1822
BAJA CALIFORNIA,TIJUANA,23,207,1,231,1822
BAJA CALIFORNIA,TIJUANA,13,141,0,154,1380
BAJA CALIFORNIA,TIJUANA,13,115,3,131,1379
BAJA CALIFORNIA,TIJUANA,19,185,3,207,1858
BAJA CALIFORNIA,TIJUANA,13,204,0,217,1857
BAJA CALIFORNIA,TIJUANA,13,163,1,177,1315
BAJA CALIFORNIA,TIJUANA,18,150,2,170,1315
BAJA CALIFORNIA,TIJUANA,25,141,1,167,1315
BAJA CALIFORNIA,TIJUANA,21,143,0,164,1918
BAJA CALIFORNIA,TIJUANA,20,152,1,173,1917
BAJA CALIFORNIA,TIJUANA,14,227,4,245,1876
BAJA CALIFORNIA,TIJUANA,15,205,2,222,1876
BAJA CALIFORNIA,TIJUANA,17,187,3,207,1697
BAJA CALIFORNIA,TIJUANA,6,208,2,216,1697
BAJA CALIFORNIA,TIJUANA,9,181,1,191,1491
BAJA CALIFORNIA,TIJUANA,13,159,0,172,1491
BAJA CALIFORNIA,TIJUANA,7,158,1,166,1490
BAJA CALIFORNIA,TIJUANA,5,153,2,160,1524
BAJA CALIFORNIA,TIJUANA,16,167,2,185,1523
BAJA CALIFORNIA,TIJUANA,4,170,0,174,1523
BAJA CALIFORNIA,TIJUANA,7,171,0,178,1523
BAJA CALIFORNIA,TIJUANA,15,186,3,204,1522
BAJA CALIFORNIA,TIJUANA,7,186,0,193,1811
BAJA CALIFORNIA,TIJUANA,11,191,2,204,1811
BAJA CALIFORNIA,TIJUANA,13,189,3,205,1383
BAJA CALIFORNIA,TIJUANA,14,214,2,230,1382
BAJA CALIFORNIA,TIJUANA,13,186,1,200,1623
BAJA CALIFORNIA,TIJUANA,12,189,3,204,1622
BAJA CALIFORNIA,TIJUANA,23,164,2,189,1627
BAJA CALIFORNIA,TIJUANA,10,181,2,193,1626
BAJA CALIFORNIA,TIJUANA,16,199,3,218,1626
BAJA CALIFORNIA,TIJUANA,13,149,0,162,1361
BAJA CALIFORNIA,TIJUANA,13,161,0,174,1361
BAJA CALIFORNIA,TIJUANA,7,188,0,195,1549
BAJA CALIFORNIA,TIJUANA,7,187,2,196,1549
BAJA CALIFORNIA,TIJUANA,13,188,6,207,1549
BAJA CALIFORNIA,TIJUANA,2,183,0,185,1548
BAJA CALIFORNIA,TIJUANA,15,111,1,127,1406
BAJA CALIFORNIA,TIJUANA,18,128,0,146,1406
BAJA CALIFORNIA,TIJUANA,22,123,1,146,1318
BAJA CALIFORNIA,TIJUANA,20,111,0,131,1318
BAJA CALIFORNIA,TIJUANA,19,127,0,146,1317
BAJA CALIFORNIA,TIJUANA,26,118,2,146,1540
BAJA CALIFORNIA,TIJUANA,26,132,2,160,1540
BAJA CALIFORNIA,TIJUANA,35,173,1,209,1892
BAJA CALIFORNIA,TIJUANA,29,177,0,206,1892
BAJA CALIFORNIA,TIJUANA,23,169,3,195,1725
BAJA CALIFORNIA,TIJUANA,27,168,0,195,1725
BAJA CALIFORNIA,TIJUANA,22,202,1,225,1691
BAJA CALIFORNIA,TIJUANA,44,180,0,224,1691
BAJA CALIFORNIA,TIJUANA,8,193,1,202,1624
BAJA CALIFORNIA,TIJUANA,7,208,2,217,1623
BAJA CALIFORNIA,TIJUANA,34,233,2,269,1814
BAJA CALIFORNIA,TIJUANA,41,228,2,271,1813
BAJA CALIFORNIA,TIJUANA,24,126,0,150,1496
BAJA CALIFORNIA,TIJUANA,11,129,1,141,1496
BAJA CALIFORNIA,TIJUANA,21,137,0,158,1495
BAJA CALIFORNIA,TIJUANA,16,265,1,282,1892
BAJA CALIFORNIA,TIJUANA,17,269,2,288,1891
BAJA CALIFORNIA,TIJUANA,7,178,1,186,1168
BAJA CALIFORNIA,TIJUANA,5,170,1,176,1167
BAJA CALIFORNIA,TIJUANA,11,138,1,150,1699
BAJA CALIFORNIA,TIJUANA,10,150,1,161,1699
BAJA CALIFORNIA,TIJUANA,12,150,2,164,1698
BAJA CALIFORNIA,TIJUANA,24,132,2,158,1950
BAJA CALIFORNIA,TIJUANA,27,110,1,138,1949
BAJA CALIFORNIA,TIJUANA,14,199,2,215,1993
BAJA CALIFORNIA,TIJUANA,18,209,2,229,1993
BAJA CALIFORNIA,TIJUANA,15,212,1,228,1993
BAJA CALIFORNIA,TIJUANA,19,226,1,246,1993
BAJA CALIFORNIA,TIJUANA,15,209,0,224,1993
BAJA CALIFORNIA,TIJUANA,13,208,0,221,1992
BAJA CALIFORNIA,TIJUANA,16,231,1,248,1992
BAJA CALIFORNIA,TIJUANA,40,260,1,301,2060
BAJA CALIFORNIA,TIJUANA,43,236,0,279,2060
BAJA CALIFORNIA,TIJUANA,30,239,0,269,2060
BAJA CALIFORNIA,TIJUANA,13,179,0,192,1247
BAJA CALIFORNIA,TIJUANA,9,231,1,241,1247
BAJA CALIFORNIA,TIJUANA,13,153,1,167,1359
BAJA CALIFORNIA,TIJUANA,9,145,1,155,1358
BAJA CALIFORNIA,TIJUANA,19,187,0,206,1358
BAJA CALIFORNIA,TIJUANA,7,187,0,194,1363
BAJA CALIFORNIA,TIJUANA,15,165,1,181,1362
BAJA CALIFORNIA,TIJUANA,15,161,2,178,1362
BAJA CALIFORNIA,TIJUANA,20,192,0,212,1707
BAJA CALIFORNIA,TIJUANA,20,184,0,204,1706
BAJA CALIFORNIA,TIJUANA,16,210,2,228,1706
BAJA CALIFORNIA,TIJUANA,24,191,1,216,1488
BAJA CALIFORNIA,TIJUANA,12,180,1,193,1488
BAJA CALIFORNIA,TIJUANA,12,205,1,218,1487
BAJA CALIFORNIA,TIJUANA,7,202,1,210,1730
BAJA CALIFORNIA,TIJUANA,4,219,0,223,1729
BAJA CALIFORNIA,TIJUANA,14,151,1,166,1540
BAJA CALIFORNIA,TIJUANA,10,159,1,170,1540
BAJA CALIFORNIA,TIJUANA,3,187,0,190,1520
BAJA CALIFORNIA,TIJUANA,11,162,1,174,1520
BAJA CALIFORNIA,TIJUANA,16,197,2,215,1705
BAJA CALIFORNIA,TIJUANA,9,195,4,208,1705
BAJA CALIFORNIA,TIJUANA,21,208,0,229,1486
BAJA CALIFORNIA,TIJUANA,17,209,0,226,1485
BAJA CALIFORNIA,MEXICALI,19,189,3,211,1633
BAJA CALIFORNIA,MEXICALI,13,193,1,207,1633
BAJA CALIFORNIA,MEXICALI,13,168,1,182,1632
BAJA CALIFORNIA,MEXICALI,5,228,5,238,1800
BAJA CALIFORNIA,MEXICALI,6,237,2,245,1800
BAJA CALIFORNIA,MEXICALI,4,224,6,234,1800
BAJA CALIFORNIA,MEXICALI,4,238,4,246,1800
BAJA CALIFORNIA,MEXICALI,4,250,1,255,1799
BAJA CALIFORNIA,MEXICALI,5,230,3,238,1799
BAJA CALIFORNIA,MEXICALI,11,215,1,227,1799
BAJA CALIFORNIA,MEXICALI,10,259,3,272,1799
BAJA CALIFORNIA,MEXICALI,8,237,4,249,1799
BAJA CALIFORNIA,MEXICALI,8,177,7,192,1443
BAJA CALIFORNIA,MEXICALI,9,184,5,198,1443
BAJA CALIFORNIA,MEXICALI,13,202,3,218,1442
BAJA CALIFORNIA,MEXICALI,9,170,0,179,1826
BAJA CALIFORNIA,MEXICALI,4,226,5,235,1826
BAJA CALIFORNIA,MEXICALI,7,200,2,209,1825
BAJA CALIFORNIA,MEXICALI,14,151,3,168,1518
BAJA CALIFORNIA,MEXICALI,7,203,3,213,1517
BAJA CALIFORNIA,MEXICALI,6,143,0,149,1995
BAJA CALIFORNIA,MEXICALI,4,140,0,144,1995
BAJA CALIFORNIA,MEXICALI,3,185,1,189,1995
BAJA CALIFORNIA,MEXICALI,9,160,1,170,1995
BAJA CALIFORNIA,MEXICALI,6,135,2,143,1994
BAJA CALIFORNIA,MEXICALI,9,159,1,169,1994
BAJA CALIFORNIA,MEXICALI,5,149,0,154,1994
BAJA CALIFORNIA,MEXICALI,6,139,1,146,1994
BAJA CALIFORNIA,MEXICALI,9,230,0,239,2072
BAJA CALIFORNIA,MEXICALI,12,210,1,223,2071
BAJA CALIFORNIA,MEXICALI,13,242,3,258,2071
BAJA CALIFORNIA,MEXICALI,3,190,2,195,1331
BAJA CALIFORNIA,MEXICALI,4,158,2,164,1331
BAJA CALIFORNIA,MEXICALI,11,171,3,185,1330
BAJA CALIFORNIA,MEXICALI,8,167,3,178,1176
BAJA CALIFORNIA,MEXICALI,2,157,0,159,1175
BAJA CALIFORNIA,MEXICALI,17,154,2,173,1366
BAJA CALIFORNIA,MEXICALI,15,164,4,183,1365
BAJA CALIFORNIA,MEXICALI,7,164,9,180,1725
BAJA CALIFORNIA,MEXICALI,12,156,1,169,1725
BAJA CALIFORNIA,MEXICALI,4,149,3,156,1724
BAJA CALIFORNIA,MEXICALI,10,160,4,174,1623
BAJA CALIFORNIA,MEXICALI,10,185,4,199,1622
BAJA CALIFORNIA,MEXICALI,14,199,8,221,1622
BAJA CALIFORNIA,MEXICALI,19,224,5,248,1792
BAJA CALIFORNIA,MEXICALI,27,0,3,30,1791
BAJA CALIFORNIA,MEXICALI,26,233,10,269,1791
BAJA CALIFORNIA,MEXICALI,12,204,6,222,1518
BAJA CALIFORNIA,MEXICALI,10,192,1,203,1517
BAJA CALIFORNIA,MEXICALI,8,205,3,216,1625
BAJA CALIFORNIA,MEXICALI,7,189,7,203,1625
BAJA CALIFORNIA,MEXICALI,9,205,5,219,1625
BAJA CALIFORNIA,MEXICALI,15,226,2,243,1654
BAJA CALIFORNIA,MEXICALI,13,254,4,271,1654
BAJA CALIFORNIA,MEXICALI,13,164,2,179,1014
BAJA CALIFORNIA,MEXICALI,5,144,3,152,1014
BAJA CALIFORNIA,MEXICALI,17,188,1,206,1886
BAJA CALIFORNIA,MEXICALI,8,210,1,219,1886
BAJA CALIFORNIA,MEXICALI,13,199,1,213,1886
BAJA CALIFORNIA,MEXICALI,8,171,1,180,1886
BAJA CALIFORNIA,MEXICALI,8,198,1,207,1886
BAJA CALIFORNIA,MEXICALI,13,185,0,198,1736
BAJA CALIFORNIA,MEXICALI,17,180,1,198,1736
BAJA CALIFORNIA,MEXICALI,14,199,2,215,1736
BAJA CALIFORNIA,MEXICALI,12,190,5,207,1736
BAJA CALIFORNIA,MEXICALI,12,211,2,225,1736
BAJA CALIFORNIA,MEXICALI,8,195,3,206,1736
BAJA CALIFORNIA,MEXICALI,16,197,5,218,1736
BAJA CALIFORNIA,MEXICALI,14,164,0,178,1519
BAJA CALIFORNIA,MEXICALI,18,176,1,195,1518
BAJA CALIFORNIA,MEXICALI,13,134,0,147,1786
BAJA CALIFORNIA,MEXICALI,21,157,2,180,1786
BAJA CALIFORNIA,MEXICALI,15,199,0,214,1892
BAJA CALIFORNIA,MEXICALI,15,213,0,228,1892
BAJA CALIFORNIA,MEXICALI,14,225,2,241,1891
BAJA CALIFORNIA,MEXICALI,9,179,4,192,1891
BAJA CALIFORNIA,MEXICALI,12,182,1,195,1651
BAJA CALIFORNIA,MEXICALI,7,186,0,193,1651
BAJA CALIFORNIA,MEXICALI,11,167,2,180,1651
BAJA CALIFORNIA,MEXICALI,12,127,0,139,1801
BAJA CALIFORNIA,MEXICALI,17,117,3,137,1801
BAJA CALIFORNIA,MEXICALI,25,112,2,139,1801
BAJA CALIFORNIA,MEXICALI,14,120,0,134,1575
BAJA CALIFORNIA,MEXICALI,15,109,1,125,1574
BAJA CALIFORNIA,MEXICALI,10,124,0,134,1574
BAJA CALIFORNIA,MEXICALI,11,167,0,178,1517
BAJA CALIFORNIA,MEXICALI,8,161,0,169,1517
BAJA CALIFORNIA,MEXICALI,13,149,5,167,1928
BAJA CALIFORNIA,MEXICALI,10,171,4,185,1928
BAJA CALIFORNIA,MEXICALI,11,226,1,238,1804
BAJA CALIFORNIA,MEXICALI,12,209,1,222,1803
BAJA CALIFORNIA,MEXICALI,11,256,1,268,1914
BAJA CALIFORNIA,MEXICALI,8,272,3,283,1914
BAJA CALIFORNIA,MEXICALI,14,142,1,157,1361
BAJA CALIFORNIA,MEXICALI,13,122,2,137,1360
BAJA CALIFORNIA,MEXICALI,17,122,7,146,1346
BAJA CALIFORNIA,MEXICALI,12,140,0,152,1345
BAJA CALIFORNIA,MEXICALI,13,144,2,159,1345
BAJA CALIFORNIA,MEXICALI,12,206,3,221,1753
BAJA CALIFORNIA,MEXICALI,11,187,0,198,1753
BAJA CALIFORNIA,MEXICALI,12,182,0,194,1753
BAJA CALIFORNIA,MEXICALI,10,194,0,204,1753
BAJA CALIFORNIA,MEXICALI,7,184,3,194,1753
BAJA CALIFORNIA,MEXICALI,9,177,5,191,1753
BAJA CALIFORNIA,MEXICALI,9,178,0,187,1753
BAJA CALIFORNIA,MEXICALI,9,195,2,206,1752
BAJA CALIFORNIA,MEXICALI,9,176,0,185,1590
BAJA CALIFORNIA,MEXICALI,10,150,2,162,1589
BAJA CALIFORNIA,MEXICALI,11,184,5,200,1589
BAJA CALIFORNIA,MEXICALI,6,109,3,118,1863
BAJA CALIFORNIA,MEXICALI,6,110,2,118,1862
BAJA CALIFORNIA,MEXICALI,12,118,1,131,1862
BAJA CALIFORNIA,MEXICALI,3,228,0,231,1932
BAJA CALIFORNIA,MEXICALI,16,224,2,242,1931
BAJA CALIFORNIA,MEXICALI,3,160,0,163,1665
BAJA CALIFORNIA,MEXICALI,5,170,1,176,1665
BAJA CALIFORNIA,MEXICALI,7,200,2,209,1665
BAJA CALIFORNIA,MEXICALI,4,162,2,168,1665
BAJA CALIFORNIA,MEXICALI,3,174,0,177,1665
BAJA CALIFORNIA,MEXICALI,12,201,0,213,1571
BAJA CALIFORNIA,MEXICALI,12,233,3,248,1571
BAJA CALIFORNIA,MEXICALI,22,212,3,237,1570
BAJA CALIFORNIA,MEXICALI,15,235,3,253,1536
BAJA CALIFORNIA,MEXICALI,16,257,6,279,1536
BAJA CALIFORNIA,MEXICALI,16,215,0,231,1600
BAJA CALIFORNIA,MEXICALI,8,221,2,231,1600
BAJA CALIFORNIA,MEXICALI,6,231,3,240,1600
BAJA CALIFORNIA,MEXICALI,9,167,2,178,1599
BAJA CALIFORNIA,MEXICALI,10,290,2,302,1585
BAJA CALIFORNIA,MEXICALI,13,262,1,276,1585
BAJA CALIFORNIA,MEXICALI,20,256,1,277,1585
BAJA CALIFORNIA,MEXICALI,8,266,0,274,1585
BAJA CALIFORNIA,MEXICALI,13,285,4,302,1919
BAJA CALIFORNIA,MEXICALI,11,285,5,301,1919
BAJA CALIFORNIA,MEXICALI,22,294,3,319,1918
BAJA CALIFORNIA,MEXICALI,12,268,5,285,1918
BAJA CALIFORNIA,MEXICALI,0,280,0,280,1918
BAJA CALIFORNIA,MEXICALI,8,165,5,178,1334
BAJA CALIFORNIA,MEXICALI,13,191,1,205,1334
BAJA CALIFORNIA,MEXICALI,16,214,3,233,1334
BAJA CALIFORNIA,MEXICALI,22,228,2,252,1574
BAJA CALIFORNIA,MEXICALI,12,217,2,231,1574
BAJA CALIFORNIA,MEXICALI,13,212,1,226,1219
BAJA CALIFORNIA,MEXICALI,12,200,4,216,1218
BAJA CALIFORNIA,MEXICALI,13,157,2,172,1514
BAJA CALIFORNIA,MEXICALI,16,141,1,158,1514
BAJA CALIFORNIA,MEXICALI,17,174,3,194,1435
BAJA CALIFORNIA,MEXICALI,0,201,5,206,1434
BAJA CALIFORNIA,MEXICALI,13,184,1,198,1607
BAJA CALIFORNIA,MEXICALI,17,168,4,189,1607
BAJA CALIFORNIA,MEXICALI,8,161,1,170,1607
BAJA CALIFORNIA,MEXICALI,49,971,8,1028,0
BAJA CALIFORNIA,MEXICALI,21,164,6,191,1315
BAJA CALIFORNIA,MEXICALI,9,151,1,161,1314
BAJA CALIFORNIA,MEXICALI,17,293,3,313,1786
BAJA CALIFORNIA,MEXICALI,15,313,1,329,1786
BAJA CALIFORNIA,MEXICALI,10,219,1,230,1909
BAJA CALIFORNIA,MEXICALI,14,202,3,219,1908
BAJA CALIFORNIA,MEXICALI,13,212,1,226,1908
BAJA CALIFORNIA,MEXICALI,13,258,1,272,1908
BAJA CALIFORNIA,MEXICALI,7,218,3,228,1908
BAJA CALIFORNIA,MEXICALI,10,218,2,230,1908
BAJA CALIFORNIA,MEXICALI,8,215,0,223,1740
BAJA CALIFORNIA,MEXICALI,6,233,2,241,1740
BAJA CALIFORNIA,MEXICALI,7,265,1,273,1740
BAJA CALIFORNIA,MEXICALI,7,208,0,215,1740
BAJA CALIFORNIA,MEXICALI,7,227,4,238,1740
BAJA CALIFORNIA,MEXICALI,5,133,1,139,1452
BAJA CALIFORNIA,MEXICALI,6,167,2,175,1452
BAJA CALIFORNIA,MEXICALI,7,154,4,165,1452
BAJA CALIFORNIA,MEXICALI,18,200,3,221,1682
BAJA CALIFORNIA,MEXICALI,15,176,2,193,1682
BAJA CALIFORNIA,MEXICALI,11,231,1,243,1742
BAJA CALIFORNIA,MEXICALI,15,224,6,245,1742
BAJA CALIFORNIA,MEXICALI,18,264,2,284,1517
BAJA CALIFORNIA,MEXICALI,7,272,1,280,1517
BAJA CALIFORNIA,MEXICALI,11,257,2,270,1516
BAJA CALIFORNIA,MEXICALI,6,235,1,242,1405
BAJA CALIFORNIA,MEXICALI,5,217,0,222,1405
BAJA CALIFORNIA,MEXICALI,7,185,0,192,1405
BAJA CALIFORNIA,MEXICALI,14,170,0,184,1543
BAJA CALIFORNIA,MEXICALI,14,211,1,226,1543
BAJA CALIFORNIA,MEXICALI,10,192,2,204,1923
BAJA CALIFORNIA,MEXICALI,6,187,1,194,1922
BAJA CALIFORNIA,MEXICALI,12,163,1,176,1724
BAJA CALIFORNIA,MEXICALI,9,156,0,165,1724
BAJA CALIFORNIA,MEXICALI,18,173,1,192,1691
BAJA CALIFORNIA,MEXICALI,11,164,0,175,1690
BAJA CALIFORNIA,MEXICALI,12,169,1,182,1834
BAJA CALIFORNIA,MEXICALI,8,152,2,162,1834
BAJA CALIFORNIA,MEXICALI,18,126,0,144,1903
BAJA CALIFORNIA,MEXICALI,12,126,0,138,1903
BAJA CALIFORNIA,MEXICALI,6,146,1,153,1658
BAJA CALIFORNIA,MEXICALI,7,144,0,151,1658
BAJA CALIFORNIA,MEXICALI,8,117,0,125,1116
BAJA CALIFORNIA,MEXICALI,11,130,0,141,1116
BAJA CALIFORNIA,MEXICALI,10,114,0,124,1411
BAJA CALIFORNIA,MEXICALI,15,125,0,140,1411
BAJA CALIFORNIA,MEXICALI,15,129,0,144,1410
BAJA CALIFORNIA,MEXICALI,5,160,1,166,1535
BAJA CALIFORNIA,MEXICALI,8,160,1,169,1535
BAJA CALIFORNIA,MEXICALI,1,191,0,192,1534
BAJA CALIFORNIA,MEXICALI,3,112,2,117,1478
BAJA CALIFORNIA,MEXICALI,8,112,2,122,1478
BAJA CALIFORNIA,MEXICALI,4,126,0,130,1477
BAJA CALIFORNIA,MEXICALI,4,107,0,111,1135
BAJA CALIFORNIA,MEXICALI,3,85,1,89,1135
BAJA CALIFORNIA,MEXICALI,8,132,0,140,1472
BAJA CALIFORNIA,MEXICALI,3,122,2,127,1471
BAJA CALIFORNIA,MEXICALI,1,101,1,103,1520
BAJA CALIFORNIA,MEXICALI,3,90,1,94,1520
BAJA CALIFORNIA,MEXICALI,11,121,1,133,1520
BAJA CALIFORNIA,MEXICALI,10,156,1,167,1032
BAJA CALIFORNIA,MEXICALI,13,153,1,167,1032
BAJA CALIFORNIA,MEXICALI,8,147,0,155,1362
BAJA CALIFORNIA,MEXICALI,6,128,0,134,1362
BAJA CALIFORNIA,MEXICALI,11,144,0,155,1362
BAJA CALIFORNIA,MEXICALI,13,125,2,140,1251
BAJA CALIFORNIA,MEXICALI,15,136,0,151,1250
BAJA CALIFORNIA,MEXICALI,12,195,1,208,1453
BAJA CALIFORNIA,MEXICALI,13,227,2,242,1453
BAJA CALIFORNIA,MEXICALI,20,179,1,200,1354
BAJA CALIFORNIA,MEXICALI,10,166,1,177,1353
BAJA CALIFORNIA,MEXICALI,16,178,1,195,1446
BAJA CALIFORNIA,MEXICALI,13,208,3,224,1445
BAJA CALIFORNIA,MEXICALI,15,246,2,263,1925
BAJA CALIFORNIA,MEXICALI,19,236,3,258,1924
BAJA CALIFORNIA,MEXICALI,13,176,2,191,1949
BAJA CALIFORNIA,MEXICALI,9,114,0,123,1949
BAJA CALIFORNIA,TIJUANA,24,83,0,107,1209
BAJA CALIFORNIA,TIJUANA,14,112,0,126,1208
BAJA CALIFORNIA,TIJUANA,9,190,2,201,1742
BAJA CALIFORNIA,TIJUANA,3,182,3,188,1741
BAJA CALIFORNIA,TIJUANA,10,142,2,154,1535
BAJA CALIFORNIA,TIJUANA,17,150,2,169,1535
BAJA CALIFORNIA,TIJUANA,14,147,0,161,1534
BAJA CALIFORNIA,TIJUANA,6,174,1,181,1487
BAJA CALIFORNIA,TIJUANA,9,187,3,199,1487
BAJA CALIFORNIA,TIJUANA,13,188,0,201,1487
BAJA CALIFORNIA,TIJUANA,29,228,3,260,1951
BAJA CALIFORNIA,TIJUANA,30,215,1,246,1951
BAJA CALIFORNIA,TIJUANA,16,143,1,160,1122
BAJA CALIFORNIA,TIJUANA,10,132,3,145,1122
BAJA CALIFORNIA,TIJUANA,19,210,0,229,1495
BAJA CALIFORNIA,TIJUANA,13,237,2,252,1495
BAJA CALIFORNIA,TIJUANA,18,142,1,161,1428
BAJA CALIFORNIA,TIJUANA,18,177,0,195,1428
BAJA CALIFORNIA,TIJUANA,17,162,2,181,1428
BAJA CALIFORNIA,TIJUANA,13,150,1,164,1610
BAJA CALIFORNIA,TIJUANA,7,144,0,151,1609
BAJA CALIFORNIA,TIJUANA,13,175,2,190,1609
BAJA CALIFORNIA,TIJUANA,8,205,0,213,1397
BAJA CALIFORNIA,TIJUANA,5,193,3,201,1396
BAJA CALIFORNIA,TIJUANA,9,181,0,190,1005
BAJA CALIFORNIA,TIJUANA,6,195,2,203,1005
BAJA CALIFORNIA,TIJUANA,11,224,2,237,1725
BAJA CALIFORNIA,TIJUANA,8,229,0,237,1724
BAJA CALIFORNIA,TIJUANA,15,200,5,220,1779
BAJA CALIFORNIA,TIJUANA,13,201,2,216,1778
BAJA CALIFORNIA,TIJUANA,17,225,2,244,1675
BAJA CALIFORNIA,TIJUANA,32,219,1,252,1675
BAJA CALIFORNIA,TIJUANA,32,210,1,243,1674
BAJA CALIFORNIA,TIJUANA,6,205,0,211,1141
BAJA CALIFORNIA,TIJUANA,6,186,1,193,1140
BAJA CALIFORNIA,TIJUANA,9,220,0,229,1428
BAJA CALIFORNIA,TIJUANA,5,218,0,223,1427
BAJA CALIFORNIA,TIJUANA,12,236,3,251,1826
BAJA CALIFORNIA,TIJUANA,18,258,0,276,1825
BAJA CALIFORNIA,TIJUANA,0,262,3,265,1819
BAJA CALIFORNIA,TIJUANA,27,228,2,257,1818
BAJA CALIFORNIA,TIJUANA,12,236,2,250,1882
BAJA CALIFORNIA,TIJUANA,12,234,1,247,1882
BAJA CALIFORNIA,TIJUANA,16,288,4,308,1621
BAJA CALIFORNIA,TIJUANA,19,242,2,263,1621
BAJA CALIFORNIA,TIJUANA,21,278,2,301,1878
BAJA CALIFORNIA,TIJUANA,16,269,1,286,1878
BAJA CALIFORNIA,TIJUANA,7,218,0,225,1627
BAJA CALIFORNIA,TIJUANA,11,211,4,226,1626
BAJA CALIFORNIA,TIJUANA,14,297,2,313,1870
BAJA CALIFORNIA,TIJUANA,10,298,4,312,1869
BAJA CALIFORNIA,TIJUANA,6,212,1,219,1421
BAJA CALIFORNIA,TIJUANA,5,210,4,219,1421
BAJA CALIFORNIA,TIJUANA,7,215,1,223,1386
BAJA CALIFORNIA,TIJUANA,4,221,1,226,1385
BAJA CALIFORNIA,TIJUANA,7,188,0,195,1450
BAJA CALIFORNIA,TIJUANA,7,231,5,243,1449
BAJA CALIFORNIA,TIJUANA,12,177,2,191,1449
BAJA CALIFORNIA,TIJUANA,14,159,0,173,1790
BAJA CALIFORNIA,TIJUANA,23,154,1,178,1790
BAJA CALIFORNIA,TIJUANA,18,153,1,172,1790
BAJA CALIFORNIA,TIJUANA,15,148,2,165,1790
BAJA CALIFORNIA,TIJUANA,18,144,2,164,1790
BAJA CALIFORNIA,TIJUANA,13,211,2,226,1904
BAJA CALIFORNIA,TIJUANA,14,202,1,217,1903
BAJA CALIFORNIA,TIJUANA,4,214,2,220,1393
BAJA CALIFORNIA,TIJUANA,23,214,5,242,1393
BAJA CALIFORNIA,TIJUANA,4,323,1,328,1608
BAJA CALIFORNIA,TIJUANA,11,277,4,292,1607
BAJA CALIFORNIA,TIJUANA,13,186,1,200,1405
BAJA CALIFORNIA,TIJUANA,17,217,4,238,1404
BAJA CALIFORNIA,TIJUANA,20,245,1,266,1867
BAJA CALIFORNIA,TIJUANA,8,255,1,264,1867
BAJA CALIFORNIA,TIJUANA,6,163,1,170,1389
BAJA CALIFORNIA,TIJUANA,11,168,1,180,1389
BAJA CALIFORNIA,TIJUANA,12,159,1,172,1389
BAJA CALIFORNIA,TIJUANA,7,197,2,206,1880
BAJA CALIFORNIA,TIJUANA,13,197,1,211,1879
BAJA CALIFORNIA,TIJUANA,11,294,2,307,1926
BAJA CALIFORNIA,TIJUANA,12,268,0,280,1926
BAJA CALIFORNIA,TIJUANA,13,298,1,312,1926
BAJA CALIFORNIA,TIJUANA,13,235,2,250,1471
BAJA CALIFORNIA,TIJUANA,4,223,1,228,1470
BAJA CALIFORNIA,TIJUANA,23,209,0,232,1785
BAJA CALIFORNIA,TIJUANA,14,250,1,265,1785
BAJA CALIFORNIA,TIJUANA,22,220,0,242,1785
BAJA CALIFORNIA,TIJUANA,17,206,0,223,1785
BAJA CALIFORNIA,TIJUANA,27,205,1,233,1785
BAJA CALIFORNIA,TIJUANA,19,231,2,252,1785
BAJA CALIFORNIA,TIJUANA,12,141,1,154,1108
BAJA CALIFORNIA,TIJUANA,6,146,2,154,1107
BAJA CALIFORNIA,TIJUANA,13,235,1,249,1929
BAJA CALIFORNIA,TIJUANA,17,225,3,245,1929
BAJA CALIFORNIA,TIJUANA,14,234,1,249,1928
BAJA CALIFORNIA,TIJUANA,9,252,2,263,1860
BAJA CALIFORNIA,TIJUANA,18,256,5,279,1860
BAJA CALIFORNIA,TIJUANA,15,255,7,277,1860
BAJA CALIFORNIA,TIJUANA,6,250,1,257,1859
BAJA CALIFORNIA,TIJUANA,13,238,0,251,1542
BAJA CALIFORNIA,TIJUANA,16,232,1,249,1542
BAJA CALIFORNIA,TIJUANA,5,292,5,302,1937
BAJA CALIFORNIA,TIJUANA,4,275,2,281,1937
BAJA CALIFORNIA,TIJUANA,3,151,2,156,1353
BAJA CALIFORNIA,TIJUANA,5,58,0,63,1352
BAJA CALIFORNIA,TIJUANA,5,114,1,120,1352
BAJA CALIFORNIA,TIJUANA,6,221,4,231,1560
BAJA CALIFORNIA,TIJUANA,10,208,2,220,1559
BAJA CALIFORNIA,TIJUANA,11,232,0,243,1740
BAJA CALIFORNIA,TIJUANA,10,231,1,242,1740
BAJA CALIFORNIA,TIJUANA,11,205,0,216,1618
BAJA CALIFORNIA,TIJUANA,10,241,2,253,1618
BAJA CALIFORNIA,TIJUANA,3,231,12,246,1749
BAJA CALIFORNIA,TIJUANA,8,234,6,248,1749
BAJA CALIFORNIA,TIJUANA,7,167,2,176,1765
BAJA CALIFORNIA,TIJUANA,12,167,0,179,1764
BAJA CALIFORNIA,TIJUANA,16,207,8,231,1592
BAJA CALIFORNIA,TIJUANA,12,203,0,215,1591
BAJA CALIFORNIA,TIJUANA,16,194,3,213,1591
BAJA CALIFORNIA,TIJUANA,12,287,4,303,1779
BAJA CALIFORNIA,TIJUANA,15,293,8,316,1778
BAJA CALIFORNIA,TIJUANA,16,288,1,305,1917
BAJA CALIFORNIA,TIJUANA,13,301,1,315,1916
BAJA CALIFORNIA,TIJUANA,18,187,1,206,1598
BAJA CALIFORNIA,TIJUANA,13,161,2,176,1598
BAJA CALIFORNIA,TIJUANA,7,187,1,195,1598
BAJA CALIFORNIA,TIJUANA,9,233,2,244,1680
BAJA CALIFORNIA,TIJUANA,5,216,1,222,1680
BAJA CALIFORNIA,TIJUANA,13,248,3,264,1993
BAJA CALIFORNIA,TIJUANA,10,213,4,227,1992
BAJA CALIFORNIA,TIJUANA,13,213,0,226,1992
BAJA CALIFORNIA,TIJUANA,10,231,1,242,1992
BAJA CALIFORNIA,TIJUANA,23,211,3,237,1485
BAJA CALIFORNIA,TIJUANA,6,193,2,201,1485
BAJA CALIFORNIA,TIJUANA,12,221,1,234,1484
BAJA CALIFORNIA,TIJUANA,9,191,1,201,1484
BAJA CALIFORNIA,TIJUANA,12,115,0,127,1067
BAJA CALIFORNIA,TIJUANA,8,129,1,138,1066
BAJA CALIFORNIA,TIJUANA,10,197,2,209,1841
BAJA CALIFORNIA,TIJUANA,17,295,4,316,1841
BAJA CALIFORNIA,TIJUANA,12,218,3,233,1727
BAJA CALIFORNIA,TIJUANA,12,219,2,233,1726
BAJA CALIFORNIA,TIJUANA,13,245,2,260,1394
BAJA CALIFORNIA,TIJUANA,5,233,3,241,1394
BAJA CALIFORNIA,TIJUANA,7,192,0,199,1430
BAJA CALIFORNIA,TIJUANA,6,173,4,183,1429
BAJA CALIFORNIA,TIJUANA,4,184,1,189,1435
BAJA CALIFORNIA,TIJUANA,3,165,4,172,1435
BAJA CALIFORNIA,TIJUANA,6,186,2,194,1474
BAJA CALIFORNIA,TIJUANA,5,187,1,193,1473
BAJA CALIFORNIA,TIJUANA,2,186,2,190,1473
BAJA CALIFORNIA,TIJUANA,12,267,5,284,1551
BAJA CALIFORNIA,TIJUANA,9,257,3,269,1551
BAJA CALIFORNIA,TIJUANA,10,190,4,204,1819
BAJA CALIFORNIA,TIJUANA,7,178,3,188,1818
BAJA CALIFORNIA,TIJUANA,8,264,3,275,1910
BAJA CALIFORNIA,TIJUANA,6,238,5,249,1910
BAJA CALIFORNIA,TIJUANA,18,131,1,150,1485
BAJA CALIFORNIA,TIJUANA,22,155,0,177,1484
BAJA CALIFORNIA,TIJUANA,19,144,1,164,1484
BAJA CALIFORNIA,TIJUANA,5,220,0,225,1831
BAJA CALIFORNIA,TIJUANA,4,234,2,240,1830
BAJA CALIFORNIA,TIJUANA,5,164,0,169,1351
BAJA CALIFORNIA,TIJUANA,9,166,1,176,1350
BAJA CALIFORNIA,TIJUANA,1,158,3,162,1350
BAJA CALIFORNIA,TIJUANA,10,222,3,235,1769
BAJA CALIFORNIA,TIJUANA,0,188,2,190,1769
BAJA CALIFORNIA,TIJUANA,4,196,3,203,1090
BAJA CALIFORNIA,TIJUANA,9,179,3,191,1090
BAJA CALIFORNIA,TIJUANA,9,186,4,199,1500
BAJA CALIFORNIA,TIJUANA,3,158,2,163,1500
BAJA CALIFORNIA,TIJUANA,13,252,1,266,1459
BAJA CALIFORNIA,TIJUANA,15,254,1,270,1458
BAJA CALIFORNIA,TIJUANA,12,235,0,247,1458
BAJA CALIFORNIA,TIJUANA,7,186,0,193,1969
BAJA CALIFORNIA,TIJUANA,5,190,2,197,1969
BAJA CALIFORNIA,TIJUANA,6,204,0,210,1969
BAJA CALIFORNIA,TIJUANA,0,200,6,206,1969
BAJA CALIFORNIA,TIJUANA,4,213,1,218,1969
BAJA CALIFORNIA,TIJUANA,6,218,3,227,1969
BAJA CALIFORNIA,TIJUANA,9,217,1,227,1968
BAJA CALIFORNIA,TIJUANA,3,200,0,203,1968
BAJA CALIFORNIA,TIJUANA,4,215,0,219,1968
BAJA CALIFORNIA,TIJUANA,9,282,2,293,2021
BAJA CALIFORNIA,TIJUANA,6,287,0,293,2021
BAJA CALIFORNIA,TIJUANA,8,281,1,290,2020
BAJA CALIFORNIA,TIJUANA,7,273,0,280,1570
BAJA CALIFORNIA,TIJUANA,3,242,2,247,1570
BAJA CALIFORNIA,TIJUANA,4,199,3,206,1641
BAJA CALIFORNIA,TIJUANA,6,198,0,204,1641
BAJA CALIFORNIA,TIJUANA,4,204,1,209,1640
BAJA CALIFORNIA,TIJUANA,4,208,0,212,1848
BAJA CALIFORNIA,TIJUANA,5,239,0,244,1848
BAJA CALIFORNIA,TIJUANA,5,215,4,224,1848
BAJA CALIFORNIA,TIJUANA,3,200,0,203,1689
BAJA CALIFORNIA,TIJUANA,7,200,1,208,1688
BAJA CALIFORNIA,TIJUANA,8,186,0,194,1645
BAJA CALIFORNIA,TIJUANA,9,190,0,199,1645
BAJA CALIFORNIA,TIJUANA,8,200,2,210,1586
BAJA CALIFORNIA,TIJUANA,9,239,1,249,1585
BAJA CALIFORNIA,TIJUANA,5,195,4,204,1509
BAJA CALIFORNIA,TIJUANA,4,187,2,193,1508
BAJA CALIFORNIA,TIJUANA,39,151,0,190,1508
BAJA CALIFORNIA,TIJUANA,6,229,3,238,1701
BAJA CALIFORNIA,TIJUANA,4,234,2,240,1701
BAJA CALIFORNIA,TIJUANA,7,239,1,247,1700
BAJA CALIFORNIA,TIJUANA,9,195,0,204,1574
BAJA CALIFORNIA,TIJUANA,8,199,0,207,1574
BAJA CALIFORNIA,TIJUANA,5,262,3,270,1922
BAJA CALIFORNIA,TIJUANA,9,274,2,285,1921
BAJA CALIFORNIA,TIJUANA,19,160,4,183,1191
BAJA CALIFORNIA,TIJUANA,20,130,1,151,1191
BAJA CALIFORNIA,TIJUANA,5,195,1,201,1834
BAJA CALIFORNIA,TIJUANA,0,206,0,206,1833
BAJA CALIFORNIA,TIJUANA,13,337,5,355,1923
BAJA CALIFORNIA,TIJUANA,12,318,0,330,1922
BAJA CALIFORNIA,TIJUANA,5,273,10,288,1633
BAJA CALIFORNIA,TIJUANA,7,260,1,268,1633
BAJA CALIFORNIA,TIJUANA,2,228,2,232,1820
BAJA CALIFORNIA,TIJUANA,11,194,2,207,1820
BAJA CALIFORNIA,TIJUANA,7,205,3,215,1880
BAJA CALIFORNIA,TIJUANA,8,206,1,215,1879
BAJA CALIFORNIA,TIJUANA,9,128,3,140,1047
BAJA CALIFORNIA,TIJUANA,4,155,2,161,1047
BAJA CALIFORNIA,TIJUANA,3,205,2,210,1558
BAJA CALIFORNIA,TIJUANA,10,206,6,222,1558
BAJA CALIFORNIA,TIJUANA,10,167,178,355,1136
BAJA CALIFORNIA,TIJUANA,6,164,0,170,1135
BAJA CALIFORNIA,TIJUANA,24,859,4,887,0
BAJA CALIFORNIA,TIJUANA,9,148,0,157,1331
BAJA CALIFORNIA,TIJUANA,8,144,3,155,1330
BAJA CALIFORNIA,TIJUANA,11,174,3,188,1330
BAJA CALIFORNIA SUR,LA PAZ,13,283,1,297,1918
BAJA CALIFORNIA SUR,LA PAZ,11,296,4,311,1917
BAJA CALIFORNIA SUR,LA PAZ,13,203,3,219,1170
BAJA CALIFORNIA SUR,LA PAZ,8,200,2,210,1169
BAJA CALIFORNIA SUR,LA PAZ,16,329,7,352,1795
BAJA CALIFORNIA SUR,LA PAZ,13,269,1,283,1794
BAJA CALIFORNIA SUR,LA PAZ,16,247,3,266,1794
BAJA CALIFORNIA SUR,LA PAZ,6,258,3,267,1766
BAJA CALIFORNIA SUR,LA PAZ,13,292,4,309,1765
BAJA CALIFORNIA SUR,LA PAZ,8,238,6,252,1467
BAJA CALIFORNIA SUR,LA PAZ,10,206,4,220,1467
BAJA CALIFORNIA SUR,LA PAZ,10,247,1,258,1467
BAJA CALIFORNIA SUR,LA PAZ,9,248,2,259,1474
BAJA CALIFORNIA SUR,LA PAZ,11,241,2,254,1473
BAJA CALIFORNIA SUR,LA PAZ,6,260,4,270,1473
BAJA CALIFORNIA SUR,LA PAZ,11,161,4,176,1379
BAJA CALIFORNIA SUR,LA PAZ,4,208,2,214,1379
BAJA CALIFORNIA SUR,LA PAZ,11,206,4,221,1378
BAJA CALIFORNIA SUR,LA PAZ,6,303,7,316,1689
BAJA CALIFORNIA SUR,LA PAZ,7,303,3,313,1689
BAJA CALIFORNIA SUR,LA PAZ,6,240,3,249,1486
BAJA CALIFORNIA SUR,LA PAZ,12,212,4,228,1486
BAJA CALIFORNIA SUR,LA PAZ,10,227,4,241,1486
BAJA CALIFORNIA SUR,LA PAZ,15,143,5,163,1117
BAJA CALIFORNIA SUR,LA PAZ,12,152,8,172,1117
BAJA CALIFORNIA SUR,LA PAZ,7,239,3,249,1647
BAJA CALIFORNIA SUR,LA PAZ,8,204,0,212,1647
BAJA CALIFORNIA SUR,LA PAZ,7,199,2,208,1647
BAJA CALIFORNIA SUR,LA PAZ,6,201,4,211,1647
BAJA CALIFORNIA SUR,LA PAZ,21,284,0,305,1920
BAJA CALIFORNIA SUR,LA PAZ,10,310,7,327,1919
BAJA CALIFORNIA SUR,LA PAZ,12,351,5,368,1430
BAJA CALIFORNIA SUR,LA PAZ,18,321,3,342,1430
BAJA CALIFORNIA SUR,LA PAZ,10,312,3,325,1429
BAJA CALIFORNIA SUR,LA PAZ,6,170,5,181,1362
BAJA CALIFORNIA SUR,LA PAZ,7,205,5,217,1361
BAJA CALIFORNIA SUR,LA PAZ,14,360,3,377,1741
BAJA CALIFORNIA SUR,LA PAZ,28,352,4,384,1741
BAJA CALIFORNIA SUR,LA PAZ,9,281,8,298,1412
BAJA CALIFORNIA SUR,LA PAZ,9,279,6,294,1412
BAJA CALIFORNIA SUR,LA PAZ,11,290,6,307,1411
BAJA CALIFORNIA SUR,LA PAZ,17,297,2,316,1474
BAJA CALIFORNIA SUR,LA PAZ,23,271,1,295,1474
BAJA CALIFORNIA SUR,LA PAZ,11,316,9,336,1893
BAJA CALIFORNIA SUR,LA PAZ,14,300,7,321,1493
BAJA CALIFORNIA SUR,LA PAZ,17,339,7,363,1492
BAJA CALIFORNIA SUR,LA PAZ,10,205,5,220,1497
BAJA CALIFORNIA SUR,LA PAZ,12,247,4,263,1497
BAJA CALIFORNIA SUR,LA PAZ,11,209,3,223,1496
BAJA CALIFORNIA SUR,LA PAZ,6,277,3,286,1649
BAJA CALIFORNIA SUR,LA PAZ,16,259,1,276,1649
BAJA CALIFORNIA SUR,LA PAZ,12,238,4,254,1649
BAJA CALIFORNIA SUR,LA PAZ,9,394,10,413,1963
BAJA CALIFORNIA SUR,LA PAZ,13,343,13,369,1963
BAJA CALIFORNIA SUR,LA PAZ,21,397,18,436,1963
BAJA CALIFORNIA SUR,LA PAZ,18,415,7,440,1962
BAJA CALIFORNIA SUR,LA PAZ,11,427,5,443,1962
BAJA CALIFORNIA SUR,LA PAZ,12,181,2,195,1661
BAJA CALIFORNIA SUR,LA PAZ,11,171,0,182,1661
BAJA CALIFORNIA SUR,LA PAZ,5,196,2,203,1359
BAJA CALIFORNIA SUR,LA PAZ,6,163,5,174,1359
BAJA CALIFORNIA SUR,LA PAZ,5,157,2,164,1358
BAJA CALIFORNIA SUR,LA PAZ,24,265,5,294,1591
BAJA CALIFORNIA SUR,LA PAZ,14,317,7,338,1591
BAJA CALIFORNIA SUR,LA PAZ,10,317,10,337,1812
BAJA CALIFORNIA SUR,LA PAZ,16,328,12,356,1812
BAJA CALIFORNIA SUR,LA PAZ,24,245,4,273,1338
BAJA CALIFORNIA SUR,LA PAZ,6,261,2,269,1338
BAJA CALIFORNIA SUR,LA PAZ,17,246,8,271,1337
BAJA CALIFORNIA SUR,LA PAZ,9,228,2,239,1682
BAJA CALIFORNIA SUR,LA PAZ,11,194,4,209,1681
BAJA CALIFORNIA SUR,LA PAZ,25,309,9,343,1835
BAJA CALIFORNIA SUR,LA PAZ,17,331,10,358,1834
BAJA CALIFORNIA SUR,LA PAZ,16,325,3,344,1834
BAJA CALIFORNIA SUR,LA PAZ,37,268,5,310,1911
BAJA CALIFORNIA SUR,LA PAZ,44,286,7,337,1910
BAJA CALIFORNIA SUR,LA PAZ,42,285,3,330,1863
BAJA CALIFORNIA SUR,LA PAZ,30,298,7,335,1862
BAJA CALIFORNIA SUR,LA PAZ,19,265,7,291,1551
BAJA CALIFORNIA SUR,LA PAZ,14,261,8,283,1551
BAJA CALIFORNIA SUR,LA PAZ,20,252,3,275,1393
BAJA CALIFORNIA SUR,LA PAZ,7,253,4,264,1393
BAJA CALIFORNIA SUR,LA PAZ,16,261,12,289,1487
BAJA CALIFORNIA SUR,LA PAZ,13,252,5,270,1486
BAJA CALIFORNIA SUR,LA PAZ,22,201,2,225,1412
BAJA CALIFORNIA SUR,LA PAZ,16,233,2,251,1411
BAJA CALIFORNIA SUR,LA PAZ,22,203,2,227,1411
BAJA CALIFORNIA SUR,LA PAZ,29,293,7,329,1811
BAJA CALIFORNIA SUR,LA PAZ,31,307,8,346,1811
BAJA CALIFORNIA SUR,LA PAZ,28,311,3,342,1811
BAJA CALIFORNIA SUR,LA PAZ,36,276,5,317,1656
BAJA CALIFORNIA SUR,LA PAZ,16,261,4,281,1656
BAJA CALIFORNIA SUR,LA PAZ,28,252,5,285,1655
BAJA CALIFORNIA SUR,LA PAZ,22,212,1,235,1487
BAJA CALIFORNIA SUR,LA PAZ,25,212,2,239,1487
BAJA CALIFORNIA SUR,LA PAZ,18,212,3,233,1486
BAJA CALIFORNIA SUR,LA PAZ,25,231,1,257,1343
BAJA CALIFORNIA SUR,LA PAZ,33,211,6,250,1342
BAJA CALIFORNIA SUR,LA PAZ,29,201,2,232,1342
BAJA CALIFORNIA SUR,LA PAZ,46,360,3,409,2124
BAJA CALIFORNIA SUR,LA PAZ,19,277,8,304,1574
BAJA CALIFORNIA SUR,LA PAZ,26,275,4,305,1574
BAJA CALIFORNIA SUR,LA PAZ,28,287,4,319,1637
BAJA CALIFORNIA SUR,LA PAZ,20,261,4,285,1636
BAJA CALIFORNIA SUR,LA PAZ,32,191,6,229,1337
BAJA CALIFORNIA SUR,LA PAZ,24,218,3,245,1337
BAJA CALIFORNIA SUR,LA PAZ,21,214,6,241,1337
BAJA CALIFORNIA SUR,LA PAZ,17,149,2,168,1379
BAJA CALIFORNIA SUR,LA PAZ,20,144,2,166,1378
BAJA CALIFORNIA SUR,LA PAZ,35,361,2,398,1961
BAJA CALIFORNIA SUR,LA PAZ,27,338,3,368,1960
BAJA CALIFORNIA SUR,LA PAZ,32,302,2,336,1498
BAJA CALIFORNIA SUR,LA PAZ,36,358,4,398,1497
BAJA CALIFORNIA SUR,LA PAZ,31,311,4,346,1896
BAJA CALIFORNIA SUR,LA PAZ,26,344,9,379,1896
BAJA CALIFORNIA SUR,LA PAZ,27,254,5,286,1258
BAJA CALIFORNIA SUR,LA PAZ,27,236,1,264,1258
BAJA CALIFORNIA SUR,LA PAZ,29,302,7,338,1786
BAJA CALIFORNIA SUR,LA PAZ,29,310,2,341,1786
BAJA CALIFORNIA SUR,LA PAZ,29,240,1,270,1406
BAJA CALIFORNIA SUR,LA PAZ,21,219,8,248,1406
BAJA CALIFORNIA SUR,LA PAZ,19,224,3,246,1405
BAJA CALIFORNIA SUR,LA PAZ,33,278,6,317,1916
BAJA CALIFORNIA SUR,LA PAZ,39,322,5,366,1916
BAJA CALIFORNIA SUR,LA PAZ,20,210,4,234,1778
BAJA CALIFORNIA SUR,LA PAZ,13,216,2,231,1778
BAJA CALIFORNIA SUR,LA PAZ,15,235,2,252,1778
BAJA CALIFORNIA SUR,LA PAZ,88,1319,10,1417,0
BAJA CALIFORNIA SUR,LA PAZ,22,286,6,314,1758
BAJA CALIFORNIA SUR,LA PAZ,15,279,4,298,1758
BAJA CALIFORNIA SUR,LA PAZ,6,121,1,128,1241
BAJA CALIFORNIA SUR,LA PAZ,5,151,3,159,1240
BAJA CALIFORNIA SUR,LA PAZ,16,314,6,336,1856
BAJA CALIFORNIA SUR,LA PAZ,29,319,4,352,1855
BAJA CALIFORNIA SUR,LA PAZ,15,267,3,285,1877
BAJA CALIFORNIA SUR,LA PAZ,15,222,3,240,1877
BAJA CALIFORNIA SUR,LA PAZ,12,206,3,221,1662
BAJA CALIFORNIA SUR,LA PAZ,5,207,4,216,1661
BAJA CALIFORNIA SUR,LA PAZ,11,219,0,230,1661
BAJA CALIFORNIA SUR,LA PAZ,17,252,5,274,1774
BAJA CALIFORNIA SUR,LA PAZ,10,262,10,282,1773
BAJA CALIFORNIA SUR,LA PAZ,30,221,2,253,1650
BAJA CALIFORNIA SUR,LA PAZ,24,201,3,228,1650
BAJA CALIFORNIA SUR,LA PAZ,21,136,2,159,1078
BAJA CALIFORNIA SUR,LA PAZ,21,159,1,181,1077
BAJA CALIFORNIA SUR,LA PAZ,27,231,2,260,1671
BAJA CALIFORNIA SUR,LA PAZ,37,236,3,276,1671
BAJA CALIFORNIA SUR,LA PAZ,18,283,3,304,2105
BAJA CALIFORNIA SUR,LA PAZ,30,313,4,347,2104
BAJA CALIFORNIA SUR,LA PAZ,11,235,2,248,1849
BAJA CALIFORNIA SUR,LA PAZ,20,242,3,265,1849
BAJA CALIFORNIA SUR,LA PAZ,21,224,2,247,1849
BAJA CALIFORNIA SUR,LA PAZ,14,254,3,271,1935
BAJA CALIFORNIA SUR,LA PAZ,27,245,1,273,1934
BAJA CALIFORNIA SUR,LA PAZ,16,169,3,188,1497
BAJA CALIFORNIA SUR,LA PAZ,19,189,1,209,1497
BAJA CALIFORNIA SUR,LA PAZ,15,193,0,208,1496
BAJA CALIFORNIA SUR,LA PAZ,11,189,2,202,1530
BAJA CALIFORNIA SUR,LA PAZ,13,197,6,216,1529
BAJA CALIFORNIA SUR,LA PAZ,8,154,3,165,1403
BAJA CALIFORNIA SUR,LA PAZ,9,194,3,206,1402
BAJA CALIFORNIA SUR,LA PAZ,17,156,3,176,1402
BAJA CALIFORNIA SUR,LA PAZ,10,229,4,243,1968
BAJA CALIFORNIA SUR,LA PAZ,7,218,2,227,1967
BAJA CALIFORNIA SUR,LA PAZ,14,248,1,263,1803
BAJA CALIFORNIA SUR,LA PAZ,23,236,5,264,1803
BAJA CALIFORNIA SUR,LA PAZ,18,174,3,195,1191
BAJA CALIFORNIA SUR,LA PAZ,13,175,2,190,1191
BAJA CALIFORNIA SUR,LA PAZ,12,137,0,149,1269
BAJA CALIFORNIA SUR,LA PAZ,12,145,0,157,1268
BAJA CALIFORNIA SUR,LA PAZ,15,159,1,175,1553
BAJA CALIFORNIA SUR,LA PAZ,5,151,0,156,1553
BAJA CALIFORNIA SUR,LA PAZ,15,151,1,167,1552
BAJA CALIFORNIA SUR,LA PAZ,28,176,1,205,1330
BAJA CALIFORNIA SUR,LA PAZ,12,188,1,201,1330
BAJA CALIFORNIA SUR,LA PAZ,24,169,1,194,1330
BAJA CALIFORNIA SUR,LA PAZ,22,217,2,241,1765
BAJA CALIFORNIA SUR,LA PAZ,26,215,2,243,1765
BAJA CALIFORNIA SUR,LA PAZ,17,246,5,268,1945
BAJA CALIFORNIA SUR,LA PAZ,29,282,1,312,1944
BAJA CALIFORNIA SUR,LA PAZ,11,171,2,184,1762
BAJA CALIFORNIA SUR,LA PAZ,14,188,1,203,1762
BAJA CALIFORNIA SUR,SAN JOSE DEL CABO,20,213,0,233,1500
BAJA CALIFORNIA SUR,SAN JOSE DEL CABO,16,196,1,213,1499
BAJA CALIFORNIA SUR,SAN JOSE DEL CABO,17,284,4,305,1574
BAJA CALIFORNIA SUR,SAN JOSE DEL CABO,14,304,5,323,1574
BAJA CALIFORNIA SUR,SAN JOSE DEL CABO,17,280,1,298,1574
BAJA CALIFORNIA SUR,SAN JOSE DEL CABO,20,274,3,297,1959
BAJA CALIFORNIA SUR,SAN JOSE DEL CABO,15,295,7,317,1959
BAJA CALIFORNIA SUR,SAN JOSE DEL CABO,20,307,5,332,1959
BAJA CALIFORNIA SUR,SAN JOSE DEL CABO,14,186,1,201,1335
BAJA CALIFORNIA SUR,SAN JOSE DEL CABO,6,157,1,164,1335
BAJA CALIFORNIA SUR,SAN JOSE DEL CABO,9,163,4,176,1335
BAJA CALIFORNIA SUR,SAN JOSE DEL CABO,3,241,4,248,1527
BAJA CALIFORNIA SUR,SAN JOSE DEL CABO,7,300,4,311,1527
BAJA CALIFORNIA SUR,SAN JOSE DEL CABO,9,237,4,250,1527
BAJA CALIFORNIA SUR,SAN JOSE DEL CABO,4,134,2,140,1223
BAJA CALIFORNIA SUR,SAN JOSE DEL CABO,5,157,2,164,1222
BAJA CALIFORNIA SUR,SAN JOSE DEL CABO,1,178,3,182,1587
BAJA CALIFORNIA SUR,SAN JOSE DEL CABO,6,189,3,198,1586
BAJA CALIFORNIA SUR,SAN JOSE DEL CABO,7,224,2,233,1538
BAJA CALIFORNIA SUR,SAN JOSE DEL CABO,9,247,1,257,1537
BAJA CALIFORNIA SUR,SAN JOSE DEL CABO,9,206,2,217,1557
BAJA CALIFORNIA SUR,SAN JOSE DEL CABO,10,169,3,182,1557
BAJA CALIFORNIA SUR,SAN JOSE DEL CABO,21,137,0,158,1759
BAJA CALIFORNIA SUR,SAN JOSE DEL CABO,18,108,0,126,1759
BAJA CALIFORNIA SUR,SAN JOSE DEL CABO,11,237,8,256,1582
BAJA CALIFORNIA SUR,SAN JOSE DEL CABO,18,199,3,220,1582
BAJA CALIFORNIA SUR,SAN JOSE DEL CABO,7,187,3,197,1581
BAJA CALIFORNIA SUR,SAN JOSE DEL CABO,13,272,1,286,1907
BAJA CALIFORNIA SUR,SAN JOSE DEL CABO,9,218,1,228,1907
BAJA CALIFORNIA SUR,SAN JOSE DEL CABO,23,206,1,230,1340
BAJA CALIFORNIA SUR,SAN JOSE DEL CABO,15,185,3,203,1339
BAJA CALIFORNIA SUR,SAN JOSE DEL CABO,13,189,4,206,1980
BAJA CALIFORNIA SUR,SAN JOSE DEL CABO,11,195,0,206,1980
BAJA CALIFORNIA SUR,SAN JOSE DEL CABO,7,195,0,202,1980
BAJA CALIFORNIA SUR,SAN JOSE DEL CABO,18,213,1,232,1980
BAJA CALIFORNIA SUR,SAN JOSE DEL CABO,13,202,4,219,1980
BAJA CALIFORNIA SUR,SAN JOSE DEL CABO,11,213,0,224,1980
BAJA CALIFORNIA SUR,SAN JOSE DEL CABO,13,215,2,230,1980
BAJA CALIFORNIA SUR,SAN JOSE DEL CABO,13,194,3,210,1979
BAJA CALIFORNIA SUR,SAN JOSE DEL CABO,10,212,0,222,1979
BAJA CALIFORNIA SUR,SAN JOSE DEL CABO,10,244,1,255,1719
BAJA CALIFORNIA SUR,SAN JOSE DEL CABO,11,241,2,254,1718
BAJA CALIFORNIA SUR,SAN JOSE DEL CABO,15,241,2,258,1484
BAJA CALIFORNIA SUR,SAN JOSE DEL CABO,13,205,2,220,1484
BAJA CALIFORNIA SUR,SAN JOSE DEL CABO,17,191,1,209,1484
BAJA CALIFORNIA SUR,SAN JOSE DEL CABO,10,288,5,303,1754
BAJA CALIFORNIA SUR,SAN JOSE DEL CABO,5,307,11,323,1753
BAJA CALIFORNIA SUR,SAN JOSE DEL CABO,8,334,4,346,1753
BAJA CALIFORNIA SUR,SAN JOSE DEL CABO,19,278,4,301,1753
BAJA CALIFORNIA SUR,SAN JOSE DEL CABO,7,269,1,277,1424
BAJA CALIFORNIA SUR,SAN JOSE DEL CABO,5,267,5,277,1424
BAJA CALIFORNIA SUR,SAN JOSE DEL CABO,8,223,2,233,1424
BAJA CALIFORNIA SUR,SAN JOSE DEL CABO,14,244,4,262,1808
BAJA CALIFORNIA SUR,SAN JOSE DEL CABO,8,255,2,265,1808
BAJA CALIFORNIA SUR,SAN JOSE DEL CABO,6,222,2,230,1808
BAJA CALIFORNIA SUR,SAN JOSE DEL CABO,10,268,6,284,1807
BAJA CALIFORNIA SUR,SAN JOSE DEL CABO,13,213,1,227,1807
BAJA CALIFORNIA SUR,SAN JOSE DEL CABO,11,231,4,246,1785
BAJA CALIFORNIA SUR,SAN JOSE DEL CABO,10,234,2,246,1785
BAJA CALIFORNIA SUR,SAN JOSE DEL CABO,2,210,4,216,1785
BAJA CALIFORNIA SUR,SAN JOSE DEL CABO,12,235,2,249,1785
BAJA CALIFORNIA SUR,SAN JOSE DEL CABO,4,234,1,239,1785
BAJA CALIFORNIA SUR,SAN JOSE DEL CABO,11,61,0,72,1462
BAJA CALIFORNIA SUR,SAN JOSE DEL CABO,15,66,0,81,1461
BAJA CALIFORNIA SUR,SAN JOSE DEL CABO,19,53,0,72,1461
BAJA CALIFORNIA SUR,SAN JOSE DEL CABO,12,181,1,194,1752
BAJA CALIFORNIA SUR,SAN JOSE DEL CABO,9,200,1,210,1752
BAJA CALIFORNIA SUR,SAN JOSE DEL CABO,11,251,2,264,1952
BAJA CALIFORNIA SUR,SAN JOSE DEL CABO,13,229,1,243,1952
BAJA CALIFORNIA SUR,SAN JOSE DEL CABO,9,191,1,201,1961
BAJA CALIFORNIA SUR,SAN JOSE DEL CABO,11,211,5,227,1961
BAJA CALIFORNIA SUR,SAN JOSE DEL CABO,14,213,1,228,1655
BAJA CALIFORNIA SUR,SAN JOSE DEL CABO,17,198,8,223,1655
BAJA CALIFORNIA SUR,SAN JOSE DEL CABO,7,239,5,251,1759
BAJA CALIFORNIA SUR,SAN JOSE DEL CABO,10,230,3,243,1759
BAJA CALIFORNIA SUR,SAN JOSE DEL CABO,8,223,1,232,1738
BAJA CALIFORNIA SUR,SAN JOSE DEL CABO,9,201,0,210,1738
BAJA CALIFORNIA SUR,SAN JOSE DEL CABO,9,207,3,219,1453
BAJA CALIFORNIA SUR,SAN JOSE DEL CABO,14,181,2,197,1453
BAJA CALIFORNIA SUR,SAN JOSE DEL CABO,11,215,0,226,1785
BAJA CALIFORNIA SUR,SAN JOSE DEL CABO,11,240,1,252,1785
BAJA CALIFORNIA SUR,SAN JOSE DEL CABO,7,165,2,174,1785
BAJA CALIFORNIA SUR,SAN JOSE DEL CABO,10,193,1,204,1784
BAJA CALIFORNIA SUR,SAN JOSE DEL CABO,16,209,3,228,1784
BAJA CALIFORNIA SUR,SAN JOSE DEL CABO,11,221,2,234,1814
BAJA CALIFORNIA SUR,SAN JOSE DEL CABO,15,224,3,242,1813
BAJA CALIFORNIA SUR,SAN JOSE DEL CABO,9,199,0,208,1377
BAJA CALIFORNIA SUR,SAN JOSE DEL CABO,11,183,1,195,1376
BAJA CALIFORNIA SUR,SAN JOSE DEL CABO,6,234,3,243,1778
BAJA CALIFORNIA SUR,SAN JOSE DEL CABO,6,262,5,273,1777
BAJA CALIFORNIA SUR,SAN JOSE DEL CABO,6,254,0,260,1777
BAJA CALIFORNIA SUR,SAN JOSE DEL CABO,5,266,2,273,1777
BAJA CALIFORNIA SUR,SAN JOSE DEL CABO,5,302,3,310,2003
BAJA CALIFORNIA SUR,SAN JOSE DEL CABO,6,314,5,325,2003
BAJA CALIFORNIA SUR,SAN JOSE DEL CABO,7,198,1,206,1392
BAJA CALIFORNIA SUR,SAN JOSE DEL CABO,10,203,0,213,1391
BAJA CALIFORNIA SUR,SAN JOSE DEL CABO,1,167,4,172,1065
BAJA CALIFORNIA SUR,SAN JOSE DEL CABO,3,158,1,162,1065
BAJA CALIFORNIA SUR,SAN JOSE DEL CABO,11,281,6,298,1980
BAJA CALIFORNIA SUR,SAN JOSE DEL CABO,9,307,3,319,1980
BAJA CALIFORNIA SUR,SAN JOSE DEL CABO,7,351,2,360,2155
BAJA CALIFORNIA SUR,SAN JOSE DEL CABO,7,322,6,335,2155
BAJA CALIFORNIA SUR,SAN JOSE DEL CABO,7,188,2,197,1389
BAJA CALIFORNIA SUR,SAN JOSE DEL CABO,6,185,2,193,1389
BAJA CALIFORNIA SUR,SAN JOSE DEL CABO,10,295,2,307,1951
BAJA CALIFORNIA SUR,SAN JOSE DEL CABO,9,279,2,290,1950
BAJA CALIFORNIA SUR,SAN JOSE DEL CABO,2,245,5,252,1580
BAJA CALIFORNIA SUR,SAN JOSE DEL CABO,7,216,1,224,1579
BAJA CALIFORNIA SUR,SAN JOSE DEL CABO,8,188,0,196,1512
BAJA CALIFORNIA SUR,SAN JOSE DEL CABO,8,171,0,179,1511
BAJA CALIFORNIA SUR,SAN JOSE DEL CABO,0,252,7,259,1526
BAJA CALIFORNIA SUR,SAN JOSE DEL CABO,5,218,4,227,1525
BAJA CALIFORNIA SUR,SAN JOSE DEL CABO,9,226,1,236,1900
BAJA CALIFORNIA SUR,SAN JOSE DEL CABO,7,228,1,236,1899
BAJA CALIFORNIA SUR,SAN JOSE DEL CABO,4,212,1,217,1450
BAJA CALIFORNIA SUR,SAN JOSE DEL CABO,2,228,1,231,1450
BAJA CALIFORNIA SUR,SAN JOSE DEL CABO,4,148,2,154,1900
BAJA CALIFORNIA SUR,SAN JOSE DEL CABO,8,284,0,292,1899
BAJA CALIFORNIA SUR,SAN JOSE DEL CABO,5,267,4,276,1798
BAJA CALIFORNIA SUR,SAN JOSE DEL CABO,9,281,3,293,1798
BAJA CALIFORNIA SUR,SAN JOSE DEL CABO,8,266,5,279,1801
BAJA CALIFORNIA SUR,SAN JOSE DEL CABO,11,255,2,268,1800
BAJA CALIFORNIA SUR,SAN JOSE DEL CABO,8,220,1,229,1692
BAJA CALIFORNIA SUR,SAN JOSE DEL CABO,5,256,1,262,1691
BAJA CALIFORNIA SUR,SAN JOSE DEL CABO,13,234,5,252,1921
BAJA CALIFORNIA SUR,SAN JOSE DEL CABO,14,199,3,216,1920
BAJA CALIFORNIA SUR,SAN JOSE DEL CABO,0,193,1,194,1497
BAJA CALIFORNIA SUR,SAN JOSE DEL CABO,8,203,3,214,1497
BAJA CALIFORNIA SUR,SAN JOSE DEL CABO,9,176,1,186,1496
BAJA CALIFORNIA SUR,SAN JOSE DEL CABO,22,180,0,202,1856
BAJA CALIFORNIA SUR,SAN JOSE DEL CABO,12,207,0,219,1856
BAJA CALIFORNIA SUR,SAN JOSE DEL CABO,112,1464,12,1588,0
BAJA CALIFORNIA SUR,SAN JOSE DEL CABO,8,120,0,128,1222
BAJA CALIFORNIA SUR,SAN JOSE DEL CABO,7,132,0,139,1222
BAJA CALIFORNIA SUR,SAN JOSE DEL CABO,9,230,2,241,1647
BAJA CALIFORNIA SUR,SAN JOSE DEL CABO,12,263,3,278,1646
BAJA CALIFORNIA SUR,SAN JOSE DEL CABO,11,227,2,240,1888
BAJA CALIFORNIA SUR,SAN JOSE DEL CABO,17,203,3,223,1888
BAJA CALIFORNIA SUR,SAN JOSE DEL CABO,11,240,3,254,1888
BAJA CALIFORNIA SUR,SAN JOSE DEL CABO,8,210,1,219,1763
BAJA CALIFORNIA SUR,SAN JOSE DEL CABO,6,207,0,213,1762
BAJA CALIFORNIA SUR,SAN JOSE DEL CABO,8,166,2,176,1202
BAJA CALIFORNIA SUR,SAN JOSE DEL CABO,17,127,1,145,1145
BAJA CALIFORNIA SUR,SAN JOSE DEL CABO,18,134,0,152,1145
BAJA CALIFORNIA SUR,SAN JOSE DEL CABO,7,203,4,214,2065
BAJA CALIFORNIA SUR,SAN JOSE DEL CABO,6,195,4,205,2065
BAJA CALIFORNIA SUR,SAN JOSE DEL CABO,15,227,5,247,2065
BAJA CALIFORNIA SUR,SAN JOSE DEL CABO,4,213,3,220,1750
BAJA CALIFORNIA SUR,SAN JOSE DEL CABO,9,204,4,217,1750
BAJA CALIFORNIA SUR,SAN JOSE DEL CABO,5,233,0,238,1899
BAJA CALIFORNIA SUR,SAN JOSE DEL CABO,16,218,2,236,1898
BAJA CALIFORNIA SUR,SAN JOSE DEL CABO,2,243,3,248,1791
BAJA CALIFORNIA SUR,SAN JOSE DEL CABO,3,219,1,223,1790
BAJA CALIFORNIA SUR,SAN JOSE DEL CABO,4,226,2,232,1852
BAJA CALIFORNIA SUR,SAN JOSE DEL CABO,11,220,0,231,1852
BAJA CALIFORNIA SUR,SAN JOSE DEL CABO,4,190,1,195,1471
BAJA CALIFORNIA SUR,SAN JOSE DEL CABO,5,143,2,150,1471
BAJA CALIFORNIA SUR,SAN JOSE DEL CABO,10,195,2,207,1742
BAJA CALIFORNIA SUR,SAN JOSE DEL CABO,8,203,2,213,1742
BAJA CALIFORNIA SUR,SAN JOSE DEL CABO,3,229,2,234,1742
CAMPECHE,SAN FRANCISCO DE CAMPECHE,34,459,8,501,1736
CAMPECHE,SAN FRANCISCO DE CAMPECHE,47,418,8,473,1735
CAMPECHE,SAN FRANCISCO DE CAMPECHE,22,267,3,292,1776
CAMPECHE,SAN FRANCISCO DE CAMPECHE,19,272,9,300,1775
CAMPECHE,SAN FRANCISCO DE CAMPECHE,20,260,4,284,1775
CAMPECHE,SAN FRANCISCO DE CAMPECHE,20,273,4,297,1775
CAMPECHE,SAN FRANCISCO DE CAMPECHE,10,239,2,251,1775
CAMPECHE,SAN FRANCISCO DE CAMPECHE,9,265,1,275,1775
CAMPECHE,SAN FRANCISCO DE CAMPECHE,33,267,0,300,1093
CAMPECHE,SAN FRANCISCO DE CAMPECHE,27,294,2,323,1093
CAMPECHE,SAN FRANCISCO DE CAMPECHE,33,332,8,373,1546
CAMPECHE,SAN FRANCISCO DE CAMPECHE,32,323,3,358,1545
CAMPECHE,SAN FRANCISCO DE CAMPECHE,45,324,5,374,1545
CAMPECHE,SAN FRANCISCO DE CAMPECHE,44,556,4,604,1567
CAMPECHE,SAN FRANCISCO DE CAMPECHE,37,402,7,446,1566
CAMPECHE,SAN FRANCISCO DE CAMPECHE,25,439,16,480,1946
CAMPECHE,SAN FRANCISCO DE CAMPECHE,20,415,12,447,1945
CAMPECHE,SAN FRANCISCO DE CAMPECHE,8,396,1,405,1872
CAMPECHE,SAN FRANCISCO DE CAMPECHE,23,392,3,418,1872
CAMPECHE,SAN FRANCISCO DE CAMPECHE,39,387,4,430,1871
CAMPECHE,SAN FRANCISCO DE CAMPECHE,11,309,2,322,1671
CAMPECHE,SAN FRANCISCO DE CAMPECHE,0,323,5,328,1671
CAMPECHE,SAN FRANCISCO DE CAMPECHE,18,300,1,319,1393
CAMPECHE,SAN FRANCISCO DE CAMPECHE,16,293,0,309,1393
CAMPECHE,SAN FRANCISCO DE CAMPECHE,14,308,7,329,1393
CAMPECHE,SAN FRANCISCO DE CAMPECHE,18,281,3,302,1299
CAMPECHE,SAN FRANCISCO DE CAMPECHE,20,295,7,322,1298
CAMPECHE,SAN FRANCISCO DE CAMPECHE,57,473,14,544,1825
CAMPECHE,SAN FRANCISCO DE CAMPECHE,57,480,2,539,1824
CAMPECHE,SAN FRANCISCO DE CAMPECHE,47,354,6,407,1568
CAMPECHE,SAN FRANCISCO DE CAMPECHE,50,351,3,404,1567
CAMPECHE,SAN FRANCISCO DE CAMPECHE,45,342,10,397,1567
CAMPECHE,SAN FRANCISCO DE CAMPECHE,22,381,5,408,1827
CAMPECHE,SAN FRANCISCO DE CAMPECHE,24,367,5,396,1827
CAMPECHE,SAN FRANCISCO DE CAMPECHE,16,417,5,438,1827
CAMPECHE,SAN FRANCISCO DE CAMPECHE,16,360,6,382,1906
CAMPECHE,SAN FRANCISCO DE CAMPECHE,12,358,7,377,1906
CAMPECHE,SAN FRANCISCO DE CAMPECHE,39,485,5,529,1913
CAMPECHE,SAN FRANCISCO DE CAMPECHE,34,498,7,539,1912
CAMPECHE,SAN FRANCISCO DE CAMPECHE,37,462,7,506,1878
CAMPECHE,SAN FRANCISCO DE CAMPECHE,45,424,7,476,1877
CAMPECHE,SAN FRANCISCO DE CAMPECHE,56,330,5,391,1553
CAMPECHE,SAN FRANCISCO DE CAMPECHE,38,337,5,380,1552
CAMPECHE,SAN FRANCISCO DE CAMPECHE,54,308,3,365,1552
CAMPECHE,SAN FRANCISCO DE CAMPECHE,68,1706,18,1792,0
CAMPECHE,SAN FRANCISCO DE CAMPECHE,36,366,2,404,1543
CAMPECHE,SAN FRANCISCO DE CAMPECHE,47,416,1,464,1542
CAMPECHE,SAN FRANCISCO DE CAMPECHE,38,398,7,443,1638
CAMPECHE,SAN FRANCISCO DE CAMPECHE,44,389,8,441,1638
CAMPECHE,SAN FRANCISCO DE CAMPECHE,30,513,7,550,1864
CAMPECHE,SAN FRANCISCO DE CAMPECHE,31,487,6,524,1864
CAMPECHE,SAN FRANCISCO DE CAMPECHE,48,256,8,312,1649
CAMPECHE,SAN FRANCISCO DE CAMPECHE,43,331,7,381,1648
CAMPECHE,SAN FRANCISCO DE CAMPECHE,41,358,3,402,1655
CAMPECHE,SAN FRANCISCO DE CAMPECHE,62,387,8,457,1655
CAMPECHE,SAN FRANCISCO DE CAMPECHE,40,356,9,405,1417
CAMPECHE,SAN FRANCISCO DE CAMPECHE,52,353,5,410,1416
CAMPECHE,SAN FRANCISCO DE CAMPECHE,54,365,10,429,1565
CAMPECHE,SAN FRANCISCO DE CAMPECHE,55,402,4,461,1564
CAMPECHE,SAN FRANCISCO DE CAMPECHE,20,330,2,352,1749
CAMPECHE,SAN FRANCISCO DE CAMPECHE,25,349,2,376,1749
CAMPECHE,SAN FRANCISCO DE CAMPECHE,32,302,3,337,1749
CAMPECHE,SAN FRANCISCO DE CAMPECHE,25,339,2,366,1748
CAMPECHE,SAN FRANCISCO DE CAMPECHE,25,372,3,400,1822
CAMPECHE,SAN FRANCISCO DE CAMPECHE,28,345,2,375,1822
CAMPECHE,SAN FRANCISCO DE CAMPECHE,15,327,2,344,1822
CAMPECHE,SAN FRANCISCO DE CAMPECHE,24,317,2,343,1822
CAMPECHE,SAN FRANCISCO DE CAMPECHE,29,367,3,399,1822
CAMPECHE,SAN FRANCISCO DE CAMPECHE,29,312,7,348,1822
CAMPECHE,SAN FRANCISCO DE CAMPECHE,27,322,3,352,1821
CAMPECHE,SAN FRANCISCO DE CAMPECHE,10,295,3,308,1407
CAMPECHE,SAN FRANCISCO DE CAMPECHE,25,233,3,261,1406
CAMPECHE,SAN FRANCISCO DE CAMPECHE,18,295,3,316,1406
CAMPECHE,SAN FRANCISCO DE CAMPECHE,29,335,4,368,1643
CAMPECHE,SAN FRANCISCO DE CAMPECHE,28,318,4,350,1643
CAMPECHE,SAN FRANCISCO DE CAMPECHE,29,328,7,364,1642
CAMPECHE,SAN FRANCISCO DE CAMPECHE,42,300,11,353,1762
CAMPECHE,SAN FRANCISCO DE CAMPECHE,49,362,11,422,1761
CAMPECHE,SAN FRANCISCO DE CAMPECHE,31,294,4,329,1729
CAMPECHE,SAN FRANCISCO DE CAMPECHE,24,359,2,385,1729
CAMPECHE,SAN FRANCISCO DE CAMPECHE,26,353,2,381,1767
CAMPECHE,SAN FRANCISCO DE CAMPECHE,32,410,3,445,1766
CAMPECHE,SAN FRANCISCO DE CAMPECHE,22,366,7,395,1622
CAMPECHE,SAN FRANCISCO DE CAMPECHE,25,389,9,423,1622
CAMPECHE,SAN FRANCISCO DE CAMPECHE,42,396,3,441,1791
CAMPECHE,SAN FRANCISCO DE CAMPECHE,43,360,9,412,1791
CAMPECHE,SAN FRANCISCO DE CAMPECHE,21,365,4,390,1625
CAMPECHE,SAN FRANCISCO DE CAMPECHE,20,350,0,370,1625
CAMPECHE,SAN FRANCISCO DE CAMPECHE,23,285,4,312,1150
CAMPECHE,SAN FRANCISCO DE CAMPECHE,13,260,4,277,1150
CAMPECHE,SAN FRANCISCO DE CAMPECHE,22,350,5,377,1481
CAMPECHE,SAN FRANCISCO DE CAMPECHE,25,360,6,391,1481
CAMPECHE,SAN FRANCISCO DE CAMPECHE,19,322,6,347,1481
CAMPECHE,SAN FRANCISCO DE CAMPECHE,12,261,4,277,1759
CAMPECHE,SAN FRANCISCO DE CAMPECHE,23,256,8,287,1759
CAMPECHE,SAN FRANCISCO DE CAMPECHE,20,290,12,322,1758
CAMPECHE,SAN FRANCISCO DE CAMPECHE,16,291,4,311,1758
CAMPECHE,SAN FRANCISCO DE CAMPECHE,37,372,8,417,1677
CAMPECHE,SAN FRANCISCO DE CAMPECHE,35,352,2,389,1677
CAMPECHE,SAN FRANCISCO DE CAMPECHE,16,267,3,286,1595
CAMPECHE,SAN FRANCISCO DE CAMPECHE,19,300,5,324,1595
CAMPECHE,SAN FRANCISCO DE CAMPECHE,25,292,9,326,1235
CAMPECHE,SAN FRANCISCO DE CAMPECHE,21,260,7,288,1234
CAMPECHE,SAN FRANCISCO DE CAMPECHE,30,263,3,296,1506
CAMPECHE,SAN FRANCISCO DE CAMPECHE,20,237,1,258,1505
CAMPECHE,SAN FRANCISCO DE CAMPECHE,24,266,3,293,1505
CAMPECHE,SAN FRANCISCO DE CAMPECHE,30,482,6,518,1674
CAMPECHE,SAN FRANCISCO DE CAMPECHE,23,488,6,517,1674
CAMPECHE,SAN FRANCISCO DE CAMPECHE,19,353,0,372,1255
CAMPECHE,SAN FRANCISCO DE CAMPECHE,18,334,6,358,1255
CAMPECHE,SAN FRANCISCO DE CAMPECHE,13,415,4,432,1621
CAMPECHE,SAN FRANCISCO DE CAMPECHE,17,461,2,480,1620
CAMPECHE,SAN FRANCISCO DE CAMPECHE,32,311,5,348,1465
CAMPECHE,SAN FRANCISCO DE CAMPECHE,36,334,4,374,1465
CAMPECHE,SAN FRANCISCO DE CAMPECHE,25,253,3,281,1599
CAMPECHE,SAN FRANCISCO DE CAMPECHE,19,268,3,290,1599
CAMPECHE,SAN FRANCISCO DE CAMPECHE,16,246,7,269,1599
CAMPECHE,SAN FRANCISCO DE CAMPECHE,5,211,1,217,1037
CAMPECHE,SAN FRANCISCO DE CAMPECHE,6,235,9,250,1036
CAMPECHE,SAN FRANCISCO DE CAMPECHE,8,277,11,296,1801
CAMPECHE,SAN FRANCISCO DE CAMPECHE,9,263,10,282,1801
CAMPECHE,SAN FRANCISCO DE CAMPECHE,4,305,7,316,1801
CAMPECHE,SAN FRANCISCO DE CAMPECHE,9,495,3,507,1507
CAMPECHE,SAN FRANCISCO DE CAMPECHE,9,419,3,431,1507
CAMPECHE,SAN FRANCISCO DE CAMPECHE,3,451,1,455,1506
CAMPECHE,SAN FRANCISCO DE CAMPECHE,10,367,5,382,1709
CAMPECHE,SAN FRANCISCO DE CAMPECHE,16,430,10,456,1709
CAMPECHE,SAN FRANCISCO DE CAMPECHE,10,319,8,337,1493
CAMPECHE,SAN FRANCISCO DE CAMPECHE,10,308,7,325,1493
CAMPECHE,SAN FRANCISCO DE CAMPECHE,5,344,5,354,1493
CAMPECHE,SAN FRANCISCO DE CAMPECHE,9,716,5,730,1865
CAMPECHE,SAN FRANCISCO DE CAMPECHE,8,697,11,716,1864
CAMPECHE,SAN FRANCISCO DE CAMPECHE,12,541,4,557,1416
CAMPECHE,SAN FRANCISCO DE CAMPECHE,17,566,0,583,1416
CAMPECHE,SAN FRANCISCO DE CAMPECHE,7,505,6,518,1416
CAMPECHE,SAN FRANCISCO DE CAMPECHE,10,575,3,588,1423
CAMPECHE,SAN FRANCISCO DE CAMPECHE,10,571,4,585,1422
CAMPECHE,SAN FRANCISCO DE CAMPECHE,8,604,4,616,1422
CAMPECHE,SAN FRANCISCO DE CAMPECHE,5,549,10,564,1602
CAMPECHE,SAN FRANCISCO DE CAMPECHE,6,556,5,567,1601
CAMPECHE,SAN FRANCISCO DE CAMPECHE,8,576,3,587,1816
CAMPECHE,SAN FRANCISCO DE CAMPECHE,13,602,2,617,1816
CAMPECHE,SAN FRANCISCO DE CAMPECHE,14,536,6,556,1815
CAMPECHE,SAN FRANCISCO DE CAMPECHE,14,733,9,756,1756
CAMPECHE,SAN FRANCISCO DE CAMPECHE,11,727,10,748,1755
CAMPECHE,SAN FRANCISCO DE CAMPECHE,11,535,1,547,1366
CAMPECHE,SAN FRANCISCO DE CAMPECHE,10,532,3,545,1366
CAMPECHE,SAN FRANCISCO DE CAMPECHE,9,507,5,521,1366
CAMPECHE,SAN FRANCISCO DE CAMPECHE,11,468,6,485,1332
CAMPECHE,SAN FRANCISCO DE CAMPECHE,13,364,10,387,1332
CAMPECHE,SAN FRANCISCO DE CAMPECHE,12,451,13,476,1332
CAMPECHE,SAN FRANCISCO DE CAMPECHE,8,562,17,587,1823
CAMPECHE,SAN FRANCISCO DE CAMPECHE,11,513,10,534,1823
CAMPECHE,SAN FRANCISCO DE CAMPECHE,7,592,14,613,1822
CAMPECHE,SAN FRANCISCO DE CAMPECHE,14,742,16,772,1938
CAMPECHE,SAN FRANCISCO DE CAMPECHE,19,736,14,769,1938
CAMPECHE,SAN FRANCISCO DE CAMPECHE,3,406,418,827,1017
CAMPECHE,SAN FRANCISCO DE CAMPECHE,7,285,9,301,1016
CAMPECHE,SAN FRANCISCO DE CAMPECHE,4,510,9,523,1187
CAMPECHE,SAN FRANCISCO DE CAMPECHE,13,504,10,527,1186
CAMPECHE,SAN FRANCISCO DE CAMPECHE,23,695,11,729,1565
CAMPECHE,SAN FRANCISCO DE CAMPECHE,22,708,15,745,1565
CAMPECHE,SAN FRANCISCO DE CAMPECHE,10,682,4,696,1547
CAMPECHE,SAN FRANCISCO DE CAMPECHE,12,716,11,739,1547
CAMPECHE,SAN FRANCISCO DE CAMPECHE,12,789,7,808,1668
CAMPECHE,SAN FRANCISCO DE CAMPECHE,14,738,5,757,1667
CAMPECHE,SAN FRANCISCO DE CAMPECHE,2,694,9,705,1959
CAMPECHE,SAN FRANCISCO DE CAMPECHE,9,733,4,746,1959
CAMPECHE,SAN FRANCISCO DE CAMPECHE,14,618,10,642,1187
CAMPECHE,SAN FRANCISCO DE CAMPECHE,23,645,10,678,1187
CAMPECHE,SAN FRANCISCO DE CAMPECHE,6,589,4,599,1479
CAMPECHE,SAN FRANCISCO DE CAMPECHE,9,625,5,639,1478
CAMPECHE,SAN FRANCISCO DE CAMPECHE,12,476,13,501,1757
CAMPECHE,SAN FRANCISCO DE CAMPECHE,10,463,9,482,1756
CAMPECHE,SAN FRANCISCO DE CAMPECHE,7,369,2,378,1677
CAMPECHE,SAN FRANCISCO DE CAMPECHE,3,368,4,375,1677
CAMPECHE,SAN FRANCISCO DE CAMPECHE,3,350,8,361,1677
CAMPECHE,SAN FRANCISCO DE CAMPECHE,9,393,10,412,1998
CAMPECHE,SAN FRANCISCO DE CAMPECHE,11,437,15,463,1997
CAMPECHE,SAN FRANCISCO DE CAMPECHE,6,276,2,284,1003
CAMPECHE,SAN FRANCISCO DE CAMPECHE,9,296,2,307,1002
CAMPECHE,SAN FRANCISCO DE CAMPECHE,10,483,10,503,1614
CAMPECHE,SAN FRANCISCO DE CAMPECHE,7,416,9,432,1614
CAMPECHE,SAN FRANCISCO DE CAMPECHE,11,373,8,392,1642
CAMPECHE,SAN FRANCISCO DE CAMPECHE,6,314,5,325,1641
CAMPECHE,SAN FRANCISCO DE CAMPECHE,9,460,7,476,1641
CAMPECHE,SAN FRANCISCO DE CAMPECHE,15,344,6,365,1641
CAMPECHE,SAN FRANCISCO DE CAMPECHE,14,510,5,529,1430
CAMPECHE,SAN FRANCISCO DE CAMPECHE,5,424,5,434,1430
CAMPECHE,SAN FRANCISCO DE CAMPECHE,7,497,21,525,1430
CAMPECHE,SAN FRANCISCO DE CAMPECHE,26,717,23,766,1874
CAMPECHE,SAN FRANCISCO DE CAMPECHE,28,749,13,790,1873
CAMPECHE,SAN FRANCISCO DE CAMPECHE,7,521,9,537,1122
CAMPECHE,SAN FRANCISCO DE CAMPECHE,8,498,10,516,1121
CAMPECHE,SAN FRANCISCO DE CAMPECHE,8,491,5,504,1496
CAMPECHE,SAN FRANCISCO DE CAMPECHE,9,511,10,530,1496
CAMPECHE,SAN FRANCISCO DE CAMPECHE,10,464,6,480,1495
CAMPECHE,SAN FRANCISCO DE CAMPECHE,22,661,22,705,1527
CAMPECHE,SAN FRANCISCO DE CAMPECHE,14,663,14,691,1527
CAMPECHE,SAN FRANCISCO DE CAMPECHE,12,643,21,676,1527
CAMPECHE,SAN FRANCISCO DE CAMPECHE,14,464,3,481,995
CAMPECHE,SAN FRANCISCO DE CAMPECHE,9,487,9,505,994
CAMPECHE,SAN FRANCISCO DE CAMPECHE,14,800,10,824,1976
CAMPECHE,SAN FRANCISCO DE CAMPECHE,22,805,28,855,1975
CAMPECHE,SAN FRANCISCO DE CAMPECHE,14,546,12,572,1651
CAMPECHE,SAN FRANCISCO DE CAMPECHE,13,519,19,551,1651
CAMPECHE,SAN FRANCISCO DE CAMPECHE,14,472,5,491,1689
CAMPECHE,SAN FRANCISCO DE CAMPECHE,12,468,3,483,1689
CAMPECHE,CIUDAD DEL CARMEN,9,348,2,359,1862
CAMPECHE,CIUDAD DEL CARMEN,13,361,1,375,1861
CAMPECHE,CIUDAD DEL CARMEN,9,299,4,312,1861
CAMPECHE,CIUDAD DEL CARMEN,12,266,3,281,1861
CAMPECHE,CIUDAD DEL CARMEN,9,336,1,346,1629
CAMPECHE,CIUDAD DEL CARMEN,12,360,1,373,1629
CAMPECHE,CIUDAD DEL CARMEN,11,322,3,336,1628
CAMPECHE,CIUDAD DEL CARMEN,7,458,5,470,1815
CAMPECHE,CIUDAD DEL CARMEN,8,407,4,419,1815
CAMPECHE,CIUDAD DEL CARMEN,10,297,2,309,1518
CAMPECHE,CIUDAD DEL CARMEN,2,336,2,340,1518
CAMPECHE,CIUDAD DEL CARMEN,0,290,0,290,1517
CAMPECHE,CIUDAD DEL CARMEN,18,295,4,317,1574
CAMPECHE,CIUDAD DEL CARMEN,20,290,0,310,1574
CAMPECHE,CIUDAD DEL CARMEN,13,334,4,351,1380
CAMPECHE,CIUDAD DEL CARMEN,9,360,7,376,1379
CAMPECHE,CIUDAD DEL CARMEN,11,360,1,372,1649
CAMPECHE,CIUDAD DEL CARMEN,3,348,3,354,1649
CAMPECHE,CIUDAD DEL CARMEN,9,309,1,319,1301
CAMPECHE,CIUDAD DEL CARMEN,8,293,2,303,1300
CAMPECHE,CIUDAD DEL CARMEN,20,428,1,449,1788
CAMPECHE,CIUDAD DEL CARMEN,11,404,2,417,1787
CAMPECHE,CIUDAD DEL CARMEN,11,411,2,424,1540
CAMPECHE,CIUDAD DEL CARMEN,2,366,2,370,1539
CAMPECHE,CIUDAD DEL CARMEN,10,401,4,415,1657
CAMPECHE,CIUDAD DEL CARMEN,2,408,0,410,1657
CAMPECHE,CIUDAD DEL CARMEN,5,417,1,423,1656
CAMPECHE,CIUDAD DEL CARMEN,15,330,4,349,1532
CAMPECHE,CIUDAD DEL CARMEN,18,309,4,331,1532
CAMPECHE,CIUDAD DEL CARMEN,14,383,4,401,1859
CAMPECHE,CIUDAD DEL CARMEN,9,404,3,416,1858
CAMPECHE,CIUDAD DEL CARMEN,18,338,3,359,1483
CAMPECHE,CIUDAD DEL CARMEN,16,318,4,338,1482
CAMPECHE,CIUDAD DEL CARMEN,8,424,1,433,1877
CAMPECHE,CIUDAD DEL CARMEN,11,422,6,439,1876
CAMPECHE,CIUDAD DEL CARMEN,11,357,3,371,1492
CAMPECHE,CIUDAD DEL CARMEN,15,314,1,330,1492
CAMPECHE,CIUDAD DEL CARMEN,13,329,1,343,1492
CAMPECHE,CIUDAD DEL CARMEN,57,1930,14,2001,0
CAMPECHE,CIUDAD DEL CARMEN,12,395,1,408,1552
CAMPECHE,CIUDAD DEL CARMEN,13,372,3,388,1551
CAMPECHE,CIUDAD DEL CARMEN,10,406,5,421,1738
CAMPECHE,CIUDAD DEL CARMEN,5,370,3,378,1738
CAMPECHE,CIUDAD DEL CARMEN,0,363,2,365,1641
CAMPECHE,CIUDAD DEL CARMEN,5,390,6,401,1641
CAMPECHE,CIUDAD DEL CARMEN,9,345,3,357,1641
CAMPECHE,CIUDAD DEL CARMEN,9,310,1,320,1640
CAMPECHE,CIUDAD DEL CARMEN,8,262,4,274,1132
CAMPECHE,CIUDAD DEL CARMEN,2,328,1,331,1132
CAMPECHE,CIUDAD DEL CARMEN,17,407,7,431,1906
CAMPECHE,CIUDAD DEL CARMEN,8,414,0,422,1905
CAMPECHE,CIUDAD DEL CARMEN,5,396,2,403,1605
CAMPECHE,CIUDAD DEL CARMEN,9,387,0,396,1604
CAMPECHE,CIUDAD DEL CARMEN,0,417,0,417,1854
CAMPECHE,CIUDAD DEL CARMEN,2,416,2,420,1854
CAMPECHE,CIUDAD DEL CARMEN,9,279,4,292,998
CAMPECHE,CIUDAD DEL CARMEN,6,261,7,274,997
CAMPECHE,CIUDAD DEL CARMEN,8,335,2,345,1507
CAMPECHE,CIUDAD DEL CARMEN,4,344,0,348,1507
CAMPECHE,CIUDAD DEL CARMEN,19,459,1,479,1885
CAMPECHE,CIUDAD DEL CARMEN,5,391,2,398,1884
CAMPECHE,CIUDAD DEL CARMEN,5,362,2,369,1666
CAMPECHE,CIUDAD DEL CARMEN,3,329,3,335,1666
CAMPECHE,CIUDAD DEL CARMEN,6,315,1,322,1666
CAMPECHE,CIUDAD DEL CARMEN,3,363,5,371,1665
CAMPECHE,CIUDAD DEL CARMEN,2,328,2,332,1665
CAMPECHE,CIUDAD DEL CARMEN,7,355,6,368,1537
CAMPECHE,CIUDAD DEL CARMEN,11,348,3,362,1536
CAMPECHE,CIUDAD DEL CARMEN,4,345,4,353,1324
CAMPECHE,CIUDAD DEL CARMEN,10,323,6,339,1324
CAMPECHE,CIUDAD DEL CARMEN,4,335,5,344,1630
CAMPECHE,CIUDAD DEL CARMEN,9,346,1,356,1630
CAMPECHE,CIUDAD DEL CARMEN,9,340,6,355,1627
CAMPECHE,CIUDAD DEL CARMEN,6,299,5,310,1627
CAMPECHE,CIUDAD DEL CARMEN,4,307,1,312,1626
CAMPECHE,CIUDAD DEL CARMEN,16,505,12,533,1889
CAMPECHE,CIUDAD DEL CARMEN,17,538,3,558,1888
CAMPECHE,CIUDAD DEL CARMEN,4,233,4,241,1182
CAMPECHE,CIUDAD DEL CARMEN,1,247,6,254,1181
CAMPECHE,CIUDAD DEL CARMEN,1,349,4,354,1635
CAMPECHE,CIUDAD DEL CARMEN,8,333,2,343,1634
CAMPECHE,CIUDAD DEL CARMEN,18,420,7,445,1842
CAMPECHE,CIUDAD DEL CARMEN,10,412,7,429,1842
CAMPECHE,CIUDAD DEL CARMEN,5,402,2,409,1841
CAMPECHE,CIUDAD DEL CARMEN,8,562,7,577,1856
CAMPECHE,CIUDAD DEL CARMEN,11,535,5,551,1856
CAMPECHE,CIUDAD DEL CARMEN,11,567,4,582,1856
CAMPECHE,CIUDAD DEL CARMEN,12,642,6,660,1778
CAMPECHE,CIUDAD DEL CARMEN,19,542,9,570,1777
CAMPECHE,CIUDAD DEL CARMEN,9,478,1,488,1476
CAMPECHE,CIUDAD DEL CARMEN,7,448,0,455,1475
CAMPECHE,CIUDAD DEL CARMEN,2,308,5,315,1011
CAMPECHE,CIUDAD DEL CARMEN,5,335,8,348,1010
CAMPECHE,CIUDAD DEL CARMEN,8,455,10,473,1694
CAMPECHE,CIUDAD DEL CARMEN,10,451,3,464,1694
CAMPECHE,CIUDAD DEL CARMEN,7,488,15,510,1693
CAMPECHE,CIUDAD DEL CARMEN,5,376,5,386,1540
CAMPECHE,CIUDAD DEL CARMEN,8,386,4,398,1539
CAMPECHE,CIUDAD DEL CARMEN,4,400,2,406,1539
CAMPECHE,CIUDAD DEL CARMEN,6,423,8,437,1894
CAMPECHE,CIUDAD DEL CARMEN,12,484,11,507,1893
CAMPECHE,CIUDAD DEL CARMEN,2,422,9,433,1927
CAMPECHE,CIUDAD DEL CARMEN,3,430,8,441,1926
CAMPECHE,CIUDAD DEL CARMEN,6,403,10,419,1164
CAMPECHE,CIUDAD DEL CARMEN,8,410,12,430,1164
CAMPECHE,CIUDAD DEL CARMEN,14,549,9,572,1734
CAMPECHE,CIUDAD DEL CARMEN,12,578,14,604,1733
CAMPECHE,CIUDAD DEL CARMEN,8,461,8,477,1733
CAMPECHE,CIUDAD DEL CARMEN,9,471,1,481,1174
CAMPECHE,CIUDAD DEL CARMEN,6,426,5,437,1173
CAMPECHE,CIUDAD DEL CARMEN,11,624,5,640,1403
CAMPECHE,CIUDAD DEL CARMEN,13,626,2,641,1403
CAMPECHE,CIUDAD DEL CARMEN,21,693,4,718,1402
CAMPECHE,CIUDAD DEL CARMEN,14,501,8,523,1709
CAMPECHE,CIUDAD DEL CARMEN,15,490,4,509,1708
CAMPECHE,CIUDAD DEL CARMEN,7,405,7,419,1754
CAMPECHE,CIUDAD DEL CARMEN,7,397,1,405,1754
CAMPECHE,CIUDAD DEL CARMEN,11,410,7,428,1933
CAMPECHE,CIUDAD DEL CARMEN,6,415,4,425,1933
CAMPECHE,CIUDAD DEL CARMEN,4,332,4,340,1378
CAMPECHE,CIUDAD DEL CARMEN,12,336,5,353,1377
CAMPECHE,CIUDAD DEL CARMEN,1,351,0,352,1377
CAMPECHE,CIUDAD DEL CARMEN,14,315,12,341,1569
CAMPECHE,CIUDAD DEL CARMEN,5,340,6,351,1568
CAMPECHE,CIUDAD DEL CARMEN,4,301,2,307,1568
CAMPECHE,CIUDAD DEL CARMEN,4,335,1,340,1568
CAMPECHE,CIUDAD DEL CARMEN,7,439,4,450,1339
CAMPECHE,CIUDAD DEL CARMEN,14,390,2,406,1339
CAMPECHE,CIUDAD DEL CARMEN,13,433,7,453,1338
CAMPECHE,CIUDAD DEL CARMEN,11,468,2,481,1336
CAMPECHE,CIUDAD DEL CARMEN,11,474,4,489,1335
CAMPECHE,CIUDAD DEL CARMEN,16,497,2,515,1335
CAMPECHE,CIUDAD DEL CARMEN,11,532,5,548,1618
CAMPECHE,CIUDAD DEL CARMEN,9,481,3,493,1617
CAMPECHE,CIUDAD DEL CARMEN,10,302,3,315,1216
CAMPECHE,CIUDAD DEL CARMEN,5,270,5,280,1216
CAMPECHE,CIUDAD DEL CARMEN,10,570,10,590,1603
CAMPECHE,CIUDAD DEL CARMEN,19,555,14,588,1603
CAMPECHE,CIUDAD DEL CARMEN,14,580,16,610,1602
CAMPECHE,CIUDAD DEL CARMEN,7,390,5,402,1436
CAMPECHE,CIUDAD DEL CARMEN,6,364,4,374,1436
CAMPECHE,CIUDAD DEL CARMEN,9,441,5,455,1436
CAMPECHE,CIUDAD DEL CARMEN,11,430,10,451,1669
CAMPECHE,CIUDAD DEL CARMEN,1,832,7,840,1668
CAMPECHE,CIUDAD DEL CARMEN,3,754,4,761,1668
CAMPECHE,CIUDAD DEL CARMEN,11,567,14,592,1789
CAMPECHE,CIUDAD DEL CARMEN,15,527,15,557,1788
CAMPECHE,CIUDAD DEL CARMEN,9,512,11,532,1413
CAMPECHE,CIUDAD DEL CARMEN,10,514,12,536,1413
CAMPECHE,CIUDAD DEL CARMEN,10,470,9,489,1413
CAMPECHE,CIUDAD DEL CARMEN,11,443,7,461,1412
CAMPECHE,CIUDAD DEL CARMEN,6,443,11,460,1412
CAMPECHE,CIUDAD DEL CARMEN,7,463,6,476,1411
CAMPECHE,CIUDAD DEL CARMEN,0,645,9,654,1750
CAMPECHE,CIUDAD DEL CARMEN,6,672,3,681,1749
CAMPECHE,CIUDAD DEL CARMEN,3,573,3,579,1749
CAMPECHE,CIUDAD DEL CARMEN,0,438,1,439,1084
CAMPECHE,CIUDAD DEL CARMEN,4,303,2,309,1084
CAMPECHE,CIUDAD DEL CARMEN,10,405,3,418,1627
CAMPECHE,CIUDAD DEL CARMEN,7,375,4,386,1627
CAMPECHE,CIUDAD DEL CARMEN,10,448,4,462,1751
CAMPECHE,CIUDAD DEL CARMEN,21,427,3,451,1750
CAMPECHE,CIUDAD DEL CARMEN,10,384,5,399,1578
CAMPECHE,CIUDAD DEL CARMEN,14,387,3,404,1578
CAMPECHE,CIUDAD DEL CARMEN,19,441,2,462,1845
CAMPECHE,CIUDAD DEL CARMEN,10,394,6,410,1844
CAMPECHE,CIUDAD DEL CARMEN,17,409,11,437,1671
CAMPECHE,CIUDAD DEL CARMEN,11,403,8,422,1671
CAMPECHE,CIUDAD DEL CARMEN,11,420,7,438,1671
CAMPECHE,CIUDAD DEL CARMEN,14,460,23,497,1963
CAMPECHE,CIUDAD DEL CARMEN,12,591,11,614,1956
CAMPECHE,CIUDAD DEL CARMEN,7,570,8,585,1955
CAMPECHE,CIUDAD DEL CARMEN,16,506,10,532,1872
CAMPECHE,CIUDAD DEL CARMEN,0,338,7,345,1279
CAMPECHE,CIUDAD DEL CARMEN,12,299,4,315,1279
CAMPECHE,CIUDAD DEL CARMEN,8,353,3,364,1280
CAMPECHE,CIUDAD DEL CARMEN,7,344,3,354,1279
CAMPECHE,CIUDAD DEL CARMEN,10,495,6,511,1709
CAMPECHE,CIUDAD DEL CARMEN,5,478,7,490,1709
CAMPECHE,CIUDAD DEL CARMEN,5,453,7,465,1708
CAMPECHE,CIUDAD DEL CARMEN,9,381,16,406,1796
CAMPECHE,CIUDAD DEL CARMEN,12,431,12,455,1795
CAMPECHE,CIUDAD DEL CARMEN,13,400,8,421,1795
CAMPECHE,CIUDAD DEL CARMEN,12,387,8,407,1841
CAMPECHE,CIUDAD DEL CARMEN,21,383,5,409,1840
CAMPECHE,CIUDAD DEL CARMEN,18,272,0,290,1703
CAMPECHE,CIUDAD DEL CARMEN,9,284,4,297,1703
CAMPECHE,CIUDAD DEL CARMEN,9,316,0,325,1702
CAMPECHE,CIUDAD DEL CARMEN,16,296,0,312,1702
CAMPECHE,CIUDAD DEL CARMEN,18,321,2,341,1907
CAMPECHE,CIUDAD DEL CARMEN,14,361,2,377,1907
CAMPECHE,CIUDAD DEL CARMEN,23,313,1,337,1907
CAMPECHE,CIUDAD DEL CARMEN,14,332,0,346,1907
CAMPECHE,CIUDAD DEL CARMEN,10,318,0,328,1907
CAMPECHE,CIUDAD DEL CARMEN,13,313,0,326,1906
CAMPECHE,CIUDAD DEL CARMEN,13,369,1,383,1696
CAMPECHE,CIUDAD DEL CARMEN,4,367,2,373,1696
CAMPECHE,CIUDAD DEL CARMEN,5,356,1,362,1696
CAMPECHE,CIUDAD DEL CARMEN,10,339,4,353,1696
CAMPECHE,CIUDAD DEL CARMEN,6,454,2,462,1400
CAMPECHE,CIUDAD DEL CARMEN,10,448,9,467,1400
CAMPECHE,CIUDAD DEL CARMEN,9,513,5,527,1377
CAMPECHE,CIUDAD DEL CARMEN,12,519,12,543,1377
CAMPECHE,CIUDAD DEL CARMEN,2,448,19,469,1973
CAMPECHE,CIUDAD DEL CARMEN,8,491,3,502,1973
CAMPECHE,CIUDAD DEL CARMEN,15,406,10,431,1090
CAMPECHE,CIUDAD DEL CARMEN,6,388,4,398,1089
COAHUILA,PIEDRAS NEGRAS,8,303,2,313,1826
COAHUILA,PIEDRAS NEGRAS,11,328,3,342,1825
COAHUILA,PIEDRAS NEGRAS,8,319,6,333,1808
COAHUILA,PIEDRAS NEGRAS,8,318,0,326,1808
COAHUILA,PIEDRAS NEGRAS,4,361,1,366,1808
COAHUILA,PIEDRAS NEGRAS,10,269,3,282,1826
COAHUILA,PIEDRAS NEGRAS,14,266,2,282,1826
COAHUILA,PIEDRAS NEGRAS,2,307,2,311,1808
COAHUILA,PIEDRAS NEGRAS,10,279,1,290,1807
COAHUILA,PIEDRAS NEGRAS,5,312,0,317,1807
COAHUILA,PIEDRAS NEGRAS,4,310,3,317,1807
COAHUILA,PIEDRAS NEGRAS,6,289,0,295,1807
COAHUILA,PIEDRAS NEGRAS,1,311,4,316,1807
COAHUILA,PIEDRAS NEGRAS,8,317,2,327,1807
COAHUILA,PIEDRAS NEGRAS,5,322,1,328,1807
COAHUILA,PIEDRAS NEGRAS,7,266,0,273,1807
COAHUILA,PIEDRAS NEGRAS,228,7,0,235,1261
COAHUILA,PIEDRAS NEGRAS,6,191,1,198,1260
COAHUILA,PIEDRAS NEGRAS,9,215,1,225,1598
COAHUILA,PIEDRAS NEGRAS,4,258,1,263,1598
COAHUILA,PIEDRAS NEGRAS,10,228,2,240,1905
COAHUILA,PIEDRAS NEGRAS,17,218,0,235,1905
COAHUILA,PIEDRAS NEGRAS,6,232,7,245,1720
COAHUILA,PIEDRAS NEGRAS,6,268,2,276,1720
COAHUILA,PIEDRAS NEGRAS,3,277,2,282,1720
COAHUILA,PIEDRAS NEGRAS,2,296,2,300,1720
COAHUILA,PIEDRAS NEGRAS,2,247,2,251,1719
COAHUILA,PIEDRAS NEGRAS,6,258,1,265,1719
COAHUILA,PIEDRAS NEGRAS,5,115,1,121,1010
COAHUILA,PIEDRAS NEGRAS,2,139,1,142,1009
COAHUILA,PIEDRAS NEGRAS,9,166,2,177,1350
COAHUILA,PIEDRAS NEGRAS,4,173,3,180,1349
COAHUILA,PIEDRAS NEGRAS,7,183,3,193,1349
COAHUILA,PIEDRAS NEGRAS,1,213,3,217,1804
COAHUILA,PIEDRAS NEGRAS,8,235,3,246,1804
COAHUILA,PIEDRAS NEGRAS,3,215,2,220,1804
COAHUILA,PIEDRAS NEGRAS,14,304,0,318,1872
COAHUILA,PIEDRAS NEGRAS,9,322,1,332,1872
COAHUILA,PIEDRAS NEGRAS,11,311,1,323,1872
COAHUILA,PIEDRAS NEGRAS,10,308,3,321,1872
COAHUILA,PIEDRAS NEGRAS,4,300,0,304,2005
COAHUILA,PIEDRAS NEGRAS,4,274,1,279,2004
COAHUILA,PIEDRAS NEGRAS,5,316,1,322,2004
COAHUILA,PIEDRAS NEGRAS,0,315,3,318,2004
COAHUILA,PIEDRAS NEGRAS,3,244,5,252,1511
COAHUILA,PIEDRAS NEGRAS,1,232,3,236,1510
COAHUILA,PIEDRAS NEGRAS,5,238,2,245,1510
COAHUILA,PIEDRAS NEGRAS,9,201,5,215,1475
COAHUILA,PIEDRAS NEGRAS,5,200,3,208,1474
COAHUILA,PIEDRAS NEGRAS,3,203,0,206,1474
COAHUILA,PIEDRAS NEGRAS,7,265,4,276,1721
COAHUILA,PIEDRAS NEGRAS,6,258,1,265,1721
COAHUILA,PIEDRAS NEGRAS,4,207,2,213,1291
COAHUILA,PIEDRAS NEGRAS,1,220,1,222,1291
COAHUILA,PIEDRAS NEGRAS,3,198,3,204,1866
COAHUILA,PIEDRAS NEGRAS,3,215,3,221,1866
COAHUILA,PIEDRAS NEGRAS,4,222,0,226,1866
COAHUILA,PIEDRAS NEGRAS,2,216,4,222,1866
COAHUILA,PIEDRAS NEGRAS,5,206,3,214,1865
COAHUILA,PIEDRAS NEGRAS,8,148,6,162,1688
COAHUILA,PIEDRAS NEGRAS,3,173,6,182,1688
COAHUILA,PIEDRAS NEGRAS,2,168,0,170,1603
COAHUILA,PIEDRAS NEGRAS,3,147,4,154,1603
COAHUILA,PIEDRAS NEGRAS,4,141,13,158,1602
COAHUILA,PIEDRAS NEGRAS,6,440,10,456,1861
COAHUILA,PIEDRAS NEGRAS,13,400,3,416,1861
COAHUILA,PIEDRAS NEGRAS,6,296,1,303,1547
COAHUILA,PIEDRAS NEGRAS,0,261,4,265,1547
COAHUILA,PIEDRAS NEGRAS,6,309,0,315,1498
COAHUILA,PIEDRAS NEGRAS,7,326,7,340,1497
COAHUILA,PIEDRAS NEGRAS,13,489,9,511,1998
COAHUILA,PIEDRAS NEGRAS,9,450,7,466,1998
COAHUILA,PIEDRAS NEGRAS,7,297,1,305,1370
COAHUILA,PIEDRAS NEGRAS,8,285,0,293,1369
COAHUILA,PIEDRAS NEGRAS,8,317,1,326,1369
COAHUILA,PIEDRAS NEGRAS,4,450,5,459,1716
COAHUILA,PIEDRAS NEGRAS,8,429,2,439,1715
COAHUILA,PIEDRAS NEGRAS,4,305,0,309,1542
COAHUILA,PIEDRAS NEGRAS,7,326,3,336,1542
COAHUILA,PIEDRAS NEGRAS,12,325,2,339,1542
COAHUILA,PIEDRAS NEGRAS,3,196,2,201,1362
COAHUILA,PIEDRAS NEGRAS,8,163,2,173,1361
COAHUILA,PIEDRAS NEGRAS,4,248,4,256,1741
COAHUILA,PIEDRAS NEGRAS,4,226,6,236,1740
COAHUILA,PIEDRAS NEGRAS,2,155,1,158,1557
COAHUILA,PIEDRAS NEGRAS,4,157,3,164,1556
COAHUILA,PIEDRAS NEGRAS,5,157,0,162,1556
COAHUILA,PIEDRAS NEGRAS,6,327,0,333,2120
COAHUILA,PIEDRAS NEGRAS,5,285,5,295,2120
COAHUILA,PIEDRAS NEGRAS,8,268,0,276,2120
COAHUILA,PIEDRAS NEGRAS,8,282,1,291,2119
COAHUILA,PIEDRAS NEGRAS,6,264,0,270,2119
COAHUILA,PIEDRAS NEGRAS,12,246,4,262,1635
COAHUILA,PIEDRAS NEGRAS,4,204,4,212,1634
COAHUILA,PIEDRAS NEGRAS,15,252,3,270,1634
COAHUILA,PIEDRAS NEGRAS,2,233,1,236,1504
COAHUILA,PIEDRAS NEGRAS,4,225,2,231,1503
COAHUILA,PIEDRAS NEGRAS,2,221,4,227,1503
COAHUILA,PIEDRAS NEGRAS,8,236,0,244,1503
COAHUILA,PIEDRAS NEGRAS,6,330,3,339,1953
COAHUILA,PIEDRAS NEGRAS,6,346,1,353,1952
COAHUILA,PIEDRAS NEGRAS,7,320,2,329,1952
COAHUILA,PIEDRAS NEGRAS,7,346,4,357,1952
COAHUILA,PIEDRAS NEGRAS,12,234,0,246,1701
COAHUILA,PIEDRAS NEGRAS,14,219,2,235,1701
COAHUILA,PIEDRAS NEGRAS,8,228,2,238,1700
COAHUILA,PIEDRAS NEGRAS,15,216,3,234,1700
COAHUILA,PIEDRAS NEGRAS,15,288,2,305,1936
COAHUILA,PIEDRAS NEGRAS,16,269,1,286,1935
COAHUILA,PIEDRAS NEGRAS,12,260,2,274,1876
COAHUILA,PIEDRAS NEGRAS,14,281,1,296,1876
COAHUILA,PIEDRAS NEGRAS,20,264,9,293,1909
COAHUILA,PIEDRAS NEGRAS,16,259,4,279,1908
COAHUILA,PIEDRAS NEGRAS,3,299,1,303,1854
COAHUILA,PIEDRAS NEGRAS,10,250,2,262,1853
COAHUILA,PIEDRAS NEGRAS,18,260,2,280,1692
COAHUILA,PIEDRAS NEGRAS,8,306,3,317,1692
COAHUILA,PIEDRAS NEGRAS,13,257,1,271,1691
COAHUILA,PIEDRAS NEGRAS,56,740,9,805,0
COAHUILA,PIEDRAS NEGRAS,5,220,2,227,1490
COAHUILA,PIEDRAS NEGRAS,4,190,0,194,1490
COAHUILA,PIEDRAS NEGRAS,11,176,1,188,1489
COAHUILA,PIEDRAS NEGRAS,6,291,0,297,1842
COAHUILA,PIEDRAS NEGRAS,6,291,3,300,1842
COAHUILA,PIEDRAS NEGRAS,10,271,1,282,1630
COAHUILA,PIEDRAS NEGRAS,11,289,1,301,1629
COAHUILA,PIEDRAS NEGRAS,9,266,1,276,1629
COAHUILA,PIEDRAS NEGRAS,6,260,1,267,1629
COAHUILA,PIEDRAS NEGRAS,10,280,0,290,1596
COAHUILA,PIEDRAS NEGRAS,14,256,3,273,1595
COAHUILA,PIEDRAS NEGRAS,12,293,4,309,1709
COAHUILA,PIEDRAS NEGRAS,5,250,1,256,1709
COAHUILA,PIEDRAS NEGRAS,14,247,0,261,1708
COAHUILA,PIEDRAS NEGRAS,6,247,1,254,1723
COAHUILA,PIEDRAS NEGRAS,5,241,0,246,1722
COAHUILA,PIEDRAS NEGRAS,2,234,1,237,1722
COAHUILA,PIEDRAS NEGRAS,9,223,1,233,1382
COAHUILA,PIEDRAS NEGRAS,6,211,3,220,1382
COAHUILA,PIEDRAS NEGRAS,12,296,4,312,1970
COAHUILA,PIEDRAS NEGRAS,9,270,2,281,1969
COAHUILA,PIEDRAS NEGRAS,12,289,4,305,1969
COAHUILA,PIEDRAS NEGRAS,3,295,1,299,1969
COAHUILA,PIEDRAS NEGRAS,6,262,2,270,1969
COAHUILA,PIEDRAS NEGRAS,8,269,3,280,1993
COAHUILA,PIEDRAS NEGRAS,8,270,3,281,1993
COAHUILA,PIEDRAS NEGRAS,5,246,2,253,1591
COAHUILA,PIEDRAS NEGRAS,3,239,3,245,1591
COAHUILA,PIEDRAS NEGRAS,4,158,1,163,1105
COAHUILA,PIEDRAS NEGRAS,6,167,1,174,1105
COAHUILA,PIEDRAS NEGRAS,7,304,4,315,2009
COAHUILA,PIEDRAS NEGRAS,11,269,3,283,1339
COAHUILA,PIEDRAS NEGRAS,257,12,8,277,1338
COAHUILA,PIEDRAS NEGRAS,12,371,3,386,1612
COAHUILA,PIEDRAS NEGRAS,17,333,0,350,1612
COAHUILA,PIEDRAS NEGRAS,5,256,3,264,1459
COAHUILA,PIEDRAS NEGRAS,4,254,3,261,1458
COAHUILA,PIEDRAS NEGRAS,8,257,1,266,1458
COAHUILA,PIEDRAS NEGRAS,3,364,2,369,1851
COAHUILA,PIEDRAS NEGRAS,19,342,4,365,1850
COAHUILA,PIEDRAS NEGRAS,5,324,3,332,1891
COAHUILA,PIEDRAS NEGRAS,4,359,2,365,1891
COAHUILA,PIEDRAS NEGRAS,16,337,0,353,1827
COAHUILA,PIEDRAS NEGRAS,9,370,6,385,1826
COAHUILA,PIEDRAS NEGRAS,14,385,2,401,1489
COAHUILA,PIEDRAS NEGRAS,12,357,2,371,1488
COAHUILA,PIEDRAS NEGRAS,2,224,3,229,1269
COAHUILA,PIEDRAS NEGRAS,2,255,2,259,1269
COAHUILA,PIEDRAS NEGRAS,15,329,2,346,1559
COAHUILA,PIEDRAS NEGRAS,15,342,2,359,1559
COAHUILA,PIEDRAS NEGRAS,8,278,3,289,1668
COAHUILA,PIEDRAS NEGRAS,4,302,1,307,1667
COAHUILA,PIEDRAS NEGRAS,3,169,2,174,1387
COAHUILA,PIEDRAS NEGRAS,5,231,1,237,1386
COAHUILA,PIEDRAS NEGRAS,9,252,2,263,1718
COAHUILA,PIEDRAS NEGRAS,10,298,0,308,1717
COAHUILA,PIEDRAS NEGRAS,8,243,3,254,1400
COAHUILA,PIEDRAS NEGRAS,4,233,1,238,1400
COAHUILA,PIEDRAS NEGRAS,1,241,1,243,1399
COAHUILA,PIEDRAS NEGRAS,8,279,4,291,2009
COAHUILA,PIEDRAS NEGRAS,8,301,3,312,2008
COAHUILA,PIEDRAS NEGRAS,10,301,4,315,1889
COAHUILA,PIEDRAS NEGRAS,15,298,3,316,1888
COAHUILA,PIEDRAS NEGRAS,5,198,4,207,1363
COAHUILA,PIEDRAS NEGRAS,1,180,0,181,1363
COAHUILA,PIEDRAS NEGRAS,6,267,1,274,1679
COAHUILA,PIEDRAS NEGRAS,11,246,1,258,1679
COAHUILA,PIEDRAS NEGRAS,5,204,0,209,1528
COAHUILA,PIEDRAS NEGRAS,7,178,2,187,1527
COAHUILA,PIEDRAS NEGRAS,4,221,1,226,1488
COAHUILA,PIEDRAS NEGRAS,4,227,2,233,1487
COAHUILA,PIEDRAS NEGRAS,7,220,2,229,1487
COAHUILA,PIEDRAS NEGRAS,7,370,2,379,1681
COAHUILA,PIEDRAS NEGRAS,8,326,5,339,1680
COAHUILA,PIEDRAS NEGRAS,10,336,2,348,1680
COAHUILA,PIEDRAS NEGRAS,10,332,6,348,1688
COAHUILA,PIEDRAS NEGRAS,8,361,3,372,1687
COAHUILA,PIEDRAS NEGRAS,7,354,3,364,1687
COAHUILA,PIEDRAS NEGRAS,2,377,5,384,1863
COAHUILA,PIEDRAS NEGRAS,3,356,3,362,1862
COAHUILA,SAN PEDRO,14,471,3,488,2022
COAHUILA,SAN PEDRO,3,482,5,490,2022
COAHUILA,SAN PEDRO,11,408,4,423,1897
COAHUILA,SAN PEDRO,18,342,8,368,1897
COAHUILA,SAN PEDRO,7,368,7,382,1897
COAHUILA,SAN PEDRO,6,393,2,401,1630
COAHUILA,SAN PEDRO,12,409,3,424,1629
COAHUILA,SAN PEDRO,6,369,4,379,1659
COAHUILA,SAN PEDRO,8,385,2,395,1659
COAHUILA,SAN PEDRO,4,237,2,243,1031
COAHUILA,SAN PEDRO,4,250,1,255,1030
COAHUILA,SAN PEDRO,12,342,3,357,1588
COAHUILA,SAN PEDRO,13,345,1,359,1588
COAHUILA,SAN PEDRO,7,234,2,243,1602
COAHUILA,SAN PEDRO,8,194,3,205,1602
COAHUILA,SAN PEDRO,8,230,1,239,1602
COAHUILA,SAN PEDRO,3,114,1,118,1477
COAHUILA,SAN PEDRO,3,103,5,111,1477
COAHUILA,SAN PEDRO,5,138,0,143,1477
COAHUILA,SAN PEDRO,9,369,5,383,1877
COAHUILA,SAN PEDRO,3,311,16,330,1877
COAHUILA,SAN PEDRO,7,377,3,387,1773
COAHUILA,SAN PEDRO,7,362,0,369,1773
COAHUILA,SAN PEDRO,3,384,6,393,1773
COAHUILA,SAN PEDRO,4,414,4,422,1772
COAHUILA,SAN PEDRO,11,357,0,368,1265
COAHUILA,SAN PEDRO,12,327,3,342,1264
COAHUILA,SAN PEDRO,9,370,1,380,1869
COAHUILA,SAN PEDRO,7,391,5,403,1869
COAHUILA,SAN PEDRO,8,467,6,481,1867
COAHUILA,SAN PEDRO,13,433,2,448,1867
COAHUILA,SAN PEDRO,2,328,1,331,1373
COAHUILA,SAN PEDRO,11,311,4,326,1372
COAHUILA,SAN PEDRO,8,475,5,488,1694
COAHUILA,SAN PEDRO,11,456,7,474,1694
COAHUILA,SAN PEDRO,5,493,2,500,1694
COAHUILA,SAN PEDRO,9,305,3,317,1665
COAHUILA,SAN PEDRO,6,292,5,303,1664
COAHUILA,SAN PEDRO,8,378,4,390,1791
COAHUILA,SAN PEDRO,6,379,7,392,1790
COAHUILA,SAN PEDRO,5,234,4,243,1227
COAHUILA,SAN PEDRO,5,218,5,228,1227
COAHUILA,SAN PEDRO,4,251,3,258,1689
COAHUILA,SAN PEDRO,1,285,1,287,1689
COAHUILA,SAN PEDRO,7,275,4,286,1688
COAHUILA,SAN PEDRO,5,238,1,244,1039
COAHUILA,SAN PEDRO,3,217,3,223,1038
COAHUILA,SAN PEDRO,9,303,8,320,1877
COAHUILA,SAN PEDRO,7,329,6,342,1877
COAHUILA,SAN PEDRO,7,247,4,258,1666
COAHUILA,SAN PEDRO,3,298,4,305,1665
COAHUILA,SAN PEDRO,13,234,8,255,1956
COAHUILA,SAN PEDRO,8,243,5,256,1955
COAHUILA,SAN PEDRO,5,176,6,187,1159
COAHUILA,SAN PEDRO,3,191,3,197,1158
COAHUILA,SAN PEDRO,8,240,1,249,1354
COAHUILA,SAN PEDRO,3,268,5,276,1354
COAHUILA,SAN PEDRO,7,267,3,277,1801
COAHUILA,SAN PEDRO,7,285,4,296,1800
COAHUILA,SAN PEDRO,13,291,1,305,1861
COAHUILA,SAN PEDRO,9,295,15,319,1860
COAHUILA,SAN PEDRO,9,270,1,280,1768
COAHUILA,SAN PEDRO,6,247,5,258,1767
COAHUILA,SAN PEDRO,3,195,4,202,1357
COAHUILA,SAN PEDRO,5,169,1,175,1357
COAHUILA,SAN PEDRO,4,210,2,216,1356
COAHUILA,SAN PEDRO,3,393,5,401,1526
COAHUILA,SAN PEDRO,10,403,3,416,1526
COAHUILA,SAN PEDRO,7,242,5,254,1111
COAHUILA,SAN PEDRO,6,295,1,302,1110
COAHUILA,SAN PEDRO,13,456,8,477,1887
COAHUILA,SAN PEDRO,10,472,6,488,1887
COAHUILA,SAN PEDRO,12,273,0,285,1607
COAHUILA,SAN PEDRO,12,345,3,360,1607
COAHUILA,SAN PEDRO,1,362,9,372,1606
COAHUILA,SAN PEDRO,11,310,1,322,1376
COAHUILA,SAN PEDRO,10,309,3,322,1376
COAHUILA,SAN PEDRO,6,273,3,282,1376
COAHUILA,SAN PEDRO,9,400,3,412,1688
COAHUILA,SAN PEDRO,10,436,5,451,1688
COAHUILA,SAN PEDRO,6,388,3,397,1688
COAHUILA,SAN PEDRO,10,384,5,399,1860
COAHUILA,SAN PEDRO,5,356,4,365,1860
COAHUILA,SAN PEDRO,3,188,3,194,1364
COAHUILA,SAN PEDRO,5,178,0,183,1363
COAHUILA,SAN PEDRO,6,178,5,189,1363
COAHUILA,SAN PEDRO,4,43,1,48,1230
COAHUILA,SAN PEDRO,2,31,0,33,1229
COAHUILA,SAN PEDRO,9,197,0,206,1898
COAHUILA,SAN PEDRO,15,197,2,214,1897
COAHUILA,SAN PEDRO,9,172,1,182,1897
COAHUILA,SAN PEDRO,10,229,7,246,1800
COAHUILA,SAN PEDRO,14,220,0,234,1799
COAHUILA,SAN PEDRO,21,90,1,112,1193
COAHUILA,SAN PEDRO,13,108,1,122,1193
COAHUILA,SAN PEDRO,7,207,0,214,1561
COAHUILA,SAN PEDRO,13,209,3,225,1560
COAHUILA,SAN PEDRO,10,194,1,205,1560
COAHUILA,SAN PEDRO,7,178,1,186,1922
COAHUILA,SAN PEDRO,5,181,0,186,1922
COAHUILA,SAN PEDRO,18,143,5,166,2017
COAHUILA,SAN PEDRO,16,173,2,191,2017
COAHUILA,SAN PEDRO,15,178,4,197,2016
COAHUILA,SAN PEDRO,15,165,1,181,2016
COAHUILA,SAN PEDRO,14,161,0,175,2016
COAHUILA,SAN PEDRO,8,148,3,159,1878
COAHUILA,SAN PEDRO,6,143,0,149,1878
COAHUILA,SAN PEDRO,9,173,1,183,1878
COAHUILA,SAN PEDRO,20,173,0,193,1878
COAHUILA,SAN PEDRO,14,155,0,169,1878
COAHUILA,SAN PEDRO,10,158,1,169,1878
COAHUILA,SAN PEDRO,14,156,2,172,1878
COAHUILA,SAN PEDRO,6,163,6,175,1540
COAHUILA,SAN PEDRO,4,118,5,127,1539
COAHUILA,SAN PEDRO,3,55,1,59,1029
COAHUILA,SAN PEDRO,2,46,2,50,1028
COAHUILA,SAN PEDRO,5,116,0,121,2118
COAHUILA,SAN PEDRO,8,145,0,153,2118
COAHUILA,SAN PEDRO,3,309,3,315,1550
COAHUILA,SAN PEDRO,6,355,1,362,1550
COAHUILA,SAN PEDRO,4,280,2,286,1791
COAHUILA,SAN PEDRO,8,293,2,303,1791
COAHUILA,SAN PEDRO,8,281,0,289,1791
COAHUILA,SAN PEDRO,9,379,0,388,1952
COAHUILA,SAN PEDRO,11,336,2,349,1952
COAHUILA,SAN PEDRO,8,242,4,254,1206
COAHUILA,SAN PEDRO,3,249,6,258,1205
COAHUILA,SAN PEDRO,10,312,0,322,1542
COAHUILA,SAN PEDRO,6,309,2,317,1542
COAHUILA,SAN PEDRO,10,309,2,321,1541
COAHUILA,SAN PEDRO,11,336,2,349,1940
COAHUILA,SAN PEDRO,10,330,0,340,1939
COAHUILA,SAN PEDRO,9,448,2,459,1897
COAHUILA,SAN PEDRO,6,501,12,519,1897
COAHUILA,SAN PEDRO,3,361,7,371,1732
COAHUILA,SAN PEDRO,4,339,3,346,1732
COAHUILA,SAN PEDRO,6,420,9,435,1608
COAHUILA,SAN PEDRO,3,424,2,429,1607
COAHUILA,SAN PEDRO,8,520,3,531,1932
COAHUILA,SAN PEDRO,7,526,2,535,1932
COAHUILA,SAN PEDRO,7,411,4,422,1455
COAHUILA,SAN PEDRO,10,431,0,441,1454
COAHUILA,SAN PEDRO,9,358,3,370,1364
COAHUILA,SAN PEDRO,2,331,6,339,1364
COAHUILA,SAN PEDRO,6,352,1,359,1363
COAHUILA,SAN PEDRO,11,516,2,529,0
COAHUILA,SAN PEDRO,10,361,2,373,1408
COAHUILA,SAN PEDRO,4,367,6,377,1407
COAHUILA,SAN PEDRO,9,506,2,517,1905
COAHUILA,SAN PEDRO,8,491,2,501,1905
COAHUILA,SAN PEDRO,14,513,5,532,1826
COAHUILA,SAN PEDRO,11,459,7,477,1825
COAHUILA,SAN PEDRO,7,365,3,375,1275
COAHUILA,SAN PEDRO,8,356,4,368,1274
COAHUILA,SAN PEDRO,4,336,6,346,1665
COAHUILA,SAN PEDRO,1,352,2,355,1664
COAHUILA,SAN PEDRO,6,450,16,472,1605
COAHUILA,SAN PEDRO,3,449,4,456,1604
COAHUILA,SAN PEDRO,4,288,9,301,1306
COAHUILA,SAN PEDRO,5,277,4,286,1306
COAHUILA,SAN PEDRO,6,365,5,376,1529
COAHUILA,SAN PEDRO,2,416,7,425,1529
COAHUILA,SAN PEDRO,4,415,3,422,1530
COAHUILA,SAN PEDRO,15,418,3,436,1530
COAHUILA,SAN PEDRO,4,390,7,401,1447
COAHUILA,SAN PEDRO,6,379,10,395,1446
COAHUILA,SAN PEDRO,3,393,3,399,1729
COAHUILA,SAN PEDRO,1,413,11,425,1729
COAHUILA,SAN PEDRO,4,512,4,520,1634
COAHUILA,SAN PEDRO,7,501,4,512,1633
COAHUILA,SAN PEDRO,8,399,13,420,1509
COAHUILA,SAN PEDRO,11,412,4,427,1509
COAHUILA,SAN PEDRO,4,502,7,513,1834
COAHUILA,SAN PEDRO,8,462,7,477,1833
COAHUILA,SAN PEDRO,6,372,5,383,1437
COAHUILA,SAN PEDRO,3,347,14,364,1437
COAHUILA,SAN PEDRO,4,290,6,300,1073
COAHUILA,SAN PEDRO,2,279,3,284,1073
COAHUILA,SAN PEDRO,3,138,1,142,1342
COAHUILA,SAN PEDRO,3,156,3,162,1341
COAHUILA,SAN PEDRO,2,172,1,175,1341
COAHUILA,SAN PEDRO,3,99,0,102,1320
COAHUILA,SAN PEDRO,1,83,0,84,1319
COAHUILA,SAN PEDRO,4,82,0,86,1499
COAHUILA,SAN PEDRO,4,117,1,122,1499
COAHUILA,SAN PEDRO,2,114,2,118,1499
COAHUILA,SAN PEDRO,1,81,1,83,1341
COAHUILA,SAN PEDRO,3,82,0,85,1341
COAHUILA,SAN PEDRO,3,108,2,113,1179
COAHUILA,SAN PEDRO,4,82,0,86,1178
COAHUILA,SAN PEDRO,6,142,2,150,2055
COAHUILA,SAN PEDRO,5,122,0,127,2055
COAHUILA,SAN PEDRO,3,105,0,108,1121
COAHUILA,SAN PEDRO,3,99,0,102,1121
COAHUILA,SAN PEDRO,5,125,3,133,1896
COAHUILA,SAN PEDRO,6,153,1,160,1895
COAHUILA,MONCLOVA,13,295,6,314,1723
COAHUILA,MONCLOVA,8,304,2,314,1722
COAHUILA,MONCLOVA,18,287,4,309,1722
COAHUILA,MONCLOVA,5,268,1,274,1799
COAHUILA,MONCLOVA,9,273,2,284,1799
COAHUILA,MONCLOVA,3,251,1,255,1148
COAHUILA,MONCLOVA,9,242,3,254,1569
COAHUILA,MONCLOVA,7,264,1,272,1569
COAHUILA,MONCLOVA,7,383,3,393,1827
COAHUILA,MONCLOVA,12,346,2,360,1827
COAHUILA,MONCLOVA,4,270,1,275,1390
COAHUILA,MONCLOVA,11,272,2,285,1623
COAHUILA,MONCLOVA,4,341,3,348,1854
COAHUILA,MONCLOVA,8,329,4,341,1853
COAHUILA,MONCLOVA,10,233,4,247,2026
COAHUILA,MONCLOVA,7,284,3,294,2025
COAHUILA,MONCLOVA,7,234,2,243,2025
COAHUILA,MONCLOVA,3,285,1,289,1583
COAHUILA,MONCLOVA,2,253,1,256,1582
COAHUILA,MONCLOVA,1,294,2,297,1815
COAHUILA,MONCLOVA,3,287,3,293,1815
COAHUILA,MONCLOVA,8,322,0,330,1525
COAHUILA,MONCLOVA,5,333,5,343,1524
COAHUILA,MONCLOVA,4,283,1,288,1396
COAHUILA,MONCLOVA,6,287,2,295,1395
COAHUILA,MONCLOVA,7,332,0,339,1634
COAHUILA,MONCLOVA,10,339,4,353,1634
COAHUILA,MONCLOVA,7,419,2,428,1803
COAHUILA,MONCLOVA,6,364,6,376,1802
COAHUILA,MONCLOVA,14,345,2,361,1786
COAHUILA,MONCLOVA,20,343,0,363,1786
COAHUILA,MONCLOVA,8,268,0,276,1315
COAHUILA,MONCLOVA,3,243,3,249,1314
COAHUILA,MONCLOVA,5,257,3,265,1519
COAHUILA,MONCLOVA,7,219,4,230,1519
COAHUILA,MONCLOVA,2,226,0,228,1518
COAHUILA,MONCLOVA,6,397,6,409,1893
COAHUILA,MONCLOVA,6,402,4,412,1892
COAHUILA,MONCLOVA,12,258,0,270,1356
COAHUILA,MONCLOVA,5,247,1,253,1355
COAHUILA,MONCLOVA,11,340,7,358,1856
COAHUILA,MONCLOVA,6,358,9,373,1856
COAHUILA,MONCLOVA,2,310,5,317,1588
COAHUILA,MONCLOVA,5,297,4,306,1587
COAHUILA,MONCLOVA,7,410,5,422,1918
COAHUILA,MONCLOVA,10,370,3,383,1917
COAHUILA,MONCLOVA,4,289,1,294,1578
COAHUILA,MONCLOVA,6,364,6,376,1430
COAHUILA,MONCLOVA,3,346,0,349,1430
COAHUILA,MONCLOVA,3,105,3,111,1761
COAHUILA,MONCLOVA,6,193,1,200,1308
COAHUILA,MONCLOVA,9,342,4,355,1368
COAHUILA,MONCLOVA,8,257,3,268,1382
COAHUILA,MONCLOVA,12,262,1,275,1381
COAHUILA,MONCLOVA,16,205,0,221,1362
COAHUILA,MONCLOVA,16,270,2,288,1629
COAHUILA,MONCLOVA,13,297,5,315,1629
COAHUILA,MONCLOVA,11,221,1,233,1418
COAHUILA,MONCLOVA,11,220,2,233,1418
COAHUILA,MONCLOVA,11,236,3,250,1417
COAHUILA,MONCLOVA,31,318,3,352,2050
COAHUILA,MONCLOVA,24,306,0,330,2049
COAHUILA,MONCLOVA,3,252,5,260,1962
COAHUILA,MONCLOVA,5,254,5,264,1961
COAHUILA,MONCLOVA,4,249,1,254,1458
COAHUILA,MONCLOVA,2,238,7,247,1457
COAHUILA,MONCLOVA,18,257,4,279,1598
COAHUILA,MONCLOVA,8,234,1,243,1597
COAHUILA,MONCLOVA,40,302,1,343,1878
COAHUILA,MONCLOVA,39,312,1,352,1878
COAHUILA,MONCLOVA,30,163,3,196,1419
COAHUILA,MONCLOVA,32,181,2,215,1419
COAHUILA,MONCLOVA,29,176,1,206,1419
COAHUILA,MONCLOVA,3,229,4,236,1686
COAHUILA,MONCLOVA,9,226,6,241,1686
COAHUILA,MONCLOVA,14,262,1,277,1686
COAHUILA,MONCLOVA,9,285,2,296,1671
COAHUILA,MONCLOVA,11,236,6,253,1670
COAHUILA,MONCLOVA,27,229,3,259,1457
COAHUILA,MONCLOVA,25,249,3,277,1457
COAHUILA,MONCLOVA,26,200,1,227,1708
COAHUILA,MONCLOVA,40,202,5,247,1708
COAHUILA,MONCLOVA,52,569,1,622,0
COAHUILA,MONCLOVA,14,354,8,376,1849
COAHUILA,MONCLOVA,7,337,1,345,1849
COAHUILA,MONCLOVA,19,305,1,325,1709
COAHUILA,MONCLOVA,15,309,2,326,1709
COAHUILA,MONCLOVA,16,318,1,335,1709
COAHUILA,MONCLOVA,25,226,0,251,1831
COAHUILA,MONCLOVA,24,236,4,264,1830
COAHUILA,MONCLOVA,8,303,4,315,1560
COAHUILA,MONCLOVA,7,263,3,273,1559
COAHUILA,MONCLOVA,5,282,4,291,1634
COAHUILA,MONCLOVA,0,246,5,251,1634
COAHUILA,MONCLOVA,12,221,6,239,1623
COAHUILA,MONCLOVA,5,237,0,242,1623
COAHUILA,MONCLOVA,38,134,0,172,1406
COAHUILA,MONCLOVA,40,161,3,204,1405
COAHUILA,MONCLOVA,40,158,1,199,1405
COAHUILA,MONCLOVA,14,227,3,244,1522
COAHUILA,MONCLOVA,12,337,3,352,1521
COAHUILA,MONCLOVA,5,302,6,313,1575
COAHUILA,MONCLOVA,7,253,5,265,1574
COAHUILA,MONCLOVA,10,236,4,250,1263
COAHUILA,MONCLOVA,4,203,2,209,1262
COAHUILA,MONCLOVA,5,227,4,236,1809
COAHUILA,MONCLOVA,5,211,0,216,1809
COAHUILA,MONCLOVA,5,203,3,211,1809
COAHUILA,MONCLOVA,14,288,1,303,1753
COAHUILA,MONCLOVA,9,271,2,282,1753
COAHUILA,MONCLOVA,10,267,0,277,1753
COAHUILA,MONCLOVA,8,288,3,299,1499
COAHUILA,MONCLOVA,11,290,4,305,1665
COAHUILA,MONCLOVA,5,311,0,316,1665
COAHUILA,MONCLOVA,13,380,0,393,1817
COAHUILA,MONCLOVA,19,279,0,298,1816
COAHUILA,MONCLOVA,17,374,1,392,1760
COAHUILA,MONCLOVA,9,349,1,359,1760
COAHUILA,MONCLOVA,21,257,1,279,1427
COAHUILA,MONCLOVA,13,264,0,277,1427
COAHUILA,MONCLOVA,12,252,7,271,1762
COAHUILA,MONCLOVA,5,387,7,399,1762
COAHUILA,MONCLOVA,10,263,1,274,1488
COAHUILA,MONCLOVA,6,250,1,257,1487
COAHUILA,MONCLOVA,12,344,3,359,1571
COAHUILA,MONCLOVA,9,328,1,338,1571
COAHUILA,MONCLOVA,12,314,4,330,1619
COAHUILA,MONCLOVA,15,301,0,316,1619
COAHUILA,MONCLOVA,5,284,1,290,1443
COAHUILA,MONCLOVA,7,251,1,259,1443
COAHUILA,MONCLOVA,24,425,4,453,1935
COAHUILA,MONCLOVA,9,412,3,424,1934
COAHUILA,MONCLOVA,14,349,1,364,1797
COAHUILA,MONCLOVA,15,303,1,319,1796
COAHUILA,MONCLOVA,11,299,1,311,1407
COAHUILA,MONCLOVA,7,339,2,348,1406
COAHUILA,MONCLOVA,12,314,7,333,1406
COAHUILA,MONCLOVA,9,287,0,296,1621
COAHUILA,MONCLOVA,5,289,4,298,1621
COAHUILA,MONCLOVA,9,287,4,300,1620
COAHUILA,MONCLOVA,11,298,3,312,1418
COAHUILA,MONCLOVA,10,297,1,308,1417
COAHUILA,MONCLOVA,14,363,2,379,1632
COAHUILA,MONCLOVA,7,337,0,344,1632
COAHUILA,MONCLOVA,4,256,2,262,1358
COAHUILA,MONCLOVA,6,243,5,254,1357
COAHUILA,MONCLOVA,5,211,1,217,1806
COAHUILA,MONCLOVA,4,225,0,229,1806
COAHUILA,MONCLOVA,4,207,1,212,1806
COAHUILA,MONCLOVA,11,177,1,189,1806
COAHUILA,MONCLOVA,16,332,2,350,1504
COAHUILA,MONCLOVA,14,289,4,307,1503
COAHUILA,MONCLOVA,8,289,3,300,1387
COAHUILA,MONCLOVA,8,282,1,291,1387
COAHUILA,MONCLOVA,9,330,1,340,1386
COAHUILA,MONCLOVA,9,267,0,276,1635
COAHUILA,MONCLOVA,5,271,1,277,1635
COAHUILA,MONCLOVA,5,274,4,283,1635
COAHUILA,MONCLOVA,24,334,5,363,1885
COAHUILA,MONCLOVA,8,329,3,340,1884
COAHUILA,MONCLOVA,24,358,4,386,1884
COAHUILA,MONCLOVA,2,149,5,156,1136
COAHUILA,MONCLOVA,4,382,9,395,1680
COAHUILA,MONCLOVA,9,215,0,224,1873
COAHUILA,MONCLOVA,11,244,2,257,1873
COAHUILA,MONCLOVA,6,253,1,260,1873
COAHUILA,MONCLOVA,3,202,1,206,1873
COAHUILA,MONCLOVA,6,251,3,260,1863
COAHUILA,MONCLOVA,6,263,3,272,1863
COAHUILA,MONCLOVA,12,254,4,270,1863
COAHUILA,MONCLOVA,3,273,0,276,1862
COAHUILA,MONCLOVA,22,226,2,250,1773
COAHUILA,MONCLOVA,17,221,1,239,1772
COAHUILA,MONCLOVA,15,242,2,259,1772
COAHUILA,MONCLOVA,5,185,2,192,1245
COAHUILA,MONCLOVA,13,186,3,202,1244
COAHUILA,MONCLOVA,10,283,1,294,1847
COAHUILA,MONCLOVA,17,310,4,331,1846
COAHUILA,MONCLOVA,2,186,2,190,1556
COAHUILA,MONCLOVA,2,202,0,204,1555
COAHUILA,MONCLOVA,0,312,0,312,1729
COAHUILA,MONCLOVA,7,288,13,308,1729
COAHUILA,MONCLOVA,8,274,4,286,1855
COAHUILA,MONCLOVA,5,285,2,292,1855
COAHUILA,MONCLOVA,9,299,3,311,1659
COAHUILA,MONCLOVA,7,313,2,322,1658
COAHUILA,MONCLOVA,5,369,5,379,1703
COAHUILA,MONCLOVA,9,454,2,465,1703
COAHUILA,MONCLOVA,9,333,3,345,1676
COAHUILA,MONCLOVA,5,344,3,352,1675
COAHUILA,MONCLOVA,2,375,3,380,1675
COAHUILA,MONCLOVA,7,317,7,331,1675
COAHUILA,MONCLOVA,4,297,4,305,1716
COAHUILA,MONCLOVA,9,262,6,277,1716
COAHUILA,MONCLOVA,12,276,2,290,1715
COAHUILA,SALTILLO,15,162,2,179,1607
COAHUILA,SALTILLO,3,169,15,187,1607
COAHUILA,SALTILLO,12,152,2,166,1606
COAHUILA,SALTILLO,9,143,3,155,1715
COAHUILA,SALTILLO,10,130,6,146,1715
COAHUILA,SALTILLO,8,139,1,148,1715
COAHUILA,SALTILLO,3,51,1,55,1427
COAHUILA,SALTILLO,6,84,0,90,1427
COAHUILA,SALTILLO,3,71,6,80,1432
COAHUILA,SALTILLO,5,79,1,85,1432
COAHUILA,SALTILLO,4,81,1,86,1432
COAHUILA,SALTILLO,4,82,4,90,1116
COAHUILA,SALTILLO,8,107,4,119,1115
COAHUILA,SALTILLO,27,82,3,112,1036
COAHUILA,SALTILLO,14,92,0,106,1036
COAHUILA,SALTILLO,28,129,0,157,1750
COAHUILA,SALTILLO,25,135,1,161,1750
COAHUILA,SALTILLO,20,128,0,148,1749
COAHUILA,SALTILLO,25,135,1,161,1749
COAHUILA,SALTILLO,22,110,2,134,1321
COAHUILA,SALTILLO,25,115,3,143,1320
COAHUILA,SALTILLO,39,76,2,117,1420
COAHUILA,SALTILLO,42,80,0,122,1420
COAHUILA,SALTILLO,108,766,4,878,0
COAHUILA,SALTILLO,32,85,2,119,1929
COAHUILA,SALTILLO,49,80,1,130,1929
COAHUILA,SALTILLO,50,86,1,137,1929
COAHUILA,SALTILLO,48,85,0,133,1929
COAHUILA,SALTILLO,27,89,1,117,1929
COAHUILA,SALTILLO,17,178,4,199,1571
COAHUILA,SALTILLO,29,188,2,219,1571
COAHUILA,SALTILLO,30,166,3,199,1554
COAHUILA,SALTILLO,32,183,3,218,1554
COAHUILA,SALTILLO,80,99,2,181,1958
COAHUILA,SALTILLO,32,137,0,169,1691
COAHUILA,SALTILLO,29,160,2,191,1691
COAHUILA,SALTILLO,16,86,1,103,1619
COAHUILA,SALTILLO,30,126,2,158,1618
COAHUILA,SALTILLO,28,90,0,118,1618
COAHUILA,SALTILLO,32,165,4,201,1644
COAHUILA,SALTILLO,35,163,2,200,1644
COAHUILA,SALTILLO,28,138,0,166,1644
COAHUILA,SALTILLO,13,141,1,155,1644
COAHUILA,SALTILLO,23,124,1,148,1643
COAHUILA,SALTILLO,30,197,1,228,1972
COAHUILA,SALTILLO,21,170,4,195,1972
COAHUILA,SALTILLO,14,104,3,121,1382
COAHUILA,SALTILLO,14,111,0,125,1382
COAHUILA,SALTILLO,15,150,3,168,1948
COAHUILA,SALTILLO,17,166,2,185,1948
COAHUILA,SALTILLO,21,163,2,186,1948
COAHUILA,SALTILLO,10,152,0,162,1947
COAHUILA,SALTILLO,14,178,1,193,1947
COAHUILA,SALTILLO,14,166,1,181,1947
COAHUILA,SALTILLO,12,153,1,166,1947
COAHUILA,SALTILLO,46,209,3,258,1944
COAHUILA,SALTILLO,37,234,2,273,1943
COAHUILA,SALTILLO,17,187,4,208,1813
COAHUILA,SALTILLO,20,211,0,231,1813
COAHUILA,SALTILLO,23,219,0,242,1813
COAHUILA,SALTILLO,35,171,2,208,1855
COAHUILA,SALTILLO,50,157,1,208,1855
COAHUILA,SALTILLO,37,105,0,142,1542
COAHUILA,SALTILLO,42,135,0,177,1542
COAHUILA,SALTILLO,12,153,1,166,2095
COAHUILA,SALTILLO,8,152,1,161,2095
COAHUILA,SALTILLO,9,150,0,159,2095
COAHUILA,SALTILLO,5,163,0,168,2095
COAHUILA,SALTILLO,7,163,0,170,2094
COAHUILA,SALTILLO,13,143,1,157,2094
COAHUILA,SALTILLO,4,161,1,166,2094
COAHUILA,SALTILLO,12,135,1,148,2094
COAHUILA,SALTILLO,5,150,1,156,2094
COAHUILA,SALTILLO,6,143,0,149,2094
COAHUILA,SALTILLO,16,306,3,325,1924
COAHUILA,SALTILLO,17,327,3,347,1924
COAHUILA,SALTILLO,16,232,2,250,1706
COAHUILA,SALTILLO,22,255,0,277,1706
COAHUILA,SALTILLO,24,252,0,276,1706
COAHUILA,SALTILLO,15,165,3,183,1805
COAHUILA,SALTILLO,24,202,0,226,1804
COAHUILA,SALTILLO,43,172,2,217,1542
COAHUILA,SALTILLO,41,140,0,181,1541
COAHUILA,SALTILLO,26,160,0,186,1420
COAHUILA,SALTILLO,35,119,3,157,1420
COAHUILA,SALTILLO,34,134,2,170,1420
COAHUILA,SALTILLO,28,253,0,281,1868
COAHUILA,SALTILLO,18,251,10,279,1868
COAHUILA,SALTILLO,11,159,6,176,1276
COAHUILA,SALTILLO,16,156,3,175,1276
COAHUILA,SALTILLO,15,184,5,204,1530
COAHUILA,SALTILLO,7,184,1,192,1529
COAHUILA,SALTILLO,18,217,1,236,1434
COAHUILA,SALTILLO,23,195,1,219,1433
COAHUILA,SALTILLO,15,174,2,191,1799
COAHUILA,SALTILLO,10,172,3,185,1798
COAHUILA,SALTILLO,20,196,1,217,1702
COAHUILA,SALTILLO,11,201,1,213,1702
COAHUILA,SALTILLO,16,188,1,205,1702
COAHUILA,SALTILLO,10,228,0,238,1918
COAHUILA,SALTILLO,11,240,15,266,1918
COAHUILA,SALTILLO,13,241,1,255,1828
COAHUILA,SALTILLO,10,247,4,261,1827
COAHUILA,SALTILLO,23,230,2,255,1593
COAHUILA,SALTILLO,20,240,3,263,1592
COAHUILA,SALTILLO,16,211,2,229,1823
COAHUILA,SALTILLO,11,234,3,248,1823
COAHUILA,SALTILLO,10,253,5,268,1823
COAHUILA,SALTILLO,7,174,2,183,1695
COAHUILA,SALTILLO,3,150,1,154,1694
COAHUILA,SALTILLO,5,142,1,148,1694
COAHUILA,SALTILLO,6,165,1,172,1694
COAHUILA,SALTILLO,4,163,1,168,1694
COAHUILA,SALTILLO,16,178,0,194,1694
COAHUILA,SALTILLO,18,232,4,254,1545
COAHUILA,SALTILLO,18,204,1,223,1544
COAHUILA,SALTILLO,12,147,0,159,1316
COAHUILA,SALTILLO,9,165,1,175,1315
COAHUILA,SALTILLO,9,189,3,201,1684
COAHUILA,SALTILLO,0,209,3,212,1683
COAHUILA,SALTILLO,15,242,3,260,2019
COAHUILA,SALTILLO,8,189,2,199,1649
COAHUILA,SALTILLO,11,174,1,186,1649
COAHUILA,SALTILLO,5,209,2,216,1648
COAHUILA,SALTILLO,4,193,3,200,1648
COAHUILA,SALTILLO,13,198,3,214,1616
COAHUILA,SALTILLO,17,173,5,195,1616
COAHUILA,SALTILLO,6,138,2,146,1798
COAHUILA,SALTILLO,7,126,3,136,1797
COAHUILA,SALTILLO,4,152,1,157,1797
COAHUILA,SALTILLO,3,156,4,163,1797
COAHUILA,SALTILLO,0,154,6,160,1797
COAHUILA,SALTILLO,7,146,5,158,1797
COAHUILA,SALTILLO,6,133,2,141,1797
COAHUILA,SALTILLO,3,151,5,159,1797
COAHUILA,SALTILLO,2,136,2,140,1797
COAHUILA,SALTILLO,8,170,1,179,1960
COAHUILA,SALTILLO,13,164,7,184,1960
COAHUILA,SALTILLO,4,197,4,205,1830
COAHUILA,SALTILLO,5,157,4,166,1830
COAHUILA,SALTILLO,23,218,6,247,1553
COAHUILA,SALTILLO,23,190,2,215,1552
COAHUILA,SALTILLO,22,197,0,219,1552
COAHUILA,SALTILLO,29,204,4,237,1508
COAHUILA,SALTILLO,16,198,0,214,1508
COAHUILA,SALTILLO,18,199,2,219,1508
COAHUILA,SALTILLO,15,222,7,244,1591
COAHUILA,SALTILLO,6,208,2,216,1591
COAHUILA,SALTILLO,5,170,0,175,1939
COAHUILA,SALTILLO,3,163,0,166,1939
COAHUILA,SALTILLO,12,151,0,163,1939
COAHUILA,SALTILLO,7,177,2,186,1939
COAHUILA,SALTILLO,7,162,1,170,1938
COAHUILA,SALTILLO,4,133,6,143,1715
COAHUILA,SALTILLO,2,150,3,155,1715
COAHUILA,SALTILLO,4,145,2,151,1714
COAHUILA,SALTILLO,2,134,3,139,1714
COAHUILA,SALTILLO,13,249,3,265,1947
COAHUILA,SALTILLO,18,202,1,221,1947
COAHUILA,SALTILLO,15,202,0,217,1946
COAHUILA,SALTILLO,3,189,1,193,1789
COAHUILA,SALTILLO,5,172,1,178,1789
COAHUILA,SALTILLO,9,192,5,206,1789
COAHUILA,SALTILLO,11,160,6,177,1788
COAHUILA,SALTILLO,7,140,3,150,1397
COAHUILA,SALTILLO,11,126,3,140,1396
COAHUILA,SALTILLO,7,142,0,149,1396
COAHUILA,SALTILLO,9,258,2,269,1668
COAHUILA,SALTILLO,9,238,3,250,1667
COAHUILA,SALTILLO,19,235,0,254,1754
COAHUILA,SALTILLO,19,243,1,263,1754
COAHUILA,SALTILLO,23,285,6,314,1748
COAHUILA,SALTILLO,20,264,2,286,1748
COAHUILA,SALTILLO,8,147,3,158,1330
COAHUILA,SALTILLO,10,144,2,156,1329
COAHUILA,SALTILLO,4,150,2,156,1341
COAHUILA,SALTILLO,7,130,3,140,1341
COAHUILA,SALTILLO,23,159,3,185,1552
COAHUILA,SALTILLO,7,213,3,223,1551
COAHUILA,SALTILLO,8,156,0,164,1868
COAHUILA,SALTILLO,6,154,1,161,1867
COAHUILA,SALTILLO,3,170,4,177,1867
COAHUILA,SALTILLO,6,173,6,185,1867
COAHUILA,SALTILLO,7,211,3,221,1900
COAHUILA,SALTILLO,7,190,1,198,1900
COAHUILA,SALTILLO,10,146,0,156,1405
COAHUILA,SALTILLO,14,149,0,163,1404
COAHUILA,SALTILLO,17,213,3,233,1746
COAHUILA,SALTILLO,10,178,2,190,1745
COAHUILA,SALTILLO,17,188,1,206,1745
COAHUILA,SALTILLO,1,174,0,175,1949
COAHUILA,SALTILLO,9,185,0,194,1949
COAHUILA,SALTILLO,3,157,3,163,1576
COAHUILA,SALTILLO,10,162,0,172,1576
COAHUILA,SALTILLO,10,123,0,133,1576
COAHUILA,SALTILLO,5,133,3,141,1753
COAHUILA,SALTILLO,7,130,1,138,1753
COAHUILA,SALTILLO,9,133,0,142,1752
COAHUILA,SALTILLO,5,123,0,128,1475
COAHUILA,SALTILLO,2,139,1,142,1475
COAHUILA,SALTILLO,8,133,1,142,1474
COAHUILA,TORREON,20,150,1,171,1628
COAHUILA,TORREON,21,160,3,184,1627
COAHUILA,TORREON,22,165,2,189,1627
COAHUILA,TORREON,11,205,2,218,1752
COAHUILA,TORREON,9,234,2,245,1752
COAHUILA,TORREON,6,222,1,229,1752
COAHUILA,TORREON,7,240,6,253,1735
COAHUILA,TORREON,5,229,8,242,1734
COAHUILA,TORREON,5,248,2,255,1734
COAHUILA,TORREON,9,171,3,183,1753
COAHUILA,TORREON,20,163,1,184,1753
COAHUILA,TORREON,12,197,1,210,1753
COAHUILA,TORREON,12,146,0,158,1752
COAHUILA,TORREON,10,201,0,211,1752
COAHUILA,TORREON,10,172,2,184,1752
COAHUILA,TORREON,16,141,2,159,1752
COAHUILA,TORREON,23,106,2,131,1543
COAHUILA,TORREON,30,108,1,139,1542
COAHUILA,TORREON,18,133,3,154,1542
COAHUILA,TORREON,18,318,6,342,1597
COAHUILA,TORREON,15,322,7,344,1597
COAHUILA,TORREON,17,323,5,345,1597
COAHUILA,TORREON,26,373,3,402,1890
COAHUILA,TORREON,11,360,3,374,1889
COAHUILA,TORREON,11,308,2,321,1632
COAHUILA,TORREON,12,276,3,291,1631
COAHUILA,TORREON,34,90,0,124,1548
COAHUILA,TORREON,31,103,2,136,1548
COAHUILA,TORREON,17,154,1,172,1346
COAHUILA,TORREON,22,173,6,201,1346
COAHUILA,TORREON,20,174,1,195,1346
COAHUILA,TORREON,27,283,4,314,1833
COAHUILA,TORREON,35,315,4,354,1833
COAHUILA,TORREON,28,324,1,353,1941
COAHUILA,TORREON,20,280,0,300,1941
COAHUILA,TORREON,26,305,1,332,1940
COAHUILA,TORREON,32,177,1,210,1781
COAHUILA,TORREON,38,190,0,228,1780
COAHUILA,TORREON,25,206,2,233,1327
COAHUILA,TORREON,12,191,3,206,1326
COAHUILA,TORREON,8,195,3,206,1326
COAHUILA,TORREON,53,167,0,220,1829
COAHUILA,TORREON,46,197,0,243,1829
COAHUILA,TORREON,34,240,1,275,1743
COAHUILA,TORREON,17,252,2,271,1743
COAHUILA,TORREON,19,264,5,288,1743
COAHUILA,TORREON,34,236,2,272,1892
COAHUILA,TORREON,39,266,1,306,1892
COAHUILA,TORREON,32,264,7,303,1776
COAHUILA,TORREON,30,307,0,337,1776
COAHUILA,TORREON,23,282,3,308,1863
COAHUILA,TORREON,22,279,1,302,1862
COAHUILA,TORREON,12,326,4,342,1818
COAHUILA,TORREON,10,314,4,328,1818
COAHUILA,TORREON,12,326,0,338,1616
COAHUILA,TORREON,11,305,2,318,1616
COAHUILA,TORREON,70,666,8,744,0
COAHUILA,TORREON,25,279,5,309,1689
COAHUILA,TORREON,21,238,0,259,1688
COAHUILA,TORREON,8,344,3,355,1568
COAHUILA,TORREON,11,288,0,299,1568
COAHUILA,TORREON,8,322,0,330,1568
COAHUILA,TORREON,14,238,4,256,1322
COAHUILA,TORREON,7,247,3,257,1322
COAHUILA,TORREON,6,232,5,243,1312
COAHUILA,TORREON,6,274,1,281,1312
COAHUILA,TORREON,8,254,0,262,1528
COAHUILA,TORREON,7,290,6,303,1527
COAHUILA,TORREON,11,257,4,272,1527
COAHUILA,TORREON,7,234,4,245,1373
COAHUILA,TORREON,4,216,3,223,1373
COAHUILA,TORREON,14,201,6,221,1372
COAHUILA,TORREON,5,354,2,361,1824
COAHUILA,TORREON,4,354,1,359,1823
COAHUILA,TORREON,7,264,2,273,1533
COAHUILA,TORREON,4,273,1,278,1533
COAHUILA,TORREON,0,265,5,270,1532
COAHUILA,TORREON,5,256,7,268,1532
COAHUILA,TORREON,10,240,4,254,1536
COAHUILA,TORREON,8,239,3,250,1536
COAHUILA,TORREON,6,195,2,203,1535
COAHUILA,TORREON,13,268,3,284,1861
COAHUILA,TORREON,5,290,3,298,1861
COAHUILA,TORREON,7,259,0,266,1860
COAHUILA,TORREON,6,239,3,248,1561
COAHUILA,TORREON,6,236,4,246,1561
COAHUILA,TORREON,4,242,5,251,1560
COAHUILA,TORREON,10,311,3,324,1701
COAHUILA,TORREON,11,273,6,290,1701
COAHUILA,TORREON,6,265,2,273,1529
COAHUILA,TORREON,14,266,6,286,1529
COAHUILA,TORREON,10,283,2,295,1528
COAHUILA,TORREON,12,326,0,338,1927
COAHUILA,TORREON,16,343,8,367,1927
COAHUILA,TORREON,6,230,3,239,1123
COAHUILA,TORREON,14,219,1,234,1122
COAHUILA,TORREON,10,346,1,357,1885
COAHUILA,TORREON,16,283,4,303,1884
COAHUILA,TORREON,4,235,2,241,1850
COAHUILA,TORREON,6,264,4,274,1849
COAHUILA,TORREON,13,219,4,236,1410
COAHUILA,TORREON,15,212,22,249,1410
COAHUILA,TORREON,1,214,1,216,1410
COAHUILA,TORREON,22,313,2,337,1958
COAHUILA,TORREON,22,333,1,356,1958
COAHUILA,TORREON,14,323,2,339,1957
COAHUILA,TORREON,15,304,1,320,1957
COAHUILA,TORREON,20,340,2,362,1957
COAHUILA,TORREON,17,232,0,249,1468
COAHUILA,TORREON,8,252,3,263,1468
COAHUILA,TORREON,16,241,0,257,1467
COAHUILA,TORREON,18,387,2,407,1969
COAHUILA,TORREON,15,348,1,364,1968
COAHUILA,TORREON,19,378,8,405,1968
COAHUILA,TORREON,10,270,1,281,1446
COAHUILA,TORREON,19,262,1,282,1445
COAHUILA,TORREON,23,258,0,281,1832
COAHUILA,TORREON,28,300,4,332,1831
COAHUILA,TORREON,20,227,1,248,1492
COAHUILA,TORREON,18,201,1,220,1492
COAHUILA,TORREON,28,259,2,289,1531
COAHUILA,TORREON,32,246,1,279,1530
COAHUILA,TORREON,13,263,7,283,1937
COAHUILA,TORREON,22,270,0,292,1937
COAHUILA,TORREON,7,265,4,276,1502
COAHUILA,TORREON,7,273,1,281,1501
COAHUILA,TORREON,4,244,9,257,1501
COAHUILA,TORREON,18,360,2,380,1920
COAHUILA,TORREON,27,310,7,344,1919
COAHUILA,TORREON,29,287,1,317,1814
COAHUILA,TORREON,26,290,0,316,1814
COAHUILA,TORREON,51,180,0,231,1920
COAHUILA,TORREON,52,167,1,220,1920
COAHUILA,TORREON,38,142,0,180,1359
COAHUILA,TORREON,35,150,0,185,1359
COAHUILA,TORREON,39,137,2,178,1358
COAHUILA,TORREON,26,217,1,244,1528
COAHUILA,TORREON,27,252,1,280,1528
COAHUILA,TORREON,20,220,1,241,1528
COAHUILA,TORREON,29,149,2,180,1319
COAHUILA,TORREON,31,155,0,186,1319
COAHUILA,TORREON,33,145,0,178,1318
COAHUILA,TORREON,36,223,3,262,1682
COAHUILA,TORREON,39,189,3,231,1682
COAHUILA,TORREON,15,174,2,191,1337
COAHUILA,TORREON,25,168,1,194,1336
COAHUILA,TORREON,27,162,1,190,1336
COAHUILA,TORREON,15,182,0,197,1397
COAHUILA,TORREON,5,171,2,178,1397
COAHUILA,TORREON,10,160,1,171,1397
COAHUILA,TORREON,14,230,0,244,1347
COAHUILA,TORREON,13,237,2,252,1347
COAHUILA,TORREON,8,249,2,259,1347
COAHUILA,TORREON,17,271,2,290,1509
COAHUILA,TORREON,17,262,2,281,1509
COAHUILA,TORREON,21,258,2,281,1688
COAHUILA,TORREON,10,275,0,285,1688
COAHUILA,TORREON,7,312,0,319,1817
COAHUILA,TORREON,5,316,6,327,1817
COAHUILA,TORREON,6,263,1,270,1652
COAHUILA,TORREON,9,267,7,283,1652
COAHUILA,TORREON,9,307,6,322,1436
COAHUILA,TORREON,3,256,5,264,1435
COAHUILA,TORREON,14,250,5,269,1396
COAHUILA,TORREON,3,224,5,232,1396
COAHUILA,TORREON,5,225,8,238,1396
COAHUILA,TORREON,4,307,2,313,1909
COAHUILA,TORREON,3,304,3,310,1908
COAHUILA,TORREON,7,176,5,188,1058
COAHUILA,TORREON,8,205,1,214,1057
COAHUILA,TORREON,2,208,1,211,1809
COAHUILA,TORREON,3,204,2,209,1808
COAHUILA,TORREON,5,262,0,267,1923
COAHUILA,TORREON,5,244,4,253,1922
COAHUILA,TORREON,6,231,4,241,1711
COAHUILA,TORREON,3,240,2,245,1711
COAHUILA,TORREON,11,258,1,270,1710
COAHUILA,TORREON,11,209,3,223,1557
COAHUILA,TORREON,18,287,6,311,1557
COAHUILA,TORREON,3,244,4,251,1581
COAHUILA,TORREON,7,252,6,265,1581
COAHUILA,TORREON,11,270,0,281,1889
COAHUILA,TORREON,17,295,1,313,1888
COAHUILA,TORREON,7,338,4,349,1447
COAHUILA,TORREON,9,362,6,377,1447
COAHUILA,TORREON,4,322,1,327,1750
COAHUILA,TORREON,4,303,4,311,1749
COAHUILA,TORREON,5,418,3,426,1944
COAHUILA,TORREON,4,431,439,874,1943
COAHUILA,TORREON,5,274,3,282,1513
COAHUILA,TORREON,5,284,3,292,1513
COAHUILA,TORREON,5,328,0,333,1513
COAHUILA,TORREON,6,489,2,497,1837
COAHUILA,TORREON,3,469,2,474,1836
COAHUILA,TORREON,7,450,8,465,1958
COAHUILA,TORREON,9,491,2,502,1957
COAHUILA,TORREON,11,473,3,487,1957
COAHUILA,TORREON,4,328,5,337,1682
COAHUILA,TORREON,8,319,3,330,1681
COAHUILA,TORREON,11,345,9,365,1549
COAHUILA,TORREON,11,340,3,354,1548
COAHUILA,TORREON,7,421,2,430,1841
COAHUILA,TORREON,1,414,1,416,1841
COAHUILA,TORREON,5,410,8,423,1840
COAHUILA,TORREON,7,341,8,356,1878
COAHUILA,TORREON,4,336,5,345,1878
COAHUILA,TORREON,3,310,4,317,1501
COAHUILA,TORREON,2,336,5,343,1500
COAHUILA,TORREON,5,334,8,347,1500
COAHUILA,TORREON,3,365,4,372,1500
COAHUILA,TORREON,3,389,3,395,1522
COAHUILA,TORREON,3,380,3,386,1522
COAHUILA,TORREON,1,408,9,418,1521
COAHUILA,TORREON,10,379,2,391,1627
COAHUILA,TORREON,7,401,8,416,1627
COAHUILA,TORREON,2,351,5,358,1558
COAHUILA,TORREON,6,361,5,372,1558
COAHUILA,TORREON,6,357,5,368,1557
COAHUILA,TORREON,7,375,12,394,1926
COAHUILA,TORREON,11,434,4,449,1926
COAHUILA,TORREON,7,341,3,351,1388
COAHUILA,TORREON,2,327,4,333,1387
COAHUILA,TORREON,7,360,0,367,1387
COAHUILA,TORREON,10,320,3,333,1530
COAHUILA,TORREON,9,345,3,357,1530
COAHUILA,TORREON,2,335,1,338,1530
COAHUILA,TORREON,5,460,3,468,1731
COAHUILA,TORREON,7,500,7,514,1731
COAHUILA,TORREON,2,165,3,170,997
COAHUILA,TORREON,5,178,2,185,996
COAHUILA,TORREON,9,358,7,374,1976
COAHUILA,TORREON,4,359,5,368,1976
COAHUILA,TORREON,15,60,2,77,1397
COAHUILA,TORREON,24,90,1,115,1396
COAHUILA,TORREON,9,123,3,135,1469
COAHUILA,TORREON,11,147,4,162,1468
COAHUILA,TORREON,13,136,4,153,1379
COAHUILA,TORREON,10,160,3,173,1379
COAHUILA,TORREON,13,176,1,190,1378
COAHUILA,TORREON,15,202,1,218,1982
COAHUILA,TORREON,20,256,2,278,1982
COAHUILA,TORREON,23,259,0,282,1982
COAHUILA,TORREON,12,262,3,277,1982
COAHUILA,TORREON,8,251,1,260,1982
COAHUILA,TORREON,9,229,0,238,1981
COAHUILA,TORREON,4,235,3,242,1981
COAHUILA,TORREON,8,296,0,304,1450
COAHUILA,TORREON,5,284,4,293,1450
COAHUILA,TORREON,10,237,6,253,1174
COAHUILA,TORREON,13,246,3,262,1174
COAHUILA,TORREON,13,226,1,240,1357
COAHUILA,TORREON,11,236,3,250,1357
COAHUILA,TORREON,21,337,2,360,1664
COAHUILA,TORREON,8,326,3,337,1663
COAHUILA,TORREON,7,231,1,239,1864
COAHUILA,TORREON,16,241,1,258,1863
COAHUILA,TORREON,19,270,1,290,1863
COAHUILA,TORREON,13,238,0,251,1863
COAHUILA,TORREON,20,263,2,285,1863
COAHUILA,TORREON,11,248,0,259,1863
COAHUILA,TORREON,13,233,1,247,1863
COAHUILA,TORREON,7,220,1,228,1863
COAHUILA,TORREON,4,197,2,203,1611
COAHUILA,TORREON,3,177,3,183,1611
COAHUILA,TORREON,5,155,6,166,1410
COAHUILA,TORREON,1,157,1,159,1410
COAHUILA,TORREON,4,175,0,179,1410
COAHUILA,TORREON,10,247,0,257,1931
COAHUILA,TORREON,12,265,2,279,1931
COAHUILA,TORREON,8,270,1,279,1931
COAHUILA,TORREON,13,265,1,279,1930
COAHUILA,TORREON,8,272,1,281,1930
COAHUILA,TORREON,10,260,3,273,1930
COAHUILA,TORREON,13,233,2,248,1930
COAHUILA,TORREON,7,329,7,343,1891
COAHUILA,TORREON,14,301,1,316,1890
COAHUILA,TORREON,6,177,2,185,1237
COAHUILA,TORREON,10,192,2,204,1236
COAHUILA,TORREON,15,242,1,258,1863
COAHUILA,TORREON,46,185,1,232,1863
COAHUILA,TORREON,19,246,2,267,1863
COAHUILA,TORREON,12,246,0,258,1863
COAHUILA,TORREON,13,247,1,261,1863
COAHUILA,TORREON,17,231,0,248,1862
COAHUILA,TORREON,38,518,0,556,0
COAHUILA,TORREON,7,184,3,194,1135
COAHUILA,TORREON,6,205,4,215,1134
COAHUILA,TORREON,10,313,7,330,2060
COAHUILA,TORREON,28,166,3,197,1828
COAHUILA,TORREON,18,160,2,180,1828
COAHUILA,TORREON,11,176,2,189,1828
COAHUILA,TORREON,20,167,4,191,1827
COAHUILA,TORREON,8,370,1,379,2001
COAHUILA,TORREON,5,374,4,383,2000
COAHUILA,TORREON,6,202,0,208,1883
COAHUILA,TORREON,6,198,1,205,1883
COAHUILA,TORREON,12,181,4,197,1876
COAHUILA,TORREON,7,188,0,195,1875
COAHUILA,TORREON,5,140,4,149,1875
COAHUILA,TORREON,8,168,0,176,1875
COAHUILA,TORREON,5,175,1,181,1875
COAHUILA,TORREON,13,201,3,217,1875
COAHUILA,TORREON,1,192,4,197,1372
COAHUILA,TORREON,1,252,3,256,1371
COAHUILA,TORREON,5,226,3,234,1371
COAHUILA,TORREON,4,412,7,423,1452
COAHUILA,TORREON,6,386,5,397,1451
COAHUILA,TORREON,5,269,2,276,1600
COAHUILA,TORREON,4,296,3,303,1600
COAHUILA,TORREON,5,304,2,311,1600
COAHUILA,TORREON,4,333,4,341,1906
COAHUILA,TORREON,4,402,8,414,1906
COAHUILA,TORREON,0,246,2,248,1824
COAHUILA,TORREON,2,259,5,266,1823
COAHUILA,TORREON,10,208,3,221,1447
COAHUILA,TORREON,18,154,0,172,1141
COAHUILA,TORREON,24,131,1,156,1141
COAHUILA,TORREON,11,255,9,275,1852
COAHUILA,TORREON,17,256,2,275,1851
COAHUILA,TORREON,11,225,4,240,1671
COAHUILA,TORREON,8,222,2,232,1671
COAHUILA,TORREON,18,192,1,211,1387
COAHUILA,TORREON,201,14,0,215,1387
COAHUILA,TORREON,18,163,3,184,1386
COAHUILA,TORREON,10,236,1,247,1634
COAHUILA,TORREON,6,203,2,211,1634
COAHUILA,TORREON,18,309,0,327,1994
COAHUILA,TORREON,13,204,2,219,2003
COAHUILA,TORREON,7,203,1,211,2002
COAHUILA,TORREON,10,240,2,252,1744
COAHUILA,TORREON,10,232,0,242,1744
COAHUILA,TORREON,6,171,1,178,1722
COAHUILA,TORREON,2,185,5,192,1721
COAHUILA,TORREON,3,190,1,194,1721
COAHUILA,TORREON,2,133,0,135,1531
COAHUILA,TORREON,4,98,4,106,1530
COAHUILA,TORREON,2,107,3,112,1530
COAHUILA,TORREON,6,182,1,189,2132
COAHUILA,TORREON,9,173,1,183,2131
COAHUILA,TORREON,2,197,0,199,1556
COAHUILA,TORREON,5,157,0,162,1556
COAHUILA,TORREON,12,161,0,173,1809
COAHUILA,TORREON,3,178,2,183,1808
COAHUILA,TORREON,6,176,0,182,1638
COAHUILA,TORREON,5,164,4,173,1638
COAHUILA,TORREON,4,190,1,195,1703
COAHUILA,TORREON,11,189,1,201,1703
COAHUILA,TORREON,2,197,2,201,1604
COAHUILA,TORREON,8,226,0,234,1603
COAHUILA,TORREON,4,198,0,202,1516
COAHUILA,TORREON,8,155,0,163,1516
COAHUILA,TORREON,16,172,2,190,1791
COAHUILA,TORREON,18,163,0,181,1791
COAHUILA,TORREON,5,171,2,178,1214
COAHUILA,TORREON,5,164,0,169,1213
COAHUILA,TORREON,9,199,0,208,1514
COAHUILA,TORREON,6,216,0,222,1514
COAHUILA,TORREON,9,216,0,225,1578
COAHUILA,TORREON,10,203,1,214,1577
COAHUILA,TORREON,20,201,2,223,1785
COAHUILA,TORREON,20,239,1,260,1785
COAHUILA,TORREON,6,193,2,201,1714
COAHUILA,TORREON,3,167,1,171,1713
COAHUILA,TORREON,3,199,1,203,1573
COAHUILA,TORREON,5,186,0,191,1572
COAHUILA,TORREON,2,215,1,218,1565
COAHUILA,TORREON,8,190,2,200,1564
COAHUILA,TORREON,3,127,1,131,1266
COAHUILA,TORREON,6,132,1,139,1265
COAHUILA,TORREON,7,170,3,180,1368
COAHUILA,TORREON,0,133,3,136,1368
COAHUILA,TORREON,4,145,1,150,1580
COAHUILA,TORREON,3,118,0,121,1580
COAHUILA,TORREON,2,124,3,129,1599
COAHUILA,TORREON,4,143,3,150,1599
COAHUILA,TORREON,0,131,3,134,1598
COAHUILA,SALTILLO,4,233,8,245,1901
COAHUILA,SALTILLO,7,219,3,229,1900
COAHUILA,SALTILLO,12,269,6,287,1456
COAHUILA,SALTILLO,13,213,7,233,1455
COAHUILA,SALTILLO,9,266,1,276,1774
COAHUILA,SALTILLO,13,273,2,288,1773
COAHUILA,SALTILLO,13,405,1,419,1667
COAHUILA,SALTILLO,16,397,1,414,1667
COAHUILA,SALTILLO,11,313,6,330,1414
COAHUILA,SALTILLO,13,324,5,342,1414
COAHUILA,SALTILLO,7,280,2,289,1413
COAHUILA,SALTILLO,12,372,1,385,1844
COAHUILA,SALTILLO,8,359,4,371,1844
COAHUILA,SALTILLO,7,235,4,246,1446
COAHUILA,SALTILLO,2,251,3,256,1445
COAHUILA,SALTILLO,9,335,3,347,1432
COAHUILA,SALTILLO,6,316,4,326,1431
COAHUILA,SALTILLO,7,395,1,403,1734
COAHUILA,SALTILLO,11,420,1,432,1733
COAHUILA,SALTILLO,4,249,3,256,1227
COAHUILA,SALTILLO,5,211,4,220,1226
COAHUILA,SALTILLO,5,215,3,223,1616
COAHUILA,SALTILLO,5,237,5,247,1616
COAHUILA,SALTILLO,6,103,9,118,1848
COAHUILA,SALTILLO,7,113,5,125,1847
COAHUILA,SALTILLO,10,165,2,177,1366
COAHUILA,SALTILLO,11,140,3,154,1365
COAHUILA,SALTILLO,5,149,2,156,1375
COAHUILA,SALTILLO,2,121,2,125,1375
COAHUILA,SALTILLO,7,136,2,145,1374
COAHUILA,SALTILLO,18,174,2,194,1931
COAHUILA,SALTILLO,18,148,10,176,1931
COAHUILA,SALTILLO,12,160,2,174,1826
COAHUILA,SALTILLO,16,155,3,174,1826
COAHUILA,SALTILLO,19,205,2,226,1816
COAHUILA,SALTILLO,15,207,2,224,1815
COAHUILA,SALTILLO,13,197,0,210,1815
COAHUILA,SALTILLO,2,148,1,151,1574
COAHUILA,SALTILLO,3,167,0,170,1573
COAHUILA,SALTILLO,4,147,1,152,1573
COAHUILA,SALTILLO,15,270,5,290,1778
COAHUILA,SALTILLO,11,287,2,300,1777
COAHUILA,SALTILLO,8,187,1,196,1888
COAHUILA,SALTILLO,7,183,1,191,1888
COAHUILA,SALTILLO,11,212,2,225,1888
COAHUILA,SALTILLO,7,207,1,215,1888
COAHUILA,SALTILLO,7,193,2,202,1888
COAHUILA,SALTILLO,6,224,4,234,1888
COAHUILA,SALTILLO,14,205,0,219,1888
COAHUILA,SALTILLO,13,199,1,213,1888
COAHUILA,SALTILLO,8,205,1,214,1887
COAHUILA,SALTILLO,18,219,2,239,1445
COAHUILA,SALTILLO,10,191,3,204,1444
COAHUILA,SALTILLO,6,188,1,195,1463
COAHUILA,SALTILLO,5,199,3,207,1463
COAHUILA,SALTILLO,5,140,2,147,1061
COAHUILA,SALTILLO,9,162,4,175,1061
COAHUILA,SALTILLO,11,253,12,276,1761
COAHUILA,SALTILLO,12,273,8,293,1761
COAHUILA,SALTILLO,5,238,6,249,1734
COAHUILA,SALTILLO,5,204,5,214,1733
COAHUILA,SALTILLO,11,180,3,194,1419
COAHUILA,SALTILLO,3,173,7,183,1418
COAHUILA,SALTILLO,7,232,1,240,1391
COAHUILA,SALTILLO,11,221,0,232,1391
COAHUILA,SALTILLO,11,297,2,310,1685
COAHUILA,SALTILLO,12,297,3,312,1684
COAHUILA,SALTILLO,11,303,7,321,1684
COAHUILA,SALTILLO,8,178,1,187,1355
COAHUILA,SALTILLO,7,200,0,207,1355
COAHUILA,SALTILLO,7,177,0,184,1355
COAHUILA,SALTILLO,7,237,5,249,1919
COAHUILA,SALTILLO,5,247,4,256,1919
COAHUILA,SALTILLO,14,248,2,264,1850
COAHUILA,SALTILLO,9,266,3,278,1849
COAHUILA,SALTILLO,17,257,6,280,1799
COAHUILA,SALTILLO,15,233,1,249,1798
COAHUILA,SALTILLO,12,265,6,283,1798
COAHUILA,SALTILLO,31,183,1,215,1647
COAHUILA,SALTILLO,14,245,2,261,1647
COAHUILA,SALTILLO,22,230,0,252,1647
COAHUILA,SALTILLO,32,188,1,221,1871
COAHUILA,SALTILLO,26,195,0,221,1870
COAHUILA,SALTILLO,18,197,0,215,1870
COAHUILA,SALTILLO,6,168,2,176,1800
COAHUILA,SALTILLO,9,155,2,166,1799
COAHUILA,SALTILLO,6,189,4,199,1600
COAHUILA,SALTILLO,6,203,2,211,1599
COAHUILA,SALTILLO,4,232,0,236,1599
COAHUILA,SALTILLO,18,295,4,317,1688
COAHUILA,SALTILLO,14,294,0,308,1688
COAHUILA,SALTILLO,26,237,3,266,1677
COAHUILA,SALTILLO,10,269,5,284,1677
COAHUILA,SALTILLO,4,142,0,146,1339
COAHUILA,SALTILLO,10,125,2,137,1338
COAHUILA,SALTILLO,15,252,0,267,1913
COAHUILA,SALTILLO,18,262,2,282,1913
COAHUILA,SALTILLO,15,233,0,248,1532
COAHUILA,SALTILLO,7,245,4,256,1532
COAHUILA,SALTILLO,10,223,5,238,1532
COAHUILA,SALTILLO,21,233,4,258,1846
COAHUILA,SALTILLO,18,221,2,241,1845
COAHUILA,SALTILLO,9,188,1,198,1179
COAHUILA,SALTILLO,6,185,6,197,1179
COAHUILA,SALTILLO,22,300,1,323,1901
COAHUILA,SALTILLO,26,276,3,305,1901
COAHUILA,SALTILLO,8,230,3,241,1839
COAHUILA,SALTILLO,4,227,3,234,1838
COAHUILA,SALTILLO,4,193,2,199,1862
COAHUILA,SALTILLO,7,196,5,208,1861
COAHUILA,SALTILLO,12,221,4,237,1681
COAHUILA,SALTILLO,3,224,2,229,1681
COAHUILA,SALTILLO,17,209,2,228,1604
COAHUILA,SALTILLO,9,237,5,251,1604
COAHUILA,SALTILLO,17,220,2,239,1603
COAHUILA,SALTILLO,12,262,4,278,1686
COAHUILA,SALTILLO,5,228,6,239,1686
COAHUILA,SALTILLO,48,1270,14,1332,0
COAHUILA,SALTILLO,13,226,1,240,1421
COAHUILA,SALTILLO,15,236,3,254,1420
COAHUILA,SALTILLO,10,288,3,301,1650
COAHUILA,SALTILLO,10,255,5,270,1650
COAHUILA,SALTILLO,9,189,0,198,1455
COAHUILA,SALTILLO,11,182,2,195,1454
COAHUILA,SALTILLO,3,157,4,164,1614
COAHUILA,SALTILLO,6,152,4,162,1614
COAHUILA,SALTILLO,10,160,3,173,1830
COAHUILA,SALTILLO,10,196,7,213,1830
COAHUILA,SALTILLO,10,169,3,182,1829
COAHUILA,SALTILLO,7,195,6,208,1829
COAHUILA,SALTILLO,3,234,6,243,1681
COAHUILA,SALTILLO,14,241,5,260,1681
COAHUILA,SALTILLO,5,224,12,241,1507
COAHUILA,SALTILLO,6,232,2,240,1506
COAHUILA,SALTILLO,11,251,1,263,1531
COAHUILA,SALTILLO,16,230,5,251,1530
COAHUILA,SALTILLO,8,174,4,186,1209
COAHUILA,SALTILLO,3,198,1,202,1209
COAHUILA,SALTILLO,16,175,2,193,1302
COAHUILA,SALTILLO,13,176,2,191,1302
COAHUILA,SALTILLO,12,292,4,308,1627
COAHUILA,SALTILLO,11,266,5,282,1627
COAHUILA,SALTILLO,12,270,6,288,1675
COAHUILA,SALTILLO,18,255,3,276,1674
COAHUILA,SALTILLO,14,202,2,218,1732
COAHUILA,SALTILLO,6,202,1,209,1732
COAHUILA,SALTILLO,7,178,8,193,1732
COAHUILA,SALTILLO,12,168,4,184,1732
COAHUILA,SALTILLO,24,330,2,356,1849
COAHUILA,SALTILLO,21,276,2,299,1849
COAHUILA,SALTILLO,8,203,2,213,1728
COAHUILA,SALTILLO,5,244,3,252,1727
COAHUILA,SALTILLO,4,167,0,171,1727
COAHUILA,SALTILLO,10,204,2,216,1727
COAHUILA,SALTILLO,4,218,0,222,1727
COAHUILA,SALTILLO,19,233,4,256,1885
COAHUILA,SALTILLO,14,249,5,268,1885
COAHUILA,SALTILLO,33,207,1,241,1873
COAHUILA,SALTILLO,20,232,2,254,1873
COAHUILA,SALTILLO,2,147,1,150,1878
COAHUILA,SALTILLO,8,156,0,164,1878
COAHUILA,SALTILLO,4,133,3,140,1877
COAHUILA,SALTILLO,5,107,1,113,1544
COAHUILA,SALTILLO,1,137,0,138,1544
COAHUILA,SALTILLO,1,106,1,108,1544
COAHUILA,SALTILLO,8,176,0,184,1820
COAHUILA,SALTILLO,6,152,1,159,1819
COAHUILA,SALTILLO,5,125,0,130,1819
COAHUILA,SALTILLO,3,109,5,117,1819
COAHUILA,SALTILLO,4,135,2,141,1819
COAHUILA,SALTILLO,4,156,1,161,1819
COAHUILA,SALTILLO,6,106,3,115,1410
COAHUILA,SALTILLO,6,100,3,109,1410
COAHUILA,SALTILLO,6,94,2,102,1409
COAHUILA,SALTILLO,2,96,2,100,1734
COAHUILA,SALTILLO,3,102,3,108,1733
COAHUILA,SALTILLO,7,85,2,94,1733
COAHUILA,SALTILLO,2,96,1,99,1733
COAHUILA,SALTILLO,16,63,4,83,1628
COAHUILA,SALTILLO,10,79,1,90,1627
COAHUILA,SALTILLO,17,172,5,194,1898
COAHUILA,SALTILLO,9,157,1,167,1897
COAHUILA,SALTILLO,13,176,2,191,1615
COAHUILA,SALTILLO,13,177,2,192,1614
COAHUILA,SALTILLO,24,194,0,218,2132
COAHUILA,SALTILLO,24,194,0,218,2131
COAHUILA,SALTILLO,13,170,3,186,2021
COAHUILA,SALTILLO,9,166,6,181,2021
COAHUILA,SALTILLO,5,191,0,196,2020
COAHUILA,SALTILLO,5,181,1,187,1579
COAHUILA,SALTILLO,5,161,4,170,1579
COAHUILA,SALTILLO,9,166,2,177,1579
COAHUILA,SALTILLO,4,117,2,123,1638
COAHUILA,SALTILLO,5,99,1,105,1638
COAHUILA,SALTILLO,4,121,1,126,1638
COAHUILA,SALTILLO,8,145,2,155,1738
COAHUILA,SALTILLO,183,6,2,191,1738
COAHUILA,SALTILLO,6,153,2,161,1737
COLIMA,COLIMA,26,180,3,209,1903
COLIMA,COLIMA,27,198,0,225,1902
COLIMA,COLIMA,34,157,3,194,1902
COLIMA,COLIMA,18,247,5,270,1656
COLIMA,COLIMA,11,211,3,225,1655
COLIMA,COLIMA,13,218,3,234,1655
COLIMA,COLIMA,12,208,6,226,1699
COLIMA,COLIMA,14,226,1,241,1699
COLIMA,COLIMA,20,219,1,240,1699
COLIMA,COLIMA,27,181,3,211,1908
COLIMA,COLIMA,14,172,1,187,1907
COLIMA,COLIMA,31,226,3,260,1549
COLIMA,COLIMA,22,236,4,262,1548
COLIMA,COLIMA,20,240,4,264,1888
COLIMA,COLIMA,32,295,3,330,1888
COLIMA,COLIMA,19,264,4,287,1888
COLIMA,COLIMA,21,207,2,230,1829
COLIMA,COLIMA,13,251,2,266,1828
COLIMA,COLIMA,16,232,3,251,1828
COLIMA,COLIMA,8,209,6,223,1596
COLIMA,COLIMA,10,192,4,206,1596
COLIMA,COLIMA,12,267,1,280,1596
COLIMA,COLIMA,22,280,2,304,1867
COLIMA,COLIMA,27,278,3,308,1867
COLIMA,COLIMA,10,258,6,274,1896
COLIMA,COLIMA,4,272,4,280,1896
COLIMA,COLIMA,11,279,2,292,1895
COLIMA,COLIMA,26,212,1,239,1761
COLIMA,COLIMA,15,278,1,294,1761
COLIMA,COLIMA,11,175,1,187,1479
COLIMA,COLIMA,10,178,2,190,1479
COLIMA,COLIMA,14,283,2,299,1892
COLIMA,COLIMA,17,308,4,329,1891
COLIMA,COLIMA,14,292,3,309,1891
COLIMA,COLIMA,12,269,2,283,1536
COLIMA,COLIMA,31,291,3,325,1535
COLIMA,COLIMA,16,299,1,316,1535
COLIMA,COLIMA,15,250,3,268,1802
COLIMA,COLIMA,16,240,4,260,1802
COLIMA,COLIMA,10,230,5,245,1554
COLIMA,COLIMA,23,206,4,233,1553
COLIMA,COLIMA,5,199,3,207,1605
COLIMA,COLIMA,11,199,2,212,1605
COLIMA,COLIMA,4,178,2,184,1605
COLIMA,COLIMA,9,191,1,201,1605
COLIMA,COLIMA,8,161,2,171,1604
COLIMA,COLIMA,92,1079,6,1177,0
COLIMA,COLIMA,14,198,5,217,1768
COLIMA,COLIMA,4,227,3,234,1768
COLIMA,COLIMA,9,225,5,239,1768
COLIMA,COLIMA,11,230,3,244,1768
COLIMA,COLIMA,14,236,4,254,1768
COLIMA,COLIMA,10,174,2,186,1768
COLIMA,COLIMA,11,200,1,212,1849
COLIMA,COLIMA,8,185,3,196,1849
COLIMA,COLIMA,12,235,2,249,1848
COLIMA,COLIMA,10,301,0,311,1982
COLIMA,COLIMA,17,245,2,264,1886
COLIMA,COLIMA,21,245,6,272,1886
COLIMA,COLIMA,18,188,5,211,1885
COLIMA,COLIMA,14,135,1,150,1490
COLIMA,COLIMA,10,144,1,155,1489
COLIMA,COLIMA,10,138,2,150,1489
COLIMA,COLIMA,8,199,0,207,1917
COLIMA,COLIMA,13,203,1,217,1916
COLIMA,COLIMA,17,157,3,177,1295
COLIMA,COLIMA,16,153,6,175,1295
COLIMA,COLIMA,8,187,2,197,1141
COLIMA,COLIMA,13,175,1,189,1141
COLIMA,COLIMA,13,226,2,241,1554
COLIMA,COLIMA,16,243,3,262,1554
COLIMA,COLIMA,7,200,3,210,1844
COLIMA,COLIMA,2,247,4,253,1843
COLIMA,COLIMA,6,262,8,276,1337
COLIMA,COLIMA,11,257,5,273,1336
COLIMA,COLIMA,11,236,5,252,1336
COLIMA,COLIMA,15,201,6,222,1396
COLIMA,COLIMA,17,185,3,205,1396
COLIMA,COLIMA,11,196,1,208,1396
COLIMA,COLIMA,14,180,2,196,1396
COLIMA,COLIMA,21,177,4,202,1395
COLIMA,COLIMA,11,194,2,207,1395
COLIMA,COLIMA,14,266,9,289,1654
COLIMA,COLIMA,7,290,7,304,1654
COLIMA,COLIMA,18,229,6,253,1455
COLIMA,COLIMA,13,271,5,289,1455
COLIMA,COLIMA,28,287,8,323,1920
COLIMA,COLIMA,28,262,7,297,1919
COLIMA,COLIMA,2,220,5,227,1718
COLIMA,COLIMA,7,225,1,233,1718
COLIMA,COLIMA,10,244,5,259,1664
COLIMA,COLIMA,13,214,4,231,1663
COLIMA,COLIMA,13,278,5,296,1616
COLIMA,COLIMA,6,313,3,322,1615
COLIMA,COLIMA,6,207,1,214,1463
COLIMA,COLIMA,11,195,3,209,1463
COLIMA,COLIMA,10,417,9,436,1775
COLIMA,COLIMA,11,433,4,448,1774
COLIMA,COLIMA,15,254,3,272,1712
COLIMA,COLIMA,9,264,2,275,1711
COLIMA,COLIMA,14,208,5,227,1393
COLIMA,COLIMA,12,240,1,253,1393
COLIMA,COLIMA,7,238,2,247,1392
COLIMA,COLIMA,9,220,1,230,1516
COLIMA,COLIMA,7,257,4,268,1516
COLIMA,COLIMA,12,380,4,396,1969
COLIMA,COLIMA,21,343,2,366,1969
COLIMA,COLIMA,10,296,0,306,1495
COLIMA,COLIMA,6,282,2,290,1494
COLIMA,COLIMA,12,295,2,309,1968
COLIMA,COLIMA,8,317,3,328,1968
COLIMA,COLIMA,7,305,0,312,1968
COLIMA,COLIMA,12,255,2,269,1841
COLIMA,COLIMA,10,231,0,241,1840
COLIMA,COLIMA,10,240,2,252,1840
COLIMA,COLIMA,16,229,1,246,1840
COLIMA,COLIMA,19,270,1,290,1915
COLIMA,COLIMA,15,272,3,290,1915
COLIMA,COLIMA,23,259,2,284,1914
COLIMA,COLIMA,19,262,3,284,1914
COLIMA,COLIMA,14,222,4,240,1914
COLIMA,COLIMA,22,186,6,214,1549
COLIMA,COLIMA,16,194,5,215,1549
COLIMA,COLIMA,12,199,1,212,1549
COLIMA,COLIMA,25,225,0,250,1663
COLIMA,COLIMA,21,240,1,262,1663
COLIMA,COLIMA,20,258,2,280,1662
COLIMA,COLIMA,28,237,0,265,1824
COLIMA,COLIMA,24,243,3,270,1824
COLIMA,COLIMA,27,209,4,240,1824
COLIMA,COLIMA,23,201,1,225,1824
COLIMA,COLIMA,22,232,3,257,1824
COLIMA,COLIMA,18,221,0,239,1823
COLIMA,COLIMA,15,144,1,160,1731
COLIMA,COLIMA,7,160,0,167,1731
COLIMA,COLIMA,10,171,1,182,1731
COLIMA,COLIMA,7,155,0,162,1730
COLIMA,COLIMA,9,152,0,161,1730
COLIMA,COLIMA,16,268,6,290,1930
COLIMA,COLIMA,14,279,2,295,1929
COLIMA,COLIMA,15,228,0,243,1989
COLIMA,COLIMA,17,217,3,237,1988
COLIMA,COLIMA,16,216,2,234,1988
COLIMA,COLIMA,11,207,6,224,1366
COLIMA,COLIMA,19,211,2,232,1366
COLIMA,COLIMA,9,231,4,244,1365
COLIMA,COLIMA,17,282,2,301,1775
COLIMA,COLIMA,10,264,2,276,1775
COLIMA,COLIMA,11,297,6,314,1774
COLIMA,COLIMA,7,235,2,244,1464
COLIMA,COLIMA,11,183,0,194,1463
COLIMA,COLIMA,12,141,1,154,1371
COLIMA,COLIMA,10,167,4,181,1371
COLIMA,COLIMA,15,152,2,169,1371
COLIMA,COLIMA,9,197,2,208,1847
COLIMA,COLIMA,16,247,4,267,1846
COLIMA,COLIMA,15,219,1,235,1421
COLIMA,COLIMA,6,247,3,256,1421
COLIMA,COLIMA,11,193,2,206,1881
COLIMA,COLIMA,15,211,3,229,1880
COLIMA,COLIMA,19,182,0,201,1416
COLIMA,COLIMA,10,166,0,176,1416
COLIMA,COLIMA,21,165,2,188,1416
COLIMA,COLIMA,16,269,1,286,1852
COLIMA,COLIMA,18,215,4,237,1852
COLIMA,COLIMA,11,252,1,264,1852
COLIMA,COLIMA,13,195,3,211,1659
COLIMA,COLIMA,18,214,0,232,1659
COLIMA,COLIMA,19,220,2,241,1658
COLIMA,COLIMA,11,150,1,162,1280
COLIMA,COLIMA,11,139,0,150,1280
COLIMA,COLIMA,10,204,3,217,1853
COLIMA,COLIMA,18,178,1,197,1852
COLIMA,COLIMA,15,195,2,212,1852
COLIMA,MANZANILLO,5,343,6,354,1837
COLIMA,MANZANILLO,11,370,5,386,1837
COLIMA,MANZANILLO,8,291,3,302,1466
COLIMA,MANZANILLO,6,305,4,315,1465
COLIMA,MANZANILLO,8,288,3,299,1817
COLIMA,MANZANILLO,7,356,5,368,1816
COLIMA,MANZANILLO,6,291,3,300,1685
COLIMA,MANZANILLO,7,272,3,282,1684
COLIMA,MANZANILLO,14,360,6,380,2313
COLIMA,MANZANILLO,4,297,3,304,1524
COLIMA,MANZANILLO,4,295,5,304,1523
COLIMA,MANZANILLO,4,298,4,306,1356
COLIMA,MANZANILLO,7,291,3,301,1355
COLIMA,MANZANILLO,11,399,4,414,1610
COLIMA,MANZANILLO,7,396,3,406,1609
COLIMA,MANZANILLO,13,355,3,371,1946
COLIMA,MANZANILLO,9,222,2,233,1169
COLIMA,MANZANILLO,11,191,2,204,1168
COLIMA,MANZANILLO,6,319,2,327,2102
COLIMA,MANZANILLO,9,190,1,200,1199
COLIMA,MANZANILLO,5,170,2,177,1199
COLIMA,MANZANILLO,7,178,2,187,1202
COLIMA,MANZANILLO,12,200,0,212,1201
COLIMA,MANZANILLO,3,310,2,315,2091
COLIMA,MANZANILLO,6,271,0,277,1794
COLIMA,MANZANILLO,6,271,6,283,1793
COLIMA,MANZANILLO,1,169,1,171,1198
COLIMA,MANZANILLO,4,144,0,148,1197
COLIMA,MANZANILLO,13,307,4,324,1513
COLIMA,MANZANILLO,11,282,6,299,1512
COLIMA,MANZANILLO,14,324,4,342,1570
COLIMA,MANZANILLO,8,313,1,322,1569
COLIMA,MANZANILLO,14,227,6,247,1270
COLIMA,MANZANILLO,6,181,4,191,1269
COLIMA,MANZANILLO,15,386,5,406,2212
COLIMA,MANZANILLO,8,453,4,465,2291
COLIMA,MANZANILLO,5,199,0,204,1278
COLIMA,MANZANILLO,4,176,1,181,1277
COLIMA,MANZANILLO,13,258,2,273,1800
COLIMA,MANZANILLO,5,263,3,271,1799
COLIMA,MANZANILLO,15,163,2,180,1569
COLIMA,MANZANILLO,11,182,1,194,1569
COLIMA,MANZANILLO,2,169,6,177,1884
COLIMA,MANZANILLO,3,181,6,190,1884
COLIMA,MANZANILLO,3,197,2,202,1884
COLIMA,MANZANILLO,3,161,2,166,1883
COLIMA,MANZANILLO,2,168,2,172,1883
COLIMA,MANZANILLO,2,173,1,176,1883
COLIMA,MANZANILLO,2,178,0,180,1883
COLIMA,MANZANILLO,6,235,0,241,1681
COLIMA,MANZANILLO,7,248,7,262,1681
COLIMA,MANZANILLO,7,240,2,249,1842
COLIMA,MANZANILLO,13,228,6,247,1842
COLIMA,MANZANILLO,8,195,2,205,1842
COLIMA,MANZANILLO,7,214,1,222,1842
COLIMA,MANZANILLO,1,223,0,224,1842
COLIMA,MANZANILLO,4,217,1,222,1841
COLIMA,MANZANILLO,8,215,2,225,1841
COLIMA,MANZANILLO,7,206,1,214,1841
COLIMA,MANZANILLO,8,319,0,327,2059
COLIMA,MANZANILLO,13,177,0,190,1416
COLIMA,MANZANILLO,15,163,6,184,1415
COLIMA,MANZANILLO,10,230,1,241,1733
COLIMA,MANZANILLO,11,223,235,469,1733
COLIMA,MANZANILLO,4,207,0,211,1733
COLIMA,MANZANILLO,5,206,0,211,1732
COLIMA,MANZANILLO,11,211,1,223,1732
COLIMA,MANZANILLO,14,294,6,314,2035
COLIMA,MANZANILLO,6,181,1,188,1223
COLIMA,MANZANILLO,3,206,0,209,1223
COLIMA,MANZANILLO,12,206,2,220,1794
COLIMA,MANZANILLO,11,210,1,222,1794
COLIMA,MANZANILLO,9,196,2,207,1794
COLIMA,MANZANILLO,18,188,2,208,1794
COLIMA,MANZANILLO,9,188,1,198,1794
COLIMA,MANZANILLO,16,246,0,262,1793
COLIMA,MANZANILLO,11,209,2,222,1793
COLIMA,MANZANILLO,168,1344,8,1520,0
COLIMA,MANZANILLO,14,260,7,281,1749
COLIMA,MANZANILLO,14,230,6,250,1749
COLIMA,MANZANILLO,11,212,1,224,1749
COLIMA,MANZANILLO,8,224,0,232,1749
COLIMA,MANZANILLO,9,244,2,255,1749
COLIMA,MANZANILLO,7,261,2,270,1749
COLIMA,MANZANILLO,11,228,4,243,1748
COLIMA,MANZANILLO,8,387,3,398,1944
COLIMA,MANZANILLO,4,362,2,368,1944
COLIMA,MANZANILLO,9,194,1,204,1358
COLIMA,MANZANILLO,7,214,3,224,1358
COLIMA,MANZANILLO,13,264,1,278,1863
COLIMA,MANZANILLO,16,228,2,246,1862
COLIMA,MANZANILLO,7,280,5,292,1599
COLIMA,MANZANILLO,5,315,4,324,1599
COLIMA,MANZANILLO,7,292,5,304,1476
COLIMA,MANZANILLO,3,279,3,285,1476
COLIMA,MANZANILLO,13,286,3,302,1336
COLIMA,MANZANILLO,7,259,3,269,1335
COLIMA,MANZANILLO,3,242,0,245,1447
COLIMA,MANZANILLO,10,271,7,288,1446
COLIMA,MANZANILLO,0,396,9,405,2326
COLIMA,MANZANILLO,6,192,2,200,1164
COLIMA,MANZANILLO,2,174,2,178,1164
COLIMA,MANZANILLO,6,248,2,256,1176
COLIMA,MANZANILLO,8,254,3,265,1175
COLIMA,MANZANILLO,10,509,4,523,2331
COLIMA,MANZANILLO,10,432,14,456,2203
COLIMA,MANZANILLO,11,272,10,293,1540
COLIMA,MANZANILLO,10,249,2,261,1540
COLIMA,MANZANILLO,6,229,4,239,1536
COLIMA,MANZANILLO,8,223,3,234,1536
COLIMA,MANZANILLO,8,213,3,224,1260
COLIMA,MANZANILLO,8,266,3,277,1260
COLIMA,MANZANILLO,7,257,4,268,1921
COLIMA,MANZANILLO,3,242,1,246,1921
COLIMA,MANZANILLO,8,246,4,258,1921
COLIMA,MANZANILLO,6,208,2,216,1920
COLIMA,MANZANILLO,15,364,14,393,2296
COLIMA,MANZANILLO,14,268,5,287,1702
COLIMA,MANZANILLO,6,250,4,260,1701
COLIMA,MANZANILLO,5,248,1,254,1664
COLIMA,MANZANILLO,4,235,3,242,1663
COLIMA,MANZANILLO,15,321,10,346,1958
COLIMA,MANZANILLO,11,287,1,299,1755
COLIMA,MANZANILLO,10,289,7,306,1755
COLIMA,MANZANILLO,3,194,1,198,1431
COLIMA,MANZANILLO,7,194,8,209,1431
COLIMA,MANZANILLO,3,164,3,170,1431
COLIMA,MANZANILLO,7,229,5,241,1481
COLIMA,MANZANILLO,6,215,0,221,1481
COLIMA,MANZANILLO,14,245,3,262,1561
COLIMA,MANZANILLO,10,238,3,251,1560
COLIMA,MANZANILLO,3,210,1,214,1514
COLIMA,MANZANILLO,10,232,3,245,1514
COLIMA,MANZANILLO,3,258,11,272,1943
COLIMA,MANZANILLO,6,243,1,250,1943
COLIMA,MANZANILLO,12,246,1,259,1221
COLIMA,MANZANILLO,15,206,1,222,1220
COLIMA,MANZANILLO,2,271,6,279,1447
COLIMA,MANZANILLO,4,264,7,275,1447
COLIMA,MANZANILLO,10,312,6,328,1980
COLIMA,MANZANILLO,8,257,1,266,1634
COLIMA,MANZANILLO,2,232,1,235,1633
COLIMA,MANZANILLO,8,265,5,278,1603
COLIMA,MANZANILLO,10,278,5,293,1602
COLIMA,MANZANILLO,6,180,2,188,1295
COLIMA,MANZANILLO,10,202,0,212,1295
COLIMA,MANZANILLO,9,278,2,289,1777
COLIMA,MANZANILLO,9,254,1,264,1776
COLIMA,MANZANILLO,2,241,0,243,1441
COLIMA,MANZANILLO,15,222,8,245,1440
COLIMA,MANZANILLO,4,339,7,350,1839
COLIMA,MANZANILLO,2,353,2,357,1838
COLIMA,MANZANILLO,5,181,1,187,1294
COLIMA,MANZANILLO,7,137,1,145,1294
COLIMA,MANZANILLO,3,197,2,202,1445
COLIMA,MANZANILLO,2,202,3,207,1445
COLIMA,MANZANILLO,4,186,1,191,1504
COLIMA,MANZANILLO,3,174,3,180,1504
COLIMA,MANZANILLO,1,209,3,213,1855
COLIMA,MANZANILLO,5,229,1,235,1854
CHIAPAS,PALENQUE,9,723,4,736,1901
CHIAPAS,PALENQUE,7,735,4,746,1901
CHIAPAS,PALENQUE,0,681,4,685,1805
CHIAPAS,PALENQUE,7,725,9,741,1805
CHIAPAS,PALENQUE,0,798,10,808,1947
CHIAPAS,PALENQUE,17,710,4,731,1947
CHIAPAS,PALENQUE,9,500,12,521,1588
CHIAPAS,PALENQUE,10,508,4,522,1587
CHIAPAS,PALENQUE,9,455,5,469,1555
CHIAPAS,PALENQUE,9,411,5,425,1555
CHIAPAS,PALENQUE,13,460,7,480,1555
CHIAPAS,PALENQUE,8,481,3,492,1555
CHIAPAS,PALENQUE,7,531,5,543,1692
CHIAPAS,PALENQUE,11,583,6,600,1691
CHIAPAS,PALENQUE,15,608,15,638,1807
CHIAPAS,PALENQUE,18,557,9,584,1807
CHIAPAS,PALENQUE,10,557,13,580,1807
CHIAPAS,PALENQUE,8,543,19,570,1806
CHIAPAS,PALENQUE,8,326,2,336,997
CHIAPAS,PALENQUE,5,327,3,335,997
CHIAPAS,PALENQUE,24,532,7,563,1598
CHIAPAS,PALENQUE,27,523,8,558,1598
CHIAPAS,PALENQUE,17,553,16,586,1598
CHIAPAS,PALENQUE,29,465,6,500,1597
CHIAPAS,PALENQUE,16,521,11,548,1711
CHIAPAS,PALENQUE,11,469,10,490,1710
CHIAPAS,PALENQUE,18,523,4,545,1710
CHIAPAS,PALENQUE,11,478,5,494,1710
CHIAPAS,PALENQUE,11,344,5,360,1130
CHIAPAS,PALENQUE,6,389,8,403,1129
CHIAPAS,PALENQUE,42,1746,34,1822,0
CHIAPAS,PALENQUE,1,636,11,648,1210
CHIAPAS,PALENQUE,12,636,12,660,1210
CHIAPAS,PALENQUE,18,955,9,982,1857
CHIAPAS,PALENQUE,11,947,12,970,1856
CHIAPAS,PALENQUE,16,587,8,611,1951
CHIAPAS,PALENQUE,1,569,9,579,1950
CHIAPAS,PALENQUE,9,686,19,714,1592
CHIAPAS,PALENQUE,24,663,26,713,1592
CHIAPAS,PALENQUE,31,546,15,592,1434
CHIAPAS,PALENQUE,28,570,24,622,1434
CHIAPAS,PALENQUE,22,525,19,566,1433
CHIAPAS,PALENQUE,17,627,12,656,1427
CHIAPAS,PALENQUE,20,626,22,668,1427
CHIAPAS,PALENQUE,7,411,9,427,1153
CHIAPAS,PALENQUE,6,378,13,397,1153
CHIAPAS,PALENQUE,10,485,5,500,1085
CHIAPAS,PALENQUE,15,429,13,457,1085
CHIAPAS,PALENQUE,25,530,24,579,1454
CHIAPAS,PALENQUE,27,493,10,530,1454
CHIAPAS,PALENQUE,38,598,16,652,1341
CHIAPAS,PALENQUE,26,668,19,713,1341
CHIAPAS,PALENQUE,15,748,13,776,1892
CHIAPAS,PALENQUE,28,696,25,749,1891
CHIAPAS,PALENQUE,16,701,13,730,1891
CHIAPAS,PALENQUE,20,464,18,502,1078
CHIAPAS,PALENQUE,31,496,13,540,1078
CHIAPAS,PALENQUE,23,576,12,611,1366
CHIAPAS,PALENQUE,28,481,19,528,1365
CHIAPAS,PALENQUE,22,531,16,569,1365
CHIAPAS,PALENQUE,19,654,17,690,1424
CHIAPAS,PALENQUE,19,677,20,716,1423
CHIAPAS,PALENQUE,0,732,4,736,1159
CHIAPAS,PALENQUE,14,857,6,877,1158
CHIAPAS,PALENQUE,6,967,6,979,1436
CHIAPAS,PALENQUE,21,942,14,977,1435
CHIAPAS,PALENQUE,59,429,29,517,1052
CHIAPAS,PALENQUE,69,449,25,543,1051
CHIAPAS,PALENQUE,34,1073,5,1112,1492
CHIAPAS,PALENQUE,76,573,20,669,1492
CHIAPAS,PALENQUE,0,0,0,0,1157
CHIAPAS,PALENQUE,0,0,0,0,1157
CHIAPAS,PALENQUE,0,0,0,0,1915
CHIAPAS,PALENQUE,0,0,0,0,1914
CHIAPAS,PALENQUE,30,912,10,952,1452
CHIAPAS,PALENQUE,25,945,5,975,1452
CHIAPAS,PALENQUE,98,686,16,800,1372
CHIAPAS,PALENQUE,117,566,13,696,1372
CHIAPAS,PALENQUE,89,606,37,732,1371
CHIAPAS,PALENQUE,20,1004,19,1043,1489
CHIAPAS,PALENQUE,7,950,15,972,1489
CHIAPAS,PALENQUE,11,934,21,966,1641
CHIAPAS,PALENQUE,13,544,11,568,1640
CHIAPAS,PALENQUE,14,401,18,433,1346
CHIAPAS,PALENQUE,25,453,36,514,1346
CHIAPAS,PALENQUE,7,292,5,304,1345
CHIAPAS,PALENQUE,20,702,15,737,1506
CHIAPAS,PALENQUE,17,1323,21,1361,1505
CHIAPAS,PALENQUE,12,498,9,519,1684
CHIAPAS,PALENQUE,6,513,9,528,1684
CHIAPAS,PALENQUE,34,490,31,555,1539
CHIAPAS,PALENQUE,23,617,13,653,1539
CHIAPAS,PALENQUE,25,506,23,554,1716
CHIAPAS,PALENQUE,25,471,23,519,1716
CHIAPAS,PALENQUE,4,862,5,871,1340
CHIAPAS,PALENQUE,4,654,2,660,1340
CHIAPAS,PALENQUE,4,550,11,565,1339
CHIAPAS,PALENQUE,9,1049,2,1060,1344
CHIAPAS,PALENQUE,6,909,2,917,1343
CHIAPAS,PALENQUE,13,972,8,993,1343
CHIAPAS,PALENQUE,34,570,29,633,1449
CHIAPAS,PALENQUE,21,720,22,763,1449
CHIAPAS,PALENQUE,16,943,24,983,1937
CHIAPAS,PALENQUE,2,916,33,951,1937
CHIAPAS,PALENQUE,15,621,15,651,1281
CHIAPAS,PALENQUE,15,761,11,787,1281
CHIAPAS,PALENQUE,36,1301,30,1367,1735
CHIAPAS,PALENQUE,49,1441,95,1585,1734
CHIAPAS,PALENQUE,0,1106,21,1127,1379
CHIAPAS,PALENQUE,1,1067,17,1085,1379
CHIAPAS,PALENQUE,36,417,30,483,1347
CHIAPAS,PALENQUE,27,448,26,501,1347
CHIAPAS,PALENQUE,21,454,21,496,1347
CHIAPAS,PALENQUE,36,387,20,443,1305
CHIAPAS,PALENQUE,22,398,18,438,1305
CHIAPAS,PALENQUE,30,323,23,376,1229
CHIAPAS,PALENQUE,17,316,10,343,1229
CHIAPAS,PALENQUE,13,318,9,340,1091
CHIAPAS,PALENQUE,23,271,18,312,1090
CHIAPAS,PALENQUE,104,401,68,573,1685
CHIAPAS,PALENQUE,92,375,59,526,1685
CHIAPAS,PALENQUE,25,278,50,353,1443
CHIAPAS,PALENQUE,38,238,69,345,1443
CHIAPAS,PALENQUE,24,324,30,378,1338
CHIAPAS,PALENQUE,43,399,11,453,1338
CHIAPAS,PALENQUE,32,334,42,408,1336
CHIAPAS,PALENQUE,33,262,38,333,1336
CHIAPAS,PALENQUE,70,383,41,494,1129
CHIAPAS,PALENQUE,43,438,92,573,1128
CHIAPAS,PALENQUE,84,493,52,629,1421
CHIAPAS,PALENQUE,77,348,72,497,1421
CHIAPAS,PALENQUE,20,231,18,269,1787
CHIAPAS,PALENQUE,17,186,24,227,1786
CHIAPAS,PALENQUE,89,392,29,510,1117
CHIAPAS,PALENQUE,88,416,29,533,1117
CHIAPAS,PALENQUE,24,509,18,551,1027
CHIAPAS,PALENQUE,20,483,11,514,1027
CHIAPAS,PALENQUE,49,641,54,744,1555
CHIAPAS,PALENQUE,31,691,18,740,1554
CHIAPAS,PALENQUE,42,361,56,459,1867
CHIAPAS,PALENQUE,63,476,51,590,1867
CHIAPAS,PALENQUE,3,529,33,565,1867
CHIAPAS,PALENQUE,72,740,62,874,1939
CHIAPAS,PALENQUE,56,760,52,868,1938
CHIAPAS,PALENQUE,41,748,35,824,1684
CHIAPAS,PALENQUE,38,827,22,887,1683
CHIAPAS,PALENQUE,16,693,17,726,1310
CHIAPAS,PALENQUE,25,712,14,751,1310
CHIAPAS,PALENQUE,87,847,64,998,1908
CHIAPAS,PALENQUE,88,767,108,963,1908
CHIAPAS,PALENQUE,95,436,124,655,1112
CHIAPAS,PALENQUE,95,466,92,653,1112
CHIAPAS,PALENQUE,40,668,43,751,1846
CHIAPAS,PALENQUE,49,790,44,883,1845
CHIAPAS,PALENQUE,33,1104,27,1164,1750
CHIAPAS,PALENQUE,30,809,62,901,1750
CHIAPAS,PALENQUE,38,795,15,848,1750
CHIAPAS,PALENQUE,41,603,24,668,1964
CHIAPAS,PALENQUE,50,721,19,790,1963
CHIAPAS,PALENQUE,9,497,10,516,1459
CHIAPAS,PALENQUE,7,523,14,544,1458
CHIAPAS,PALENQUE,17,477,25,519,1656
CHIAPAS,PALENQUE,14,557,15,586,1656
CHIAPAS,PALENQUE,6,962,115,1083,1728
CHIAPAS,PALENQUE,8,757,5,770,1728
CHIAPAS,PALENQUE,7,526,14,547,1398
CHIAPAS,PALENQUE,12,510,6,528,1398
CHIAPAS,PALENQUE,14,514,16,544,1378
CHIAPAS,PALENQUE,28,441,37,506,1377
CHIAPAS,PALENQUE,14,851,26,891,1269
CHIAPAS,PALENQUE,19,665,16,700,1269
CHIAPAS,PALENQUE,21,766,22,809,1678
CHIAPAS,PALENQUE,12,549,14,575,1677
CHIAPAS,PALENQUE,0,222,15,237,1482
CHIAPAS,PALENQUE,3,216,4,223,1481
CHIAPAS,PALENQUE,15,386,13,414,1278
CHIAPAS,PALENQUE,16,362,0,378,1278
CHIAPAS,PALENQUE,13,580,19,612,1286
CHIAPAS,PALENQUE,14,567,13,594,1286
CHIAPAS,PALENQUE,17,621,21,659,1285
CHIAPAS,BOCHIL,21,578,15,614,1674
CHIAPAS,BOCHIL,6,587,6,599,1674
CHIAPAS,BOCHIL,29,499,10,538,1673
CHIAPAS,BOCHIL,27,441,18,486,1877
CHIAPAS,BOCHIL,6,522,17,545,1876
CHIAPAS,BOCHIL,12,489,13,514,1876
CHIAPAS,BOCHIL,63,606,46,715,1926
CHIAPAS,BOCHIL,57,533,54,644,1926
CHIAPAS,BOCHIL,19,421,18,458,1579
CHIAPAS,BOCHIL,10,1424,15,1449,1579
CHIAPAS,BOCHIL,23,404,0,427,1578
CHIAPAS,BOCHIL,12,1452,8,1472,1680
CHIAPAS,BOCHIL,7,458,12,477,1679
CHIAPAS,BOCHIL,10,428,11,449,1593
CHIAPAS,BOCHIL,9,428,11,448,1593
CHIAPAS,BOCHIL,37,673,22,732,0
CHIAPAS,BOCHIL,3,188,1,192,1571
CHIAPAS,BOCHIL,7,99,4,110,1570
CHIAPAS,BOCHIL,7,1127,0,1134,1570
CHIAPAS,BOCHIL,21,281,16,318,1413
CHIAPAS,BOCHIL,14,1295,11,1320,1412
CHIAPAS,BOCHIL,5,335,17,357,1223
CHIAPAS,BOCHIL,8,333,7,348,1222
CHIAPAS,BOCHIL,10,387,15,412,1674
CHIAPAS,BOCHIL,25,344,13,382,1673
CHIAPAS,BOCHIL,35,271,47,353,1212
CHIAPAS,BOCHIL,56,632,77,765,1212
CHIAPAS,BOCHIL,33,339,49,421,1666
CHIAPAS,BOCHIL,36,290,30,356,1665
CHIAPAS,BOCHIL,52,305,51,408,1665
CHIAPAS,BOCHIL,18,164,22,204,1378
CHIAPAS,BOCHIL,16,190,33,239,1378
CHIAPAS,BOCHIL,22,186,21,229,1377
CHIAPAS,BOCHIL,21,584,7,612,1489
CHIAPAS,BOCHIL,23,583,26,632,1489
CHIAPAS,BOCHIL,34,406,17,457,1489
CHIAPAS,BOCHIL,74,225,24,323,1353
CHIAPAS,BOCHIL,104,100,18,222,1353
CHIAPAS,BOCHIL,64,862,51,977,1363
CHIAPAS,BOCHIL,64,799,25,888,1363
CHIAPAS,BOCHIL,128,221,75,424,1382
CHIAPAS,BOCHIL,116,268,55,439,1381
CHIAPAS,BOCHIL,54,496,103,653,1845
CHIAPAS,BOCHIL,62,703,60,825,1845
CHIAPAS,BOCHIL,36,268,10,314,1491
CHIAPAS,BOCHIL,44,289,17,350,1490
CHIAPAS,BOCHIL,14,88,6,108,1453
CHIAPAS,BOCHIL,11,91,3,105,1453
CHIAPAS,BOCHIL,12,82,1,95,1452
CHIAPAS,BOCHIL,7,106,3,116,1490
CHIAPAS,BOCHIL,6,100,1,107,1490
CHIAPAS,BOCHIL,30,155,4,189,1772
CHIAPAS,BOCHIL,49,187,14,250,1771
CHIAPAS,BOCHIL,21,95,5,121,1333
CHIAPAS,BOCHIL,63,166,21,250,1332
CHIAPAS,BOCHIL,27,88,4,119,1332
CHIAPAS,BOCHIL,8,53,2,63,1518
CHIAPAS,BOCHIL,6,42,2,50,1518
CHIAPAS,BOCHIL,5,52,2,59,1518
CHIAPAS,BOCHIL,67,271,33,371,1251
CHIAPAS,BOCHIL,44,172,4,220,1251
CHIAPAS,BOCHIL,36,92,15,143,1296
CHIAPAS,BOCHIL,44,78,13,135,1296
CHIAPAS,BOCHIL,34,1496,19,1549,1669
CHIAPAS,BOCHIL,8,1492,30,1530,1668
CHIAPAS,BOCHIL,48,1456,45,1549,1668
CHIAPAS,BOCHIL,6,1300,2,1308,1552
CHIAPAS,BOCHIL,22,1217,0,1239,1552
CHIAPAS,BOCHIL,19,1517,15,1551,1551
CHIAPAS,BOCHIL,32,904,39,975,1046
CHIAPAS,BOCHIL,27,925,19,971,1045
CHIAPAS,BOCHIL,41,1423,8,1472,1909
CHIAPAS,BOCHIL,70,1340,14,1424,1908
CHIAPAS,BOCHIL,16,1238,3,1257,1581
CHIAPAS,BOCHIL,27,1379,13,1419,1580
CHIAPAS,BOCHIL,36,1430,7,1473,1703
CHIAPAS,BOCHIL,16,1342,11,1369,1702
CHIAPAS,BOCHIL,27,1179,10,1216,1702
CHIAPAS,BOCHIL,9,1055,3,1067,1053
CHIAPAS,BOCHIL,17,1017,1,1035,1052
CHIAPAS,BOCHIL,27,371,16,414,1475
CHIAPAS,BOCHIL,16,381,13,410,1474
CHIAPAS,BOCHIL,0,1431,0,1431,1430
CHIAPAS,BOCHIL,1,1425,2,1428,1430
CHIAPAS,BOCHIL,0,1433,2,1435,1430
CHIAPAS,BOCHIL,0,1446,10,1456,1451
CHIAPAS,BOCHIL,7,1433,10,1450,1450
CHIAPAS,BOCHIL,15,1914,13,1942,1929
CHIAPAS,BOCHIL,15,1917,11,1943,1929
CHIAPAS,BOCHIL,17,1756,16,1789,1777
CHIAPAS,BOCHIL,19,1767,1,1787,1777
CHIAPAS,BOCHIL,30,1151,32,1213,1792
CHIAPAS,BOCHIL,40,1147,28,1215,1791
CHIAPAS,BOCHIL,57,889,45,991,1308
CHIAPAS,BOCHIL,34,1123,7,1164,1308
CHIAPAS,BOCHIL,5,951,4,960,1126
CHIAPAS,BOCHIL,21,938,10,969,1125
CHIAPAS,BOCHIL,149,629,77,855,1325
CHIAPAS,BOCHIL,110,1054,60,1224,1324
CHIAPAS,BOCHIL,44,1144,19,1207,1495
CHIAPAS,BOCHIL,43,676,31,750,1495
CHIAPAS,BOCHIL,11,141,3,155,1220
CHIAPAS,BOCHIL,9,140,6,155,1219
CHIAPAS,BOCHIL,41,301,51,393,1158
CHIAPAS,BOCHIL,32,323,30,385,1158
CHIAPAS,BOCHIL,70,944,33,1047,1365
CHIAPAS,BOCHIL,0,1010,11,1021,1365
CHIAPAS,BOCHIL,9,117,10,136,1675
CHIAPAS,BOCHIL,6,132,7,145,1675
CHIAPAS,BOCHIL,5,95,6,106,1927
CHIAPAS,BOCHIL,12,122,9,143,1926
CHIAPAS,BOCHIL,5,90,4,99,1837
CHIAPAS,BOCHIL,5,79,4,88,1836
CHIAPAS,BOCHIL,30,37,27,94,1225
CHIAPAS,BOCHIL,31,54,18,103,1225
CHIAPAS,BOCHIL,18,52,14,84,1599
CHIAPAS,BOCHIL,16,65,27,108,1599
CHIAPAS,BOCHIL,23,58,23,104,1599
CHIAPAS,BOCHIL,27,485,34,546,1784
CHIAPAS,BOCHIL,33,482,52,567,1783
CHIAPAS,BOCHIL,42,480,53,575,1867
CHIAPAS,BOCHIL,56,444,55,555,1867
CHIAPAS,BOCHIL,8,950,2,960,1376
CHIAPAS,BOCHIL,5,965,5,975,1376
CHIAPAS,BOCHIL,953,23,2,978,1375
CHIAPAS,BOCHIL,17,1628,32,1677,1688
CHIAPAS,BOCHIL,36,1632,5,1673,1688
CHIAPAS,BOCHIL,26,1613,30,1669,1687
CHIAPAS,BOCHIL,12,1441,16,1469,1455
CHIAPAS,BOCHIL,17,1439,10,1466,1455
CHIAPAS,BOCHIL,10,1629,7,1646,1638
CHIAPAS,BOCHIL,14,1601,6,1621,1638
CHIAPAS,BOCHIL,33,1129,56,1218,1253
CHIAPAS,BOCHIL,10,395,8,413,1253
CHIAPAS,BOCHIL,19,398,18,435,1584
CHIAPAS,BOCHIL,27,359,38,424,1584
CHIAPAS,BOCHIL,3,193,11,207,1583
CHIAPAS,BOCHIL,16,1293,21,1330,1831
CHIAPAS,BOCHIL,7,365,15,387,1830
CHIAPAS,BOCHIL,76,1053,82,1211,1339
CHIAPAS,BOCHIL,46,1071,62,1179,1339
CHIAPAS,BOCHIL,52,1776,50,1878,1878
CHIAPAS,BOCHIL,60,1556,36,1652,1877
CHIAPAS,BOCHIL,23,1450,51,1524,1682
CHIAPAS,BOCHIL,13,1634,15,1662,1681
CHIAPAS,BOCHIL,22,593,33,648,1028
CHIAPAS,BOCHIL,23,526,25,574,1027
CHIAPAS,BOCHIL,30,1043,21,1094,1621
CHIAPAS,BOCHIL,0,1234,4,1238,1621
CHIAPAS,BOCHIL,27,1454,23,1504,1621
CHIAPAS,BOCHIL,29,1422,29,1480,1565
CHIAPAS,BOCHIL,24,1418,60,1502,1564
CHIAPAS,BOCHIL,18,598,8,624,1396
CHIAPAS,BOCHIL,32,527,9,568,1396
CHIAPAS,BOCHIL,18,537,12,567,1395
CHIAPAS,BOCHIL,36,445,34,515,1712
CHIAPAS,BOCHIL,38,459,33,530,1712
CHIAPAS,BOCHIL,47,318,28,393,1412
CHIAPAS,BOCHIL,39,423,52,514,1411
CHIAPAS,BOCHIL,79,380,56,515,1443
CHIAPAS,BOCHIL,66,415,0,481,1442
CHIAPAS,BOCHIL,32,182,13,227,1579
CHIAPAS,BOCHIL,30,136,8,174,1579
CHIAPAS,BOCHIL,39,142,19,200,1578
CHIAPAS,OCOSINGO,4,1149,14,1167,1391
CHIAPAS,OCOSINGO,10,1227,34,1271,1390
CHIAPAS,OCOSINGO,9,1047,34,1090,1396
CHIAPAS,OCOSINGO,33,747,15,795,1395
CHIAPAS,OCOSINGO,8,1067,8,1083,1149
CHIAPAS,OCOSINGO,23,919,22,964,1149
CHIAPAS,OCOSINGO,24,741,41,806,1061
CHIAPAS,OCOSINGO,24,909,45,978,1060
CHIAPAS,OCOSINGO,19,1228,12,1259,1565
CHIAPAS,OCOSINGO,37,1166,9,1212,1564
CHIAPAS,OCOSINGO,20,1223,10,1253,1564
CHIAPAS,OCOSINGO,31,732,10,773,1440
CHIAPAS,OCOSINGO,15,691,0,706,1439
CHIAPAS,OCOSINGO,33,508,9,550,1828
CHIAPAS,OCOSINGO,26,755,6,787,1827
CHIAPAS,OCOSINGO,7,1192,3,1202,1909
CHIAPAS,OCOSINGO,5,1253,14,1272,1909
CHIAPAS,OCOSINGO,29,1419,30,1478,1520
CHIAPAS,OCOSINGO,21,974,21,1016,1520
CHIAPAS,OCOSINGO,4,1019,35,1058,1520
CHIAPAS,OCOSINGO,80,886,28,994,1972
CHIAPAS,OCOSINGO,44,527,36,607,1971
CHIAPAS,OCOSINGO,13,396,9,418,1361
CHIAPAS,OCOSINGO,29,424,13,466,1360
CHIAPAS,OCOSINGO,35,404,26,465,1648
CHIAPAS,OCOSINGO,53,403,26,482,1648
CHIAPAS,OCOSINGO,8,1165,8,1181,1930
CHIAPAS,OCOSINGO,27,1008,11,1046,1929
CHIAPAS,OCOSINGO,28,381,22,431,1437
CHIAPAS,OCOSINGO,34,363,21,418,1437
CHIAPAS,OCOSINGO,75,491,34,600,1246
CHIAPAS,OCOSINGO,65,590,27,682,1245
CHIAPAS,OCOSINGO,40,575,34,649,1910
CHIAPAS,OCOSINGO,48,572,26,646,1909
CHIAPAS,OCOSINGO,25,315,9,349,1115
CHIAPAS,OCOSINGO,30,335,11,376,1115
CHIAPAS,OCOSINGO,53,844,11,908,1843
CHIAPAS,OCOSINGO,46,816,20,882,1842
CHIAPAS,OCOSINGO,21,625,7,653,2059
CHIAPAS,OCOSINGO,22,570,3,595,2058
CHIAPAS,OCOSINGO,12,340,5,357,2009
CHIAPAS,OCOSINGO,18,324,4,346,2008
CHIAPAS,OCOSINGO,10,298,4,312,1941
CHIAPAS,OCOSINGO,7,272,4,283,1940
CHIAPAS,OCOSINGO,15,302,4,321,1940
CHIAPAS,OCOSINGO,16,257,7,280,1940
CHIAPAS,OCOSINGO,6,273,6,285,1940
CHIAPAS,OCOSINGO,5,170,4,179,1157
CHIAPAS,OCOSINGO,12,208,0,220,1157
CHIAPAS,OCOSINGO,10,298,9,317,1757
CHIAPAS,OCOSINGO,8,278,9,295,1756
CHIAPAS,OCOSINGO,50,1549,41,1640,0
CHIAPAS,OCOSINGO,10,220,6,236,1744
CHIAPAS,OCOSINGO,10,188,5,203,1744
CHIAPAS,OCOSINGO,7,262,3,272,1744
CHIAPAS,OCOSINGO,6,260,6,272,1824
CHIAPAS,OCOSINGO,7,224,5,236,1824
CHIAPAS,OCOSINGO,11,272,2,285,1823
CHIAPAS,OCOSINGO,10,286,6,302,1823
CHIAPAS,OCOSINGO,8,231,1,240,1823
CHIAPAS,OCOSINGO,28,707,26,761,1908
CHIAPAS,OCOSINGO,20,705,3,728,1907
CHIAPAS,OCOSINGO,3,311,4,318,1526
CHIAPAS,OCOSINGO,0,308,7,315,1526
CHIAPAS,OCOSINGO,16,302,11,329,1526
CHIAPAS,OCOSINGO,12,210,8,230,1500
CHIAPAS,OCOSINGO,22,221,7,250,1499
CHIAPAS,OCOSINGO,5,241,6,252,1499
CHIAPAS,OCOSINGO,25,530,22,577,1342
CHIAPAS,OCOSINGO,40,463,39,542,1341
CHIAPAS,OCOSINGO,30,762,25,817,2031
CHIAPAS,OCOSINGO,16,731,31,778,2030
CHIAPAS,OCOSINGO,5,243,7,255,1434
CHIAPAS,OCOSINGO,9,235,6,250,1434
CHIAPAS,OCOSINGO,3,247,11,261,1434
CHIAPAS,OCOSINGO,17,1167,5,1189,1981
CHIAPAS,OCOSINGO,27,1344,22,1393,1981
CHIAPAS,OCOSINGO,13,113,6,132,1423
CHIAPAS,OCOSINGO,12,163,5,180,1422
CHIAPAS,OCOSINGO,18,134,6,158,1422
CHIAPAS,OCOSINGO,12,277,11,300,1615
CHIAPAS,OCOSINGO,12,362,6,380,1615
CHIAPAS,OCOSINGO,49,280,16,345,1557
CHIAPAS,OCOSINGO,62,265,28,355,1556
CHIAPAS,OCOSINGO,18,241,13,272,1598
CHIAPAS,OCOSINGO,2,213,7,222,1598
CHIAPAS,OCOSINGO,22,261,20,303,1597
CHIAPAS,OCOSINGO,7,196,13,216,1755
CHIAPAS,OCOSINGO,11,241,11,263,1755
CHIAPAS,OCOSINGO,8,252,10,270,1755
CHIAPAS,OCOSINGO,9,266,18,293,1754
CHIAPAS,OCOSINGO,30,263,32,325,1746
CHIAPAS,OCOSINGO,29,263,31,323,1746
CHIAPAS,OCOSINGO,22,288,16,326,1399
CHIAPAS,OCOSINGO,12,311,14,337,1398
CHIAPAS,OCOSINGO,16,359,15,390,1321
CHIAPAS,OCOSINGO,5,389,14,408,1320
CHIAPAS,OCOSINGO,10,323,18,351,1294
CHIAPAS,OCOSINGO,14,296,22,332,1293
CHIAPAS,OCOSINGO,25,1431,121,1577,2028
CHIAPAS,OCOSINGO,10,772,99,881,2028
CHIAPAS,OCOSINGO,2,648,14,664,1834
CHIAPAS,OCOSINGO,27,410,27,464,1833
CHIAPAS,OCOSINGO,47,801,20,868,1690
CHIAPAS,OCOSINGO,25,752,16,793,1689
CHIAPAS,OCOSINGO,10,302,3,315,1028
CHIAPAS,OCOSINGO,5,308,8,321,1027
CHIAPAS,OCOSINGO,9,626,11,646,1278
CHIAPAS,OCOSINGO,7,446,4,457,1278
CHIAPAS,OCOSINGO,15,779,4,798,1995
CHIAPAS,OCOSINGO,4,797,3,804,1995
CHIAPAS,OCOSINGO,33,403,36,472,1089
CHIAPAS,OCOSINGO,49,507,13,569,1088
CHIAPAS,OCOSINGO,30,489,22,541,1961
CHIAPAS,OCOSINGO,19,676,13,708,1961
CHIAPAS,OCOSINGO,12,356,16,384,1276
CHIAPAS,OCOSINGO,13,362,15,390,1275
CHIAPAS,OCOSINGO,8,258,14,280,1276
CHIAPAS,OCOSINGO,5,229,18,252,1275
CHIAPAS,OCOSINGO,10,460,10,480,1045
CHIAPAS,OCOSINGO,6,472,14,492,1044
CHIAPAS,OCOSINGO,21,712,17,750,1254
CHIAPAS,OCOSINGO,7,720,15,742,1254
CHIAPAS,OCOSINGO,3,1001,12,1016,1301
CHIAPAS,OCOSINGO,2,1161,7,1170,1300
CHIAPAS,OCOSINGO,5,1070,3,1078,1305
CHIAPAS,OCOSINGO,12,969,23,1004,1304
CHIAPAS,OCOSINGO,3,1147,17,1167,1436
CHIAPAS,OCOSINGO,14,1009,13,1036,1435
CHIAPAS,OCOSINGO,23,766,31,820,1931
CHIAPAS,OCOSINGO,21,532,22,575,1930
CHIAPAS,OCOSINGO,17,691,21,729,1930
CHIAPAS,OCOSINGO,1,199,5,205,1040
CHIAPAS,OCOSINGO,5,217,2,224,1040
CHIAPAS,OCOSINGO,6,326,0,332,1300
CHIAPAS,OCOSINGO,10,346,6,362,1299
CHIAPAS,OCOSINGO,10,483,5,498,1612
CHIAPAS,OCOSINGO,9,437,6,452,1612
CHIAPAS,OCOSINGO,9,543,4,556,1742
CHIAPAS,OCOSINGO,11,728,17,756,1742
CHIAPAS,OCOSINGO,4,422,8,434,1042
CHIAPAS,OCOSINGO,14,412,11,437,1042
CHIAPAS,OCOSINGO,7,497,6,510,1634
CHIAPAS,OCOSINGO,6,563,6,575,1633
CHIAPAS,OCOSINGO,17,694,13,724,1531
CHIAPAS,OCOSINGO,19,706,14,739,1531
CHIAPAS,OCOSINGO,17,641,18,676,1865
CHIAPAS,OCOSINGO,15,616,13,644,1865
CHIAPAS,OCOSINGO,3,435,9,447,1579
CHIAPAS,OCOSINGO,8,413,9,430,1578
CHIAPAS,OCOSINGO,11,463,9,483,1578
CHIAPAS,OCOSINGO,24,918,30,972,1058
CHIAPAS,OCOSINGO,23,1019,15,1057,1057
CHIAPAS,OCOSINGO,3,955,3,961,1017
CHIAPAS,OCOSINGO,4,957,1,962,1017
CHIAPAS,OCOSINGO,47,1120,2,1169,1220
CHIAPAS,OCOSINGO,48,1076,10,1134,1220
CHIAPAS,OCOSINGO,17,1555,19,1591,1578
CHIAPAS,OCOSINGO,19,1555,17,1591,1577
CHIAPAS,OCOSINGO,52,877,20,949,1735
CHIAPAS,OCOSINGO,104,935,72,1111,1734
CHIAPAS,OCOSINGO,43,569,40,652,1431
CHIAPAS,OCOSINGO,47,1204,23,1274,1431
CHIAPAS,OCOSINGO,35,714,36,785,1065
CHIAPAS,OCOSINGO,38,303,24,365,1065
CHIAPAS,OCOSINGO,62,703,37,802,1829
CHIAPAS,OCOSINGO,48,675,13,736,1829
CHIAPAS,OCOSINGO,18,129,7,154,1570
CHIAPAS,OCOSINGO,32,146,12,190,1570
CHIAPAS,OCOSINGO,8,280,21,309,1371
CHIAPAS,OCOSINGO,27,278,21,326,1370
CHIAPAS,PICHUCALCO,15,1224,4,1243,1606
CHIAPAS,PICHUCALCO,4,1280,16,1300,1606
CHIAPAS,PICHUCALCO,13,1462,6,1481,1606
CHIAPAS,PICHUCALCO,10,1379,2,1391,1605
CHIAPAS,PICHUCALCO,16,1159,4,1179,1413
CHIAPAS,PICHUCALCO,6,1094,8,1108,1413
CHIAPAS,PICHUCALCO,15,1027,3,1045,1461
CHIAPAS,PICHUCALCO,6,1138,8,1152,1460
CHIAPAS,PICHUCALCO,53,1236,9,1298,0
CHIAPAS,PICHUCALCO,7,266,5,278,1365
CHIAPAS,PICHUCALCO,17,278,6,301,1365
CHIAPAS,PICHUCALCO,8,250,5,263,1155
CHIAPAS,PICHUCALCO,15,268,3,286,1154
CHIAPAS,PICHUCALCO,9,821,4,834,1273
CHIAPAS,PICHUCALCO,8,924,3,935,1272
CHIAPAS,PICHUCALCO,2,330,15,347,1883
CHIAPAS,PICHUCALCO,7,286,7,300,1883
CHIAPAS,PICHUCALCO,7,291,5,303,1883
CHIAPAS,PICHUCALCO,19,297,3,319,1882
CHIAPAS,PICHUCALCO,0,1503,7,1510,1508
CHIAPAS,PICHUCALCO,18,1379,9,1406,1507
CHIAPAS,PICHUCALCO,28,1030,5,1063,1305
CHIAPAS,PICHUCALCO,30,958,10,998,1304
CHIAPAS,PICHUCALCO,0,210,10,220,1580
CHIAPAS,PICHUCALCO,11,198,2,211,1580
CHIAPAS,PICHUCALCO,9,205,2,216,1580
CHIAPAS,PICHUCALCO,15,887,3,905,1766
CHIAPAS,PICHUCALCO,10,1272,14,1296,1765
CHIAPAS,PICHUCALCO,4,783,0,787,1641
CHIAPAS,PICHUCALCO,12,495,6,513,2073
CHIAPAS,PICHUCALCO,10,457,18,485,2073
CHIAPAS,PICHUCALCO,14,493,18,525,2072
CHIAPAS,PICHUCALCO,11,392,2,405,1832
CHIAPAS,PICHUCALCO,2,388,0,390,1832
CHIAPAS,PICHUCALCO,9,453,14,476,2086
CHIAPAS,PICHUCALCO,8,383,7,398,1601
CHIAPAS,PICHUCALCO,3,399,8,410,1600
CHIAPAS,PICHUCALCO,27,691,28,746,1722
CHIAPAS,PICHUCALCO,38,643,31,712,1722
CHIAPAS,PICHUCALCO,25,679,31,735,1722
CHIAPAS,PICHUCALCO,15,270,5,290,1114
CHIAPAS,PICHUCALCO,10,301,1,312,1114
CHIAPAS,PICHUCALCO,2,319,11,332,1315
CHIAPAS,PICHUCALCO,7,448,8,463,1315
CHIAPAS,PICHUCALCO,16,564,19,599,1687
CHIAPAS,PICHUCALCO,18,582,17,617,1687
CHIAPAS,PICHUCALCO,10,536,12,558,1686
CHIAPAS,PICHUCALCO,15,643,11,669,1914
CHIAPAS,PICHUCALCO,14,705,21,740,1913
CHIAPAS,PICHUCALCO,14,805,21,840,1789
CHIAPAS,PICHUCALCO,18,893,22,933,2068
CHIAPAS,PICHUCALCO,13,1022,11,1046,1652
CHIAPAS,PICHUCALCO,15,966,9,990,1652
CHIAPAS,PICHUCALCO,14,927,22,963,1242
CHIAPAS,PICHUCALCO,7,872,2,881,1241
CHIAPAS,PICHUCALCO,21,657,24,702,1983
CHIAPAS,PICHUCALCO,13,651,13,677,1982
CHIAPAS,PICHUCALCO,12,431,4,447,1422
CHIAPAS,PICHUCALCO,16,437,8,461,1422
CHIAPAS,PICHUCALCO,16,421,9,446,1422
CHIAPAS,PICHUCALCO,9,449,5,463,1460
CHIAPAS,PICHUCALCO,10,599,2,611,1460
CHIAPAS,PICHUCALCO,3,508,7,518,1330
CHIAPAS,PICHUCALCO,6,458,11,475,1330
CHIAPAS,PICHUCALCO,32,1598,10,1640,1969
CHIAPAS,PICHUCALCO,18,708,27,753,1968
CHIAPAS,PICHUCALCO,2,582,0,584,1737
CHIAPAS,PICHUCALCO,4,510,1,515,1736
CHIAPAS,PICHUCALCO,3,408,2,413,1244
CHIAPAS,PICHUCALCO,3,353,0,356,1244
CHIAPAS,PICHUCALCO,2,513,1,516,1381
CHIAPAS,PICHUCALCO,2,462,0,464,1380
CHIAPAS,PICHUCALCO,12,482,14,508,1561
CHIAPAS,PICHUCALCO,4,497,8,509,1560
CHIAPAS,PICHUCALCO,8,533,19,560,1945
CHIAPAS,PICHUCALCO,9,550,9,568,1945
CHIAPAS,PICHUCALCO,14,860,5,879,1434
CHIAPAS,PICHUCALCO,11,887,6,904,1434
CHIAPAS,PICHUCALCO,14,594,12,620,1595
CHIAPAS,PICHUCALCO,17,516,14,547,1595
CHIAPAS,PICHUCALCO,4,571,22,597,1595
CHIAPAS,PICHUCALCO,20,599,12,631,1594
CHIAPAS,PICHUCALCO,21,709,24,754,1808
CHIAPAS,PICHUCALCO,8,756,17,781,1807
CHIAPAS,PICHUCALCO,10,466,9,485,1436
CHIAPAS,PICHUCALCO,8,436,4,448,1436
CHIAPAS,PICHUCALCO,14,430,10,454,1436
CHIAPAS,PICHUCALCO,18,436,7,461,1447
CHIAPAS,PICHUCALCO,23,477,8,508,1447
CHIAPAS,PICHUCALCO,14,544,7,565,1585
CHIAPAS,PICHUCALCO,20,541,10,571,1585
CHIAPAS,PICHUCALCO,17,490,0,507,1585
CHIAPAS,PICHUCALCO,18,662,10,690,2031
CHIAPAS,PICHUCALCO,20,612,10,642,2031
CHIAPAS,PICHUCALCO,0,698,18,716,1663
CHIAPAS,PICHUCALCO,16,683,21,720,1691
CHIAPAS,PICHUCALCO,19,695,21,735,1612
CHIAPAS,PICHUCALCO,21,603,18,642,1612
CHIAPAS,PICHUCALCO,19,598,20,637,1612
CHIAPAS,PICHUCALCO,32,601,13,646,2044
CHIAPAS,PICHUCALCO,9,768,3,780,1419
CHIAPAS,PICHUCALCO,2,1024,6,1032,1419
CHIAPAS,PICHUCALCO,5,1108,1,1114,1418
CHIAPAS,PICHUCALCO,9,770,8,787,1937
CHIAPAS,PICHUCALCO,9,728,5,742,1937
CHIAPAS,PICHUCALCO,2,599,6,607,1603
CHIAPAS,PICHUCALCO,6,626,7,639,1603
CHIAPAS,PICHUCALCO,15,542,3,560,1602
CHIAPAS,PICHUCALCO,8,548,3,559,1601
CHIAPAS,PICHUCALCO,12,1600,3,1615,1748
CHIAPAS,PICHUCALCO,10,1667,8,1685,1748
CHIAPAS,PICHUCALCO,32,1482,17,1531,1748
CHIAPAS,PICHUCALCO,11,1036,10,1057,1886
CHIAPAS,PICHUCALCO,8,849,13,870,1885
CHIAPAS,PICHUCALCO,10,1670,10,1690,1738
CHIAPAS,PICHUCALCO,12,677,17,706,1737
CHIAPAS,PICHUCALCO,11,487,10,508,1478
CHIAPAS,PICHUCALCO,12,491,0,503,1477
CHIAPAS,PICHUCALCO,44,540,14,598,2012
CHIAPAS,PICHUCALCO,14,539,14,567,2012
CHIAPAS,PICHUCALCO,17,564,3,584,2012
CHIAPAS,PICHUCALCO,17,527,2,546,2012
CHIAPAS,PICHUCALCO,14,452,3,469,1560
CHIAPAS,PICHUCALCO,21,460,4,485,1559
CHIAPAS,PICHUCALCO,16,493,3,512,1972
CHIAPAS,PICHUCALCO,10,416,9,435,1972
CHIAPAS,PICHUCALCO,12,349,3,364,1461
CHIAPAS,PICHUCALCO,19,350,12,381,1460
CHIAPAS,PICHUCALCO,8,468,0,476,1162
CHIAPAS,PICHUCALCO,7,416,2,425,1161
CHIAPAS,PICHUCALCO,24,1668,6,1698,1855
CHIAPAS,PICHUCALCO,39,1522,41,1602,1854
CHIAPAS,PICHUCALCO,12,961,5,978,1176
CHIAPAS,PICHUCALCO,12,987,2,1001,1176
CHIAPAS,PICHUCALCO,36,789,14,839,1696
CHIAPAS,PICHUCALCO,63,722,13,798,1696
CHIAPAS,PICHUCALCO,13,819,1,833,1826
CHIAPAS,PICHUCALCO,20,802,8,830,1826
CHIAPAS,PICHUCALCO,6,748,9,763,1917
CHIAPAS,PICHUCALCO,6,782,8,796,1917
CHIAPAS,PICHUCALCO,24,1175,10,1209,1880
CHIAPAS,PICHUCALCO,7,834,5,846,1686
CHIAPAS,PICHUCALCO,5,833,4,842,1686
CHIAPAS,PICHUCALCO,11,1276,9,1296,1932
CHIAPAS,PICHUCALCO,11,901,24,936,1932
CHIAPAS,PICHUCALCO,18,612,15,645,1738
CHIAPAS,PICHUCALCO,20,686,9,715,1738
CHIAPAS,PICHUCALCO,8,625,10,643,1543
CHIAPAS,PICHUCALCO,3,664,3,670,1543
CHIAPAS,PICHUCALCO,6,394,7,407,1543
CHIAPAS,PICHUCALCO,8,521,9,538,1863
CHIAPAS,PICHUCALCO,9,462,12,483,1862
CHIAPAS,PICHUCALCO,12,523,20,555,1186
CHIAPAS,PICHUCALCO,9,576,11,596,1185
CHIAPAS,PICHUCALCO,0,1410,0,1410,1632
CHIAPAS,PICHUCALCO,13,1223,41,1277,1632
CHIAPAS,PICHUCALCO,18,761,5,784,1109
CHIAPAS,PICHUCALCO,13,554,2,569,1109
CHIAPAS,PICHUCALCO,4,956,9,969,1662
CHIAPAS,PICHUCALCO,0,1057,18,1075,1661
CHIAPAS,PICHUCALCO,14,416,11,441,1473
CHIAPAS,PICHUCALCO,6,415,11,432,1472
CHIAPAS,PICHUCALCO,11,429,8,448,1472
CHIAPAS,PICHUCALCO,13,255,3,271,1259
CHIAPAS,PICHUCALCO,1,257,1,259,1258
CHIAPAS,PICHUCALCO,14,541,0,555,1942
CHIAPAS,PICHUCALCO,9,528,8,545,1942
CHIAPAS,PICHUCALCO,12,519,15,546,1942
CHIAPAS,PICHUCALCO,3,828,23,854,1979
CHIAPAS,PICHUCALCO,6,542,14,562,1978
CHIAPAS,PICHUCALCO,17,520,2,539,1868
CHIAPAS,PICHUCALCO,11,488,10,509,1867
CHIAPAS,SAN CRISTOBAL DE LAS CASAS,12,59,3,74,1209
CHIAPAS,SAN CRISTOBAL DE LAS CASAS,7,32,1,40,1208
CHIAPAS,SAN CRISTOBAL DE LAS CASAS,12,41,1,54,1799
CHIAPAS,SAN CRISTOBAL DE LAS CASAS,7,38,7,52,1799
CHIAPAS,SAN CRISTOBAL DE LAS CASAS,26,127,4,157,1710
CHIAPAS,SAN CRISTOBAL DE LAS CASAS,15,104,11,130,1709
CHIAPAS,SAN CRISTOBAL DE LAS CASAS,12,67,2,81,1869
CHIAPAS,SAN CRISTOBAL DE LAS CASAS,11,57,6,74,1868
CHIAPAS,SAN CRISTOBAL DE LAS CASAS,19,91,138,248,1110
CHIAPAS,SAN CRISTOBAL DE LAS CASAS,13,37,3,53,1110
CHIAPAS,SAN CRISTOBAL DE LAS CASAS,68,68,8,144,1136
CHIAPAS,SAN CRISTOBAL DE LAS CASAS,27,57,4,88,1136
CHIAPAS,SAN CRISTOBAL DE LAS CASAS,9,24,0,33,1336
CHIAPAS,SAN CRISTOBAL DE LAS CASAS,16,40,5,61,1336
CHIAPAS,SAN CRISTOBAL DE LAS CASAS,14,42,5,61,1336
CHIAPAS,SAN CRISTOBAL DE LAS CASAS,3,24,3,30,1827
CHIAPAS,SAN CRISTOBAL DE LAS CASAS,13,59,3,75,1827
CHIAPAS,SAN CRISTOBAL DE LAS CASAS,47,50,13,110,1516
CHIAPAS,SAN CRISTOBAL DE LAS CASAS,44,51,11,106,1515
CHIAPAS,SAN CRISTOBAL DE LAS CASAS,16,58,7,81,1652
CHIAPAS,SAN CRISTOBAL DE LAS CASAS,19,71,11,101,1652
CHIAPAS,SAN CRISTOBAL DE LAS CASAS,7,41,5,53,1772
CHIAPAS,SAN CRISTOBAL DE LAS CASAS,8,54,11,73,1772
CHIAPAS,SAN CRISTOBAL DE LAS CASAS,2,24,1,27,1732
CHIAPAS,SAN CRISTOBAL DE LAS CASAS,15,39,9,63,1732
CHIAPAS,SAN CRISTOBAL DE LAS CASAS,7,40,2,49,1662
CHIAPAS,SAN CRISTOBAL DE LAS CASAS,5,33,4,42,1662
CHIAPAS,SAN CRISTOBAL DE LAS CASAS,8,18,6,32,1961
CHIAPAS,SAN CRISTOBAL DE LAS CASAS,18,37,2,57,1960
CHIAPAS,SAN CRISTOBAL DE LAS CASAS,12,29,0,41,1600
CHIAPAS,SAN CRISTOBAL DE LAS CASAS,5,37,3,45,1600
CHIAPAS,SAN CRISTOBAL DE LAS CASAS,10,40,2,52,1599
CHIAPAS,SAN CRISTOBAL DE LAS CASAS,22,43,3,68,1545
CHIAPAS,SAN CRISTOBAL DE LAS CASAS,14,68,5,87,1544
CHIAPAS,SAN CRISTOBAL DE LAS CASAS,23,54,10,87,1544
CHIAPAS,SAN CRISTOBAL DE LAS CASAS,9,37,2,48,1885
CHIAPAS,SAN CRISTOBAL DE LAS CASAS,22,63,3,88,1885
CHIAPAS,SAN CRISTOBAL DE LAS CASAS,33,84,12,129,1389
CHIAPAS,SAN CRISTOBAL DE LAS CASAS,22,81,5,108,1388
CHIAPAS,SAN CRISTOBAL DE LAS CASAS,37,75,7,119,1388
CHIAPAS,SAN CRISTOBAL DE LAS CASAS,32,53,9,94,1892
CHIAPAS,SAN CRISTOBAL DE LAS CASAS,19,35,5,59,1892
CHIAPAS,SAN CRISTOBAL DE LAS CASAS,12,208,1,221,1553
CHIAPAS,SAN CRISTOBAL DE LAS CASAS,8,136,0,144,1552
CHIAPAS,SAN CRISTOBAL DE LAS CASAS,17,191,0,208,1552
CHIAPAS,SAN CRISTOBAL DE LAS CASAS,11,190,4,205,1552
CHIAPAS,SAN CRISTOBAL DE LAS CASAS,7,159,4,170,1708
CHIAPAS,SAN CRISTOBAL DE LAS CASAS,6,191,0,197,1708
CHIAPAS,SAN CRISTOBAL DE LAS CASAS,10,159,2,171,1708
CHIAPAS,SAN CRISTOBAL DE LAS CASAS,10,180,0,190,1707
CHIAPAS,SAN CRISTOBAL DE LAS CASAS,11,185,3,199,1707
CHIAPAS,SAN CRISTOBAL DE LAS CASAS,15,172,1,188,1707
CHIAPAS,SAN CRISTOBAL DE LAS CASAS,6,216,3,225,1707
CHIAPAS,SAN CRISTOBAL DE LAS CASAS,14,176,5,195,1351
CHIAPAS,SAN CRISTOBAL DE LAS CASAS,8,190,1,199,1350
CHIAPAS,SAN CRISTOBAL DE LAS CASAS,6,178,0,184,1350
CHIAPAS,SAN CRISTOBAL DE LAS CASAS,13,267,3,283,1586
CHIAPAS,SAN CRISTOBAL DE LAS CASAS,13,232,1,246,1585
CHIAPAS,SAN CRISTOBAL DE LAS CASAS,7,147,0,154,1357
CHIAPAS,SAN CRISTOBAL DE LAS CASAS,2,168,1,171,1357
CHIAPAS,SAN CRISTOBAL DE LAS CASAS,7,133,1,141,1900
CHIAPAS,SAN CRISTOBAL DE LAS CASAS,3,192,5,200,1899
CHIAPAS,SAN CRISTOBAL DE LAS CASAS,13,280,2,295,1598
CHIAPAS,SAN CRISTOBAL DE LAS CASAS,8,275,1,284,1598
CHIAPAS,SAN CRISTOBAL DE LAS CASAS,8,291,0,299,1465
CHIAPAS,SAN CRISTOBAL DE LAS CASAS,14,227,2,243,1465
CHIAPAS,SAN CRISTOBAL DE LAS CASAS,10,230,1,241,1464
CHIAPAS,SAN CRISTOBAL DE LAS CASAS,18,267,4,289,1786
CHIAPAS,SAN CRISTOBAL DE LAS CASAS,16,257,2,275,1786
CHIAPAS,SAN CRISTOBAL DE LAS CASAS,17,196,1,214,1358
CHIAPAS,SAN CRISTOBAL DE LAS CASAS,12,179,2,193,1357
CHIAPAS,SAN CRISTOBAL DE LAS CASAS,8,188,1,197,1254
CHIAPAS,SAN CRISTOBAL DE LAS CASAS,22,210,1,233,1254
CHIAPAS,SAN CRISTOBAL DE LAS CASAS,14,191,0,205,1221
CHIAPAS,SAN CRISTOBAL DE LAS CASAS,9,179,2,190,1221
CHIAPAS,SAN CRISTOBAL DE LAS CASAS,6,130,0,136,1217
CHIAPAS,SAN CRISTOBAL DE LAS CASAS,7,89,0,96,1216
CHIAPAS,SAN CRISTOBAL DE LAS CASAS,24,179,1,204,1712
CHIAPAS,SAN CRISTOBAL DE LAS CASAS,12,168,2,182,1711
CHIAPAS,SAN CRISTOBAL DE LAS CASAS,5,212,2,219,1711
CHIAPAS,SAN CRISTOBAL DE LAS CASAS,14,219,1,234,1711
CHIAPAS,SAN CRISTOBAL DE LAS CASAS,1,76,2,79,1332
CHIAPAS,SAN CRISTOBAL DE LAS CASAS,2,69,1,72,1331
CHIAPAS,SAN CRISTOBAL DE LAS CASAS,5,63,1,69,1331
CHIAPAS,SAN CRISTOBAL DE LAS CASAS,9,144,3,156,986
CHIAPAS,SAN CRISTOBAL DE LAS CASAS,22,128,0,150,986
CHIAPAS,SAN CRISTOBAL DE LAS CASAS,22,230,3,255,1575
CHIAPAS,SAN CRISTOBAL DE LAS CASAS,28,213,3,244,1575
CHIAPAS,SAN CRISTOBAL DE LAS CASAS,82,1596,7,1685,0
CHIAPAS,SAN CRISTOBAL DE LAS CASAS,9,210,0,219,1473
CHIAPAS,SAN CRISTOBAL DE LAS CASAS,7,211,1,219,1472
CHIAPAS,SAN CRISTOBAL DE LAS CASAS,0,244,0,244,1869
CHIAPAS,SAN CRISTOBAL DE LAS CASAS,23,263,1,287,1868
CHIAPAS,SAN CRISTOBAL DE LAS CASAS,21,236,2,259,1636
CHIAPAS,SAN CRISTOBAL DE LAS CASAS,9,218,1,228,1636
CHIAPAS,SAN CRISTOBAL DE LAS CASAS,19,233,1,253,1635
CHIAPAS,SAN CRISTOBAL DE LAS CASAS,10,211,2,223,1526
CHIAPAS,SAN CRISTOBAL DE LAS CASAS,6,172,2,180,1526
CHIAPAS,SAN CRISTOBAL DE LAS CASAS,10,164,7,181,1525
CHIAPAS,SAN CRISTOBAL DE LAS CASAS,10,187,5,202,1525
CHIAPAS,SAN CRISTOBAL DE LAS CASAS,16,228,5,249,1506
CHIAPAS,SAN CRISTOBAL DE LAS CASAS,12,180,0,192,1506
CHIAPAS,SAN CRISTOBAL DE LAS CASAS,14,206,1,221,1639
CHIAPAS,SAN CRISTOBAL DE LAS CASAS,19,204,0,223,1638
CHIAPAS,SAN CRISTOBAL DE LAS CASAS,11,124,1,136,1366
CHIAPAS,SAN CRISTOBAL DE LAS CASAS,6,133,4,143,1365
CHIAPAS,SAN CRISTOBAL DE LAS CASAS,16,153,0,169,1539
CHIAPAS,SAN CRISTOBAL DE LAS CASAS,8,150,1,159,1539
CHIAPAS,SAN CRISTOBAL DE LAS CASAS,9,133,1,143,1539
CHIAPAS,SAN CRISTOBAL DE LAS CASAS,9,137,0,146,1538
CHIAPAS,SAN CRISTOBAL DE LAS CASAS,11,231,1,243,1728
CHIAPAS,SAN CRISTOBAL DE LAS CASAS,9,197,2,208,1728
CHIAPAS,SAN CRISTOBAL DE LAS CASAS,17,194,2,213,1728
CHIAPAS,SAN CRISTOBAL DE LAS CASAS,5,208,0,213,1728
CHIAPAS,SAN CRISTOBAL DE LAS CASAS,7,206,4,217,1727
CHIAPAS,SAN CRISTOBAL DE LAS CASAS,11,177,0,188,1727
CHIAPAS,SAN CRISTOBAL DE LAS CASAS,5,57,3,65,1777
CHIAPAS,SAN CRISTOBAL DE LAS CASAS,2,34,1,37,1776
CHIAPAS,SAN CRISTOBAL DE LAS CASAS,9,15,1,25,1180
CHIAPAS,SAN CRISTOBAL DE LAS CASAS,9,15,0,24,1179
CHIAPAS,SAN CRISTOBAL DE LAS CASAS,22,442,4,468,1936
CHIAPAS,SAN CRISTOBAL DE LAS CASAS,17,340,6,363,1936
CHIAPAS,SAN CRISTOBAL DE LAS CASAS,17,327,3,347,1936
CHIAPAS,SAN CRISTOBAL DE LAS CASAS,0,1420,5,1425,1694
CHIAPAS,SAN CRISTOBAL DE LAS CASAS,4,1307,39,1350,1693
CHIAPAS,SAN CRISTOBAL DE LAS CASAS,22,396,23,441,1703
CHIAPAS,SAN CRISTOBAL DE LAS CASAS,21,358,19,398,1703
CHIAPAS,SAN CRISTOBAL DE LAS CASAS,35,211,16,262,1479
CHIAPAS,SAN CRISTOBAL DE LAS CASAS,23,257,22,302,1479
CHIAPAS,SAN CRISTOBAL DE LAS CASAS,2,4,0,6,1884
CHIAPAS,SAN CRISTOBAL DE LAS CASAS,0,0,0,0,1883
CHIAPAS,SAN CRISTOBAL DE LAS CASAS,14,254,13,281,1487
CHIAPAS,SAN CRISTOBAL DE LAS CASAS,7,249,6,262,1487
CHIAPAS,SAN CRISTOBAL DE LAS CASAS,5,270,4,279,1486
CHIAPAS,SAN CRISTOBAL DE LAS CASAS,28,79,3,110,1343
CHIAPAS,SAN CRISTOBAL DE LAS CASAS,8,59,1,68,1343
CHIAPAS,SAN CRISTOBAL DE LAS CASAS,12,86,1,99,1343
CHIAPAS,SAN CRISTOBAL DE LAS CASAS,26,355,10,391,1876
CHIAPAS,SAN CRISTOBAL DE LAS CASAS,25,348,23,396,1875
CHIAPAS,SAN CRISTOBAL DE LAS CASAS,11,351,3,365,1392
CHIAPAS,SAN CRISTOBAL DE LAS CASAS,23,355,5,383,1391
CHIAPAS,SAN CRISTOBAL DE LAS CASAS,13,307,0,320,1612
CHIAPAS,SAN CRISTOBAL DE LAS CASAS,8,316,0,324,1611
CHIAPAS,SAN CRISTOBAL DE LAS CASAS,39,361,32,432,1489
CHIAPAS,SAN CRISTOBAL DE LAS CASAS,40,413,34,487,1489
CHIAPAS,SAN CRISTOBAL DE LAS CASAS,39,1699,25,1763,1849
CHIAPAS,SAN CRISTOBAL DE LAS CASAS,39,1692,24,1755,1849
CHIAPAS,SAN CRISTOBAL DE LAS CASAS,16,138,21,175,1736
CHIAPAS,SAN CRISTOBAL DE LAS CASAS,57,288,38,383,1736
CHIAPAS,SAN CRISTOBAL DE LAS CASAS,55,356,21,432,1736
CHIAPAS,SAN CRISTOBAL DE LAS CASAS,41,1200,21,1262,1761
CHIAPAS,SAN CRISTOBAL DE LAS CASAS,53,1200,15,1268,1761
CHIAPAS,SAN CRISTOBAL DE LAS CASAS,46,800,50,896,1761
CHIAPAS,SAN CRISTOBAL DE LAS CASAS,41,1659,29,1729,1768
CHIAPAS,SAN CRISTOBAL DE LAS CASAS,40,662,44,746,1767
CHIAPAS,SAN CRISTOBAL DE LAS CASAS,12,519,2,533,1334
CHIAPAS,SAN CRISTOBAL DE LAS CASAS,40,483,5,528,1333
CHIAPAS,SAN CRISTOBAL DE LAS CASAS,0,454,16,470,1333
CHIAPAS,SAN CRISTOBAL DE LAS CASAS,87,389,19,495,1290
CHIAPAS,SAN CRISTOBAL DE LAS CASAS,117,417,47,581,1290
CHIAPAS,SAN CRISTOBAL DE LAS CASAS,3,102,3,108,1513
CHIAPAS,SAN CRISTOBAL DE LAS CASAS,7,81,5,93,1512
CHIAPAS,SAN CRISTOBAL DE LAS CASAS,15,175,1,191,1881
CHIAPAS,SAN CRISTOBAL DE LAS CASAS,11,164,0,175,1881
CHIAPAS,SAN CRISTOBAL DE LAS CASAS,5,67,2,74,1973
CHIAPAS,SAN CRISTOBAL DE LAS CASAS,7,110,1,118,1972
CHIAPAS,SAN CRISTOBAL DE LAS CASAS,3,48,3,54,1802
CHIAPAS,SAN CRISTOBAL DE LAS CASAS,4,32,1,37,1802
CHIAPAS,SAN CRISTOBAL DE LAS CASAS,1,24,0,25,1120
CHIAPAS,SAN CRISTOBAL DE LAS CASAS,0,20,1,21,1119
CHIAPAS,SAN CRISTOBAL DE LAS CASAS,3,45,0,48,1789
CHIAPAS,SAN CRISTOBAL DE LAS CASAS,2,62,1,65,1789
CHIAPAS,SAN CRISTOBAL DE LAS CASAS,0,36,1,37,1454
CHIAPAS,SAN CRISTOBAL DE LAS CASAS,1,34,3,38,1454
CHIAPAS,SAN CRISTOBAL DE LAS CASAS,4,33,0,37,1453
CHIAPAS,SAN CRISTOBAL DE LAS CASAS,2,8,0,10,1890
CHIAPAS,SAN CRISTOBAL DE LAS CASAS,0,12,0,12,1890
CHIAPAS,SAN CRISTOBAL DE LAS CASAS,4,21,0,25,1586
CHIAPAS,SAN CRISTOBAL DE LAS CASAS,11,8,0,19,1585
CHIAPAS,SAN CRISTOBAL DE LAS CASAS,6,41,3,50,1299
CHIAPAS,SAN CRISTOBAL DE LAS CASAS,8,38,8,54,1299
CHIAPAS,SAN CRISTOBAL DE LAS CASAS,7,107,5,119,1740
CHIAPAS,SAN CRISTOBAL DE LAS CASAS,7,129,4,140,1739
CHIAPAS,SAN CRISTOBAL DE LAS CASAS,9,201,0,210,1438
CHIAPAS,SAN CRISTOBAL DE LAS CASAS,10,216,1,227,1437
CHIAPAS,SAN CRISTOBAL DE LAS CASAS,15,274,1,290,1947
CHIAPAS,SAN CRISTOBAL DE LAS CASAS,10,270,1,281,1946
CHIAPAS,SAN CRISTOBAL DE LAS CASAS,53,446,26,525,1493
CHIAPAS,SAN CRISTOBAL DE LAS CASAS,57,485,9,551,1492
CHIAPAS,SAN CRISTOBAL DE LAS CASAS,38,502,11,551,1492
CHIAPAS,TUXTLA GUTIERREZ,7,497,12,516,1726
CHIAPAS,TUXTLA GUTIERREZ,6,498,12,516,1726
CHIAPAS,TUXTLA GUTIERREZ,5,572,2,579,1568
CHIAPAS,TUXTLA GUTIERREZ,1,537,4,542,1567
CHIAPAS,TUXTLA GUTIERREZ,6,585,7,598,1567
CHIAPAS,TUXTLA GUTIERREZ,14,587,5,606,1891
CHIAPAS,TUXTLA GUTIERREZ,6,624,7,637,1890
CHIAPAS,TUXTLA GUTIERREZ,11,419,7,437,1183
CHIAPAS,TUXTLA GUTIERREZ,19,398,10,427,1183
CHIAPAS,TUXTLA GUTIERREZ,10,477,7,494,1539
CHIAPAS,TUXTLA GUTIERREZ,9,464,11,484,1538
CHIAPAS,TUXTLA GUTIERREZ,9,254,3,266,1002
CHIAPAS,TUXTLA GUTIERREZ,16,291,6,313,1002
CHIAPAS,TUXTLA GUTIERREZ,28,535,13,576,1660
CHIAPAS,TUXTLA GUTIERREZ,18,515,14,547,1659
CHIAPAS,TUXTLA GUTIERREZ,12,313,6,331,1797
CHIAPAS,TUXTLA GUTIERREZ,14,268,13,295,1797
CHIAPAS,TUXTLA GUTIERREZ,14,258,7,279,1797
CHIAPAS,TUXTLA GUTIERREZ,15,268,6,289,1797
CHIAPAS,TUXTLA GUTIERREZ,14,233,12,259,1797
CHIAPAS,TUXTLA GUTIERREZ,19,309,4,332,1796
CHIAPAS,TUXTLA GUTIERREZ,24,773,19,816,1519
CHIAPAS,TUXTLA GUTIERREZ,24,963,4,991,1519
CHIAPAS,TUXTLA GUTIERREZ,12,384,3,399,1571
CHIAPAS,TUXTLA GUTIERREZ,18,294,13,325,1570
CHIAPAS,TUXTLA GUTIERREZ,22,294,5,321,1570
CHIAPAS,TUXTLA GUTIERREZ,16,311,1,328,1570
CHIAPAS,TUXTLA GUTIERREZ,18,344,10,372,1807
CHIAPAS,TUXTLA GUTIERREZ,16,325,1,342,1807
CHIAPAS,TUXTLA GUTIERREZ,24,507,13,544,1776
CHIAPAS,TUXTLA GUTIERREZ,37,475,10,522,1776
CHIAPAS,TUXTLA GUTIERREZ,20,380,3,403,1243
CHIAPAS,TUXTLA GUTIERREZ,8,411,6,425,1243
CHIAPAS,TUXTLA GUTIERREZ,19,451,8,478,1595
CHIAPAS,TUXTLA GUTIERREZ,11,420,4,435,1594
CHIAPAS,TUXTLA GUTIERREZ,20,531,6,557,1635
CHIAPAS,TUXTLA GUTIERREZ,32,684,3,719,1634
CHIAPAS,TUXTLA GUTIERREZ,27,1176,14,1217,1300
CHIAPAS,TUXTLA GUTIERREZ,44,1161,8,1213,1299
CHIAPAS,TUXTLA GUTIERREZ,23,205,14,242,1027
CHIAPAS,TUXTLA GUTIERREZ,19,159,5,183,1027
CHIAPAS,TUXTLA GUTIERREZ,27,374,11,412,1598
CHIAPAS,TUXTLA GUTIERREZ,25,242,16,283,1597
CHIAPAS,TUXTLA GUTIERREZ,19,330,18,367,1478
CHIAPAS,TUXTLA GUTIERREZ,16,468,55,539,1478
CHIAPAS,TUXTLA GUTIERREZ,25,496,8,529,1478
CHIAPAS,TUXTLA GUTIERREZ,30,359,8,397,1942
CHIAPAS,TUXTLA GUTIERREZ,23,368,19,410,1941
CHIAPAS,TUXTLA GUTIERREZ,23,353,13,389,1750
CHIAPAS,TUXTLA GUTIERREZ,16,377,7,400,1749
CHIAPAS,TUXTLA GUTIERREZ,52,519,5,576,0
CHIAPAS,TUXTLA GUTIERREZ,26,389,21,436,1383
CHIAPAS,TUXTLA GUTIERREZ,39,341,25,405,1383
CHIAPAS,TUXTLA GUTIERREZ,33,481,20,534,1748
CHIAPAS,TUXTLA GUTIERREZ,31,418,17,466,1748
CHIAPAS,TUXTLA GUTIERREZ,5,513,0,518,1226
CHIAPAS,TUXTLA GUTIERREZ,4,560,1,565,1225
CHIAPAS,TUXTLA GUTIERREZ,1,837,1,839,1191
CHIAPAS,TUXTLA GUTIERREZ,4,813,8,825,1190
CHIAPAS,TUXTLA GUTIERREZ,23,871,118,1012,1696
CHIAPAS,TUXTLA GUTIERREZ,4,944,8,956,1696
CHIAPAS,TUXTLA GUTIERREZ,7,586,5,598,1570
CHIAPAS,TUXTLA GUTIERREZ,14,796,4,814,1570
CHIAPAS,TUXTLA GUTIERREZ,27,416,34,477,1570
CHIAPAS,TUXTLA GUTIERREZ,12,306,7,325,1315
CHIAPAS,TUXTLA GUTIERREZ,7,375,112,494,1315
CHIAPAS,TUXTLA GUTIERREZ,10,428,9,447,1615
CHIAPAS,TUXTLA GUTIERREZ,17,457,6,480,1614
CHIAPAS,TUXTLA GUTIERREZ,13,439,11,463,1614
CHIAPAS,TUXTLA GUTIERREZ,6,275,1,282,1329
CHIAPAS,TUXTLA GUTIERREZ,7,354,3,364,1329
CHIAPAS,TUXTLA GUTIERREZ,17,335,8,360,1433
CHIAPAS,TUXTLA GUTIERREZ,16,300,8,324,1433
CHIAPAS,TUXTLA GUTIERREZ,17,407,1,425,1536
CHIAPAS,TUXTLA GUTIERREZ,16,417,6,439,1536
CHIAPAS,TUXTLA GUTIERREZ,11,365,7,383,1881
CHIAPAS,TUXTLA GUTIERREZ,18,371,10,399,1880
CHIAPAS,TUXTLA GUTIERREZ,16,414,3,433,1880
CHIAPAS,TUXTLA GUTIERREZ,14,361,3,378,1630
CHIAPAS,TUXTLA GUTIERREZ,18,321,1,340,1630
CHIAPAS,TUXTLA GUTIERREZ,14,373,5,392,1630
CHIAPAS,TUXTLA GUTIERREZ,20,324,9,353,1960
CHIAPAS,TUXTLA GUTIERREZ,24,372,20,416,1959
CHIAPAS,TUXTLA GUTIERREZ,13,269,6,288,1487
CHIAPAS,TUXTLA GUTIERREZ,5,252,13,270,1487
CHIAPAS,TUXTLA GUTIERREZ,23,379,24,426,1781
CHIAPAS,TUXTLA GUTIERREZ,25,364,16,405,1780
CHIAPAS,TUXTLA GUTIERREZ,17,376,16,409,1362
CHIAPAS,TUXTLA GUTIERREZ,12,397,10,419,1361
CHIAPAS,TUXTLA GUTIERREZ,7,377,6,390,1361
CHIAPAS,TUXTLA GUTIERREZ,27,347,22,396,1456
CHIAPAS,TUXTLA GUTIERREZ,21,306,19,346,1455
CHIAPAS,TUXTLA GUTIERREZ,3,332,7,342,1437
CHIAPAS,TUXTLA GUTIERREZ,4,272,10,286,1437
CHIAPAS,TUXTLA GUTIERREZ,7,301,9,317,1437
CHIAPAS,TUXTLA GUTIERREZ,13,434,9,456,1411
CHIAPAS,TUXTLA GUTIERREZ,20,313,5,338,1411
CHIAPAS,TUXTLA GUTIERREZ,15,338,19,372,1512
CHIAPAS,TUXTLA GUTIERREZ,11,354,14,379,1512
CHIAPAS,TUXTLA GUTIERREZ,12,216,2,230,1053
CHIAPAS,TUXTLA GUTIERREZ,8,218,2,228,1053
CHIAPAS,TUXTLA GUTIERREZ,4,281,0,285,1665
CHIAPAS,TUXTLA GUTIERREZ,6,301,0,307,1665
CHIAPAS,TUXTLA GUTIERREZ,2,312,3,317,1664
CHIAPAS,TUXTLA GUTIERREZ,11,510,8,529,1884
CHIAPAS,TUXTLA GUTIERREZ,4,494,13,511,1883
CHIAPAS,TUXTLA GUTIERREZ,9,269,1,279,1952
CHIAPAS,TUXTLA GUTIERREZ,7,377,0,384,1951
CHIAPAS,TUXTLA GUTIERREZ,8,304,2,314,1379
CHIAPAS,TUXTLA GUTIERREZ,8,293,11,312,1379
CHIAPAS,TUXTLA GUTIERREZ,17,297,2,316,1379
CHIAPAS,TUXTLA GUTIERREZ,4,245,2,251,1055
CHIAPAS,TUXTLA GUTIERREZ,1,355,1,357,1055
CHIAPAS,TUXTLA GUTIERREZ,19,362,1,382,1445
CHIAPAS,TUXTLA GUTIERREZ,16,307,3,326,1444
CHIAPAS,TUXTLA GUTIERREZ,9,244,2,255,1831
CHIAPAS,TUXTLA GUTIERREZ,10,265,5,280,1831
CHIAPAS,TUXTLA GUTIERREZ,13,254,1,268,1831
CHIAPAS,TUXTLA GUTIERREZ,10,258,1,269,1830
CHIAPAS,TUXTLA GUTIERREZ,14,218,0,232,1830
CHIAPAS,TUXTLA GUTIERREZ,6,207,3,216,1018
CHIAPAS,TUXTLA GUTIERREZ,3,187,1,191,1018
CHIAPAS,TUXTLA GUTIERREZ,30,270,0,300,1702
CHIAPAS,TUXTLA GUTIERREZ,0,283,0,283,1702
CHIAPAS,TUXTLA GUTIERREZ,14,263,3,280,1702
CHIAPAS,TUXTLA GUTIERREZ,17,281,3,301,1702
CHIAPAS,TUXTLA GUTIERREZ,13,278,4,295,1702
CHIAPAS,TUXTLA GUTIERREZ,17,279,2,298,1827
CHIAPAS,TUXTLA GUTIERREZ,18,264,4,286,1827
CHIAPAS,TUXTLA GUTIERREZ,16,250,3,269,1454
CHIAPAS,TUXTLA GUTIERREZ,16,225,3,244,1454
CHIAPAS,TUXTLA GUTIERREZ,4,235,2,241,1330
CHIAPAS,TUXTLA GUTIERREZ,9,200,5,214,1329
CHIAPAS,TUXTLA GUTIERREZ,2,244,3,249,1329
CHIAPAS,TUXTLA GUTIERREZ,12,243,4,259,1645
CHIAPAS,TUXTLA GUTIERREZ,261,8,2,271,1645
CHIAPAS,TUXTLA GUTIERREZ,10,251,3,264,1592
CHIAPAS,TUXTLA GUTIERREZ,8,234,2,244,1591
CHIAPAS,TUXTLA GUTIERREZ,11,258,4,273,1591
CHIAPAS,TUXTLA GUTIERREZ,12,202,3,217,1340
CHIAPAS,TUXTLA GUTIERREZ,13,247,7,267,1340
CHIAPAS,TUXTLA GUTIERREZ,14,211,0,225,1340
CHIAPAS,TUXTLA GUTIERREZ,9,261,0,270,1271
CHIAPAS,TUXTLA GUTIERREZ,19,257,0,276,1270
CHIAPAS,TUXTLA GUTIERREZ,17,326,6,349,1512
CHIAPAS,TUXTLA GUTIERREZ,19,298,1,318,1512
CHIAPAS,TUXTLA GUTIERREZ,12,215,2,229,1273
CHIAPAS,TUXTLA GUTIERREZ,5,202,2,209,1273
CHIAPAS,TUXTLA GUTIERREZ,0,207,0,207,1622
CHIAPAS,TUXTLA GUTIERREZ,10,199,1,210,1622
CHIAPAS,TUXTLA GUTIERREZ,10,206,6,222,1621
CHIAPAS,TUXTLA GUTIERREZ,15,251,1,267,1621
CHIAPAS,TUXTLA GUTIERREZ,16,243,2,261,1929
CHIAPAS,TUXTLA GUTIERREZ,20,241,2,263,1928
CHIAPAS,TUXTLA GUTIERREZ,8,221,5,234,1928
CHIAPAS,TUXTLA GUTIERREZ,9,222,2,233,1928
CHIAPAS,TUXTLA GUTIERREZ,15,244,0,259,1928
CHIAPAS,TUXTLA GUTIERREZ,7,255,5,267,1928
CHIAPAS,TUXTLA GUTIERREZ,16,263,0,279,1928
CHIAPAS,TUXTLA GUTIERREZ,12,190,1,203,1788
CHIAPAS,TUXTLA GUTIERREZ,4,175,0,179,1788
CHIAPAS,TUXTLA GUTIERREZ,12,185,4,201,1788
CHIAPAS,TUXTLA GUTIERREZ,2,190,2,194,1788
CHIAPAS,TUXTLA GUTIERREZ,8,214,2,224,1788
CHIAPAS,TUXTLA GUTIERREZ,10,166,3,179,1788
CHIAPAS,TUXTLA GUTIERREZ,13,201,3,217,1787
CHIAPAS,TUXTLA GUTIERREZ,8,199,6,213,1787
CHIAPAS,TUXTLA GUTIERREZ,9,244,4,257,1698
CHIAPAS,TUXTLA GUTIERREZ,11,232,5,248,1698
CHIAPAS,TUXTLA GUTIERREZ,7,209,4,220,1929
CHIAPAS,TUXTLA GUTIERREZ,6,196,7,209,1929
CHIAPAS,TUXTLA GUTIERREZ,2,171,3,176,1929
CHIAPAS,TUXTLA GUTIERREZ,0,217,5,222,1929
CHIAPAS,TUXTLA GUTIERREZ,7,225,1,233,1707
CHIAPAS,TUXTLA GUTIERREZ,6,224,4,234,1707
CHIAPAS,TUXTLA GUTIERREZ,11,219,3,233,1707
CHIAPAS,TUXTLA GUTIERREZ,5,235,7,247,1570
CHIAPAS,TUXTLA GUTIERREZ,11,227,4,242,1569
CHIAPAS,TUXTLA GUTIERREZ,250,9,10,269,1909
CHIAPAS,TUXTLA GUTIERREZ,7,213,8,228,1909
CHIAPAS,TUXTLA GUTIERREZ,17,313,10,340,1963
CHIAPAS,TUXTLA GUTIERREZ,7,308,7,322,1962
CHIAPAS,TUXTLA GUTIERREZ,3,303,6,312,1962
CHIAPAS,TUXTLA GUTIERREZ,7,180,4,191,1729
CHIAPAS,TUXTLA GUTIERREZ,6,164,2,172,1729
CHIAPAS,TUXTLA GUTIERREZ,7,126,3,136,1728
CHIAPAS,TUXTLA GUTIERREZ,23,311,0,334,1910
CHIAPAS,TUXTLA GUTIERREZ,24,321,4,349,1910
CHIAPAS,TUXTLA GUTIERREZ,24,341,1,366,1909
CHIAPAS,TUXTLA GUTIERREZ,14,722,7,743,1136
CHIAPAS,TUXTLA GUTIERREZ,15,823,9,847,1136
CHIAPAS,TUXTLA GUTIERREZ,48,614,12,674,1726
CHIAPAS,TUXTLA GUTIERREZ,50,1539,26,1615,1725
CHIAPAS,TUXTLA GUTIERREZ,7,549,4,560,1390
CHIAPAS,TUXTLA GUTIERREZ,14,227,1,242,1390
CHIAPAS,TUXTLA GUTIERREZ,5,263,5,273,1259
CHIAPAS,TUXTLA GUTIERREZ,15,295,12,322,1259
CHIAPAS,TUXTLA GUTIERREZ,8,824,4,836,1294
CHIAPAS,TUXTLA GUTIERREZ,10,835,11,856,1294
CHIAPAS,TUXTLA GUTIERREZ,15,198,2,215,1229
CHIAPAS,TUXTLA GUTIERREZ,10,176,2,188,1228
CHIAPAS,TUXTLA GUTIERREZ,10,276,2,288,1940
CHIAPAS,TUXTLA GUTIERREZ,13,276,1,290,1939
CHIAPAS,TUXTLA GUTIERREZ,10,202,1,213,1419
CHIAPAS,TUXTLA GUTIERREZ,1,235,8,244,1419
CHIAPAS,TUXTLA GUTIERREZ,17,177,0,194,1419
CHIAPAS,TONALA,10,297,7,314,1087
CHIAPAS,TONALA,7,271,4,282,1087
CHIAPAS,TONALA,7,238,1,246,1146
CHIAPAS,TONALA,6,261,3,270,1145
CHIAPAS,TONALA,11,332,49,392,1075
CHIAPAS,TONALA,16,308,11,335,1074
CHIAPAS,TONALA,14,245,2,261,1053
CHIAPAS,TONALA,8,214,7,229,1052
CHIAPAS,TONALA,9,405,13,427,1883
CHIAPAS,TONALA,12,400,5,417,1883
CHIAPAS,TONALA,14,582,6,602,1974
CHIAPAS,TONALA,11,550,3,564,1974
CHIAPAS,TONALA,13,416,23,452,2043
CHIAPAS,TONALA,0,387,0,387,1601
CHIAPAS,TONALA,16,340,11,367,1601
CHIAPAS,TONALA,6,398,8,412,1600
CHIAPAS,TONALA,8,357,1,366,1541
CHIAPAS,TONALA,6,356,1,363,1540
CHIAPAS,TONALA,9,519,8,536,1619
CHIAPAS,TONALA,13,491,12,516,1618
CHIAPAS,TONALA,6,495,2,503,1409
CHIAPAS,TONALA,10,518,4,532,1409
CHIAPAS,TONALA,2,486,3,491,1409
CHIAPAS,TONALA,11,540,20,571,1869
CHIAPAS,TONALA,7,503,6,516,1868
CHIAPAS,TONALA,10,375,10,395,1672
CHIAPAS,TONALA,2,378,4,384,1671
CHIAPAS,TONALA,4,362,3,369,1671
CHIAPAS,TONALA,7,358,4,369,1479
CHIAPAS,TONALA,7,340,6,353,1479
CHIAPAS,TONALA,12,331,4,347,1479
CHIAPAS,TONALA,7,344,5,356,1429
CHIAPAS,TONALA,2,361,3,366,1429
CHIAPAS,TONALA,3,327,7,337,1428
CHIAPAS,TONALA,9,489,0,498,1407
CHIAPAS,TONALA,7,474,5,486,1407
CHIAPAS,TONALA,5,495,0,500,1407
CHIAPAS,TONALA,21,658,13,692,1775
CHIAPAS,TONALA,14,604,7,625,1727
CHIAPAS,TONALA,11,617,4,632,1726
CHIAPAS,TONALA,8,941,3,952,1852
CHIAPAS,TONALA,9,853,5,867,1851
CHIAPAS,TONALA,20,313,35,368,1123
CHIAPAS,TONALA,25,252,19,296,1122
CHIAPAS,TONALA,39,351,13,403,1679
CHIAPAS,TONALA,21,432,19,472,1678
CHIAPAS,TONALA,13,626,15,654,2126
CHIAPAS,TONALA,7,587,7,601,2126
CHIAPAS,TONALA,30,526,22,578,1828
CHIAPAS,TONALA,25,485,15,525,1827
CHIAPAS,TONALA,19,804,12,835,1982
CHIAPAS,TONALA,16,589,7,612,1982
CHIAPAS,TONALA,5,458,7,470,1525
CHIAPAS,TONALA,6,480,6,492,1524
CHIAPAS,TONALA,5,690,9,704,1874
CHIAPAS,TONALA,9,720,36,765,1873
CHIAPAS,TONALA,2,828,0,830,1693
CHIAPAS,TONALA,10,288,2,300,1692
CHIAPAS,TONALA,10,384,1,395,1775
CHIAPAS,TONALA,6,885,2,893,1775
CHIAPAS,TONALA,6,685,5,696,1842
CHIAPAS,TONALA,6,641,6,653,1842
CHIAPAS,TONALA,17,1102,0,1119,1294
CHIAPAS,TONALA,22,1026,8,1056,1294
CHIAPAS,TONALA,15,1425,9,1449,1685
CHIAPAS,TONALA,6,409,3,418,1685
CHIAPAS,TONALA,8,726,7,741,1628
CHIAPAS,TONALA,1,893,2,896,1628
CHIAPAS,TONALA,8,944,5,957,1627
CHIAPAS,TONALA,4,889,4,897,1968
CHIAPAS,TONALA,5,546,0,551,1968
CHIAPAS,TONALA,20,451,8,479,2086
CHIAPAS,TONALA,24,661,16,701,2085
CHIAPAS,TONALA,22,444,5,471,1547
CHIAPAS,TONALA,10,667,2,679,1546
CHIAPAS,TONALA,15,560,6,581,1546
CHIAPAS,TONALA,12,255,0,267,1212
CHIAPAS,TONALA,6,274,6,286,1211
CHIAPAS,TONALA,4,229,10,243,1405
CHIAPAS,TONALA,5,915,4,924,1404
CHIAPAS,TONALA,6,1279,3,1288,1404
CHIAPAS,TONALA,102,1275,0,1377,1554
CHIAPAS,TONALA,6,1207,8,1221,1554
CHIAPAS,TONALA,10,1478,16,1504,2056
CHIAPAS,TONALA,13,856,8,877,1496
CHIAPAS,TONALA,10,1347,13,1370,1496
CHIAPAS,TONALA,15,947,4,966,1496
CHIAPAS,TONALA,4,278,2,284,1537
CHIAPAS,TONALA,6,275,0,281,1537
CHIAPAS,TONALA,20,242,10,272,1536
CHIAPAS,TONALA,20,1615,13,1648,1800
CHIAPAS,TONALA,14,1602,18,1634,1799
CHIAPAS,TONALA,5,446,8,459,1643
CHIAPAS,TONALA,5,463,1,469,1643
CHIAPAS,TONALA,14,484,10,508,2028
CHIAPAS,TONALA,8,483,8,499,2028
CHIAPAS,TONALA,14,539,10,563,2027
CHIAPAS,TONALA,5,382,7,394,1598
CHIAPAS,TONALA,4,608,1,613,1598
CHIAPAS,TONALA,2,371,2,375,1597
CHIAPAS,TONALA,8,595,2,605,1846
CHIAPAS,TONALA,14,527,10,551,1845
CHIAPAS,TONALA,11,566,8,585,1777
CHIAPAS,TONALA,11,509,11,531,1776
CHIAPAS,TONALA,4,1004,4,1012,1766
CHIAPAS,TONALA,9,679,3,691,1964
CHIAPAS,TONALA,13,490,10,513,2094
CHIAPAS,TONALA,11,505,8,524,2094
CHIAPAS,TONALA,10,570,3,583,2093
CHIAPAS,TONALA,6,676,5,687,1995
CHIAPAS,TONALA,4,565,2,571,1995
CHIAPAS,TONALA,4,579,7,590,1995
CHIAPAS,TONALA,11,322,3,336,1656
CHIAPAS,TONALA,10,334,3,347,1656
CHIAPAS,TONALA,7,341,2,350,1655
CHIAPAS,TONALA,22,909,3,934,0
CHIAPAS,TONALA,3,300,2,305,1441
CHIAPAS,TONALA,11,710,6,727,1441
CHIAPAS,TONALA,5,305,3,313,1441
CHIAPAS,TONALA,9,392,8,409,1828
CHIAPAS,TONALA,10,327,4,341,1828
CHIAPAS,TONALA,11,390,8,409,1828
CHIAPAS,TONALA,12,493,4,509,1972
CHIAPAS,TONALA,19,405,4,428,1971
CHIAPAS,TONALA,7,300,5,312,1581
CHIAPAS,TONALA,2,300,4,306,1581
CHIAPAS,TONALA,6,314,6,326,1581
CHIAPAS,TONALA,10,331,0,341,1421
CHIAPAS,TONALA,10,307,2,319,1420
CHIAPAS,TONALA,14,343,1,358,1420
CHIAPAS,TONALA,8,440,6,454,1791
CHIAPAS,TONALA,7,393,4,404,1791
CHIAPAS,TONALA,10,462,7,479,1477
CHIAPAS,TONALA,4,394,2,400,1477
CHIAPAS,TONALA,5,423,2,430,1476
CHIAPAS,TONALA,3,639,5,647,1831
CHIAPAS,TONALA,5,765,4,774,1831
CHIAPAS,TONALA,3,654,11,668,1831
CHIAPAS,TONALA,10,409,6,425,1551
CHIAPAS,TONALA,9,402,3,414,1550
CHIAPAS,TONALA,9,384,6,399,1550
CHIAPAS,TONALA,15,357,8,380,1173
CHIAPAS,TONALA,13,357,1,371,1172
CHIAPAS,TONALA,12,1235,0,1247,1504
CHIAPAS,TONALA,5,1210,7,1222,1504
CHIAPAS,TONALA,3,647,6,656,1526
CHIAPAS,TONALA,10,580,5,595,1525
CHIAPAS,TONALA,12,607,6,625,1525
CHIAPAS,TONALA,16,557,6,579,1763
CHIAPAS,TONALA,8,482,10,500,1763
CHIAPAS,TONALA,7,491,5,503,1762
CHIAPAS,TONALA,15,510,5,530,1809
CHIAPAS,TONALA,17,454,9,480,1809
CHIAPAS,TONALA,11,613,6,630,2030
CHIAPAS,TONALA,1,300,4,305,1337
CHIAPAS,TONALA,9,438,5,452,1337
CHIAPAS,TONALA,8,464,6,478,1870
CHIAPAS,TONALA,7,497,3,507,1870
CHIAPAS,TONALA,10,440,14,464,1815
CHIAPAS,TONALA,7,381,11,399,1814
CHIAPAS,TONALA,10,352,0,362,1326
CHIAPAS,TONALA,5,333,9,347,1325
CHIAPAS,TONALA,22,381,10,413,1225
CHIAPAS,TONALA,21,398,6,425,1225
CHIAPAS,TONALA,11,479,10,500,1967
CHIAPAS,TONALA,12,515,3,530,1966
CHIAPAS,TONALA,4,233,4,241,1469
CHIAPAS,TONALA,5,245,5,255,1469
CHIAPAS,TONALA,18,234,5,257,1469
CHIAPAS,TONALA,9,482,18,509,2006
CHIAPAS,TONALA,18,463,14,495,2006
CHIAPAS,TONALA,9,330,1,340,1126
CHIAPAS,TONALA,2,297,0,299,1125
CHIAPAS,TONALA,19,294,3,316,1699
CHIAPAS,TONALA,9,332,5,346,1699
CHIAPAS,TONALA,12,343,2,357,1698
CHIAPAS,TONALA,8,970,12,990,1977
CHIAPAS,TONALA,15,810,6,831,1977
CHIAPAS,COMITAN DE DOMINGUEZ,19,261,9,289,1512
CHIAPAS,COMITAN DE DOMINGUEZ,18,241,7,266,1511
CHIAPAS,COMITAN DE DOMINGUEZ,23,226,6,255,1511
CHIAPAS,COMITAN DE DOMINGUEZ,16,362,8,386,1885
CHIAPAS,COMITAN DE DOMINGUEZ,26,313,13,352,1885
CHIAPAS,COMITAN DE DOMINGUEZ,8,218,9,235,1679
CHIAPAS,COMITAN DE DOMINGUEZ,15,241,6,262,1678
CHIAPAS,COMITAN DE DOMINGUEZ,16,380,8,404,1671
CHIAPAS,COMITAN DE DOMINGUEZ,27,352,11,390,1671
CHIAPAS,COMITAN DE DOMINGUEZ,32,559,12,603,1671
CHIAPAS,COMITAN DE DOMINGUEZ,30,1334,25,1389,1847
CHIAPAS,COMITAN DE DOMINGUEZ,45,1047,9,1101,1846
CHIAPAS,COMITAN DE DOMINGUEZ,34,1072,52,1158,1498
CHIAPAS,COMITAN DE DOMINGUEZ,34,918,28,980,1498
CHIAPAS,COMITAN DE DOMINGUEZ,38,260,2,300,1674
CHIAPAS,COMITAN DE DOMINGUEZ,25,215,5,245,1674
CHIAPAS,COMITAN DE DOMINGUEZ,28,237,6,271,1673
CHIAPAS,COMITAN DE DOMINGUEZ,23,539,14,576,1409
CHIAPAS,COMITAN DE DOMINGUEZ,15,511,3,529,1408
CHIAPAS,COMITAN DE DOMINGUEZ,18,199,6,223,1415
CHIAPAS,COMITAN DE DOMINGUEZ,7,151,9,167,1415
CHIAPAS,COMITAN DE DOMINGUEZ,12,185,7,204,1414
CHIAPAS,COMITAN DE DOMINGUEZ,29,395,6,430,1757
CHIAPAS,COMITAN DE DOMINGUEZ,22,382,5,409,1757
CHIAPAS,COMITAN DE DOMINGUEZ,15,278,4,297,1894
CHIAPAS,COMITAN DE DOMINGUEZ,18,264,6,288,1893
CHIAPAS,COMITAN DE DOMINGUEZ,16,277,3,296,1651
CHIAPAS,COMITAN DE DOMINGUEZ,20,287,3,310,1651
CHIAPAS,COMITAN DE DOMINGUEZ,19,264,9,292,1651
CHIAPAS,COMITAN DE DOMINGUEZ,20,271,9,300,1651
CHIAPAS,COMITAN DE DOMINGUEZ,24,278,2,304,1650
CHIAPAS,COMITAN DE DOMINGUEZ,25,328,3,356,1714
CHIAPAS,COMITAN DE DOMINGUEZ,11,256,17,284,1713
CHIAPAS,COMITAN DE DOMINGUEZ,21,309,3,333,1860
CHIAPAS,COMITAN DE DOMINGUEZ,20,319,3,342,1860
CHIAPAS,COMITAN DE DOMINGUEZ,14,521,0,535,1601
CHIAPAS,COMITAN DE DOMINGUEZ,22,215,7,244,1600
CHIAPAS,COMITAN DE DOMINGUEZ,17,228,5,250,1600
CHIAPAS,COMITAN DE DOMINGUEZ,13,622,4,639,1483
CHIAPAS,COMITAN DE DOMINGUEZ,18,479,11,508,1482
CHIAPAS,COMITAN DE DOMINGUEZ,32,566,11,609,1482
CHIAPAS,COMITAN DE DOMINGUEZ,30,610,7,647,1778
CHIAPAS,COMITAN DE DOMINGUEZ,2,452,19,473,1777
CHIAPAS,COMITAN DE DOMINGUEZ,16,251,6,273,1777
CHIAPAS,COMITAN DE DOMINGUEZ,16,275,4,295,1777
CHIAPAS,COMITAN DE DOMINGUEZ,14,1406,10,1430,1806
CHIAPAS,COMITAN DE DOMINGUEZ,142,1454,31,1627,1805
CHIAPAS,COMITAN DE DOMINGUEZ,30,763,24,817,1980
CHIAPAS,COMITAN DE DOMINGUEZ,32,1222,12,1266,1979
CHIAPAS,COMITAN DE DOMINGUEZ,33,932,20,985,1182
CHIAPAS,COMITAN DE DOMINGUEZ,23,1073,1,1097,1182
CHIAPAS,COMITAN DE DOMINGUEZ,27,669,9,705,1070
CHIAPAS,COMITAN DE DOMINGUEZ,15,728,25,768,1069
CHIAPAS,COMITAN DE DOMINGUEZ,11,956,16,983,1567
CHIAPAS,COMITAN DE DOMINGUEZ,20,1067,13,1100,1567
CHIAPAS,COMITAN DE DOMINGUEZ,8,745,5,758,1567
CHIAPAS,COMITAN DE DOMINGUEZ,13,1282,8,1303,1594
CHIAPAS,COMITAN DE DOMINGUEZ,50,1468,9,1527,1593
CHIAPAS,COMITAN DE DOMINGUEZ,22,1074,16,1112,1336
CHIAPAS,COMITAN DE DOMINGUEZ,58,970,31,1059,1336
CHIAPAS,COMITAN DE DOMINGUEZ,15,815,4,834,1174
CHIAPAS,COMITAN DE DOMINGUEZ,15,802,19,836,1173
CHIAPAS,COMITAN DE DOMINGUEZ,21,817,23,861,1396
CHIAPAS,COMITAN DE DOMINGUEZ,26,854,17,897,1396
CHIAPAS,COMITAN DE DOMINGUEZ,29,236,13,278,1396
CHIAPAS,COMITAN DE DOMINGUEZ,26,891,37,954,1534
CHIAPAS,COMITAN DE DOMINGUEZ,24,907,31,962,1533
CHIAPAS,COMITAN DE DOMINGUEZ,21,645,22,688,1409
CHIAPAS,COMITAN DE DOMINGUEZ,22,668,10,700,1408
CHIAPAS,COMITAN DE DOMINGUEZ,23,656,5,684,1408
CHIAPAS,COMITAN DE DOMINGUEZ,36,685,36,757,1764
CHIAPAS,COMITAN DE DOMINGUEZ,37,972,16,1025,1763
CHIAPAS,COMITAN DE DOMINGUEZ,16,483,11,510,1589
CHIAPAS,COMITAN DE DOMINGUEZ,12,448,15,475,1589
CHIAPAS,COMITAN DE DOMINGUEZ,20,513,14,547,1589
CHIAPAS,COMITAN DE DOMINGUEZ,23,272,23,318,1548
CHIAPAS,COMITAN DE DOMINGUEZ,25,284,17,326,1548
CHIAPAS,COMITAN DE DOMINGUEZ,31,391,24,446,1328
CHIAPAS,COMITAN DE DOMINGUEZ,7,408,9,424,1328
CHIAPAS,COMITAN DE DOMINGUEZ,24,463,13,500,1327
CHIAPAS,COMITAN DE DOMINGUEZ,7,428,10,445,1408
CHIAPAS,COMITAN DE DOMINGUEZ,9,404,8,421,1408
CHIAPAS,COMITAN DE DOMINGUEZ,13,405,22,440,1408
CHIAPAS,COMITAN DE DOMINGUEZ,17,303,10,330,1832
CHIAPAS,COMITAN DE DOMINGUEZ,10,284,14,308,1832
CHIAPAS,COMITAN DE DOMINGUEZ,16,1248,16,1280,1600
CHIAPAS,COMITAN DE DOMINGUEZ,22,1272,17,1311,1600
CHIAPAS,COMITAN DE DOMINGUEZ,17,729,9,755,1281
CHIAPAS,COMITAN DE DOMINGUEZ,22,716,7,745,1280
CHIAPAS,COMITAN DE DOMINGUEZ,67,1241,54,1362,1638
CHIAPAS,COMITAN DE DOMINGUEZ,23,956,81,1060,1637
CHIAPAS,COMITAN DE DOMINGUEZ,42,1000,13,1055,1707
CHIAPAS,COMITAN DE DOMINGUEZ,57,872,14,943,1707
CHIAPAS,COMITAN DE DOMINGUEZ,69,1165,37,1271,1388
CHIAPAS,COMITAN DE DOMINGUEZ,58,870,10,938,1388
CHIAPAS,COMITAN DE DOMINGUEZ,35,1368,11,1414,1531
CHIAPAS,COMITAN DE DOMINGUEZ,60,1413,8,1481,1530
CHIAPAS,COMITAN DE DOMINGUEZ,56,1356,10,1422,1730
CHIAPAS,COMITAN DE DOMINGUEZ,55,1011,20,1086,1730
CHIAPAS,COMITAN DE DOMINGUEZ,59,1270,42,1371,1374
CHIAPAS,COMITAN DE DOMINGUEZ,36,1293,24,1353,1374
CHIAPAS,COMITAN DE DOMINGUEZ,84,1280,12,1376,1373
CHIAPAS,COMITAN DE DOMINGUEZ,154,1030,56,1240,1650
CHIAPAS,COMITAN DE DOMINGUEZ,137,1464,63,1664,1650
CHIAPAS,COMITAN DE DOMINGUEZ,113,861,34,1008,1082
CHIAPAS,COMITAN DE DOMINGUEZ,91,921,31,1043,1081
CHIAPAS,COMITAN DE DOMINGUEZ,68,828,21,917,1037
CHIAPAS,COMITAN DE DOMINGUEZ,27,902,15,944,1036
CHIAPAS,COMITAN DE DOMINGUEZ,33,1018,24,1075,1898
CHIAPAS,COMITAN DE DOMINGUEZ,54,1164,30,1248,1897
CHIAPAS,COMITAN DE DOMINGUEZ,27,1297,22,1346,1537
CHIAPAS,COMITAN DE DOMINGUEZ,42,1321,49,1412,1537
CHIAPAS,COMITAN DE DOMINGUEZ,87,787,22,896,1840
CHIAPAS,COMITAN DE DOMINGUEZ,22,1015,27,1064,1840
CHIAPAS,COMITAN DE DOMINGUEZ,34,584,5,623,1099
CHIAPAS,COMITAN DE DOMINGUEZ,43,561,6,610,1099
CHIAPAS,COMITAN DE DOMINGUEZ,42,444,18,504,1663
CHIAPAS,COMITAN DE DOMINGUEZ,41,428,18,487,1663
CHIAPAS,COMITAN DE DOMINGUEZ,16,607,32,655,1016
CHIAPAS,COMITAN DE DOMINGUEZ,11,666,11,688,1015
CHIAPAS,COMITAN DE DOMINGUEZ,41,1199,30,1270,1891
CHIAPAS,COMITAN DE DOMINGUEZ,43,1235,32,1310,1891
CHIAPAS,COMITAN DE DOMINGUEZ,46,1049,31,1126,1877
CHIAPAS,COMITAN DE DOMINGUEZ,67,1107,9,1183,1876
CHIAPAS,COMITAN DE DOMINGUEZ,60,346,31,437,1918
CHIAPAS,COMITAN DE DOMINGUEZ,33,362,30,425,1918
CHIAPAS,COMITAN DE DOMINGUEZ,16,285,22,323,1199
CHIAPAS,COMITAN DE DOMINGUEZ,13,280,12,305,1199
CHIAPAS,COMITAN DE DOMINGUEZ,5,398,8,411,1084
CHIAPAS,COMITAN DE DOMINGUEZ,2,320,8,330,1084
CHIAPAS,COMITAN DE DOMINGUEZ,15,513,12,540,1658
CHIAPAS,COMITAN DE DOMINGUEZ,9,511,9,529,1658
CHIAPAS,COMITAN DE DOMINGUEZ,13,426,9,448,1658
CHIAPAS,COMITAN DE DOMINGUEZ,15,291,8,314,1463
CHIAPAS,COMITAN DE DOMINGUEZ,22,234,7,263,1462
CHIAPAS,COMITAN DE DOMINGUEZ,17,303,4,324,1462
CHIAPAS,COMITAN DE DOMINGUEZ,77,1306,18,1401,0
CHIAPAS,TUXTLA GUTIERREZ,8,312,3,323,2096
CHIAPAS,TUXTLA GUTIERREZ,8,299,12,319,2096
CHIAPAS,TUXTLA GUTIERREZ,12,262,5,279,2096
CHIAPAS,TUXTLA GUTIERREZ,9,285,4,298,2095
CHIAPAS,TUXTLA GUTIERREZ,16,310,11,337,2095
CHIAPAS,TUXTLA GUTIERREZ,10,251,5,266,1681
CHIAPAS,TUXTLA GUTIERREZ,8,259,2,269,1681
CHIAPAS,TUXTLA GUTIERREZ,11,288,0,299,1766
CHIAPAS,TUXTLA GUTIERREZ,7,219,2,228,1766
CHIAPAS,TUXTLA GUTIERREZ,5,212,31,248,1838
CHIAPAS,TUXTLA GUTIERREZ,1,247,6,254,1837
CHIAPAS,TUXTLA GUTIERREZ,5,140,2,147,1189
CHIAPAS,TUXTLA GUTIERREZ,2,123,2,127,1188
CHIAPAS,TUXTLA GUTIERREZ,3,235,2,240,1553
CHIAPAS,TUXTLA GUTIERREZ,5,178,1,184,1553
CHIAPAS,TUXTLA GUTIERREZ,7,238,4,249,1553
CHIAPAS,TUXTLA GUTIERREZ,14,313,5,332,1803
CHIAPAS,TUXTLA GUTIERREZ,6,281,8,295,1802
CHIAPAS,TUXTLA GUTIERREZ,12,278,0,290,1802
CHIAPAS,TUXTLA GUTIERREZ,19,381,3,403,2022
CHIAPAS,TUXTLA GUTIERREZ,8,343,5,356,2022
CHIAPAS,TUXTLA GUTIERREZ,17,318,2,337,2022
CHIAPAS,TUXTLA GUTIERREZ,14,315,3,332,1906
CHIAPAS,TUXTLA GUTIERREZ,11,356,3,370,1905
CHIAPAS,TUXTLA GUTIERREZ,4,251,1,256,1234
CHIAPAS,TUXTLA GUTIERREZ,6,228,2,236,1234
CHIAPAS,TUXTLA GUTIERREZ,10,227,2,239,1093
CHIAPAS,TUXTLA GUTIERREZ,8,249,3,260,1093
CHIAPAS,TUXTLA GUTIERREZ,10,283,2,295,1558
CHIAPAS,TUXTLA GUTIERREZ,11,280,3,294,1557
CHIAPAS,TUXTLA GUTIERREZ,6,231,2,239,1556
CHIAPAS,TUXTLA GUTIERREZ,7,177,1,185,1556
CHIAPAS,TUXTLA GUTIERREZ,6,226,3,235,1555
CHIAPAS,TUXTLA GUTIERREZ,14,273,0,287,2077
CHIAPAS,TUXTLA GUTIERREZ,14,253,1,268,2077
CHIAPAS,TUXTLA GUTIERREZ,6,229,3,238,2077
CHIAPAS,TUXTLA GUTIERREZ,14,235,5,254,2077
CHIAPAS,TUXTLA GUTIERREZ,19,235,0,254,2077
CHIAPAS,TUXTLA GUTIERREZ,9,238,3,250,2077
CHIAPAS,TUXTLA GUTIERREZ,5,229,3,237,2077
CHIAPAS,TUXTLA GUTIERREZ,11,366,2,379,1837
CHIAPAS,TUXTLA GUTIERREZ,10,370,1,381,1837
CHIAPAS,TUXTLA GUTIERREZ,23,406,3,432,2020
CHIAPAS,TUXTLA GUTIERREZ,18,440,3,461,2019
CHIAPAS,TUXTLA GUTIERREZ,12,255,4,271,1679
CHIAPAS,TUXTLA GUTIERREZ,7,226,3,236,1679
CHIAPAS,TUXTLA GUTIERREZ,7,222,1,230,1679
CHIAPAS,TUXTLA GUTIERREZ,9,246,3,258,1678
CHIAPAS,TUXTLA GUTIERREZ,7,165,3,175,1252
CHIAPAS,TUXTLA GUTIERREZ,5,186,5,196,1251
CHIAPAS,TUXTLA GUTIERREZ,4,214,2,220,1160
CHIAPAS,TUXTLA GUTIERREZ,7,208,7,222,1159
CHIAPAS,TUXTLA GUTIERREZ,11,261,5,277,1521
CHIAPAS,TUXTLA GUTIERREZ,6,259,3,268,1521
CHIAPAS,TUXTLA GUTIERREZ,9,296,2,307,1417
CHIAPAS,TUXTLA GUTIERREZ,15,297,1,313,1417
CHIAPAS,TUXTLA GUTIERREZ,14,407,3,424,1947
CHIAPAS,TUXTLA GUTIERREZ,17,416,0,433,1946
CHIAPAS,TUXTLA GUTIERREZ,20,392,2,414,1820
CHIAPAS,TUXTLA GUTIERREZ,22,386,1,409,1820
CHIAPAS,TUXTLA GUTIERREZ,21,368,1,390,1922
CHIAPAS,TUXTLA GUTIERREZ,15,396,1,412,1921
CHIAPAS,TUXTLA GUTIERREZ,13,260,3,276,1786
CHIAPAS,TUXTLA GUTIERREZ,19,231,0,250,1786
CHIAPAS,TUXTLA GUTIERREZ,22,336,4,362,1958
CHIAPAS,TUXTLA GUTIERREZ,32,324,1,357,1958
CHIAPAS,TUXTLA GUTIERREZ,18,221,1,240,1574
CHIAPAS,TUXTLA GUTIERREZ,17,225,2,244,1573
CHIAPAS,TUXTLA GUTIERREZ,16,304,1,321,1899
CHIAPAS,TUXTLA GUTIERREZ,21,291,0,312,1899
CHIAPAS,TUXTLA GUTIERREZ,23,322,5,350,1599
CHIAPAS,TUXTLA GUTIERREZ,13,297,1,311,1598
CHIAPAS,TUXTLA GUTIERREZ,14,322,3,339,1841
CHIAPAS,TUXTLA GUTIERREZ,18,332,2,352,1841
CHIAPAS,TUXTLA GUTIERREZ,17,255,2,274,1836
CHIAPAS,TUXTLA GUTIERREZ,17,217,3,237,1836
CHIAPAS,TUXTLA GUTIERREZ,22,378,4,404,1982
CHIAPAS,TUXTLA GUTIERREZ,20,399,4,423,1981
CHIAPAS,TUXTLA GUTIERREZ,16,277,0,293,1348
CHIAPAS,TUXTLA GUTIERREZ,14,295,0,309,1347
CHIAPAS,TUXTLA GUTIERREZ,9,359,1,369,1654
CHIAPAS,TUXTLA GUTIERREZ,20,307,2,329,1653
CHIAPAS,TUXTLA GUTIERREZ,10,290,2,302,1486
CHIAPAS,TUXTLA GUTIERREZ,19,270,0,289,1486
CHIAPAS,TUXTLA GUTIERREZ,11,243,5,259,1442
CHIAPAS,TUXTLA GUTIERREZ,16,272,2,290,1442
CHIAPAS,TUXTLA GUTIERREZ,6,251,4,261,1303
CHIAPAS,TUXTLA GUTIERREZ,4,228,4,236,1302
CHIAPAS,TUXTLA GUTIERREZ,8,284,5,297,1564
CHIAPAS,TUXTLA GUTIERREZ,12,256,6,274,1564
CHIAPAS,TUXTLA GUTIERREZ,22,412,2,436,1948
CHIAPAS,TUXTLA GUTIERREZ,26,408,5,439,1948
CHIAPAS,TUXTLA GUTIERREZ,11,282,1,294,1716
CHIAPAS,TUXTLA GUTIERREZ,21,285,1,307,1715
CHIAPAS,TUXTLA GUTIERREZ,15,266,2,283,1675
CHIAPAS,TUXTLA GUTIERREZ,19,293,2,314,1675
CHIAPAS,TUXTLA GUTIERREZ,10,144,1,155,1346
CHIAPAS,TUXTLA GUTIERREZ,13,138,2,153,1345
CHIAPAS,TUXTLA GUTIERREZ,88,1897,12,1997,0
CHIAPAS,TUXTLA GUTIERREZ,13,163,1,177,1502
CHIAPAS,TUXTLA GUTIERREZ,12,154,3,169,1502
CHIAPAS,TUXTLA GUTIERREZ,20,334,3,357,1998
CHIAPAS,TUXTLA GUTIERREZ,13,317,1,331,1998
CHIAPAS,TUXTLA GUTIERREZ,16,303,1,320,1656
CHIAPAS,TUXTLA GUTIERREZ,21,316,1,338,1656
CHIAPAS,TUXTLA GUTIERREZ,17,168,1,186,1366
CHIAPAS,TUXTLA GUTIERREZ,22,232,2,256,1366
CHIAPAS,TUXTLA GUTIERREZ,10,297,1,308,1782
CHIAPAS,TUXTLA GUTIERREZ,21,325,1,347,1781
CHIAPAS,TUXTLA GUTIERREZ,8,344,0,352,1874
CHIAPAS,TUXTLA GUTIERREZ,13,367,1,381,1874
CHIAPAS,TUXTLA GUTIERREZ,20,290,0,310,1528
CHIAPAS,TUXTLA GUTIERREZ,20,299,4,323,1527
CHIAPAS,TUXTLA GUTIERREZ,21,412,4,437,2041
CHIAPAS,TUXTLA GUTIERREZ,16,394,2,412,2041
CHIAPAS,TUXTLA GUTIERREZ,32,250,3,285,1716
CHIAPAS,TUXTLA GUTIERREZ,10,273,1,284,1715
CHIAPAS,TUXTLA GUTIERREZ,12,335,1,348,1835
CHIAPAS,TUXTLA GUTIERREZ,18,307,5,330,1834
CHIAPAS,TUXTLA GUTIERREZ,33,321,3,357,1881
CHIAPAS,TUXTLA GUTIERREZ,19,333,3,355,1881
CHIAPAS,TUXTLA GUTIERREZ,21,307,4,332,1450
CHIAPAS,TUXTLA GUTIERREZ,18,299,3,320,1450
CHIAPAS,TUXTLA GUTIERREZ,10,224,0,234,1346
CHIAPAS,TUXTLA GUTIERREZ,12,223,2,237,1346
CHIAPAS,TUXTLA GUTIERREZ,21,320,3,344,1676
CHIAPAS,TUXTLA GUTIERREZ,9,327,2,338,1675
CHIAPAS,TUXTLA GUTIERREZ,17,358,0,375,1672
CHIAPAS,TUXTLA GUTIERREZ,15,381,3,399,1672
CHIAPAS,TUXTLA GUTIERREZ,15,315,3,333,1610
CHIAPAS,TUXTLA GUTIERREZ,14,356,0,370,1610
CHIAPAS,TUXTLA GUTIERREZ,5,265,0,270,1370
CHIAPAS,TUXTLA GUTIERREZ,12,271,3,286,1369
CHIAPAS,TUXTLA GUTIERREZ,10,383,4,397,1956
CHIAPAS,TUXTLA GUTIERREZ,12,356,3,371,1955
CHIAPAS,TUXTLA GUTIERREZ,6,252,1,259,1387
CHIAPAS,TUXTLA GUTIERREZ,2,261,3,266,1387
CHIAPAS,TUXTLA GUTIERREZ,12,252,3,267,1416
CHIAPAS,TUXTLA GUTIERREZ,18,277,0,295,1416
CHIAPAS,TUXTLA GUTIERREZ,12,266,3,281,1686
CHIAPAS,TUXTLA GUTIERREZ,11,247,1,259,1685
CHIAPAS,TUXTLA GUTIERREZ,9,222,3,234,1601
CHIAPAS,TUXTLA GUTIERREZ,9,218,3,230,1601
CHIAPAS,TUXTLA GUTIERREZ,5,222,3,230,1601
CHIAPAS,TUXTLA GUTIERREZ,7,235,9,251,1896
CHIAPAS,TUXTLA GUTIERREZ,11,264,3,278,1896
CHIAPAS,TUXTLA GUTIERREZ,10,262,6,278,1895
CHIAPAS,TUXTLA GUTIERREZ,13,222,3,238,1895
CHIAPAS,TUXTLA GUTIERREZ,5,228,4,237,1895
CHIAPAS,TUXTLA GUTIERREZ,9,383,1,393,2018
CHIAPAS,TUXTLA GUTIERREZ,11,347,3,361,2018
CHIAPAS,TUXTLA GUTIERREZ,21,377,1,399,2017
CHIAPAS,TUXTLA GUTIERREZ,11,204,0,215,1336
CHIAPAS,TUXTLA GUTIERREZ,11,194,2,207,1335
CHIAPAS,TUXTLA GUTIERREZ,29,305,1,335,1911
CHIAPAS,TUXTLA GUTIERREZ,38,305,0,343,1910
CHIAPAS,TUXTLA GUTIERREZ,4,169,1,174,1640
CHIAPAS,TUXTLA GUTIERREZ,8,162,0,170,1639
CHIAPAS,TUXTLA GUTIERREZ,16,253,2,271,1753
CHIAPAS,TUXTLA GUTIERREZ,11,212,2,225,1752
CHIAPAS,TUXTLA GUTIERREZ,10,277,1,288,1906
CHIAPAS,TUXTLA GUTIERREZ,5,275,1,281,1905
CHIAPAS,TUXTLA GUTIERREZ,22,224,8,254,2031
CHIAPAS,TUXTLA GUTIERREZ,23,196,1,220,2030
CHIAPAS,TUXTLA GUTIERREZ,15,314,1,330,2078
CHIAPAS,TUXTLA GUTIERREZ,16,314,3,333,2077
CHIAPAS,TUXTLA GUTIERREZ,21,306,1,328,1728
CHIAPAS,TUXTLA GUTIERREZ,20,291,1,312,1728
CHIAPAS,TUXTLA GUTIERREZ,12,185,2,199,1991
CHIAPAS,TUXTLA GUTIERREZ,3,171,6,180,1990
CHIAPAS,TUXTLA GUTIERREZ,13,278,1,292,1988
CHIAPAS,TUXTLA GUTIERREZ,12,253,7,272,1988
CHIAPAS,TUXTLA GUTIERREZ,16,338,4,358,1827
CHIAPAS,TUXTLA GUTIERREZ,16,368,1,385,1826
CHIAPAS,TUXTLA GUTIERREZ,14,258,0,272,2105
CHIAPAS,TUXTLA GUTIERREZ,12,265,3,280,2105
CHIAPAS,TUXTLA GUTIERREZ,17,409,4,430,2075
CHIAPAS,TUXTLA GUTIERREZ,17,371,5,393,2075
CHIAPAS,TUXTLA GUTIERREZ,6,170,2,178,1220
CHIAPAS,TUXTLA GUTIERREZ,8,184,3,195,1219
CHIAPAS,TUXTLA GUTIERREZ,7,237,4,248,1986
CHIAPAS,TUXTLA GUTIERREZ,10,225,1,236,1985
CHIAPAS,TUXTLA GUTIERREZ,11,223,3,237,1566
CHIAPAS,TUXTLA GUTIERREZ,14,223,2,239,1565
CHIAPAS,VILLAFLORES,11,1469,19,1499,2004
CHIAPAS,VILLAFLORES,11,1562,15,1588,2004
CHIAPAS,VILLAFLORES,12,1629,18,1659,2004
CHIAPAS,VILLAFLORES,10,1414,22,1446,2004
CHIAPAS,VILLAFLORES,7,1499,12,1518,2004
CHIAPAS,VILLAFLORES,12,1498,10,1520,2004
CHIAPAS,VILLAFLORES,2,1399,16,1417,2003
CHIAPAS,VILLAFLORES,13,399,15,427,2064
CHIAPAS,VILLAFLORES,11,390,13,414,2064
CHIAPAS,VILLAFLORES,15,361,23,399,2064
CHIAPAS,VILLAFLORES,13,355,12,380,1383
CHIAPAS,VILLAFLORES,9,381,15,405,1382
CHIAPAS,VILLAFLORES,11,273,14,298,1382
CHIAPAS,VILLAFLORES,27,527,18,572,2008
CHIAPAS,VILLAFLORES,19,519,21,559,2008
CHIAPAS,VILLAFLORES,13,577,2,592,2008
CHIAPAS,VILLAFLORES,9,252,7,268,1090
CHIAPAS,VILLAFLORES,9,223,3,235,1090
CHIAPAS,VILLAFLORES,8,279,6,293,1750
CHIAPAS,VILLAFLORES,9,315,7,331,1749
CHIAPAS,VILLAFLORES,11,301,3,315,1319
CHIAPAS,VILLAFLORES,7,294,2,303,1318
CHIAPAS,VILLAFLORES,10,310,6,326,1759
CHIAPAS,VILLAFLORES,7,341,6,354,1759
CHIAPAS,VILLAFLORES,10,308,0,318,1293
CHIAPAS,VILLAFLORES,2,573,2,577,1292
CHIAPAS,VILLAFLORES,15,736,3,754,2006
CHIAPAS,VILLAFLORES,9,318,5,332,1462
CHIAPAS,VILLAFLORES,9,347,4,360,1461
CHIAPAS,VILLAFLORES,10,322,1,333,1461
CHIAPAS,VILLAFLORES,1,246,7,254,1420
CHIAPAS,VILLAFLORES,5,222,1,228,1419
CHIAPAS,VILLAFLORES,8,295,7,310,1944
CHIAPAS,VILLAFLORES,25,565,32,622,1943
CHIAPAS,VILLAFLORES,11,301,1,313,1943
CHIAPAS,VILLAFLORES,12,426,6,444,2057
CHIAPAS,VILLAFLORES,7,336,7,350,1872
CHIAPAS,VILLAFLORES,1,363,9,373,1872
CHIAPAS,VILLAFLORES,3,204,8,215,1106
CHIAPAS,VILLAFLORES,7,220,4,231,1106
CHIAPAS,VILLAFLORES,21,95,5,121,1732
CHIAPAS,VILLAFLORES,25,96,10,131,1731
CHIAPAS,VILLAFLORES,23,87,12,122,1731
CHIAPAS,VILLAFLORES,7,587,6,600,1949
CHIAPAS,VILLAFLORES,7,433,7,447,1949
CHIAPAS,VILLAFLORES,7,532,10,549,1949
CHIAPAS,VILLAFLORES,14,719,12,745,1405
CHIAPAS,VILLAFLORES,23,662,9,694,1404
CHIAPAS,VILLAFLORES,13,1026,13,1052,1932
CHIAPAS,VILLAFLORES,6,926,2,934,1932
CHIAPAS,VILLAFLORES,13,613,9,635,1490
CHIAPAS,VILLAFLORES,9,303,7,319,1490
CHIAPAS,VILLAFLORES,7,1223,19,1249,2005
CHIAPAS,VILLAFLORES,8,971,22,1001,2004
CHIAPAS,VILLAFLORES,6,1300,4,1310,1494
CHIAPAS,VILLAFLORES,4,1053,4,1061,1494
CHIAPAS,VILLAFLORES,14,658,32,704,1983
CHIAPAS,VILLAFLORES,10,556,13,579,1983
CHIAPAS,VILLAFLORES,11,470,19,500,1488
CHIAPAS,VILLAFLORES,10,467,11,488,1487
CHIAPAS,VILLAFLORES,12,285,9,306,1569
CHIAPAS,VILLAFLORES,10,233,15,258,1569
CHIAPAS,VILLAFLORES,28,357,26,411,1599
CHIAPAS,VILLAFLORES,17,390,21,428,1599
CHIAPAS,VILLAFLORES,16,436,14,466,1639
CHIAPAS,VILLAFLORES,18,436,9,463,1638
CHIAPAS,VILLAFLORES,16,380,4,400,1376
CHIAPAS,VILLAFLORES,13,385,11,409,1375
CHIAPAS,VILLAFLORES,17,388,2,407,1375
CHIAPAS,VILLAFLORES,16,240,26,282,1725
CHIAPAS,VILLAFLORES,4,255,19,278,1724
CHIAPAS,VILLAFLORES,17,488,29,534,1881
CHIAPAS,VILLAFLORES,15,409,10,434,1880
CHIAPAS,VILLAFLORES,20,487,19,526,1880
CHIAPAS,VILLAFLORES,10,387,8,405,1613
CHIAPAS,VILLAFLORES,10,365,15,390,1613
CHIAPAS,VILLAFLORES,7,367,5,379,1264
CHIAPAS,VILLAFLORES,5,433,4,442,1263
CHIAPAS,VILLAFLORES,1,806,1,808,1806
CHIAPAS,VILLAFLORES,10,941,7,958,1805
CHIAPAS,VILLAFLORES,17,421,19,457,2004
CHIAPAS,VILLAFLORES,20,358,13,391,2004
CHIAPAS,VILLAFLORES,15,441,27,483,1566
CHIAPAS,VILLAFLORES,21,405,24,450,1566
CHIAPAS,VILLAFLORES,13,442,14,469,1566
CHIAPAS,VILLAFLORES,6,570,12,588,1947
CHIAPAS,VILLAFLORES,12,562,10,584,1946
CHIAPAS,VILLAFLORES,25,562,32,619,1949
CHIAPAS,VILLAFLORES,13,600,24,637,1948
CHIAPAS,VILLAFLORES,0,365,15,380,1733
CHIAPAS,VILLAFLORES,358,21,13,392,1732
CHIAPAS,VILLAFLORES,13,379,6,398,1732
CHIAPAS,VILLAFLORES,4,1324,0,1328,1457
CHIAPAS,VILLAFLORES,1,1456,1,1458,1457
CHIAPAS,VILLAFLORES,9,1282,4,1295,1456
CHIAPAS,VILLAFLORES,9,1479,5,1493,1822
CHIAPAS,VILLAFLORES,11,1385,9,1405,1821
CHIAPAS,VILLAFLORES,11,1475,4,1490,1496
CHIAPAS,VILLAFLORES,0,1485,18,1503,1495
CHIAPAS,VILLAFLORES,14,536,0,550,1782
CHIAPAS,VILLAFLORES,5,528,6,539,1782
CHIAPAS,VILLAFLORES,9,482,9,500,1781
CHIAPAS,VILLAFLORES,4,468,1,473,1781
CHIAPAS,VILLAFLORES,9,489,4,502,1781
CHIAPAS,VILLAFLORES,11,587,3,601,1745
CHIAPAS,VILLAFLORES,6,545,8,559,1745
CHIAPAS,VILLAFLORES,5,478,6,489,1745
CHIAPAS,VILLAFLORES,8,1624,2,1634,1669
CHIAPAS,VILLAFLORES,5,1621,6,1632,1669
CHIAPAS,VILLAFLORES,2,504,7,513,1559
CHIAPAS,VILLAFLORES,5,465,0,470,1559
CHIAPAS,VILLAFLORES,8,1764,9,1781,1817
CHIAPAS,VILLAFLORES,4,1786,5,1795,1817
CHIAPAS,VILLAFLORES,2,1921,13,1936,1927
CHIAPAS,VILLAFLORES,1,1891,3,1895,1926
CHIAPAS,VILLAFLORES,7,1813,1,1821,1846
CHIAPAS,VILLAFLORES,7,1810,1,1818,1845
CHIAPAS,VILLAFLORES,22,1729,1,1752,1752
CHIAPAS,VILLAFLORES,16,1713,4,1733,1752
CHIAPAS,VILLAFLORES,2,1419,17,1438,1426
CHIAPAS,VILLAFLORES,1,1427,10,1438,1426
CHIAPAS,VILLAFLORES,19,1828,12,1859,1895
CHIAPAS,VILLAFLORES,12,1827,12,1851,1895
CHIAPAS,VILLAFLORES,6,1706,15,1727,1742
CHIAPAS,VILLAFLORES,16,1618,12,1646,1741
CHIAPAS,VILLAFLORES,6,322,2,330,1934
CHIAPAS,VILLAFLORES,9,1185,4,1198,1934
CHIAPAS,VILLAFLORES,8,1365,5,1378,1934
CHIAPAS,VILLAFLORES,6,1584,9,1599,1636
CHIAPAS,VILLAFLORES,4,1620,11,1635,1635
CHIAPAS,VILLAFLORES,2,1522,1,1525,1627
CHIAPAS,VILLAFLORES,34,1537,4,1575,1627
CHIAPAS,VILLAFLORES,7,1561,3,1571,1627
CHIAPAS,VILLAFLORES,6,642,3,651,1774
CHIAPAS,VILLAFLORES,11,837,0,848,1773
CHIAPAS,VILLAFLORES,11,1477,51,1539,1704
CHIAPAS,VILLAFLORES,23,1462,0,1485,1704
CHIAPAS,VILLAFLORES,6,1074,1,1081,1241
CHIAPAS,VILLAFLORES,4,1211,12,1227,1241
CHIAPAS,VILLAFLORES,15,956,6,977,1395
CHIAPAS,VILLAFLORES,12,873,5,890,1395
CHIAPAS,VILLAFLORES,30,1835,1,1866,0
CHIAPAS,VILLAFLORES,7,313,5,325,1539
CHIAPAS,VILLAFLORES,2,340,2,344,1538
CHIAPAS,VILLAFLORES,7,877,12,896,1586
CHIAPAS,VILLAFLORES,2,315,3,320,1586
CHIAPAS,VILLAFLORES,9,1042,4,1055,1586
CHIAPAS,VILLAFLORES,2,742,6,750,1585
CHIAPAS,VILLAFLORES,18,1552,96,1666,1666
CHIAPAS,VILLAFLORES,95,1564,7,1666,1666
CHIAPAS,VILLAFLORES,12,1726,14,1752,1825
CHIAPAS,VILLAFLORES,30,1718,6,1754,1824
CHIAPAS,VILLAFLORES,7,1556,4,1567,1627
CHIAPAS,VILLAFLORES,15,1549,31,1595,1626
CHIAPAS,VILLAFLORES,44,1835,6,1885,2001
CHIAPAS,VILLAFLORES,13,1685,4,1702,2001
CHIAPAS,VILLAFLORES,11,1659,85,1755,1819
CHIAPAS,VILLAFLORES,0,1677,5,1682,1819
CHIAPAS,VILLAFLORES,17,1835,54,1906,1932
CHIAPAS,VILLAFLORES,22,1788,8,1818,1932
CHIAPAS,VILLAFLORES,1,852,1,854,1932
CHIAPAS,VILLAFLORES,4,1110,8,1122,1122
CHIAPAS,VILLAFLORES,3,1108,6,1117,1121
CHIAPAS,VILLAFLORES,64,1201,60,1325,1312
CHIAPAS,VILLAFLORES,66,1235,21,1322,1311
CHIAPAS,VILLAFLORES,16,1400,10,1426,1535
CHIAPAS,VILLAFLORES,2,1491,4,1497,1535
CHIAPAS,VILLAFLORES,3,1351,4,1358,1438
CHIAPAS,VILLAFLORES,3,1400,2,1405,1438
CHIAPAS,VILLAFLORES,19,1361,6,1386,1438
CHIAPAS,VILLAFLORES,19,1095,8,1122,1123
CHIAPAS,VILLAFLORES,16,1094,3,1113,1123
CHIAPAS,VILLAFLORES,19,1465,11,1495,1541
CHIAPAS,VILLAFLORES,6,1495,8,1509,1540
CHIAPAS,VILLAFLORES,12,1355,0,1367,1465
CHIAPAS,VILLAFLORES,12,1293,6,1311,1465
CHIAPAS,VILLAFLORES,5,1292,2,1299,1398
CHIAPAS,VILLAFLORES,7,1318,2,1327,1398
CHIAPAS,VILLAFLORES,8,1335,5,1348,1397
CHIAPAS,LAS MARGARITAS,14,302,19,335,1628
CHIAPAS,LAS MARGARITAS,14,340,13,367,1628
CHIAPAS,LAS MARGARITAS,23,441,33,497,1799
CHIAPAS,LAS MARGARITAS,25,441,25,491,1799
CHIAPAS,LAS MARGARITAS,12,358,19,389,1764
CHIAPAS,LAS MARGARITAS,18,319,27,364,1764
CHIAPAS,LAS MARGARITAS,5,394,12,411,1947
CHIAPAS,LAS MARGARITAS,18,1322,25,1365,1946
CHIAPAS,LAS MARGARITAS,33,336,24,393,1564
CHIAPAS,LAS MARGARITAS,31,326,29,386,1564
CHIAPAS,LAS MARGARITAS,2,433,1,436,1457
CHIAPAS,LAS MARGARITAS,6,575,10,591,1457
CHIAPAS,LAS MARGARITAS,42,203,32,277,1907
CHIAPAS,LAS MARGARITAS,44,248,25,317,1907
CHIAPAS,LAS MARGARITAS,30,176,32,238,1621
CHIAPAS,LAS MARGARITAS,30,112,14,156,1621
CHIAPAS,LAS MARGARITAS,59,303,52,414,1100
CHIAPAS,LAS MARGARITAS,41,309,50,400,1100
CHIAPAS,LAS MARGARITAS,136,406,83,625,1852
CHIAPAS,LAS MARGARITAS,134,454,76,664,1851
CHIAPAS,LAS MARGARITAS,18,414,12,444,1298
CHIAPAS,LAS MARGARITAS,14,386,17,417,1298
CHIAPAS,LAS MARGARITAS,50,761,45,856,1599
CHIAPAS,LAS MARGARITAS,47,482,35,564,1431
CHIAPAS,LAS MARGARITAS,58,440,32,530,1431
CHIAPAS,LAS MARGARITAS,10,325,32,367,1552
CHIAPAS,LAS MARGARITAS,7,403,32,442,1552
CHIAPAS,LAS MARGARITAS,30,564,23,617,1124
CHIAPAS,LAS MARGARITAS,60,353,34,447,1123
CHIAPAS,LAS MARGARITAS,24,276,35,335,1436
CHIAPAS,LAS MARGARITAS,37,331,36,404,1435
CHIAPAS,LAS MARGARITAS,25,357,41,423,1631
CHIAPAS,LAS MARGARITAS,42,251,31,324,1630
CHIAPAS,LAS MARGARITAS,25,252,22,299,1474
CHIAPAS,LAS MARGARITAS,19,215,10,244,1474
CHIAPAS,LAS MARGARITAS,20,216,14,250,1474
CHIAPAS,LAS MARGARITAS,8,550,6,564,1292
CHIAPAS,LAS MARGARITAS,24,556,20,600,1291
CHIAPAS,LAS MARGARITAS,6,729,14,749,2073
CHIAPAS,LAS MARGARITAS,189,1167,73,1429,1608
CHIAPAS,LAS MARGARITAS,51,1315,3,1369,1608
CHIAPAS,LAS MARGARITAS,134,1654,24,1812,1809
CHIAPAS,LAS MARGARITAS,106,1487,5,1598,1809
CHIAPAS,LAS MARGARITAS,211,1591,12,1814,2138
CHIAPAS,LAS MARGARITAS,38,744,1,783,1168
CHIAPAS,LAS MARGARITAS,30,830,1,861,1167
CHIAPAS,LAS MARGARITAS,43,1277,10,1330,2055
CHIAPAS,LAS MARGARITAS,254,1453,3,1710,1977
CHIAPAS,LAS MARGARITAS,20,675,23,718,1832
CHIAPAS,LAS MARGARITAS,92,542,13,647,1832
CHIAPAS,LAS MARGARITAS,28,321,10,359,2139
CHIAPAS,LAS MARGARITAS,20,218,6,244,1844
CHIAPAS,LAS MARGARITAS,7,201,4,212,1844
CHIAPAS,LAS MARGARITAS,22,263,20,305,0
CHIAPAS,LAS MARGARITAS,6,109,2,117,1467
CHIAPAS,LAS MARGARITAS,4,82,3,89,1466
CHIAPAS,LAS MARGARITAS,3,128,0,131,1466
CHIAPAS,LAS MARGARITAS,17,251,5,273,1718
CHIAPAS,LAS MARGARITAS,9,208,10,227,1717
CHIAPAS,LAS MARGARITAS,5,181,6,192,1734
CHIAPAS,LAS MARGARITAS,14,209,8,231,1734
CHIAPAS,LAS MARGARITAS,28,472,44,544,1424
CHIAPAS,LAS MARGARITAS,28,535,39,602,1423
CHIAPAS,LAS MARGARITAS,38,668,31,737,1604
CHIAPAS,LAS MARGARITAS,36,848,32,916,1603
CHIAPAS,LAS MARGARITAS,14,364,18,396,1627
CHIAPAS,LAS MARGARITAS,13,335,20,368,1627
CHIAPAS,LAS MARGARITAS,16,191,2,209,1755
CHIAPAS,LAS MARGARITAS,7,159,2,168,1754
CHIAPAS,LAS MARGARITAS,5,81,1,87,1112
CHIAPAS,LAS MARGARITAS,21,75,3,99,1111
CHIAPAS,LAS MARGARITAS,4,181,14,199,1666
CHIAPAS,LAS MARGARITAS,2,115,3,120,1666
CHIAPAS,LAS MARGARITAS,12,138,13,163,1514
CHIAPAS,LAS MARGARITAS,5,118,10,133,1514
CHIAPAS,LAS MARGARITAS,21,677,17,715,1986
CHIAPAS,LAS MARGARITAS,23,539,38,600,1986
CHIAPAS,LAS MARGARITAS,13,427,17,457,1143
CHIAPAS,LAS MARGARITAS,15,492,22,529,1143
CHIAPAS,LAS MARGARITAS,17,580,11,608,1442
CHIAPAS,LAS MARGARITAS,31,499,20,550,1442
CHIAPAS,LAS MARGARITAS,10,176,4,190,2010
CHIAPAS,LAS MARGARITAS,8,311,9,328,2009
CHIAPAS,LAS MARGARITAS,11,109,21,141,1529
CHIAPAS,LAS MARGARITAS,7,101,4,112,1529
CHIAPAS,LAS MARGARITAS,10,111,14,135,1528
CHIAPAS,LAS MARGARITAS,23,975,20,1018,1108
CHIAPAS,LAS MARGARITAS,17,487,21,525,1107
CHIAPAS,LAS MARGARITAS,3,1202,21,1226,1214
CHIAPAS,LAS MARGARITAS,17,1184,27,1228,1214
CHIAPAS,LAS MARGARITAS,32,463,20,515,1224
CHIAPAS,LAS MARGARITAS,29,482,41,552,1223
CHIAPAS,LAS MARGARITAS,26,292,35,353,1953
CHIAPAS,LAS MARGARITAS,12,157,10,179,1952
CHIAPAS,LAS MARGARITAS,16,121,9,146,1158
CHIAPAS,LAS MARGARITAS,7,85,7,99,1158
CHIAPAS,LAS MARGARITAS,10,61,4,75,1548
CHIAPAS,LAS MARGARITAS,8,106,9,123,1548
CHIAPAS,LAS MARGARITAS,4,487,98,589,1443
CHIAPAS,LAS MARGARITAS,9,969,22,1000,1443
CHIAPAS,LAS MARGARITAS,7,922,23,952,1195
CHIAPAS,LAS MARGARITAS,12,364,3,379,1195
CHIAPAS,LAS MARGARITAS,12,156,6,174,1449
CHIAPAS,LAS MARGARITAS,6,156,3,165,1448
CHIAPAS,LAS MARGARITAS,16,110,22,148,1711
CHIAPAS,LAS MARGARITAS,13,102,14,129,1710
CHIAPAS,LAS MARGARITAS,13,177,2,192,1745
CHIAPAS,LAS MARGARITAS,11,282,2,295,1744
CHIAPAS,LAS MARGARITAS,19,586,18,623,1451
CHIAPAS,LAS MARGARITAS,22,730,8,760,1450
CHIAPAS,LAS MARGARITAS,18,1440,20,1478,1940
CHIAPAS,LAS MARGARITAS,15,1378,19,1412,1940
CHIAPAS,LAS MARGARITAS,48,1420,26,1494,1692
CHIAPAS,LAS MARGARITAS,53,1360,27,1440,1691
CHIAPAS,LAS MARGARITAS,14,266,13,293,1877
CHIAPAS,LAS MARGARITAS,14,280,15,309,1877
CHIAPAS,LAS MARGARITAS,24,360,21,405,2151
CHIAPAS,LAS MARGARITAS,13,303,22,338,2151
CHIAPAS,LAS MARGARITAS,12,239,8,259,1740
CHIAPAS,LAS MARGARITAS,14,237,18,269,1739
CHIAPAS,LAS MARGARITAS,17,380,14,411,1383
CHIAPAS,LAS MARGARITAS,20,381,12,413,1383
CHIAPAS,LAS MARGARITAS,23,238,25,286,1903
CHIAPAS,LAS MARGARITAS,32,242,15,289,1903
CHIAPAS,LAS MARGARITAS,52,239,22,313,1795
CHIAPAS,LAS MARGARITAS,32,235,34,301,1795
CHIAPAS,LAS MARGARITAS,40,186,34,260,1795
CHIAPAS,LAS MARGARITAS,39,195,18,252,1631
CHIAPAS,LAS MARGARITAS,31,132,18,181,1630
CHIAPAS,LAS MARGARITAS,98,342,68,508,1361
CHIAPAS,LAS MARGARITAS,97,330,41,468,1360
CHIAPAS,LAS MARGARITAS,15,184,1,200,1140
CHIAPAS,LAS MARGARITAS,18,224,6,248,1140
CHIAPAS,LAS MARGARITAS,19,843,34,896,1906
CHIAPAS,LAS MARGARITAS,13,404,24,441,1905
CHIAPAS,TAPACHULA,11,294,7,312,1570
CHIAPAS,TAPACHULA,15,347,4,366,1570
CHIAPAS,TAPACHULA,9,346,11,366,1570
CHIAPAS,TAPACHULA,10,324,7,341,1721
CHIAPAS,TAPACHULA,10,325,6,341,1720
CHIAPAS,TAPACHULA,11,280,5,296,1476
CHIAPAS,TAPACHULA,4,305,6,315,1475
CHIAPAS,TAPACHULA,13,296,5,314,1306
CHIAPAS,TAPACHULA,4,311,4,319,1306
CHIAPAS,TAPACHULA,23,483,20,526,1623
CHIAPAS,TAPACHULA,20,552,20,592,1622
CHIAPAS,TAPACHULA,11,1070,10,1091,1503
CHIAPAS,TAPACHULA,13,339,2,354,1502
CHIAPAS,TAPACHULA,20,451,23,494,1502
CHIAPAS,TAPACHULA,14,491,18,523,1919
CHIAPAS,TAPACHULA,16,494,20,530,1919
CHIAPAS,TAPACHULA,10,418,11,439,1790
CHIAPAS,TAPACHULA,14,415,5,434,1790
CHIAPAS,TAPACHULA,15,359,4,378,1790
CHIAPAS,TAPACHULA,17,339,6,362,1389
CHIAPAS,TAPACHULA,1,336,23,360,1389
CHIAPAS,TAPACHULA,8,341,5,354,1139
CHIAPAS,TAPACHULA,9,328,10,347,1139
CHIAPAS,TAPACHULA,19,432,5,456,1745
CHIAPAS,TAPACHULA,16,402,5,423,1745
CHIAPAS,TAPACHULA,9,403,3,415,1744
CHIAPAS,TAPACHULA,14,364,3,381,1610
CHIAPAS,TAPACHULA,22,348,8,378,1610
CHIAPAS,TAPACHULA,17,392,10,419,1610
CHIAPAS,TAPACHULA,13,410,3,426,1614
CHIAPAS,TAPACHULA,12,409,11,432,1613
CHIAPAS,TAPACHULA,12,420,3,435,1613
CHIAPAS,TAPACHULA,34,495,7,536,2116
CHIAPAS,TAPACHULA,30,552,7,589,2115
CHIAPAS,TAPACHULA,27,1291,31,1349,1660
CHIAPAS,TAPACHULA,14,1275,6,1295,1659
CHIAPAS,TAPACHULA,11,266,8,285,1409
CHIAPAS,TAPACHULA,14,297,6,317,1408
CHIAPAS,TAPACHULA,20,274,13,307,1469
CHIAPAS,TAPACHULA,23,256,10,289,1469
CHIAPAS,TAPACHULA,26,277,10,313,1638
CHIAPAS,TAPACHULA,16,277,4,297,1638
CHIAPAS,TAPACHULA,5,736,16,757,1429
CHIAPAS,TAPACHULA,15,584,16,615,1429
CHIAPAS,TAPACHULA,14,682,13,709,1428
CHIAPAS,TAPACHULA,16,847,7,870,1494
CHIAPAS,TAPACHULA,26,831,13,870,1493
CHIAPAS,TAPACHULA,10,204,3,217,1205
CHIAPAS,TAPACHULA,13,188,0,201,1204
CHIAPAS,TAPACHULA,13,296,3,312,1900
CHIAPAS,TAPACHULA,8,255,7,270,1899
CHIAPAS,TAPACHULA,3,269,10,282,1899
CHIAPAS,TAPACHULA,12,408,8,428,1877
CHIAPAS,TAPACHULA,10,372,4,386,1877
CHIAPAS,TAPACHULA,17,303,6,326,1939
CHIAPAS,TAPACHULA,11,284,2,297,1939
CHIAPAS,TAPACHULA,12,272,2,286,1939
CHIAPAS,TAPACHULA,21,280,2,303,1484
CHIAPAS,TAPACHULA,24,276,3,303,1483
CHIAPAS,TAPACHULA,13,269,4,286,1483
CHIAPAS,TAPACHULA,14,215,4,233,1674
CHIAPAS,TAPACHULA,12,235,4,251,1674
CHIAPAS,TAPACHULA,11,253,10,274,1673
CHIAPAS,TAPACHULA,16,340,2,358,1788
CHIAPAS,TAPACHULA,19,342,4,365,1787
CHIAPAS,TAPACHULA,11,330,2,343,1744
CHIAPAS,TAPACHULA,13,339,4,356,1744
CHIAPAS,TAPACHULA,25,347,1,373,1712
CHIAPAS,TAPACHULA,22,336,1,359,1711
CHIAPAS,TAPACHULA,9,282,2,293,1540
CHIAPAS,TAPACHULA,15,263,2,280,1540
CHIAPAS,TAPACHULA,15,308,2,325,1540
CHIAPAS,TAPACHULA,16,381,2,399,1723
CHIAPAS,TAPACHULA,6,399,4,409,1722
CHIAPAS,TAPACHULA,14,342,1,357,1722
CHIAPAS,TAPACHULA,17,357,12,386,1721
CHIAPAS,TAPACHULA,18,300,3,321,1679
CHIAPAS,TAPACHULA,16,279,6,301,1678
CHIAPAS,TAPACHULA,17,267,3,287,1678
CHIAPAS,TAPACHULA,10,340,8,358,1992
CHIAPAS,TAPACHULA,11,365,9,385,1991
CHIAPAS,TAPACHULA,71,1515,18,1604,0
CHIAPAS,TAPACHULA,13,327,2,342,1679
CHIAPAS,TAPACHULA,12,335,4,351,1678
CHIAPAS,TAPACHULA,37,341,4,382,1603
CHIAPAS,TAPACHULA,21,385,6,412,1602
CHIAPAS,TAPACHULA,16,406,7,429,2086
CHIAPAS,TAPACHULA,10,387,8,405,2085
CHIAPAS,TAPACHULA,21,402,1,424,1976
CHIAPAS,TAPACHULA,11,407,2,420,1976
CHIAPAS,TAPACHULA,8,295,6,309,1520
CHIAPAS,TAPACHULA,15,253,2,270,1519
CHIAPAS,TAPACHULA,8,343,3,354,1958
CHIAPAS,TAPACHULA,17,385,5,407,1957
CHIAPAS,TAPACHULA,12,368,6,386,1608
CHIAPAS,TAPACHULA,15,293,4,312,1607
CHIAPAS,TAPACHULA,15,337,1,353,1408
CHIAPAS,TAPACHULA,7,311,1,319,1407
CHIAPAS,TAPACHULA,6,335,6,347,1640
CHIAPAS,TAPACHULA,16,332,2,350,1640
CHIAPAS,TAPACHULA,14,389,7,410,1955
CHIAPAS,TAPACHULA,10,413,2,425,1954
CHIAPAS,TAPACHULA,18,309,7,334,1832
CHIAPAS,TAPACHULA,20,336,2,358,1831
CHIAPAS,TAPACHULA,15,293,4,312,1460
CHIAPAS,TAPACHULA,11,289,9,309,1459
CHIAPAS,TAPACHULA,9,297,6,312,1459
CHIAPAS,TAPACHULA,10,336,4,350,2087
CHIAPAS,TAPACHULA,12,338,7,357,2087
CHIAPAS,TAPACHULA,14,345,8,367,2087
CHIAPAS,TAPACHULA,12,337,3,352,2087
CHIAPAS,TAPACHULA,11,333,7,351,2086
CHIAPAS,TAPACHULA,16,349,4,369,2086
CHIAPAS,TAPACHULA,22,244,4,270,1676
CHIAPAS,TAPACHULA,11,223,5,239,1675
CHIAPAS,TAPACHULA,10,261,4,275,1573
CHIAPAS,TAPACHULA,18,289,5,312,1572
CHIAPAS,TAPACHULA,11,269,3,283,1572
CHIAPAS,TAPACHULA,10,215,1,226,1289
CHIAPAS,TAPACHULA,9,177,2,188,1288
CHIAPAS,TAPACHULA,2,207,4,213,1489
CHIAPAS,TAPACHULA,4,169,2,175,1489
CHIAPAS,TAPACHULA,2,223,4,229,1489
CHIAPAS,TAPACHULA,26,245,5,276,1944
CHIAPAS,TAPACHULA,17,261,11,289,1944
CHIAPAS,TAPACHULA,16,379,11,406,1957
CHIAPAS,TAPACHULA,18,409,11,438,1957
CHIAPAS,TAPACHULA,12,221,11,244,1480
CHIAPAS,TAPACHULA,9,236,3,248,1479
CHIAPAS,TAPACHULA,10,238,6,254,1479
CHIAPAS,TAPACHULA,7,175,3,185,1839
CHIAPAS,TAPACHULA,8,254,7,269,1838
CHIAPAS,TAPACHULA,6,186,7,199,1838
CHIAPAS,TAPACHULA,6,134,4,144,1284
CHIAPAS,TAPACHULA,8,147,4,159,1284
CHIAPAS,TAPACHULA,7,357,5,369,1384
CHIAPAS,TAPACHULA,7,299,1,307,1383
CHIAPAS,TAPACHULA,10,283,4,297,1473
CHIAPAS,TAPACHULA,11,288,2,301,1473
CHIAPAS,TAPACHULA,16,287,18,321,1616
CHIAPAS,TAPACHULA,16,312,14,342,1615
CHIAPAS,TAPACHULA,12,266,5,283,1866
CHIAPAS,TAPACHULA,14,295,7,316,1865
CHIAPAS,TAPACHULA,7,370,4,381,1357
CHIAPAS,TAPACHULA,5,593,22,620,1357
CHIAPAS,TAPACHULA,2,208,2,212,1429
CHIAPAS,TAPACHULA,4,185,1,190,1429
CHIAPAS,TAPACHULA,2,212,5,219,1151
CHIAPAS,TAPACHULA,11,174,9,194,1150
CHIAPAS,TAPACHULA,11,197,4,212,1299
CHIAPAS,TAPACHULA,6,171,3,180,1299
CHIAPAS,TAPACHULA,10,187,8,205,1449
CHIAPAS,TAPACHULA,12,172,13,197,1448
CHIAPAS,TAPACHULA,9,201,9,219,1606
CHIAPAS,TAPACHULA,12,194,7,213,1605
CHIAPAS,TAPACHULA,12,134,8,154,1227
CHIAPAS,TAPACHULA,6,132,4,142,1227
CHIAPAS,TAPACHULA,14,524,13,551,2127
CHIAPAS,TAPACHULA,4,497,27,528,2127
CHIAPAS,TAPACHULA,19,460,16,495,1510
CHIAPAS,TAPACHULA,8,1088,11,1107,1509
CHIAPAS,TAPACHULA,15,474,7,496,1637
CHIAPAS,TAPACHULA,14,482,13,509,1637
CHIAPAS,TAPACHULA,16,358,3,377,1642
CHIAPAS,TAPACHULA,19,359,1,379,1641
CHIAPAS,TAPACHULA,14,308,4,326,1641
CHIAPAS,TAPACHULA,12,219,9,240,1627
CHIAPAS,TAPACHULA,15,192,7,214,1626
CHIAPAS,TAPACHULA,14,225,5,244,1236
CHIAPAS,TAPACHULA,3,207,14,224,1235
CHIAPAS,TAPACHULA,16,270,4,290,1757
CHIAPAS,TAPACHULA,14,239,3,256,1757
CHIAPAS,TAPACHULA,14,243,3,260,1757
CHIAPAS,TAPACHULA,27,332,6,365,1768
CHIAPAS,TAPACHULA,18,376,5,399,1768
CHIAPAS,TAPACHULA,21,326,5,352,1767
CHIAPAS,TAPACHULA,12,225,1,238,1319
CHIAPAS,TAPACHULA,2,267,6,275,1318
CHIAPAS,TAPACHULA,6,312,3,321,1940
CHIAPAS,TAPACHULA,10,306,2,318,1940
CHIAPAS,TAPACHULA,17,275,9,301,1635
CHIAPAS,TAPACHULA,10,239,12,261,1635
CHIAPAS,TAPACHULA,7,174,3,184,1207
CHIAPAS,TAPACHULA,8,171,11,190,1206
CHIAPAS,TAPACHULA,11,409,6,426,2014
CHIAPAS,HUEHUETAN,14,295,13,322,1765
CHIAPAS,HUEHUETAN,20,283,12,315,1765
CHIAPAS,HUEHUETAN,17,426,10,453,1936
CHIAPAS,HUEHUETAN,8,401,20,429,1936
CHIAPAS,HUEHUETAN,10,616,21,647,1835
CHIAPAS,HUEHUETAN,14,652,25,691,1835
CHIAPAS,HUEHUETAN,19,501,28,548,2147
CHIAPAS,HUEHUETAN,26,532,25,583,2147
CHIAPAS,HUEHUETAN,17,387,10,414,1440
CHIAPAS,HUEHUETAN,9,374,9,392,1440
CHIAPAS,HUEHUETAN,5,268,11,284,1453
CHIAPAS,HUEHUETAN,5,271,7,283,1452
CHIAPAS,HUEHUETAN,4,212,7,223,1452
CHIAPAS,HUEHUETAN,58,386,11,455,2029
CHIAPAS,HUEHUETAN,12,515,11,538,2051
CHIAPAS,HUEHUETAN,10,380,13,403,1462
CHIAPAS,HUEHUETAN,20,338,12,370,1462
CHIAPAS,HUEHUETAN,9,298,12,319,1817
CHIAPAS,HUEHUETAN,5,207,4,216,1684
CHIAPAS,HUEHUETAN,8,212,3,223,1683
CHIAPAS,HUEHUETAN,14,344,5,363,1857
CHIAPAS,HUEHUETAN,20,459,16,495,2054
CHIAPAS,HUEHUETAN,20,381,7,408,2053
CHIAPAS,HUEHUETAN,8,232,10,250,1466
CHIAPAS,HUEHUETAN,14,225,10,249,1466
CHIAPAS,HUEHUETAN,7,299,15,321,1718
CHIAPAS,HUEHUETAN,0,268,11,279,1717
CHIAPAS,HUEHUETAN,11,226,6,243,1969
CHIAPAS,HUEHUETAN,4,200,4,208,1969
CHIAPAS,HUEHUETAN,10,168,16,194,2062
CHIAPAS,HUEHUETAN,19,142,18,179,2062
CHIAPAS,HUEHUETAN,20,124,6,150,1518
CHIAPAS,HUEHUETAN,25,122,15,162,1518
CHIAPAS,HUEHUETAN,20,342,14,376,2020
CHIAPAS,HUEHUETAN,11,104,9,124,1945
CHIAPAS,HUEHUETAN,9,134,10,153,1945
CHIAPAS,HUEHUETAN,14,314,18,346,2152
CHIAPAS,HUEHUETAN,17,465,9,491,1848
CHIAPAS,HUEHUETAN,19,486,11,516,1847
CHIAPAS,HUEHUETAN,10,240,3,253,1926
CHIAPAS,HUEHUETAN,21,223,5,249,1926
CHIAPAS,HUEHUETAN,6,256,7,269,1926
CHIAPAS,HUEHUETAN,13,361,11,385,1338
CHIAPAS,HUEHUETAN,11,343,12,366,1337
CHIAPAS,HUEHUETAN,18,443,5,466,1511
CHIAPAS,HUEHUETAN,13,415,20,448,1511
CHIAPAS,HUEHUETAN,16,443,2,461,1634
CHIAPAS,HUEHUETAN,3,249,3,255,1224
CHIAPAS,HUEHUETAN,7,302,7,316,1224
CHIAPAS,HUEHUETAN,13,320,12,345,1479
CHIAPAS,HUEHUETAN,10,306,12,328,1479
CHIAPAS,HUEHUETAN,12,310,13,335,1479
CHIAPAS,HUEHUETAN,10,438,6,454,1954
CHIAPAS,HUEHUETAN,15,468,9,492,1954
CHIAPAS,HUEHUETAN,17,349,6,372,1512
CHIAPAS,HUEHUETAN,12,330,10,352,1511
CHIAPAS,HUEHUETAN,10,368,5,383,1240
CHIAPAS,HUEHUETAN,9,329,3,341,1240
CHIAPAS,HUEHUETAN,25,699,17,741,0
CHIAPAS,HUEHUETAN,26,610,16,652,2161
CHIAPAS,HUEHUETAN,12,325,5,342,1687
CHIAPAS,HUEHUETAN,14,336,10,360,1686
CHIAPAS,HUEHUETAN,24,985,7,1016,1462
CHIAPAS,HUEHUETAN,93,940,7,1040,1461
CHIAPAS,HUEHUETAN,16,362,0,378,1177
CHIAPAS,HUEHUETAN,5,375,3,383,1177
CHIAPAS,HUEHUETAN,21,362,5,388,1287
CHIAPAS,HUEHUETAN,11,353,0,364,1286
CHIAPAS,HUEHUETAN,3,323,3,329,1196
CHIAPAS,HUEHUETAN,13,324,3,340,1196
CHIAPAS,HUEHUETAN,17,656,6,679,2053
CHIAPAS,HUEHUETAN,10,364,2,376,1547
CHIAPAS,HUEHUETAN,11,387,6,404,1546
CHIAPAS,HUEHUETAN,11,423,4,438,1453
CHIAPAS,HUEHUETAN,9,381,6,396,1452
CHIAPAS,HUEHUETAN,11,458,3,472,1452
CHIAPAS,HUEHUETAN,14,422,4,440,1410
CHIAPAS,HUEHUETAN,6,449,5,460,1410
CHIAPAS,HUEHUETAN,24,516,57,597,1935
CHIAPAS,HUEHUETAN,9,332,2,343,1935
CHIAPAS,HUEHUETAN,16,405,5,426,1935
CHIAPAS,HUEHUETAN,18,578,4,600,1351
CHIAPAS,HUEHUETAN,11,587,5,603,1351
CHIAPAS,HUEHUETAN,10,695,10,715,1988
CHIAPAS,HUEHUETAN,9,701,14,724,1988
CHIAPAS,HUEHUETAN,7,527,8,542,1488
CHIAPAS,HUEHUETAN,8,609,8,625,1487
CHIAPAS,HUEHUETAN,11,388,6,405,1361
CHIAPAS,HUEHUETAN,6,389,8,403,1360
CHIAPAS,HUEHUETAN,19,498,8,525,1991
CHIAPAS,HUEHUETAN,7,645,3,655,1478
CHIAPAS,HUEHUETAN,0,647,17,664,1477
CHIAPAS,HUEHUETAN,10,410,3,423,1896
CHIAPAS,HUEHUETAN,9,463,19,491,1895
CHIAPAS,HUEHUETAN,15,329,14,358,1435
CHIAPAS,HUEHUETAN,24,337,18,379,1435
CHIAPAS,HUEHUETAN,24,603,7,634,2138
CHIAPAS,HUEHUETAN,9,329,14,352,1158
CHIAPAS,HUEHUETAN,6,424,53,483,1157
CHIAPAS,HUEHUETAN,19,595,27,641,2166
CHIAPAS,HUEHUETAN,25,678,30,733,2166
CHIAPAS,HUEHUETAN,12,407,15,434,1357
CHIAPAS,HUEHUETAN,15,435,58,508,1357
CHIAPAS,HUEHUETAN,21,573,15,609,2013
CHIAPAS,HUEHUETAN,18,536,17,571,2013
CHIAPAS,HUEHUETAN,24,685,6,715,1997
CHIAPAS,HUEHUETAN,32,633,19,684,1997
CHIAPAS,HUEHUETAN,32,263,15,310,1773
CHIAPAS,HUEHUETAN,22,254,25,301,1772
CHIAPAS,HUEHUETAN,18,489,8,515,2040
CHIAPAS,HUEHUETAN,25,453,4,482,2039
CHIAPAS,HUEHUETAN,21,500,7,528,2039
CHIAPAS,HUEHUETAN,21,512,7,540,2039
CHIAPAS,HUEHUETAN,3,307,1,311,1762
CHIAPAS,HUEHUETAN,10,356,10,376,1762
CHIAPAS,HUEHUETAN,1,333,0,334,1761
CHIAPAS,HUEHUETAN,4,375,17,396,1761
CHIAPAS,HUEHUETAN,6,256,6,268,1761
CHIAPAS,HUEHUETAN,14,465,4,483,1860
CHIAPAS,HUEHUETAN,6,412,8,426,1860
CHIAPAS,HUEHUETAN,4,515,15,534,1860
CHIAPAS,HUEHUETAN,10,460,7,477,1860
CHIAPAS,HUEHUETAN,10,448,6,464,1859
CHIAPAS,HUEHUETAN,2,140,2,144,1401
CHIAPAS,HUEHUETAN,4,116,3,123,1401
CHIAPAS,HUEHUETAN,88,385,62,535,1748
CHIAPAS,HUEHUETAN,48,487,78,613,1748
CHIAPAS,HUEHUETAN,8,80,11,99,1493
CHIAPAS,HUEHUETAN,19,89,5,113,1492
CHIAPAS,HUEHUETAN,3,104,13,120,1094
CHIAPAS,HUEHUETAN,10,112,16,138,1094
CHIAPAS,HUEHUETAN,18,183,23,224,1099
CHIAPAS,HUEHUETAN,26,178,20,224,1098
CHIAPAS,HUEHUETAN,24,257,16,297,1860
CHIAPAS,HUEHUETAN,22,257,18,297,1860
CHIAPAS,HUEHUETAN,17,536,20,573,1441
CHIAPAS,HUEHUETAN,20,448,32,500,1441
CHIAPAS,HUEHUETAN,10,202,13,225,1882
CHIAPAS,HUEHUETAN,5,200,15,220,1881
CHIAPAS,HUEHUETAN,5,176,15,196,1881
CHIAPAS,HUEHUETAN,15,326,4,345,1649
CHIAPAS,HUEHUETAN,18,386,4,408,1648
CHIAPAS,HUEHUETAN,5,202,1,208,1643
CHIAPAS,HUEHUETAN,12,171,5,188,1643
CHIAPAS,HUEHUETAN,16,215,9,240,1325
CHIAPAS,HUEHUETAN,14,197,7,218,1324
CHIAPAS,HUEHUETAN,18,309,7,334,1837
CHIAPAS,HUEHUETAN,9,279,13,301,1837
CHIAPAS,HUEHUETAN,10,274,17,301,1716
CHIAPAS,HUEHUETAN,18,262,4,284,1716
CHIAPAS,HUEHUETAN,10,377,7,394,1733
CHIAPAS,HUEHUETAN,3,284,4,291,1386
CHIAPAS,HUEHUETAN,8,233,11,252,1385
CHIAPAS,HUEHUETAN,13,311,13,337,1939
CHIAPAS,HUEHUETAN,11,259,7,277,1938
CHIAPAS,HUEHUETAN,15,268,9,292,1334
CHIAPAS,HUEHUETAN,6,258,7,271,1334
CHIAPAS,HUEHUETAN,22,479,15,516,2061
CHIAPAS,HUEHUETAN,11,496,6,513,1838
CHIAPAS,HUEHUETAN,18,472,16,506,1837
CHIAPAS,HUEHUETAN,17,327,4,348,2036
CHIAPAS,HUEHUETAN,14,288,9,311,1978
CHIAPAS,HUEHUETAN,10,262,6,278,1978
CHIAPAS,HUEHUETAN,6,271,8,285,1914
CHIAPAS,HUEHUETAN,17,220,8,245,1562
CHIAPAS,HUEHUETAN,16,120,3,139,1561
CHIAPAS,HUEHUETAN,8,169,3,180,1949
CHIAPAS,HUEHUETAN,14,199,4,217,1948
CHIAPAS,HUEHUETAN,5,478,8,491,1548
CHIAPAS,HUEHUETAN,7,397,3,407,1548
CHIHUAHUA,JUAREZ,11,243,2,256,1790
CHIHUAHUA,JUAREZ,15,211,4,230,1789
CHIHUAHUA,JUAREZ,12,278,2,292,1772
CHIHUAHUA,JUAREZ,16,280,2,298,1772
CHIHUAHUA,JUAREZ,21,327,2,350,2010
CHIHUAHUA,JUAREZ,29,360,7,396,2009
CHIHUAHUA,JUAREZ,5,252,3,260,1474
CHIHUAHUA,JUAREZ,4,192,1,197,1473
CHIHUAHUA,JUAREZ,5,195,3,203,1473
CHIHUAHUA,JUAREZ,14,267,4,285,1837
CHIHUAHUA,JUAREZ,8,231,2,241,1837
CHIHUAHUA,JUAREZ,16,237,3,256,1836
CHIHUAHUA,JUAREZ,19,297,3,319,1939
CHIHUAHUA,JUAREZ,12,259,2,273,1938
CHIHUAHUA,JUAREZ,10,182,0,192,1331
CHIHUAHUA,JUAREZ,14,154,0,168,1330
CHIHUAHUA,JUAREZ,7,204,3,214,1365
CHIHUAHUA,JUAREZ,11,217,3,231,1365
CHIHUAHUA,JUAREZ,12,269,1,282,1943
CHIHUAHUA,JUAREZ,10,282,3,295,1942
CHIHUAHUA,JUAREZ,15,298,4,317,1876
CHIHUAHUA,JUAREZ,12,293,1,306,1876
CHIHUAHUA,JUAREZ,9,278,7,294,1876
CHIHUAHUA,JUAREZ,7,180,3,190,1176
CHIHUAHUA,JUAREZ,7,183,1,191,1175
CHIHUAHUA,JUAREZ,4,221,0,225,1527
CHIHUAHUA,JUAREZ,5,212,5,222,1527
CHIHUAHUA,JUAREZ,6,233,0,239,1527
CHIHUAHUA,JUAREZ,7,211,1,219,1498
CHIHUAHUA,JUAREZ,11,193,3,207,1498
CHIHUAHUA,JUAREZ,5,215,4,224,1497
CHIHUAHUA,JUAREZ,12,291,0,303,1883
CHIHUAHUA,JUAREZ,15,321,6,342,1882
CHIHUAHUA,JUAREZ,7,195,2,204,1508
CHIHUAHUA,JUAREZ,11,217,4,232,1508
CHIHUAHUA,JUAREZ,10,270,9,289,1538
CHIHUAHUA,JUAREZ,9,213,0,222,1537
CHIHUAHUA,JUAREZ,11,212,1,224,1362
CHIHUAHUA,JUAREZ,9,225,2,236,1361
CHIHUAHUA,JUAREZ,19,261,1,281,1891
CHIHUAHUA,JUAREZ,25,273,0,298,1891
CHIHUAHUA,JUAREZ,8,212,5,225,1250
CHIHUAHUA,JUAREZ,10,200,5,215,1249
CHIHUAHUA,JUAREZ,19,248,1,268,1784
CHIHUAHUA,JUAREZ,25,284,6,315,1783
CHIHUAHUA,JUAREZ,14,272,2,288,1783
CHIHUAHUA,JUAREZ,17,241,9,267,1754
CHIHUAHUA,JUAREZ,11,245,2,258,1754
CHIHUAHUA,JUAREZ,14,248,0,262,1754
CHIHUAHUA,JUAREZ,15,258,2,275,1754
CHIHUAHUA,JUAREZ,15,246,0,261,1754
CHIHUAHUA,JUAREZ,24,315,0,339,1962
CHIHUAHUA,JUAREZ,21,331,0,352,1962
CHIHUAHUA,JUAREZ,22,251,1,274,1788
CHIHUAHUA,JUAREZ,11,248,1,260,1788
CHIHUAHUA,JUAREZ,10,158,0,168,1215
CHIHUAHUA,JUAREZ,12,171,0,183,1214
CHIHUAHUA,JUAREZ,11,221,1,233,1563
CHIHUAHUA,JUAREZ,9,202,1,212,1563
CHIHUAHUA,JUAREZ,21,292,2,315,1895
CHIHUAHUA,JUAREZ,18,320,1,339,1895
CHIHUAHUA,JUAREZ,15,285,0,300,1898
CHIHUAHUA,JUAREZ,0,309,0,309,1897
CHIHUAHUA,JUAREZ,10,240,3,253,1897
CHIHUAHUA,JUAREZ,3,193,1,197,1407
CHIHUAHUA,JUAREZ,4,216,4,224,1407
CHIHUAHUA,JUAREZ,5,205,6,216,1406
CHIHUAHUA,JUAREZ,18,273,2,293,1904
CHIHUAHUA,JUAREZ,8,263,1,272,1904
CHIHUAHUA,JUAREZ,10,229,0,239,1677
CHIHUAHUA,JUAREZ,14,257,1,272,1676
CHIHUAHUA,JUAREZ,12,268,2,282,1891
CHIHUAHUA,JUAREZ,14,228,0,242,1890
CHIHUAHUA,JUAREZ,7,230,0,237,1636
CHIHUAHUA,JUAREZ,6,284,1,291,1636
CHIHUAHUA,JUAREZ,14,263,1,278,1636
CHIHUAHUA,JUAREZ,10,225,1,236,1609
CHIHUAHUA,JUAREZ,3,217,2,222,1609
CHIHUAHUA,JUAREZ,15,238,1,254,1609
CHIHUAHUA,JUAREZ,11,305,0,316,1922
CHIHUAHUA,JUAREZ,4,327,0,331,1921
CHIHUAHUA,JUAREZ,18,254,1,273,1692
CHIHUAHUA,JUAREZ,17,240,1,258,1692
CHIHUAHUA,JUAREZ,12,235,0,247,1691
CHIHUAHUA,JUAREZ,17,243,0,260,1523
CHIHUAHUA,JUAREZ,9,260,0,269,1522
CHIHUAHUA,JUAREZ,6,278,1,285,1999
CHIHUAHUA,JUAREZ,6,291,0,297,1999
CHIHUAHUA,JUAREZ,4,307,1,312,1998
CHIHUAHUA,JUAREZ,11,273,2,286,1998
CHIHUAHUA,JUAREZ,9,293,0,302,1722
CHIHUAHUA,JUAREZ,10,338,3,351,1722
CHIHUAHUA,JUAREZ,2,298,2,302,1721
CHIHUAHUA,JUAREZ,2,291,3,296,1721
CHIHUAHUA,JUAREZ,2,178,7,187,1412
CHIHUAHUA,JUAREZ,6,185,2,193,1412
CHIHUAHUA,JUAREZ,4,199,4,207,1412
CHIHUAHUA,JUAREZ,4,251,3,258,1727
CHIHUAHUA,JUAREZ,5,240,2,247,1727
CHIHUAHUA,JUAREZ,9,254,2,265,1772
CHIHUAHUA,JUAREZ,7,232,0,239,1771
CHIHUAHUA,JUAREZ,11,265,2,278,1933
CHIHUAHUA,JUAREZ,18,283,0,301,1933
CHIHUAHUA,JUAREZ,14,206,3,223,1360
CHIHUAHUA,JUAREZ,12,208,4,224,1360
CHIHUAHUA,JUAREZ,11,188,1,200,1359
CHIHUAHUA,JUAREZ,14,242,2,258,1583
CHIHUAHUA,JUAREZ,12,265,1,278,1583
CHIHUAHUA,JUAREZ,15,293,2,310,1913
CHIHUAHUA,JUAREZ,6,236,3,245,1913
CHIHUAHUA,JUAREZ,10,280,1,291,1857
CHIHUAHUA,JUAREZ,7,265,0,272,1857
CHIHUAHUA,JUAREZ,8,266,2,276,1944
CHIHUAHUA,JUAREZ,14,272,3,289,1944
CHIHUAHUA,JUAREZ,5,271,2,278,1944
CHIHUAHUA,JUAREZ,6,255,3,264,1944
CHIHUAHUA,JUAREZ,23,279,1,303,1914
CHIHUAHUA,JUAREZ,17,253,3,273,1913
CHIHUAHUA,JUAREZ,8,181,1,190,1444
CHIHUAHUA,JUAREZ,6,158,1,165,1444
CHIHUAHUA,JUAREZ,10,176,3,189,1444
CHIHUAHUA,JUAREZ,8,264,0,272,1970
CHIHUAHUA,JUAREZ,8,256,2,266,1970
CHIHUAHUA,JUAREZ,6,260,0,266,1969
CHIHUAHUA,JUAREZ,13,253,0,266,1969
CHIHUAHUA,JUAREZ,6,221,0,227,1969
CHIHUAHUA,JUAREZ,8,239,1,248,1969
CHIHUAHUA,JUAREZ,39,1141,9,1189,0
CHIHUAHUA,JUAREZ,4,143,0,147,1284
CHIHUAHUA,JUAREZ,12,169,1,182,1283
CHIHUAHUA,JUAREZ,12,247,1,260,1791
CHIHUAHUA,JUAREZ,9,280,0,289,1791
CHIHUAHUA,JUAREZ,13,206,1,220,1790
CHIHUAHUA,JUAREZ,8,186,0,194,1059
CHIHUAHUA,JUAREZ,7,170,1,178,1058
CHIHUAHUA,JUAREZ,13,368,1,382,2074
CHIHUAHUA,JUAREZ,9,361,0,370,2074
CHIHUAHUA,JUAREZ,9,309,1,319,2074
CHIHUAHUA,JUAREZ,5,367,1,373,2073
CHIHUAHUA,JUAREZ,8,327,3,338,2073
CHIHUAHUA,JUAREZ,9,337,0,346,2073
CHIHUAHUA,JUAREZ,10,289,9,308,2026
CHIHUAHUA,JUAREZ,9,305,0,314,2026
CHIHUAHUA,JUAREZ,9,346,1,356,2026
CHIHUAHUA,JUAREZ,3,270,0,273,2026
CHIHUAHUA,JUAREZ,11,339,2,352,2025
CHIHUAHUA,JUAREZ,10,284,0,294,1816
CHIHUAHUA,JUAREZ,8,255,2,265,1816
CHIHUAHUA,JUAREZ,7,249,2,258,1815
CHIHUAHUA,JUAREZ,5,245,5,255,1815
CHIHUAHUA,JUAREZ,22,292,1,315,1734
CHIHUAHUA,JUAREZ,15,272,5,292,1734
CHIHUAHUA,JUAREZ,9,274,2,285,1785
CHIHUAHUA,JUAREZ,13,287,2,302,1784
CHIHUAHUA,JUAREZ,18,256,2,276,1784
CHIHUAHUA,JUAREZ,4,266,0,270,2005
CHIHUAHUA,JUAREZ,10,309,2,321,2005
CHIHUAHUA,JUAREZ,5,303,0,308,2004
CHIHUAHUA,JUAREZ,11,296,1,308,2004
CHIHUAHUA,JUAREZ,10,308,2,320,2004
CHIHUAHUA,JUAREZ,2,284,1,287,2004
CHIHUAHUA,JUAREZ,2,293,2,297,2004
CHIHUAHUA,JUAREZ,8,225,0,233,2008
CHIHUAHUA,JUAREZ,7,235,0,242,2007
CHIHUAHUA,JUAREZ,5,247,2,254,2007
CHIHUAHUA,JUAREZ,3,245,4,252,2007
CHIHUAHUA,JUAREZ,2,214,4,220,1872
CHIHUAHUA,JUAREZ,2,231,1,234,1871
CHIHUAHUA,JUAREZ,2,144,4,150,1290
CHIHUAHUA,JUAREZ,6,109,33,148,1289
CHIHUAHUA,JUAREZ,6,214,0,220,1682
CHIHUAHUA,JUAREZ,5,234,0,239,1682
CHIHUAHUA,JUAREZ,1,214,2,217,1682
CHIHUAHUA,JUAREZ,7,209,0,216,2007
CHIHUAHUA,JUAREZ,3,244,0,247,2007
CHIHUAHUA,JUAREZ,0,254,1,255,2006
CHIHUAHUA,JUAREZ,2,198,1,201,2006
CHIHUAHUA,JUAREZ,3,236,1,240,2006
CHIHUAHUA,JUAREZ,3,195,1,199,1608
CHIHUAHUA,JUAREZ,6,180,1,187,1607
CHIHUAHUA,JUAREZ,3,834,0,837,1848
CHIHUAHUA,JUAREZ,4,233,1,238,1848
CHIHUAHUA,JUAREZ,8,198,1,207,1848
CHIHUAHUA,JUAREZ,7,236,2,245,1765
CHIHUAHUA,JUAREZ,4,257,4,265,1765
CHIHUAHUA,JUAREZ,1,217,0,218,1765
CHIHUAHUA,JUAREZ,2,243,0,245,1765
CHIHUAHUA,JUAREZ,3,215,2,220,1819
CHIHUAHUA,JUAREZ,4,209,1,214,1819
CHIHUAHUA,JUAREZ,2,142,0,144,1428
CHIHUAHUA,JUAREZ,0,130,1,131,1428
CHIHUAHUA,JUAREZ,3,132,1,136,1428
CHIHUAHUA,JUAREZ,14,193,7,214,1462
CHIHUAHUA,JUAREZ,5,158,3,166,1462
CHIHUAHUA,JUAREZ,3,166,10,179,1461
CHIHUAHUA,JUAREZ,4,150,7,161,1461
CHIHUAHUA,JUAREZ,15,406,9,430,1839
CHIHUAHUA,JUAREZ,18,359,8,385,1839
CHIHUAHUA,JUAREZ,12,200,6,218,1775
CHIHUAHUA,JUAREZ,8,157,1,166,1774
CHIHUAHUA,JUAREZ,7,228,7,242,1975
CHIHUAHUA,JUAREZ,8,205,2,215,1975
CHIHUAHUA,JUAREZ,6,234,2,242,1916
CHIHUAHUA,JUAREZ,14,201,4,219,1916
CHIHUAHUA,JUAREZ,13,142,7,162,1702
CHIHUAHUA,JUAREZ,9,161,4,174,1701
CHIHUAHUA,JUAREZ,0,123,4,127,1326
CHIHUAHUA,JUAREZ,4,100,1,105,1325
CHIHUAHUA,JUAREZ,2,143,5,150,1325
CHIHUAHUA,JUAREZ,12,83,8,103,1752
CHIHUAHUA,JUAREZ,9,87,3,99,1752
CHIHUAHUA,JUAREZ,5,108,4,117,1752
CHIHUAHUA,JUAREZ,9,97,2,108,1752
CHIHUAHUA,JUAREZ,18,111,1,130,1751
CHIHUAHUA,JUAREZ,8,241,14,263,1887
CHIHUAHUA,JUAREZ,5,235,6,246,1887
CHIHUAHUA,JUAREZ,8,226,7,241,1887
CHIHUAHUA,JUAREZ,4,261,2,267,1886
CHIHUAHUA,JUAREZ,6,188,3,197,1481
CHIHUAHUA,JUAREZ,3,175,9,187,1480
CHIHUAHUA,JUAREZ,9,217,2,228,2024
CHIHUAHUA,JUAREZ,12,225,7,244,2024
CHIHUAHUA,JUAREZ,11,230,2,243,2023
CHIHUAHUA,JUAREZ,6,177,3,186,1658
CHIHUAHUA,JUAREZ,10,164,1,175,1657
CHIHUAHUA,JUAREZ,3,173,3,179,993
CHIHUAHUA,JUAREZ,5,153,2,160,993
CHIHUAHUA,JUAREZ,14,155,7,176,1650
CHIHUAHUA,JUAREZ,9,108,3,120,1650
CHIHUAHUA,JUAREZ,17,140,5,162,1650
CHIHUAHUA,JUAREZ,6,288,9,303,1467
CHIHUAHUA,JUAREZ,8,255,7,270,1466
CHIHUAHUA,JUAREZ,8,282,9,299,1466
CHIHUAHUA,JUAREZ,8,418,13,439,1790
CHIHUAHUA,JUAREZ,10,371,9,390,1790
CHIHUAHUA,JUAREZ,17,354,14,385,1790
CHIHUAHUA,JUAREZ,22,283,6,311,1750
CHIHUAHUA,JUAREZ,30,252,6,288,1749
CHIHUAHUA,JUAREZ,3,98,0,101,1498
CHIHUAHUA,JUAREZ,5,100,1,106,1498
CHIHUAHUA,JUAREZ,8,113,11,132,1497
CHIHUAHUA,JUAREZ,4,185,6,195,1731
CHIHUAHUA,JUAREZ,10,197,5,212,1731
CHIHUAHUA,JUAREZ,4,204,2,210,1730
CHIHUAHUA,JUAREZ,7,199,1,207,1730
CHIHUAHUA,JUAREZ,12,184,2,198,1665
CHIHUAHUA,JUAREZ,11,189,2,202,1665
CHIHUAHUA,JUAREZ,8,228,2,238,1686
CHIHUAHUA,JUAREZ,7,217,3,227,1685
CHIHUAHUA,JUAREZ,10,204,3,217,1685
CHIHUAHUA,JUAREZ,5,149,2,156,1367
CHIHUAHUA,JUAREZ,11,155,4,170,1366
CHIHUAHUA,JUAREZ,7,120,0,127,1366
CHIHUAHUA,JUAREZ,9,172,4,185,1116
CHIHUAHUA,JUAREZ,9,180,4,193,1115
CHIHUAHUA,JUAREZ,10,249,7,266,1647
CHIHUAHUA,JUAREZ,8,285,2,295,1647
CHIHUAHUA,JUAREZ,10,245,3,258,1647
CHIHUAHUA,JUAREZ,3,252,6,261,1647
CHIHUAHUA,JUAREZ,11,273,2,286,1647
CHIHUAHUA,JUAREZ,6,207,1,214,1354
CHIHUAHUA,JUAREZ,5,152,2,159,1354
CHIHUAHUA,JUAREZ,4,177,2,183,1353
CHIHUAHUA,JUAREZ,10,247,0,257,1811
CHIHUAHUA,JUAREZ,9,220,6,235,1810
CHIHUAHUA,JUAREZ,8,224,3,235,1810
CHIHUAHUA,JUAREZ,7,188,4,199,1827
CHIHUAHUA,JUAREZ,9,176,1,186,1827
CHIHUAHUA,JUAREZ,13,207,1,221,1827
CHIHUAHUA,JUAREZ,7,190,1,198,1827
CHIHUAHUA,JUAREZ,11,185,1,197,1826
CHIHUAHUA,JUAREZ,13,200,3,216,1826
CHIHUAHUA,JUAREZ,9,208,1,218,1826
CHIHUAHUA,JUAREZ,21,263,3,287,1944
CHIHUAHUA,JUAREZ,24,293,3,320,1944
CHIHUAHUA,JUAREZ,29,764,9,802,0
CHIHUAHUA,JUAREZ,14,260,2,276,1612
CHIHUAHUA,JUAREZ,17,256,0,273,1611
CHIHUAHUA,JUAREZ,18,186,2,206,1668
CHIHUAHUA,JUAREZ,11,215,11,237,1668
CHIHUAHUA,JUAREZ,3,192,2,197,1327
CHIHUAHUA,JUAREZ,10,168,16,194,1327
CHIHUAHUA,JUAREZ,10,200,0,210,1327
CHIHUAHUA,JUAREZ,3,162,2,167,1339
CHIHUAHUA,JUAREZ,1,171,0,172,1338
CHIHUAHUA,JUAREZ,8,179,3,190,1338
CHIHUAHUA,JUAREZ,2,158,2,162,1848
CHIHUAHUA,JUAREZ,3,142,38,183,1848
CHIHUAHUA,JUAREZ,4,164,2,170,1847
CHIHUAHUA,JUAREZ,3,180,0,183,1847
CHIHUAHUA,JUAREZ,5,183,0,188,1847
CHIHUAHUA,JUAREZ,26,195,2,223,1898
CHIHUAHUA,JUAREZ,27,230,2,259,1897
CHIHUAHUA,JUAREZ,12,223,0,235,1967
CHIHUAHUA,JUAREZ,12,235,2,249,1967
CHIHUAHUA,JUAREZ,10,221,6,237,1896
CHIHUAHUA,JUAREZ,10,248,6,264,1896
CHIHUAHUA,JUAREZ,5,230,13,248,1896
CHIHUAHUA,JUAREZ,14,149,0,163,1407
CHIHUAHUA,JUAREZ,10,179,2,191,1406
CHIHUAHUA,JUAREZ,18,150,4,172,1406
CHIHUAHUA,JUAREZ,8,251,5,264,1534
CHIHUAHUA,JUAREZ,12,281,9,302,1533
CHIHUAHUA,JUAREZ,8,219,4,231,1891
CHIHUAHUA,JUAREZ,10,205,4,219,1891
CHIHUAHUA,JUAREZ,3,216,4,223,1583
CHIHUAHUA,JUAREZ,10,174,8,192,1582
CHIHUAHUA,JUAREZ,5,174,2,181,1582
CHIHUAHUA,JUAREZ,14,310,5,329,1664
CHIHUAHUA,JUAREZ,9,302,4,315,1663
CHIHUAHUA,JUAREZ,9,213,2,224,1898
CHIHUAHUA,JUAREZ,15,251,1,267,1898
CHIHUAHUA,JUAREZ,6,183,2,191,1400
CHIHUAHUA,JUAREZ,7,181,1,189,1400
CHIHUAHUA,JUAREZ,11,169,1,181,1400
CHIHUAHUA,JUAREZ,12,236,4,252,1835
CHIHUAHUA,JUAREZ,10,200,2,212,1835
CHIHUAHUA,JUAREZ,13,215,4,232,1835
CHIHUAHUA,JUAREZ,6,151,2,159,1433
CHIHUAHUA,JUAREZ,7,127,3,137,1433
CHIHUAHUA,JUAREZ,8,164,3,175,1432
CHIHUAHUA,JUAREZ,10,241,8,259,1775
CHIHUAHUA,JUAREZ,16,221,2,239,1774
CHIHUAHUA,JUAREZ,4,212,7,223,1774
CHIHUAHUA,JUAREZ,15,187,0,202,1628
CHIHUAHUA,JUAREZ,5,202,1,208,1628
CHIHUAHUA,JUAREZ,3,187,1,191,1628
CHIHUAHUA,JUAREZ,6,203,1,210,1792
CHIHUAHUA,JUAREZ,7,238,4,249,1792
CHIHUAHUA,JUAREZ,9,218,2,229,1501
CHIHUAHUA,JUAREZ,8,211,1,220,1501
CHIHUAHUA,JUAREZ,15,235,2,252,1501
CHIHUAHUA,JUAREZ,6,208,2,216,1917
CHIHUAHUA,JUAREZ,7,258,8,273,1916
CHIHUAHUA,JUAREZ,11,233,5,249,1746
CHIHUAHUA,JUAREZ,5,204,1,210,1746
CHIHUAHUA,JUAREZ,6,198,3,207,1745
CHIHUAHUA,JUAREZ,4,261,3,268,1553
CHIHUAHUA,JUAREZ,5,188,2,195,1552
CHIHUAHUA,JUAREZ,8,234,1,243,1862
CHIHUAHUA,JUAREZ,5,244,3,252,1862
CHIHUAHUA,JUAREZ,5,241,8,254,1862
CHIHUAHUA,JUAREZ,2,191,2,195,1391
CHIHUAHUA,JUAREZ,3,177,11,191,1390
CHIHUAHUA,JUAREZ,5,185,3,193,1390
CHIHUAHUA,JUAREZ,6,223,0,229,1793
CHIHUAHUA,JUAREZ,6,250,0,256,1793
CHIHUAHUA,JUAREZ,1,229,1,231,1792
CHIHUAHUA,JUAREZ,7,242,3,252,1792
CHIHUAHUA,JUAREZ,3,280,1,284,1881
CHIHUAHUA,JUAREZ,1,307,2,310,1881
CHIHUAHUA,JUAREZ,7,267,3,277,1881
CHIHUAHUA,JUAREZ,4,282,1,287,1881
CHIHUAHUA,JUAREZ,2,191,0,193,1762
CHIHUAHUA,JUAREZ,7,220,0,227,1762
CHIHUAHUA,JUAREZ,6,220,1,227,1762
CHIHUAHUA,JUAREZ,8,187,1,196,1761
CHIHUAHUA,JUAREZ,3,232,0,235,1761
CHIHUAHUA,JUAREZ,7,216,0,223,1761
CHIHUAHUA,JUAREZ,6,192,0,198,1845
CHIHUAHUA,JUAREZ,5,182,1,188,1845
CHIHUAHUA,JUAREZ,3,167,2,172,1845
CHIHUAHUA,JUAREZ,6,155,1,162,1845
CHIHUAHUA,JUAREZ,6,171,0,177,1845
CHIHUAHUA,JUAREZ,3,176,3,182,1844
CHIHUAHUA,JUAREZ,3,130,8,141,1709
CHIHUAHUA,JUAREZ,3,132,2,137,1709
CHIHUAHUA,JUAREZ,3,150,0,153,1709
CHIHUAHUA,JUAREZ,5,211,3,219,2029
CHIHUAHUA,JUAREZ,7,175,4,186,2029
CHIHUAHUA,JUAREZ,4,141,2,147,1513
CHIHUAHUA,JUAREZ,1,158,0,159,1513
CHIHUAHUA,JUAREZ,1,197,3,201,2046
CHIHUAHUA,JUAREZ,3,193,4,200,2045
CHIHUAHUA,JUAREZ,4,144,0,148,1689
CHIHUAHUA,JUAREZ,5,160,1,166,1689
CHIHUAHUA,JUAREZ,6,152,2,160,1745
CHIHUAHUA,JUAREZ,0,168,1,169,1744
CHIHUAHUA,JUAREZ,8,212,2,222,1888
CHIHUAHUA,JUAREZ,8,209,3,220,1887
CHIHUAHUA,JUAREZ,9,201,5,215,1887
CHIHUAHUA,JUAREZ,8,181,1,190,1324
CHIHUAHUA,JUAREZ,3,154,4,161,1323
CHIHUAHUA,JUAREZ,4,148,0,152,1323
CHIHUAHUA,JUAREZ,5,137,1,143,1361
CHIHUAHUA,JUAREZ,2,146,1,149,1360
CHIHUAHUA,JUAREZ,8,241,0,249,1415
CHIHUAHUA,JUAREZ,6,182,2,190,1415
CHIHUAHUA,JUAREZ,8,150,0,158,1415
CHIHUAHUA,JUAREZ,4,157,0,161,1259
CHIHUAHUA,JUAREZ,4,163,1,168,1258
CHIHUAHUA,JUAREZ,5,163,2,170,1849
CHIHUAHUA,JUAREZ,8,171,0,179,1848
CHIHUAHUA,JUAREZ,6,130,1,137,1506
CHIHUAHUA,JUAREZ,5,158,2,165,1506
CHIHUAHUA,JUAREZ,9,124,0,133,1505
CHIHUAHUA,JUAREZ,11,182,3,196,1782
CHIHUAHUA,JUAREZ,11,182,3,196,1781
CHIHUAHUA,JUAREZ,7,216,1,224,1781
CHIHUAHUA,JUAREZ,4,283,8,295,1855
CHIHUAHUA,JUAREZ,1,89,2,92,1855
CHIHUAHUA,JUAREZ,2,121,0,123,1077
CHIHUAHUA,JUAREZ,2,130,5,137,1076
CHIHUAHUA,JUAREZ,13,215,3,231,1963
CHIHUAHUA,JUAREZ,4,238,2,244,1963
CHIHUAHUA,JUAREZ,4,127,0,131,1643
CHIHUAHUA,JUAREZ,4,148,1,153,1643
CHIHUAHUA,JUAREZ,3,130,0,133,1642
CHIHUAHUA,JUAREZ,7,116,2,125,1642
CHIHUAHUA,JUAREZ,2,127,1,130,1642
CHIHUAHUA,JUAREZ,11,184,0,195,1438
CHIHUAHUA,JUAREZ,6,180,5,191,1437
CHIHUAHUA,JUAREZ,3,171,3,177,1437
CHIHUAHUA,JUAREZ,7,178,1,186,1936
CHIHUAHUA,JUAREZ,6,189,2,197,1935
CHIHUAHUA,JUAREZ,9,129,0,138,1480
CHIHUAHUA,JUAREZ,3,155,0,158,1479
CHIHUAHUA,JUAREZ,7,135,5,147,1479
CHIHUAHUA,JUAREZ,6,223,5,234,1942
CHIHUAHUA,JUAREZ,4,255,3,262,1941
CHIHUAHUA,JUAREZ,11,226,5,242,1782
CHIHUAHUA,JUAREZ,4,228,4,236,1781
CHIHUAHUA,JUAREZ,7,208,5,220,1953
CHIHUAHUA,JUAREZ,5,268,5,278,1953
CHIHUAHUA,JUAREZ,12,219,7,238,1788
CHIHUAHUA,JUAREZ,9,250,3,262,1787
CHIHUAHUA,JUAREZ,7,224,7,238,1656
CHIHUAHUA,JUAREZ,5,227,4,236,1655
CHIHUAHUA,JUAREZ,5,159,4,168,1935
CHIHUAHUA,JUAREZ,8,190,5,203,1935
CHIHUAHUA,JUAREZ,5,236,2,243,1954
CHIHUAHUA,JUAREZ,5,230,3,238,1953
CHIHUAHUA,JUAREZ,6,282,7,295,1743
CHIHUAHUA,JUAREZ,6,240,1,247,1743
CHIHUAHUA,JUAREZ,7,267,4,278,1821
CHIHUAHUA,JUAREZ,4,280,4,288,1821
CHIHUAHUA,JUAREZ,13,394,2,409,0
CHIHUAHUA,JUAREZ,5,177,5,187,1543
CHIHUAHUA,JUAREZ,3,179,4,186,1543
CHIHUAHUA,JUAREZ,7,181,5,193,1542
CHIHUAHUA,JUAREZ,5,174,1,180,1453
CHIHUAHUA,JUAREZ,3,183,3,189,1453
CHIHUAHUA,JUAREZ,2,177,0,179,1452
CHIHUAHUA,JUAREZ,4,170,5,179,1715
CHIHUAHUA,JUAREZ,4,178,0,182,1715
CHIHUAHUA,JUAREZ,5,180,2,187,1715
CHIHUAHUA,JUAREZ,17,275,0,292,1819
CHIHUAHUA,JUAREZ,19,278,0,297,1818
CHIHUAHUA,JUAREZ,4,207,3,214,1554
CHIHUAHUA,JUAREZ,3,183,2,188,1553
CHIHUAHUA,JUAREZ,7,176,5,188,1553
CHIHUAHUA,JUAREZ,7,207,0,214,1525
CHIHUAHUA,JUAREZ,17,195,1,213,1525
CHIHUAHUA,JUAREZ,15,206,1,222,1525
CHIHUAHUA,JUAREZ,9,285,1,295,1945
CHIHUAHUA,JUAREZ,10,258,2,270,1945
CHIHUAHUA,JUAREZ,8,302,1,311,1945
CHIHUAHUA,JUAREZ,6,147,1,154,1504
CHIHUAHUA,JUAREZ,4,144,1,149,1504
CHIHUAHUA,JUAREZ,8,146,2,156,1784
CHIHUAHUA,JUAREZ,14,128,2,144,1784
CHIHUAHUA,JUAREZ,10,180,4,194,1784
CHIHUAHUA,JUAREZ,10,147,2,159,1784
CHIHUAHUA,JUAREZ,15,269,1,285,1945
CHIHUAHUA,JUAREZ,8,235,5,248,1944
CHIHUAHUA,JUAREZ,6,183,1,190,1590
CHIHUAHUA,JUAREZ,8,158,0,166,1590
CHIHUAHUA,JUAREZ,6,207,2,215,1639
CHIHUAHUA,JUAREZ,2,181,3,186,1639
CHIHUAHUA,JUAREZ,5,205,5,215,1639
CHIHUAHUA,JUAREZ,13,163,1,177,1543
CHIHUAHUA,JUAREZ,6,196,1,203,1542
CHIHUAHUA,JUAREZ,11,205,7,223,1542
CHIHUAHUA,JUAREZ,11,176,4,191,1370
CHIHUAHUA,JUAREZ,6,195,7,208,1370
CHIHUAHUA,JUAREZ,7,140,1,148,1370
CHIHUAHUA,JUAREZ,12,210,6,228,1829
CHIHUAHUA,JUAREZ,7,165,4,176,1829
CHIHUAHUA,JUAREZ,8,196,4,208,1828
CHIHUAHUA,JUAREZ,11,247,3,261,1884
CHIHUAHUA,JUAREZ,11,202,3,216,1884
CHIHUAHUA,JUAREZ,7,157,3,167,1377
CHIHUAHUA,JUAREZ,5,164,3,172,1376
CHIHUAHUA,JUAREZ,9,164,1,174,1376
CHIHUAHUA,JUAREZ,7,129,2,138,1256
CHIHUAHUA,JUAREZ,8,181,2,191,1256
CHIHUAHUA,JUAREZ,5,190,4,199,1501
CHIHUAHUA,JUAREZ,6,259,4,269,1501
CHIHUAHUA,JUAREZ,10,219,1,230,1812
CHIHUAHUA,JUAREZ,6,194,4,204,1812
CHIHUAHUA,JUAREZ,8,142,6,156,1412
CHIHUAHUA,JUAREZ,1,136,2,139,1412
CHIHUAHUA,JUAREZ,0,126,0,126,1412
CHIHUAHUA,JUAREZ,10,250,7,267,1825
CHIHUAHUA,JUAREZ,7,236,5,248,1825
CHIHUAHUA,JUAREZ,5,188,1,194,1945
CHIHUAHUA,JUAREZ,4,187,0,191,1944
CHIHUAHUA,JUAREZ,6,200,0,206,1588
CHIHUAHUA,JUAREZ,7,192,0,199,1587
CHIHUAHUA,JUAREZ,16,189,6,211,1587
CHIHUAHUA,JUAREZ,5,162,1,168,1309
CHIHUAHUA,JUAREZ,0,152,1,153,1309
CHIHUAHUA,JUAREZ,4,281,2,287,1935
CHIHUAHUA,JUAREZ,9,262,3,274,1934
CHIHUAHUA,JUAREZ,6,335,6,347,1966
CHIHUAHUA,JUAREZ,5,339,3,347,1966
CHIHUAHUA,JUAREZ,6,303,1,310,1965
CHIHUAHUA,JUAREZ,3,169,0,172,1160
CHIHUAHUA,JUAREZ,1,163,2,166,1160
CHIHUAHUA,JUAREZ,15,253,4,272,1722
CHIHUAHUA,JUAREZ,7,222,2,231,1721
CHIHUAHUA,JUAREZ,3,234,5,242,1932
CHIHUAHUA,JUAREZ,10,247,4,261,1931
CHIHUAHUA,JUAREZ,2,205,3,210,1368
CHIHUAHUA,JUAREZ,8,185,1,194,1368
CHIHUAHUA,JUAREZ,7,248,6,261,1965
CHIHUAHUA,JUAREZ,10,237,3,250,1964
CHIHUAHUA,JUAREZ,4,164,2,170,1053
CHIHUAHUA,JUAREZ,4,175,1,180,1052
CHIHUAHUA,JUAREZ,0,206,2,208,1360
CHIHUAHUA,JUAREZ,23,206,4,233,1360
CHIHUAHUA,JUAREZ,7,279,4,290,1871
CHIHUAHUA,JUAREZ,13,290,3,306,1870
CHIHUAHUA,JUAREZ,12,226,3,241,1721
CHIHUAHUA,JUAREZ,16,189,2,207,1721
CHIHUAHUA,JUAREZ,10,213,3,226,1691
CHIHUAHUA,JUAREZ,18,212,3,233,1690
CHIHUAHUA,JUAREZ,4,161,0,165,1150
CHIHUAHUA,JUAREZ,6,143,3,152,1150
CHIHUAHUA,JUAREZ,8,268,3,279,1791
CHIHUAHUA,JUAREZ,8,323,1,332,1790
CHIHUAHUA,JUAREZ,9,231,3,243,1790
CHIHUAHUA,JUAREZ,5,176,0,181,1265
CHIHUAHUA,JUAREZ,7,171,5,183,1265
CHIHUAHUA,JUAREZ,5,142,1,148,1024
CHIHUAHUA,JUAREZ,3,154,3,160,1024
CHIHUAHUA,JUAREZ,11,253,2,266,1897
CHIHUAHUA,JUAREZ,19,223,1,243,1896
CHIHUAHUA,JUAREZ,2,193,1,196,1689
CHIHUAHUA,JUAREZ,5,192,1,198,1688
CHIHUAHUA,JUAREZ,4,204,5,213,1688
CHIHUAHUA,JUAREZ,6,169,0,175,1198
CHIHUAHUA,JUAREZ,3,167,2,172,1198
CHIHUAHUA,JUAREZ,7,183,2,192,1310
CHIHUAHUA,JUAREZ,5,179,1,185,1310
CHIHUAHUA,JUAREZ,10,153,1,164,1663
CHIHUAHUA,JUAREZ,4,168,1,173,1663
CHIHUAHUA,JUAREZ,7,177,3,187,1663
CHIHUAHUA,JUAREZ,4,155,3,162,1156
CHIHUAHUA,JUAREZ,1,146,1,148,1156
CHIHUAHUA,JUAREZ,11,199,0,210,1695
CHIHUAHUA,JUAREZ,17,196,1,214,1695
CHIHUAHUA,JUAREZ,12,194,1,207,1695
CHIHUAHUA,JUAREZ,7,234,4,245,1516
CHIHUAHUA,JUAREZ,18,218,0,236,1516
CHIHUAHUA,JUAREZ,10,224,0,234,1669
CHIHUAHUA,JUAREZ,5,231,0,236,1669
CHIHUAHUA,JUAREZ,9,215,0,224,1572
CHIHUAHUA,JUAREZ,9,245,2,256,1571
CHIHUAHUA,JUAREZ,6,207,1,214,1571
CHIHUAHUA,JUAREZ,13,250,2,265,1759
CHIHUAHUA,JUAREZ,19,247,2,268,1758
CHIHUAHUA,JUAREZ,18,175,0,193,1666
CHIHUAHUA,JUAREZ,32,201,1,234,1666
CHIHUAHUA,JUAREZ,35,154,3,192,1744
CHIHUAHUA,JUAREZ,29,161,1,191,1744
CHIHUAHUA,JUAREZ,20,159,4,183,1466
CHIHUAHUA,JUAREZ,16,166,2,184,1465
CHIHUAHUA,JUAREZ,18,151,0,169,1465
CHIHUAHUA,JUAREZ,19,152,4,175,1687
CHIHUAHUA,JUAREZ,29,185,2,216,1686
CHIHUAHUA,JUAREZ,23,258,3,284,1899
CHIHUAHUA,JUAREZ,27,250,3,280,1898
CHIHUAHUA,JUAREZ,24,167,4,195,1768
CHIHUAHUA,JUAREZ,22,152,0,174,1767
CHIHUAHUA,JUAREZ,17,185,2,204,1493
CHIHUAHUA,JUAREZ,16,202,1,219,1492
CHIHUAHUA,JUAREZ,16,162,0,178,1492
CHIHUAHUA,JUAREZ,14,202,0,216,1956
CHIHUAHUA,JUAREZ,10,178,3,191,1955
CHIHUAHUA,JUAREZ,15,230,0,245,1481
CHIHUAHUA,JUAREZ,15,193,7,215,1480
CHIHUAHUA,JUAREZ,28,137,0,165,1508
CHIHUAHUA,JUAREZ,30,131,1,162,1507
CHIHUAHUA,JUAREZ,25,162,0,187,1507
CHIHUAHUA,JUAREZ,18,200,1,219,1639
CHIHUAHUA,JUAREZ,26,183,3,212,1639
CHIHUAHUA,JUAREZ,21,189,1,211,1638
CHIHUAHUA,JUAREZ,17,141,0,158,1327
CHIHUAHUA,JUAREZ,18,140,1,159,1326
CHIHUAHUA,JUAREZ,27,137,4,168,1326
CHIHUAHUA,JUAREZ,26,146,3,175,1475
CHIHUAHUA,JUAREZ,15,155,0,170,1474
CHIHUAHUA,JUAREZ,32,162,0,194,1867
CHIHUAHUA,JUAREZ,25,172,1,198,1866
CHIHUAHUA,JUAREZ,13,147,2,162,1544
CHIHUAHUA,JUAREZ,11,147,2,160,1544
CHIHUAHUA,JUAREZ,9,157,1,167,1544
CHIHUAHUA,JUAREZ,17,160,0,177,1758
CHIHUAHUA,JUAREZ,19,169,1,189,1757
CHIHUAHUA,JUAREZ,22,129,1,152,1948
CHIHUAHUA,JUAREZ,16,154,1,171,1947
CHIHUAHUA,JUAREZ,20,92,0,112,1562
CHIHUAHUA,JUAREZ,23,108,1,132,1561
CHIHUAHUA,JUAREZ,24,79,1,104,1329
CHIHUAHUA,JUAREZ,25,78,0,103,1328
CHIHUAHUA,JUAREZ,16,85,3,104,1328
CHIHUAHUA,JUAREZ,31,114,2,147,1815
CHIHUAHUA,JUAREZ,33,121,1,155,1815
CHIHUAHUA,JUAREZ,35,110,1,146,1815
CHIHUAHUA,JUAREZ,31,133,0,164,1814
CHIHUAHUA,JUAREZ,26,158,3,187,1779
CHIHUAHUA,JUAREZ,29,148,1,178,1779
CHIHUAHUA,JUAREZ,20,174,2,196,1763
CHIHUAHUA,JUAREZ,22,155,0,177,1762
CHIHUAHUA,JUAREZ,18,115,0,133,1079
CHIHUAHUA,JUAREZ,7,134,3,144,1078
CHIHUAHUA,JUAREZ,33,182,1,216,1911
CHIHUAHUA,JUAREZ,28,177,3,208,1910
CHIHUAHUA,JUAREZ,18,124,0,142,1321
CHIHUAHUA,JUAREZ,21,143,2,166,1321
CHIHUAHUA,JUAREZ,13,154,0,167,1320
CHIHUAHUA,JUAREZ,17,195,1,213,1746
CHIHUAHUA,JUAREZ,12,197,4,213,1746
CHIHUAHUA,JUAREZ,17,112,0,129,1404
CHIHUAHUA,JUAREZ,22,119,0,141,1404
CHIHUAHUA,JUAREZ,19,173,1,193,1919
CHIHUAHUA,JUAREZ,18,185,3,206,1918
CHIHUAHUA,JUAREZ,27,166,0,193,1995
CHIHUAHUA,JUAREZ,40,151,1,192,1994
CHIHUAHUA,JUAREZ,21,126,0,147,1994
CHIHUAHUA,JUAREZ,34,173,1,208,1994
CHIHUAHUA,JUAREZ,34,128,6,168,1994
CHIHUAHUA,JUAREZ,36,151,0,187,1994
CHIHUAHUA,JUAREZ,20,216,0,236,1915
CHIHUAHUA,JUAREZ,26,205,1,232,1914
CHIHUAHUA,JUAREZ,11,132,0,143,1348
CHIHUAHUA,JUAREZ,7,153,3,163,1347
CHIHUAHUA,JUAREZ,8,146,0,154,1347
CHIHUAHUA,JUAREZ,28,130,1,159,1563
CHIHUAHUA,JUAREZ,16,132,0,148,1563
CHIHUAHUA,JUAREZ,29,128,1,158,1563
CHIHUAHUA,JUAREZ,21,119,1,141,1563
CHIHUAHUA,JUAREZ,20,246,3,269,1837
CHIHUAHUA,JUAREZ,23,283,5,311,1837
CHIHUAHUA,JUAREZ,21,219,0,240,1861
CHIHUAHUA,JUAREZ,26,171,0,197,1860
CHIHUAHUA,JUAREZ,32,183,3,218,1852
CHIHUAHUA,JUAREZ,30,164,0,194,1852
CHIHUAHUA,JUAREZ,28,155,1,184,1851
CHIHUAHUA,JUAREZ,28,160,2,190,1996
CHIHUAHUA,JUAREZ,27,169,0,196,1996
CHIHUAHUA,JUAREZ,23,170,0,193,1996
CHIHUAHUA,JUAREZ,27,169,3,199,1996
CHIHUAHUA,JUAREZ,14,130,0,144,1273
CHIHUAHUA,JUAREZ,17,120,1,138,1273
CHIHUAHUA,JUAREZ,11,197,2,210,1739
CHIHUAHUA,JUAREZ,11,194,0,205,1739
CHIHUAHUA,JUAREZ,20,332,3,355,1965
CHIHUAHUA,JUAREZ,14,204,6,224,1500
CHIHUAHUA,JUAREZ,13,212,3,228,1500
CHIHUAHUA,JUAREZ,23,299,1,323,1808
CHIHUAHUA,JUAREZ,16,300,1,317,1808
CHIHUAHUA,JUAREZ,15,201,2,218,1311
CHIHUAHUA,JUAREZ,11,178,3,192,1310
CHIHUAHUA,JUAREZ,22,121,0,143,1180
CHIHUAHUA,JUAREZ,21,113,0,134,1179
CHIHUAHUA,JUAREZ,17,203,1,221,1794
CHIHUAHUA,JUAREZ,26,210,5,241,1793
CHIHUAHUA,JUAREZ,23,186,3,212,1793
CHIHUAHUA,JUAREZ,31,161,3,195,1864
CHIHUAHUA,JUAREZ,24,154,1,179,1864
CHIHUAHUA,JUAREZ,22,175,1,198,1864
CHIHUAHUA,JUAREZ,17,219,3,239,1871
CHIHUAHUA,JUAREZ,13,242,3,258,1871
CHIHUAHUA,JUAREZ,10,179,1,190,2138
CHIHUAHUA,JUAREZ,126,1176,12,1314,0
CHIHUAHUA,JUAREZ,25,119,1,145,1541
CHIHUAHUA,JUAREZ,23,134,0,157,1541
CHIHUAHUA,JUAREZ,22,100,1,123,1540
CHIHUAHUA,JUAREZ,22,258,3,283,1750
CHIHUAHUA,JUAREZ,12,284,1,297,1750
CHIHUAHUA,JUAREZ,18,175,0,193,1485
CHIHUAHUA,JUAREZ,13,125,3,141,1485
CHIHUAHUA,JUAREZ,15,227,1,243,1517
CHIHUAHUA,JUAREZ,19,188,5,212,1516
CHIHUAHUA,JUAREZ,7,189,1,197,1516
CHIHUAHUA,JUAREZ,16,183,1,200,1646
CHIHUAHUA,JUAREZ,14,191,0,205,1646
CHIHUAHUA,JUAREZ,0,197,1,198,1646
CHIHUAHUA,JUAREZ,16,186,0,202,1646
CHIHUAHUA,JUAREZ,10,253,2,265,1511
CHIHUAHUA,JUAREZ,10,240,1,251,1510
CHIHUAHUA,JUAREZ,2,235,5,242,1510
CHIHUAHUA,JUAREZ,1,157,8,166,1419
CHIHUAHUA,JUAREZ,5,176,2,183,1419
CHIHUAHUA,JUAREZ,11,145,0,156,1419
CHIHUAHUA,JUAREZ,12,197,1,210,1674
CHIHUAHUA,JUAREZ,10,193,0,203,1673
CHIHUAHUA,JUAREZ,26,185,0,211,1892
CHIHUAHUA,JUAREZ,16,181,1,198,1892
CHIHUAHUA,JUAREZ,22,212,1,235,1891
CHIHUAHUA,JUAREZ,17,197,0,214,1891
CHIHUAHUA,JUAREZ,22,207,1,230,1891
CHIHUAHUA,JUAREZ,13,173,3,189,1814
CHIHUAHUA,JUAREZ,8,197,1,206,1814
CHIHUAHUA,JUAREZ,6,188,3,197,1813
CHIHUAHUA,JUAREZ,10,195,0,205,1826
CHIHUAHUA,JUAREZ,14,194,1,209,1826
CHIHUAHUA,JUAREZ,13,232,4,249,1601
CHIHUAHUA,JUAREZ,16,242,1,259,1601
CHIHUAHUA,JUAREZ,13,226,4,243,1601
CHIHUAHUA,JUAREZ,13,176,2,191,1048
CHIHUAHUA,JUAREZ,14,149,2,165,1048
CHIHUAHUA,JUAREZ,11,250,2,263,1535
CHIHUAHUA,JUAREZ,18,264,1,283,1535
CHIHUAHUA,JUAREZ,15,243,3,261,1534
CHIHUAHUA,JUAREZ,6,181,2,189,1699
CHIHUAHUA,JUAREZ,6,192,5,203,1699
CHIHUAHUA,JUAREZ,9,202,6,217,1699
CHIHUAHUA,JUAREZ,8,164,4,176,1452
CHIHUAHUA,JUAREZ,10,129,2,141,1452
CHIHUAHUA,JUAREZ,8,134,1,143,1451
CHIHUAHUA,JUAREZ,7,169,2,178,1452
CHIHUAHUA,JUAREZ,6,156,4,166,1452
CHIHUAHUA,JUAREZ,8,154,4,166,1452
CHIHUAHUA,JUAREZ,10,153,4,167,1552
CHIHUAHUA,JUAREZ,4,157,2,163,1552
CHIHUAHUA,JUAREZ,8,170,1,179,1552
CHIHUAHUA,JUAREZ,10,208,0,218,1764
CHIHUAHUA,JUAREZ,14,163,1,178,1763
CHIHUAHUA,JUAREZ,5,182,4,191,1763
CHIHUAHUA,JUAREZ,12,191,1,204,1395
CHIHUAHUA,JUAREZ,11,155,4,170,1395
CHIHUAHUA,JUAREZ,13,206,0,219,1646
CHIHUAHUA,JUAREZ,9,236,2,247,1646
CHIHUAHUA,JUAREZ,10,203,3,216,1381
CHIHUAHUA,JUAREZ,11,192,2,205,1381
CHIHUAHUA,JUAREZ,8,209,3,220,1658
CHIHUAHUA,JUAREZ,14,182,1,197,1657
CHIHUAHUA,JUAREZ,9,242,1,252,1533
CHIHUAHUA,JUAREZ,4,231,2,237,1533
CHIHUAHUA,JUAREZ,11,160,2,173,1331
CHIHUAHUA,JUAREZ,11,145,2,158,1330
CHIHUAHUA,JUAREZ,9,140,1,150,1330
CHIHUAHUA,JUAREZ,6,215,3,224,1817
CHIHUAHUA,JUAREZ,5,215,1,221,1816
CHIHUAHUA,JUAREZ,12,281,4,297,1875
CHIHUAHUA,JUAREZ,15,309,2,326,1875
CHIHUAHUA,JUAREZ,7,161,0,168,1398
CHIHUAHUA,JUAREZ,4,160,4,168,1398
CHIHUAHUA,JUAREZ,3,177,3,183,1397
CHIHUAHUA,JUAREZ,8,278,2,288,1928
CHIHUAHUA,JUAREZ,13,290,1,304,1928
CHIHUAHUA,JUAREZ,8,265,2,275,1560
CHIHUAHUA,JUAREZ,8,247,5,260,1559
CHIHUAHUA,JUAREZ,4,235,3,242,1403
CHIHUAHUA,JUAREZ,7,210,1,218,1402
CHIHUAHUA,JUAREZ,9,207,1,217,1402
CHIHUAHUA,JUAREZ,8,162,2,172,1307
CHIHUAHUA,JUAREZ,8,147,0,155,1307
CHIHUAHUA,JUAREZ,9,227,3,239,1693
CHIHUAHUA,JUAREZ,3,217,1,221,1693
CHIHUAHUA,JUAREZ,4,112,0,116,1057
CHIHUAHUA,JUAREZ,11,102,0,113,1057
CHIHUAHUA,JUAREZ,12,292,3,307,1901
CHIHUAHUA,JUAREZ,12,300,10,322,1900
CHIHUAHUA,JUAREZ,5,278,2,285,1633
CHIHUAHUA,JUAREZ,4,242,10,256,1632
CHIHUAHUA,JUAREZ,5,182,3,190,1312
CHIHUAHUA,JUAREZ,7,153,3,163,1312
CHIHUAHUA,JUAREZ,49,191,0,240,1919
CHIHUAHUA,JUAREZ,36,177,0,213,1918
CHIHUAHUA,DELICIAS,14,135,5,154,1760
CHIHUAHUA,DELICIAS,8,145,0,153,1759
CHIHUAHUA,DELICIAS,12,129,2,143,1759
CHIHUAHUA,DELICIAS,15,175,2,192,1638
CHIHUAHUA,DELICIAS,7,182,2,191,1638
CHIHUAHUA,DELICIAS,10,173,5,188,1637
CHIHUAHUA,DELICIAS,11,233,2,246,1671
CHIHUAHUA,DELICIAS,16,213,4,233,1670
CHIHUAHUA,DELICIAS,11,226,2,239,1837
CHIHUAHUA,DELICIAS,14,244,4,262,1837
CHIHUAHUA,DELICIAS,5,94,1,100,1030
CHIHUAHUA,DELICIAS,5,72,3,80,1029
CHIHUAHUA,DELICIAS,8,54,0,62,1681
CHIHUAHUA,DELICIAS,10,63,0,73,1681
CHIHUAHUA,DELICIAS,7,58,0,65,1681
CHIHUAHUA,DELICIAS,5,56,1,62,1681
CHIHUAHUA,DELICIAS,12,53,4,69,1680
CHIHUAHUA,DELICIAS,4,60,1,65,1680
CHIHUAHUA,DELICIAS,2,55,2,59,1680
CHIHUAHUA,DELICIAS,29,131,3,163,1845
CHIHUAHUA,DELICIAS,29,165,1,195,1845
CHIHUAHUA,DELICIAS,33,132,2,167,1844
CHIHUAHUA,DELICIAS,23,80,0,103,1595
CHIHUAHUA,DELICIAS,19,90,2,111,1595
CHIHUAHUA,DELICIAS,16,107,0,123,1594
CHIHUAHUA,DELICIAS,23,112,3,138,1784
CHIHUAHUA,DELICIAS,22,129,1,152,1783
CHIHUAHUA,DELICIAS,24,91,0,115,1748
CHIHUAHUA,DELICIAS,13,79,0,92,1747
CHIHUAHUA,DELICIAS,13,81,2,96,1825
CHIHUAHUA,DELICIAS,12,79,0,91,1824
CHIHUAHUA,DELICIAS,15,70,1,86,1508
CHIHUAHUA,DELICIAS,17,78,0,95,1507
CHIHUAHUA,DELICIAS,9,92,1,102,1836
CHIHUAHUA,DELICIAS,8,85,1,94,1836
CHIHUAHUA,DELICIAS,13,100,2,115,1835
CHIHUAHUA,DELICIAS,12,116,1,129,1623
CHIHUAHUA,DELICIAS,20,110,1,131,1623
CHIHUAHUA,DELICIAS,11,99,3,113,1623
CHIHUAHUA,DELICIAS,9,76,0,85,1783
CHIHUAHUA,DELICIAS,17,92,0,109,1783
CHIHUAHUA,DELICIAS,6,118,2,126,1308
CHIHUAHUA,DELICIAS,5,114,0,119,1308
CHIHUAHUA,DELICIAS,13,54,3,70,1597
CHIHUAHUA,DELICIAS,13,57,3,73,1597
CHIHUAHUA,DELICIAS,19,48,3,70,1596
CHIHUAHUA,DELICIAS,22,212,4,238,1934
CHIHUAHUA,DELICIAS,15,218,4,237,1933
CHIHUAHUA,DELICIAS,13,204,2,219,1736
CHIHUAHUA,DELICIAS,17,218,2,237,1735
CHIHUAHUA,DELICIAS,23,197,2,222,1735
CHIHUAHUA,DELICIAS,17,142,1,160,1851
CHIHUAHUA,DELICIAS,22,132,2,156,1851
CHIHUAHUA,DELICIAS,12,202,7,221,1886
CHIHUAHUA,DELICIAS,21,166,4,191,1886
CHIHUAHUA,DELICIAS,16,157,3,176,1885
CHIHUAHUA,DELICIAS,9,139,0,148,1885
CHIHUAHUA,DELICIAS,9,183,2,194,1885
CHIHUAHUA,DELICIAS,21,244,4,269,1988
CHIHUAHUA,DELICIAS,23,167,5,195,1688
CHIHUAHUA,DELICIAS,17,154,1,172,1688
CHIHUAHUA,DELICIAS,20,136,5,161,1790
CHIHUAHUA,DELICIAS,22,123,0,145,1790
CHIHUAHUA,DELICIAS,22,153,3,178,1737
CHIHUAHUA,DELICIAS,32,159,3,194,1737
CHIHUAHUA,DELICIAS,33,169,0,202,1974
CHIHUAHUA,DELICIAS,30,176,2,208,1973
CHIHUAHUA,DELICIAS,27,174,2,203,1973
CHIHUAHUA,DELICIAS,10,112,0,122,1655
CHIHUAHUA,DELICIAS,16,111,2,129,1654
CHIHUAHUA,DELICIAS,13,145,1,159,1263
CHIHUAHUA,DELICIAS,9,154,4,167,1263
CHIHUAHUA,DELICIAS,23,159,4,186,1569
CHIHUAHUA,DELICIAS,15,134,2,151,1568
CHIHUAHUA,DELICIAS,12,163,1,176,1731
CHIHUAHUA,DELICIAS,23,181,1,205,1730
CHIHUAHUA,DELICIAS,8,216,12,236,1744
CHIHUAHUA,DELICIAS,10,231,8,249,1743
CHIHUAHUA,DELICIAS,9,162,1,172,1809
CHIHUAHUA,DELICIAS,10,152,2,164,1809
CHIHUAHUA,DELICIAS,14,118,2,134,1809
CHIHUAHUA,DELICIAS,4,153,2,159,1808
CHIHUAHUA,DELICIAS,8,156,4,168,1808
CHIHUAHUA,DELICIAS,41,319,3,363,0
CHIHUAHUA,DELICIAS,13,137,3,153,1112
CHIHUAHUA,DELICIAS,7,158,2,167,1112
CHIHUAHUA,DELICIAS,12,136,2,150,1338
CHIHUAHUA,DELICIAS,6,143,1,150,1338
CHIHUAHUA,DELICIAS,9,137,3,149,1338
CHIHUAHUA,DELICIAS,9,209,0,218,1959
CHIHUAHUA,DELICIAS,12,217,5,234,1958
CHIHUAHUA,DELICIAS,12,161,4,177,1867
CHIHUAHUA,DELICIAS,21,141,2,164,1867
CHIHUAHUA,DELICIAS,6,142,3,151,1867
CHIHUAHUA,DELICIAS,10,178,1,189,1378
CHIHUAHUA,DELICIAS,4,157,3,164,1377
CHIHUAHUA,DELICIAS,11,60,29,100,1596
CHIHUAHUA,DELICIAS,5,129,3,137,1596
CHIHUAHUA,DELICIAS,6,101,0,107,1595
CHIHUAHUA,DELICIAS,8,106,3,117,1419
CHIHUAHUA,DELICIAS,3,87,4,94,1419
CHIHUAHUA,DELICIAS,7,62,1,70,1418
CHIHUAHUA,DELICIAS,8,138,4,150,1497
CHIHUAHUA,DELICIAS,13,151,2,166,1497
CHIHUAHUA,DELICIAS,11,161,6,178,1496
CHIHUAHUA,DELICIAS,13,104,2,119,1838
CHIHUAHUA,DELICIAS,9,76,1,86,1838
CHIHUAHUA,DELICIAS,9,90,0,99,1837
CHIHUAHUA,DELICIAS,14,187,4,205,1884
CHIHUAHUA,DELICIAS,8,167,6,181,1884
CHIHUAHUA,DELICIAS,13,154,4,171,1884
CHIHUAHUA,DELICIAS,13,134,1,148,1086
CHIHUAHUA,DELICIAS,15,123,2,140,1085
CHIHUAHUA,DELICIAS,17,214,3,234,1815
CHIHUAHUA,DELICIAS,17,212,3,232,1815
CHIHUAHUA,DELICIAS,20,257,7,284,1761
CHIHUAHUA,DELICIAS,17,232,4,253,1761
CHIHUAHUA,DELICIAS,17,268,3,288,1761
CHIHUAHUA,DELICIAS,12,122,0,134,1554
CHIHUAHUA,DELICIAS,15,128,1,144,1554
CHIHUAHUA,DELICIAS,5,128,0,133,1553
CHIHUAHUA,DELICIAS,16,180,4,200,1599
CHIHUAHUA,DELICIAS,14,195,4,213,1599
CHIHUAHUA,DELICIAS,11,200,3,214,1599
CHIHUAHUA,DELICIAS,16,189,7,212,1686
CHIHUAHUA,DELICIAS,27,165,4,196,1686
CHIHUAHUA,DELICIAS,12,78,4,94,1320
CHIHUAHUA,DELICIAS,4,108,4,116,1320
CHIHUAHUA,DELICIAS,10,78,1,89,1436
CHIHUAHUA,DELICIAS,11,66,6,83,1435
CHIHUAHUA,DELICIAS,7,85,3,95,1050
CHIHUAHUA,DELICIAS,6,87,4,97,1049
CHIHUAHUA,DELICIAS,17,135,2,154,1516
CHIHUAHUA,DELICIAS,11,125,1,137,1516
CHIHUAHUA,DELICIAS,12,141,4,157,1581
CHIHUAHUA,DELICIAS,16,167,1,184,1581
CHIHUAHUA,DELICIAS,18,146,4,168,1797
CHIHUAHUA,DELICIAS,12,0,6,18,1796
CHIHUAHUA,DELICIAS,13,176,3,192,1796
CHIHUAHUA,DELICIAS,17,179,3,199,1967
CHIHUAHUA,DELICIAS,23,187,7,217,1967
CHIHUAHUA,DELICIAS,22,106,3,131,1338
CHIHUAHUA,DELICIAS,13,121,2,136,1337
CHIHUAHUA,DELICIAS,13,116,2,131,1337
CHIHUAHUA,DELICIAS,28,93,2,123,1869
CHIHUAHUA,DELICIAS,17,89,1,107,1868
CHIHUAHUA,DELICIAS,19,102,1,122,1961
CHIHUAHUA,DELICIAS,9,115,1,125,1961
CHIHUAHUA,DELICIAS,12,60,1,73,1492
CHIHUAHUA,DELICIAS,9,54,1,64,1491
CHIHUAHUA,DELICIAS,11,73,3,87,1491
CHIHUAHUA,DELICIAS,10,52,1,63,1772
CHIHUAHUA,DELICIAS,28,91,3,122,1624
CHIHUAHUA,DELICIAS,22,95,2,119,1624
CHIHUAHUA,DELICIAS,12,57,4,73,1016
CHIHUAHUA,DELICIAS,6,63,2,71,1015
CHIHUAHUA,DELICIAS,14,112,3,129,1838
CHIHUAHUA,DELICIAS,15,100,0,115,1838
CHIHUAHUA,DELICIAS,10,84,2,96,1594
CHIHUAHUA,DELICIAS,9,89,4,102,1594
CHIHUAHUA,DELICIAS,6,77,1,84,1593
CHIHUAHUA,DELICIAS,12,113,4,129,1977
CHIHUAHUA,DELICIAS,17,135,2,154,1976
CHIHUAHUA,DELICIAS,12,65,1,78,1614
CHIHUAHUA,DELICIAS,10,87,2,99,1614
CHIHUAHUA,DELICIAS,6,56,2,64,1610
CHIHUAHUA,DELICIAS,6,86,1,93,1610
CHIHUAHUA,DELICIAS,11,80,7,98,1609
CHIHUAHUA,DELICIAS,2,21,2,25,1064
CHIHUAHUA,DELICIAS,8,11,1,20,1063
CHIHUAHUA,DELICIAS,10,120,8,138,1687
CHIHUAHUA,DELICIAS,12,93,2,107,1687
CHIHUAHUA,DELICIAS,9,106,3,118,1687
CHIHUAHUA,DELICIAS,4,110,2,116,1422
CHIHUAHUA,DELICIAS,5,90,1,96,1422
CHIHUAHUA,DELICIAS,14,120,2,136,1355
CHIHUAHUA,DELICIAS,13,123,2,138,1355
CHIHUAHUA,DELICIAS,19,200,3,222,1284
CHIHUAHUA,DELICIAS,17,182,2,201,1283
CHIHUAHUA,DELICIAS,26,177,4,207,1672
CHIHUAHUA,DELICIAS,15,216,3,234,1671
CHIHUAHUA,DELICIAS,12,173,6,191,1771
CHIHUAHUA,DELICIAS,24,208,3,235,1771
CHIHUAHUA,DELICIAS,5,119,3,127,1710
CHIHUAHUA,DELICIAS,13,134,1,148,1710
CHIHUAHUA,DELICIAS,17,93,3,113,1885
CHIHUAHUA,DELICIAS,7,114,2,123,1884
CHIHUAHUA,DELICIAS,8,109,0,117,1884
CHIHUAHUA,DELICIAS,5,95,1,101,1884
CHIHUAHUA,DELICIAS,17,370,2,389,1799
CHIHUAHUA,DELICIAS,11,382,5,398,1799
CHIHUAHUA,DELICIAS,9,119,7,135,1456
CHIHUAHUA,DELICIAS,5,122,5,132,1455
CHIHUAHUA,DELICIAS,15,122,1,138,1551
CHIHUAHUA,DELICIAS,13,95,4,112,1550
CHIHUAHUA,DELICIAS,11,83,0,94,1327
CHIHUAHUA,DELICIAS,6,93,1,100,1327
CHIHUAHUA,DELICIAS,12,80,0,92,1326
CHIHUAHUA,DELICIAS,16,138,4,158,1584
CHIHUAHUA,DELICIAS,10,168,2,180,1584
CHIHUAHUA,DELICIAS,7,179,3,189,1584
CHIHUAHUA,DELICIAS,33,164,2,199,1920
CHIHUAHUA,DELICIAS,17,188,2,207,1919
CHIHUAHUA,DELICIAS,22,145,1,168,1960
CHIHUAHUA,DELICIAS,14,164,0,178,1959
CHIHUAHUA,CHIHUAHUA,8,170,8,186,1862
CHIHUAHUA,CHIHUAHUA,7,185,8,200,1861
CHIHUAHUA,CHIHUAHUA,10,139,2,151,1662
CHIHUAHUA,CHIHUAHUA,16,123,8,147,1662
CHIHUAHUA,CHIHUAHUA,8,119,3,130,1661
CHIHUAHUA,CHIHUAHUA,21,165,2,188,1897
CHIHUAHUA,CHIHUAHUA,14,161,1,176,1897
CHIHUAHUA,CHIHUAHUA,25,208,8,241,1896
CHIHUAHUA,CHIHUAHUA,24,203,2,229,1895
CHIHUAHUA,CHIHUAHUA,32,156,2,190,1851
CHIHUAHUA,CHIHUAHUA,48,138,2,188,1850
CHIHUAHUA,CHIHUAHUA,48,72,0,120,1904
CHIHUAHUA,CHIHUAHUA,53,85,0,138,1903
CHIHUAHUA,CHIHUAHUA,32,141,0,173,1789
CHIHUAHUA,CHIHUAHUA,53,118,1,172,1789
CHIHUAHUA,CHIHUAHUA,32,144,2,178,1543
CHIHUAHUA,CHIHUAHUA,34,127,1,162,1542
CHIHUAHUA,CHIHUAHUA,27,149,4,180,1542
CHIHUAHUA,CHIHUAHUA,26,145,0,171,1542
CHIHUAHUA,CHIHUAHUA,22,81,0,103,1367
CHIHUAHUA,CHIHUAHUA,29,105,1,135,1367
CHIHUAHUA,CHIHUAHUA,37,77,0,114,1367
CHIHUAHUA,CHIHUAHUA,10,53,1,64,1544
CHIHUAHUA,CHIHUAHUA,16,54,0,70,1543
CHIHUAHUA,CHIHUAHUA,130,834,10,974,0
CHIHUAHUA,CHIHUAHUA,27,138,1,166,1439
CHIHUAHUA,CHIHUAHUA,29,135,1,165,1439
CHIHUAHUA,CHIHUAHUA,21,138,0,159,1439
CHIHUAHUA,CHIHUAHUA,22,123,2,147,1256
CHIHUAHUA,CHIHUAHUA,23,116,0,139,1256
CHIHUAHUA,CHIHUAHUA,18,190,2,210,1729
CHIHUAHUA,CHIHUAHUA,21,191,0,212,1729
CHIHUAHUA,CHIHUAHUA,24,164,4,192,1683
CHIHUAHUA,CHIHUAHUA,21,194,4,219,1683
CHIHUAHUA,CHIHUAHUA,43,128,0,171,1429
CHIHUAHUA,CHIHUAHUA,31,108,2,141,1429
CHIHUAHUA,CHIHUAHUA,24,152,1,177,1525
CHIHUAHUA,CHIHUAHUA,39,122,2,163,1524
CHIHUAHUA,CHIHUAHUA,25,184,5,214,1954
CHIHUAHUA,CHIHUAHUA,24,186,2,212,1954
CHIHUAHUA,CHIHUAHUA,14,124,1,139,1423
CHIHUAHUA,CHIHUAHUA,8,137,3,148,1422
CHIHUAHUA,CHIHUAHUA,7,121,3,131,1422
CHIHUAHUA,CHIHUAHUA,13,124,0,137,1404
CHIHUAHUA,CHIHUAHUA,11,96,1,108,1404
CHIHUAHUA,CHIHUAHUA,17,132,1,150,1362
CHIHUAHUA,CHIHUAHUA,13,128,0,141,1361
CHIHUAHUA,CHIHUAHUA,21,139,2,162,1825
CHIHUAHUA,CHIHUAHUA,23,120,0,143,1825
CHIHUAHUA,CHIHUAHUA,20,126,6,152,1825
CHIHUAHUA,CHIHUAHUA,16,105,0,121,1825
CHIHUAHUA,CHIHUAHUA,22,125,1,148,1824
CHIHUAHUA,CHIHUAHUA,17,127,1,145,1824
CHIHUAHUA,CHIHUAHUA,20,130,1,151,1824
CHIHUAHUA,CHIHUAHUA,22,135,1,158,1824
CHIHUAHUA,CHIHUAHUA,22,111,2,135,1824
CHIHUAHUA,CHIHUAHUA,30,109,1,140,1608
CHIHUAHUA,CHIHUAHUA,29,143,3,175,1608
CHIHUAHUA,CHIHUAHUA,30,135,2,167,1608
CHIHUAHUA,CHIHUAHUA,21,173,7,201,2012
CHIHUAHUA,CHIHUAHUA,13,193,3,209,2011
CHIHUAHUA,CHIHUAHUA,31,113,1,145,2009
CHIHUAHUA,CHIHUAHUA,23,111,0,134,2009
CHIHUAHUA,CHIHUAHUA,32,104,0,136,2009
CHIHUAHUA,CHIHUAHUA,29,126,0,155,2009
CHIHUAHUA,CHIHUAHUA,38,106,3,147,2008
CHIHUAHUA,CHIHUAHUA,30,105,0,135,2008
CHIHUAHUA,CHIHUAHUA,17,177,1,195,1799
CHIHUAHUA,CHIHUAHUA,14,145,3,162,1798
CHIHUAHUA,CHIHUAHUA,34,85,0,119,1610
CHIHUAHUA,CHIHUAHUA,38,80,2,120,1610
CHIHUAHUA,CHIHUAHUA,27,67,0,94,1610
CHIHUAHUA,CHIHUAHUA,42,69,0,111,1609
CHIHUAHUA,CHIHUAHUA,30,212,8,250,1839
CHIHUAHUA,CHIHUAHUA,18,186,3,207,1838
CHIHUAHUA,CHIHUAHUA,24,215,2,241,1796
CHIHUAHUA,CHIHUAHUA,26,194,3,223,1795
CHIHUAHUA,CHIHUAHUA,23,226,1,250,1800
CHIHUAHUA,CHIHUAHUA,18,237,2,257,1799
CHIHUAHUA,CHIHUAHUA,30,225,6,261,1922
CHIHUAHUA,CHIHUAHUA,35,243,6,284,1922
CHIHUAHUA,CHIHUAHUA,27,200,1,228,1740
CHIHUAHUA,CHIHUAHUA,22,187,2,211,1740
CHIHUAHUA,CHIHUAHUA,20,163,2,185,1622
CHIHUAHUA,CHIHUAHUA,23,170,3,196,1621
CHIHUAHUA,CHIHUAHUA,31,179,0,210,1621
CHIHUAHUA,CHIHUAHUA,30,216,3,249,1925
CHIHUAHUA,CHIHUAHUA,24,180,2,206,1925
CHIHUAHUA,CHIHUAHUA,7,138,0,145,1362
CHIHUAHUA,CHIHUAHUA,18,127,1,146,1361
CHIHUAHUA,CHIHUAHUA,9,125,0,134,1361
CHIHUAHUA,CHIHUAHUA,33,201,2,236,1911
CHIHUAHUA,CHIHUAHUA,43,205,1,249,1911
CHIHUAHUA,CHIHUAHUA,27,150,0,177,1532
CHIHUAHUA,CHIHUAHUA,24,141,1,166,1531
CHIHUAHUA,CHIHUAHUA,19,139,3,161,1531
CHIHUAHUA,CHIHUAHUA,36,165,1,202,1624
CHIHUAHUA,CHIHUAHUA,38,140,3,181,1624
CHIHUAHUA,CHIHUAHUA,30,150,2,182,1624
CHIHUAHUA,CHIHUAHUA,23,176,2,201,1930
CHIHUAHUA,CHIHUAHUA,40,172,4,216,1930
CHIHUAHUA,CHIHUAHUA,51,124,1,176,1924
CHIHUAHUA,CHIHUAHUA,33,122,3,158,1923
CHIHUAHUA,CHIHUAHUA,24,62,0,86,1665
CHIHUAHUA,CHIHUAHUA,33,67,1,101,1665
CHIHUAHUA,CHIHUAHUA,35,56,1,92,1664
CHIHUAHUA,CHIHUAHUA,34,58,0,92,1664
CHIHUAHUA,CHIHUAHUA,29,151,1,181,1495
CHIHUAHUA,CHIHUAHUA,33,163,2,198,1495
CHIHUAHUA,CHIHUAHUA,107,28,1,136,1534
CHIHUAHUA,CHIHUAHUA,44,105,2,151,1533
CHIHUAHUA,CHIHUAHUA,35,114,1,150,1484
CHIHUAHUA,CHIHUAHUA,39,112,2,153,1484
CHIHUAHUA,CHIHUAHUA,41,121,4,166,1484
CHIHUAHUA,CHIHUAHUA,50,127,1,178,1687
CHIHUAHUA,CHIHUAHUA,56,119,0,175,1687
CHIHUAHUA,CHIHUAHUA,32,91,0,123,1447
CHIHUAHUA,CHIHUAHUA,43,118,0,161,1447
CHIHUAHUA,CHIHUAHUA,37,116,2,155,1447
CHIHUAHUA,CHIHUAHUA,44,113,0,157,1584
CHIHUAHUA,CHIHUAHUA,37,92,2,131,1584
CHIHUAHUA,CHIHUAHUA,35,102,1,138,1583
CHIHUAHUA,CHIHUAHUA,45,87,0,132,1583
CHIHUAHUA,CHIHUAHUA,45,112,2,159,1411
CHIHUAHUA,CHIHUAHUA,36,99,3,138,1411
CHIHUAHUA,CHIHUAHUA,42,117,1,160,1411
CHIHUAHUA,CHIHUAHUA,42,62,0,104,1788
CHIHUAHUA,CHIHUAHUA,32,62,0,94,1788
CHIHUAHUA,CHIHUAHUA,39,55,0,94,1788
CHIHUAHUA,CHIHUAHUA,42,70,1,113,1788
CHIHUAHUA,CHIHUAHUA,42,57,1,100,1788
CHIHUAHUA,CHIHUAHUA,38,119,0,157,1417
CHIHUAHUA,CHIHUAHUA,43,102,0,145,1416
CHIHUAHUA,CHIHUAHUA,50,113,1,164,1416
CHIHUAHUA,CHIHUAHUA,61,74,0,135,1598
CHIHUAHUA,CHIHUAHUA,66,70,0,136,1597
CHIHUAHUA,CHIHUAHUA,37,104,1,142,1661
CHIHUAHUA,CHIHUAHUA,37,107,0,144,1661
CHIHUAHUA,CHIHUAHUA,43,96,1,140,1583
CHIHUAHUA,CHIHUAHUA,26,88,1,115,1583
CHIHUAHUA,CHIHUAHUA,67,95,3,165,1664
CHIHUAHUA,CHIHUAHUA,48,87,1,136,1664
CHIHUAHUA,CHIHUAHUA,59,58,5,122,1681
CHIHUAHUA,CHIHUAHUA,41,58,0,99,1680
CHIHUAHUA,CHIHUAHUA,40,97,2,139,1703
CHIHUAHUA,CHIHUAHUA,41,110,1,152,1703
CHIHUAHUA,CHIHUAHUA,44,73,0,117,1932
CHIHUAHUA,CHIHUAHUA,44,68,1,113,1932
CHIHUAHUA,CHIHUAHUA,42,93,4,139,1931
CHIHUAHUA,CHIHUAHUA,9,145,4,158,1741
CHIHUAHUA,CHIHUAHUA,16,177,10,203,1740
CHIHUAHUA,CHIHUAHUA,10,45,0,55,1461
CHIHUAHUA,CHIHUAHUA,15,33,0,48,1461
CHIHUAHUA,CHIHUAHUA,15,52,0,67,1461
CHIHUAHUA,CHIHUAHUA,14,107,0,121,1440
CHIHUAHUA,CHIHUAHUA,11,95,1,107,1440
CHIHUAHUA,CHIHUAHUA,13,112,1,126,1440
CHIHUAHUA,CHIHUAHUA,23,157,0,180,1957
CHIHUAHUA,CHIHUAHUA,19,165,1,185,1957
CHIHUAHUA,CHIHUAHUA,7,103,1,111,1674
CHIHUAHUA,CHIHUAHUA,16,130,2,148,1673
CHIHUAHUA,CHIHUAHUA,13,112,3,128,1501
CHIHUAHUA,CHIHUAHUA,13,126,1,140,1501
CHIHUAHUA,CHIHUAHUA,12,146,0,158,1500
CHIHUAHUA,CHIHUAHUA,16,148,0,164,1881
CHIHUAHUA,CHIHUAHUA,23,165,5,193,1880
CHIHUAHUA,CHIHUAHUA,20,100,0,120,1545
CHIHUAHUA,CHIHUAHUA,22,90,1,113,1544
CHIHUAHUA,CHIHUAHUA,17,119,0,136,1544
CHIHUAHUA,CHIHUAHUA,14,152,5,171,1832
CHIHUAHUA,CHIHUAHUA,9,139,0,148,1832
CHIHUAHUA,CHIHUAHUA,6,128,1,135,1546
CHIHUAHUA,CHIHUAHUA,11,168,2,181,1546
CHIHUAHUA,CHIHUAHUA,13,121,2,136,1507
CHIHUAHUA,CHIHUAHUA,5,139,2,146,1507
CHIHUAHUA,CHIHUAHUA,17,105,0,122,1506
CHIHUAHUA,CHIHUAHUA,10,171,3,184,1953
CHIHUAHUA,CHIHUAHUA,13,178,4,195,1953
CHIHUAHUA,CHIHUAHUA,15,139,3,157,1359
CHIHUAHUA,CHIHUAHUA,9,131,0,140,1358
CHIHUAHUA,CHIHUAHUA,25,148,0,173,1637
CHIHUAHUA,CHIHUAHUA,17,157,1,175,1637
CHIHUAHUA,CHIHUAHUA,18,131,7,156,1637
CHIHUAHUA,CHIHUAHUA,22,121,0,143,1803
CHIHUAHUA,CHIHUAHUA,18,134,2,154,1802
CHIHUAHUA,CHIHUAHUA,21,57,0,78,1370
CHIHUAHUA,CHIHUAHUA,18,70,0,88,1369
CHIHUAHUA,CHIHUAHUA,22,124,0,146,1483
CHIHUAHUA,CHIHUAHUA,33,123,1,157,1483
CHIHUAHUA,CHIHUAHUA,20,121,0,141,1796
CHIHUAHUA,CHIHUAHUA,15,121,1,137,1795
CHIHUAHUA,CHIHUAHUA,27,128,1,156,1795
CHIHUAHUA,CHIHUAHUA,36,93,1,130,1683
CHIHUAHUA,CHIHUAHUA,39,101,2,142,1683
CHIHUAHUA,CHIHUAHUA,36,79,1,116,1683
CHIHUAHUA,CHIHUAHUA,41,88,0,129,1834
CHIHUAHUA,CHIHUAHUA,40,85,0,125,1833
CHIHUAHUA,CHIHUAHUA,34,105,0,139,1833
CHIHUAHUA,CHIHUAHUA,25,105,0,130,1914
CHIHUAHUA,CHIHUAHUA,25,149,0,174,1914
CHIHUAHUA,CHIHUAHUA,48,112,1,161,2018
CHIHUAHUA,CHIHUAHUA,38,96,0,134,2017
CHIHUAHUA,CHIHUAHUA,8,75,0,83,1862
CHIHUAHUA,CHIHUAHUA,7,90,2,99,1862
CHIHUAHUA,CHIHUAHUA,7,91,1,99,1861
CHIHUAHUA,CHIHUAHUA,7,74,2,83,1423
CHIHUAHUA,CHIHUAHUA,6,80,0,86,1423
CHIHUAHUA,CHIHUAHUA,5,73,2,80,1423
CHIHUAHUA,CHIHUAHUA,4,123,1,128,1646
CHIHUAHUA,CHIHUAHUA,16,108,3,127,1645
CHIHUAHUA,CHIHUAHUA,6,159,1,166,2038
CHIHUAHUA,CHIHUAHUA,9,141,1,151,2037
CHIHUAHUA,CHIHUAHUA,9,100,3,112,1496
CHIHUAHUA,CHIHUAHUA,7,106,0,113,1495
CHIHUAHUA,CHIHUAHUA,5,89,0,94,1165
CHIHUAHUA,CHIHUAHUA,3,63,1,67,1164
CHIHUAHUA,CHIHUAHUA,15,163,4,182,1506
CHIHUAHUA,CHIHUAHUA,21,133,0,154,1506
CHIHUAHUA,CHIHUAHUA,19,117,5,141,1505
CHIHUAHUA,CHIHUAHUA,3,137,2,142,1224
CHIHUAHUA,CHIHUAHUA,10,148,1,159,1224
CHIHUAHUA,CUAUHTEMOC,10,214,1,225,1873
CHIHUAHUA,CUAUHTEMOC,9,202,2,213,1873
CHIHUAHUA,CUAUHTEMOC,7,191,5,203,1873
CHIHUAHUA,CUAUHTEMOC,26,105,20,151,1377
CHIHUAHUA,CUAUHTEMOC,30,130,16,176,1377
CHIHUAHUA,CUAUHTEMOC,25,132,26,183,1377
CHIHUAHUA,CUAUHTEMOC,30,99,5,134,1690
CHIHUAHUA,CUAUHTEMOC,10,86,4,100,1690
CHIHUAHUA,CUAUHTEMOC,26,95,7,128,1690
CHIHUAHUA,CUAUHTEMOC,20,92,7,119,1690
CHIHUAHUA,CUAUHTEMOC,24,101,4,129,1690
CHIHUAHUA,CUAUHTEMOC,20,100,3,123,1608
CHIHUAHUA,CUAUHTEMOC,14,124,10,148,1608
CHIHUAHUA,CUAUHTEMOC,17,123,11,151,1608
CHIHUAHUA,CUAUHTEMOC,14,106,5,125,1608
CHIHUAHUA,CUAUHTEMOC,22,129,5,156,1608
CHIHUAHUA,CUAUHTEMOC,19,147,0,166,1960
CHIHUAHUA,CUAUHTEMOC,20,164,1,185,1960
CHIHUAHUA,CUAUHTEMOC,5,40,1,46,1935
CHIHUAHUA,CUAUHTEMOC,18,37,0,55,1935
CHIHUAHUA,CUAUHTEMOC,11,113,0,124,1401
CHIHUAHUA,CUAUHTEMOC,16,102,1,119,1400
CHIHUAHUA,CUAUHTEMOC,9,65,1,75,1405
CHIHUAHUA,CUAUHTEMOC,7,72,1,80,1405
CHIHUAHUA,CUAUHTEMOC,10,57,0,67,1404
CHIHUAHUA,CUAUHTEMOC,15,128,1,144,1660
CHIHUAHUA,CUAUHTEMOC,12,142,1,155,1659
CHIHUAHUA,CUAUHTEMOC,18,114,2,134,1659
CHIHUAHUA,CUAUHTEMOC,10,97,3,110,1881
CHIHUAHUA,CUAUHTEMOC,6,115,2,123,1881
CHIHUAHUA,CUAUHTEMOC,49,479,5,533,0
CHIHUAHUA,CUAUHTEMOC,5,128,3,136,1895
CHIHUAHUA,CUAUHTEMOC,7,123,1,131,1895
CHIHUAHUA,CUAUHTEMOC,6,104,4,114,1895
CHIHUAHUA,CUAUHTEMOC,8,123,2,133,1442
CHIHUAHUA,CUAUHTEMOC,2,105,1,108,1442
CHIHUAHUA,CUAUHTEMOC,2,118,2,122,1442
CHIHUAHUA,CUAUHTEMOC,15,113,2,130,1440
CHIHUAHUA,CUAUHTEMOC,4,111,1,116,1440
CHIHUAHUA,CUAUHTEMOC,15,118,3,136,1440
CHIHUAHUA,CUAUHTEMOC,10,141,1,152,1841
CHIHUAHUA,CUAUHTEMOC,8,98,1,107,1841
CHIHUAHUA,CUAUHTEMOC,7,120,3,130,1841
CHIHUAHUA,CUAUHTEMOC,10,131,2,143,1841
CHIHUAHUA,CUAUHTEMOC,5,111,1,117,1840
CHIHUAHUA,CUAUHTEMOC,2,116,1,119,1840
CHIHUAHUA,CUAUHTEMOC,4,116,4,124,1840
CHIHUAHUA,CUAUHTEMOC,11,145,2,158,1653
CHIHUAHUA,CUAUHTEMOC,7,175,1,183,1653
CHIHUAHUA,CUAUHTEMOC,10,137,3,150,1653
CHIHUAHUA,CUAUHTEMOC,13,137,2,152,1833
CHIHUAHUA,CUAUHTEMOC,6,159,3,168,1833
CHIHUAHUA,CUAUHTEMOC,7,129,3,139,1570
CHIHUAHUA,CUAUHTEMOC,8,124,4,136,1570
CHIHUAHUA,CUAUHTEMOC,6,125,2,133,1570
CHIHUAHUA,CUAUHTEMOC,12,148,3,163,1457
CHIHUAHUA,CUAUHTEMOC,19,122,4,145,1457
CHIHUAHUA,CUAUHTEMOC,18,106,0,124,1456
CHIHUAHUA,CUAUHTEMOC,12,123,5,140,1711
CHIHUAHUA,CUAUHTEMOC,7,171,5,183,1711
CHIHUAHUA,CUAUHTEMOC,7,153,4,164,1711
CHIHUAHUA,CUAUHTEMOC,7,118,0,125,1422
CHIHUAHUA,CUAUHTEMOC,5,92,5,102,1421
CHIHUAHUA,CUAUHTEMOC,5,116,1,122,1421
CHIHUAHUA,CUAUHTEMOC,9,65,1,75,1347
CHIHUAHUA,CUAUHTEMOC,2,94,1,97,1347
CHIHUAHUA,CUAUHTEMOC,6,63,1,70,1346
CHIHUAHUA,CUAUHTEMOC,9,157,1,167,1821
CHIHUAHUA,CUAUHTEMOC,19,180,4,203,1820
CHIHUAHUA,CUAUHTEMOC,14,62,0,76,1023
CHIHUAHUA,CUAUHTEMOC,9,80,1,90,1023
CHIHUAHUA,CUAUHTEMOC,4,172,7,183,1901
CHIHUAHUA,CUAUHTEMOC,12,135,2,149,1900
CHIHUAHUA,CUAUHTEMOC,6,60,4,70,1148
CHIHUAHUA,CUAUHTEMOC,9,74,7,90,1147
CHIHUAHUA,CUAUHTEMOC,6,106,7,119,1644
CHIHUAHUA,CUAUHTEMOC,8,136,2,146,1644
CHIHUAHUA,CUAUHTEMOC,13,88,2,103,1644
CHIHUAHUA,CUAUHTEMOC,6,41,1,48,1959
CHIHUAHUA,CUAUHTEMOC,8,34,2,44,1958
CHIHUAHUA,CUAUHTEMOC,8,78,0,86,1826
CHIHUAHUA,CUAUHTEMOC,8,78,1,87,1826
CHIHUAHUA,CUAUHTEMOC,16,160,5,181,1286
CHIHUAHUA,CUAUHTEMOC,8,157,4,169,1285
CHIHUAHUA,CUAUHTEMOC,10,208,1,219,1932
CHIHUAHUA,CUAUHTEMOC,8,191,5,204,1931
CHIHUAHUA,CUAUHTEMOC,11,199,1,211,1403
CHIHUAHUA,CUAUHTEMOC,19,188,1,208,1403
CHIHUAHUA,CUAUHTEMOC,3,50,3,56,1740
CHIHUAHUA,CUAUHTEMOC,5,32,1,38,1739
CHIHUAHUA,CUAUHTEMOC,12,40,0,52,1739
CHIHUAHUA,CUAUHTEMOC,10,44,2,56,1358
CHIHUAHUA,CUAUHTEMOC,6,41,2,49,1357
CHIHUAHUA,CUAUHTEMOC,4,42,1,47,1357
CHIHUAHUA,CUAUHTEMOC,5,9,1,15,1966
CHIHUAHUA,CUAUHTEMOC,5,12,0,17,1965
CHIHUAHUA,CUAUHTEMOC,5,101,1,107,1745
CHIHUAHUA,CUAUHTEMOC,7,106,3,116,1745
CHIHUAHUA,CUAUHTEMOC,10,80,0,90,1745
CHIHUAHUA,CUAUHTEMOC,18,80,2,100,1727
CHIHUAHUA,CUAUHTEMOC,20,89,3,112,1727
CHIHUAHUA,CUAUHTEMOC,11,66,2,79,1726
CHIHUAHUA,CUAUHTEMOC,8,647,16,671,1653
CHIHUAHUA,CUAUHTEMOC,7,586,10,603,1653
CHIHUAHUA,CUAUHTEMOC,10,639,7,656,1653
CHIHUAHUA,CUAUHTEMOC,13,58,8,79,1411
CHIHUAHUA,CUAUHTEMOC,7,72,4,83,1411
CHIHUAHUA,CUAUHTEMOC,7,57,5,69,1410
CHIHUAHUA,CUAUHTEMOC,17,216,11,244,1665
CHIHUAHUA,CUAUHTEMOC,27,264,3,294,1665
CHIHUAHUA,CUAUHTEMOC,15,201,8,224,1665
CHIHUAHUA,CUAUHTEMOC,13,244,3,260,1665
CHIHUAHUA,CUAUHTEMOC,10,166,7,183,1527
CHIHUAHUA,CUAUHTEMOC,12,184,18,214,1526
CHIHUAHUA,CUAUHTEMOC,18,447,18,483,1652
CHIHUAHUA,CUAUHTEMOC,17,435,15,467,1651
CHIHUAHUA,CUAUHTEMOC,28,396,29,453,1651
CHIHUAHUA,CUAUHTEMOC,41,469,15,525,1651
CHIHUAHUA,CUAUHTEMOC,28,160,18,206,1637
CHIHUAHUA,CUAUHTEMOC,13,144,7,164,1637
CHIHUAHUA,CUAUHTEMOC,17,163,5,185,1636
CHIHUAHUA,CUAUHTEMOC,28,172,8,208,1789
CHIHUAHUA,CUAUHTEMOC,17,161,4,182,1789
CHIHUAHUA,CUAUHTEMOC,12,153,5,170,1596
CHIHUAHUA,CUAUHTEMOC,15,160,1,176,1596
CHIHUAHUA,CUAUHTEMOC,10,139,3,152,1595
CHIHUAHUA,CUAUHTEMOC,12,129,4,145,1703
CHIHUAHUA,CUAUHTEMOC,12,147,1,160,1702
CHIHUAHUA,CUAUHTEMOC,17,238,0,255,1262
CHIHUAHUA,CUAUHTEMOC,9,208,2,219,1261
CHIHUAHUA,CUAUHTEMOC,7,111,5,123,1049
CHIHUAHUA,CUAUHTEMOC,5,113,0,118,1048
CHIHUAHUA,CUAUHTEMOC,26,126,9,161,1337
CHIHUAHUA,CUAUHTEMOC,31,179,8,218,1337
CHIHUAHUA,CUAUHTEMOC,14,179,12,205,1545
CHIHUAHUA,CUAUHTEMOC,15,200,4,219,1544
CHIHUAHUA,CUAUHTEMOC,13,85,3,101,1132
CHIHUAHUA,CUAUHTEMOC,10,93,5,108,1132
CHIHUAHUA,CUAUHTEMOC,6,92,3,101,1674
CHIHUAHUA,CUAUHTEMOC,3,81,0,84,1674
CHIHUAHUA,CUAUHTEMOC,4,83,6,93,1673
CHIHUAHUA,CUAUHTEMOC,13,180,2,195,1704
CHIHUAHUA,CUAUHTEMOC,14,154,3,171,1703
CHIHUAHUA,CUAUHTEMOC,7,77,5,89,1371
CHIHUAHUA,CUAUHTEMOC,8,80,3,91,1371
CHIHUAHUA,CUAUHTEMOC,6,51,0,57,1371
CHIHUAHUA,CUAUHTEMOC,5,119,3,127,1510
CHIHUAHUA,CUAUHTEMOC,13,124,2,139,1509
CHIHUAHUA,CUAUHTEMOC,3,45,1,49,1487
CHIHUAHUA,CUAUHTEMOC,2,21,0,23,1487
CHIHUAHUA,CUAUHTEMOC,2,14,1,17,1486
CHIHUAHUA,CUAUHTEMOC,12,435,14,461,1188
CHIHUAHUA,CUAUHTEMOC,14,216,9,239,1267
CHIHUAHUA,CUAUHTEMOC,20,214,10,244,1267
CHIHUAHUA,CUAUHTEMOC,14,413,6,433,1893
CHIHUAHUA,CUAUHTEMOC,9,478,10,497,1892
CHIHUAHUA,CUAUHTEMOC,13,146,7,166,1324
CHIHUAHUA,CUAUHTEMOC,7,132,3,142,1324
CHIHUAHUA,CUAUHTEMOC,11,126,6,143,1323
CHIHUAHUA,CUAUHTEMOC,11,148,8,167,1755
CHIHUAHUA,CUAUHTEMOC,9,126,8,143,1755
CHIHUAHUA,CUAUHTEMOC,12,161,2,175,988
CHIHUAHUA,CUAUHTEMOC,16,137,4,157,988
CHIHUAHUA,CUAUHTEMOC,15,87,3,105,1474
CHIHUAHUA,CUAUHTEMOC,11,89,6,106,1474
CHIHUAHUA,CUAUHTEMOC,12,82,3,97,1474
CHIHUAHUA,CUAUHTEMOC,4,96,2,102,1812
CHIHUAHUA,CUAUHTEMOC,3,98,4,105,1812
CHIHUAHUA,CUAUHTEMOC,1,54,3,58,1812
CHIHUAHUA,CUAUHTEMOC,19,262,13,294,1526
CHIHUAHUA,CUAUHTEMOC,32,281,16,329,1526
CHIHUAHUA,CUAUHTEMOC,29,281,13,323,1526
CHIHUAHUA,CUAUHTEMOC,30,303,11,344,1525
CHIHUAHUA,CUAUHTEMOC,16,209,7,232,1773
CHIHUAHUA,CUAUHTEMOC,6,30,1,37,1883
CHIHUAHUA,CUAUHTEMOC,5,37,2,44,1882
CHIHUAHUA,CUAUHTEMOC,2,17,0,19,1882
CHIHUAHUA,CUAUHTEMOC,21,259,15,295,1719
CHIHUAHUA,CUAUHTEMOC,31,214,7,252,1719
CHIHUAHUA,CUAUHTEMOC,27,242,12,281,1719
CHIHUAHUA,CUAUHTEMOC,18,375,11,404,1644
CHIHUAHUA,CUAUHTEMOC,12,349,14,375,1643
CHIHUAHUA,CUAUHTEMOC,26,340,10,376,1643
CHIHUAHUA,CHIHUAHUA,34,160,1,195,1485
CHIHUAHUA,CHIHUAHUA,19,136,0,155,1485
CHIHUAHUA,CHIHUAHUA,19,143,4,166,1484
CHIHUAHUA,CHIHUAHUA,23,115,6,144,1235
CHIHUAHUA,CHIHUAHUA,24,131,1,156,1235
CHIHUAHUA,CHIHUAHUA,20,135,0,155,1399
CHIHUAHUA,CHIHUAHUA,16,125,2,143,1399
CHIHUAHUA,CHIHUAHUA,19,143,2,164,1398
CHIHUAHUA,CHIHUAHUA,30,164,3,197,1766
CHIHUAHUA,CHIHUAHUA,26,183,1,210,1766
CHIHUAHUA,CHIHUAHUA,22,184,1,207,1943
CHIHUAHUA,CHIHUAHUA,20,167,2,189,1942
CHIHUAHUA,CHIHUAHUA,14,108,2,124,1484
CHIHUAHUA,CHIHUAHUA,17,101,1,119,1484
CHIHUAHUA,CHIHUAHUA,14,111,0,125,1483
CHIHUAHUA,CHIHUAHUA,22,96,0,118,1306
CHIHUAHUA,CHIHUAHUA,21,107,2,130,1305
CHIHUAHUA,CHIHUAHUA,21,200,4,225,1905
CHIHUAHUA,CHIHUAHUA,17,198,2,217,1905
CHIHUAHUA,CHIHUAHUA,16,150,3,169,1626
CHIHUAHUA,CHIHUAHUA,16,160,2,178,1626
CHIHUAHUA,CHIHUAHUA,23,167,1,191,1713
CHIHUAHUA,CHIHUAHUA,19,167,4,190,1713
CHIHUAHUA,CHIHUAHUA,26,131,0,157,1796
CHIHUAHUA,CHIHUAHUA,33,168,1,202,1795
CHIHUAHUA,CHIHUAHUA,18,213,3,234,1697
CHIHUAHUA,CHIHUAHUA,18,196,1,215,1697
CHIHUAHUA,CHIHUAHUA,5,98,3,106,1165
CHIHUAHUA,CHIHUAHUA,11,87,4,102,1165
CHIHUAHUA,CHIHUAHUA,14,109,3,126,1689
CHIHUAHUA,CHIHUAHUA,9,123,2,134,1689
CHIHUAHUA,CHIHUAHUA,25,136,1,162,1625
CHIHUAHUA,CHIHUAHUA,21,108,4,133,1625
CHIHUAHUA,CHIHUAHUA,14,126,3,143,1895
CHIHUAHUA,CHIHUAHUA,16,125,4,145,1894
CHIHUAHUA,CHIHUAHUA,4,101,3,108,1048
CHIHUAHUA,CHIHUAHUA,12,102,1,115,1047
CHIHUAHUA,CHIHUAHUA,17,125,2,144,1469
CHIHUAHUA,CHIHUAHUA,17,122,2,141,1469
CHIHUAHUA,CHIHUAHUA,7,124,4,135,1468
CHIHUAHUA,CHIHUAHUA,12,138,1,151,1349
CHIHUAHUA,CHIHUAHUA,22,126,4,152,1349
CHIHUAHUA,CHIHUAHUA,37,216,2,255,1964
CHIHUAHUA,CHIHUAHUA,41,188,4,233,1963
CHIHUAHUA,CHIHUAHUA,27,149,1,177,1651
CHIHUAHUA,CHIHUAHUA,26,152,9,187,1651
CHIHUAHUA,CHIHUAHUA,27,146,1,174,1651
CHIHUAHUA,CHIHUAHUA,13,149,2,164,1615
CHIHUAHUA,CHIHUAHUA,12,142,1,155,1615
CHIHUAHUA,CHIHUAHUA,13,170,3,186,1772
CHIHUAHUA,CHIHUAHUA,12,191,1,204,1772
CHIHUAHUA,CHIHUAHUA,11,196,4,211,1772
CHIHUAHUA,CHIHUAHUA,34,171,2,207,1865
CHIHUAHUA,CHIHUAHUA,24,175,3,202,1865
CHIHUAHUA,CHIHUAHUA,11,130,4,145,1630
CHIHUAHUA,CHIHUAHUA,18,156,4,178,1629
CHIHUAHUA,CHIHUAHUA,11,209,8,228,1804
CHIHUAHUA,CHIHUAHUA,11,197,3,211,1804
CHIHUAHUA,CHIHUAHUA,9,183,5,197,1553
CHIHUAHUA,CHIHUAHUA,15,155,6,176,1553
CHIHUAHUA,CHIHUAHUA,14,134,2,150,1639
CHIHUAHUA,CHIHUAHUA,12,130,0,142,1638
CHIHUAHUA,CHIHUAHUA,14,142,2,158,1638
CHIHUAHUA,CHIHUAHUA,6,114,0,120,1848
CHIHUAHUA,CHIHUAHUA,6,104,4,114,1848
CHIHUAHUA,CHIHUAHUA,10,92,2,104,1848
CHIHUAHUA,CHIHUAHUA,14,112,0,126,1848
CHIHUAHUA,CHIHUAHUA,15,116,0,131,1847
CHIHUAHUA,CHIHUAHUA,21,200,3,224,1897
CHIHUAHUA,CHIHUAHUA,21,215,0,236,1896
CHIHUAHUA,CHIHUAHUA,10,83,1,94,1190
CHIHUAHUA,CHIHUAHUA,12,68,3,83,1190
CHIHUAHUA,CHIHUAHUA,15,198,1,214,1974
CHIHUAHUA,CHIHUAHUA,23,159,0,182,1973
CHIHUAHUA,CHIHUAHUA,20,157,0,177,1330
CHIHUAHUA,CHIHUAHUA,15,133,1,149,1330
CHIHUAHUA,CHIHUAHUA,13,143,1,157,1666
CHIHUAHUA,CHIHUAHUA,24,123,0,147,1666
CHIHUAHUA,CHIHUAHUA,5,138,1,144,1666
CHIHUAHUA,CHIHUAHUA,7,125,1,133,1666
CHIHUAHUA,CHIHUAHUA,18,130,4,152,1666
CHIHUAHUA,CHIHUAHUA,17,150,1,168,1665
CHIHUAHUA,CHIHUAHUA,20,196,0,216,1937
CHIHUAHUA,CHIHUAHUA,24,167,2,193,1937
CHIHUAHUA,CHIHUAHUA,30,155,1,186,1937
CHIHUAHUA,CHIHUAHUA,11,195,5,211,1614
CHIHUAHUA,CHIHUAHUA,12,168,1,181,1614
CHIHUAHUA,CHIHUAHUA,17,243,4,264,1931
CHIHUAHUA,CHIHUAHUA,13,239,1,253,1930
CHIHUAHUA,CHIHUAHUA,16,203,7,226,1665
CHIHUAHUA,CHIHUAHUA,21,189,6,216,1664
CHIHUAHUA,CHIHUAHUA,119,957,9,1085,0
CHIHUAHUA,CHIHUAHUA,8,170,2,180,1647
CHIHUAHUA,CHIHUAHUA,18,152,2,172,1647
CHIHUAHUA,CHIHUAHUA,14,293,3,310,1791
CHIHUAHUA,CHIHUAHUA,12,277,13,302,1791
CHIHUAHUA,CHIHUAHUA,18,269,7,294,1676
CHIHUAHUA,CHIHUAHUA,17,242,3,262,1675
CHIHUAHUA,CHIHUAHUA,19,229,1,249,1333
CHIHUAHUA,CHIHUAHUA,14,206,4,224,1333
CHIHUAHUA,CHIHUAHUA,7,284,8,299,1963
CHIHUAHUA,CHIHUAHUA,14,278,7,299,1962
CHIHUAHUA,CHIHUAHUA,25,203,1,229,1748
CHIHUAHUA,CHIHUAHUA,24,234,3,261,1748
CHIHUAHUA,CHIHUAHUA,33,151,3,187,2060
CHIHUAHUA,CHIHUAHUA,31,160,2,193,2059
CHIHUAHUA,CHIHUAHUA,6,223,1,230,1724
CHIHUAHUA,CHIHUAHUA,8,204,1,213,1723
CHIHUAHUA,CHIHUAHUA,32,191,2,225,1705
CHIHUAHUA,CHIHUAHUA,34,179,3,216,1705
CHIHUAHUA,CHIHUAHUA,40,163,2,205,1951
CHIHUAHUA,CHIHUAHUA,48,157,1,206,1950
CHIHUAHUA,CHIHUAHUA,33,197,2,232,1503
CHIHUAHUA,CHIHUAHUA,28,129,1,158,1502
CHIHUAHUA,CHIHUAHUA,30,154,0,184,1502
CHIHUAHUA,CHIHUAHUA,19,121,0,140,1557
CHIHUAHUA,CHIHUAHUA,27,82,1,110,1557
CHIHUAHUA,CHIHUAHUA,25,115,1,141,1557
CHIHUAHUA,CHIHUAHUA,26,141,3,170,1412
CHIHUAHUA,CHIHUAHUA,28,153,0,181,1412
CHIHUAHUA,CHIHUAHUA,29,178,0,207,1725
CHIHUAHUA,CHIHUAHUA,25,170,4,199,1725
CHIHUAHUA,CHIHUAHUA,15,149,3,167,1208
CHIHUAHUA,CHIHUAHUA,16,166,3,185,1207
CHIHUAHUA,CHIHUAHUA,21,170,3,194,1131
CHIHUAHUA,CHIHUAHUA,11,162,5,178,1131
CHIHUAHUA,CHIHUAHUA,12,109,2,123,1428
CHIHUAHUA,CHIHUAHUA,6,120,1,127,1428
CHIHUAHUA,CHIHUAHUA,12,107,2,121,1428
CHIHUAHUA,CHIHUAHUA,20,133,0,153,1744
CHIHUAHUA,CHIHUAHUA,20,142,1,163,1743
CHIHUAHUA,CHIHUAHUA,16,127,0,143,1743
CHIHUAHUA,CHIHUAHUA,15,140,1,156,1743
CHIHUAHUA,CHIHUAHUA,25,179,5,209,1912
CHIHUAHUA,CHIHUAHUA,27,178,7,212,1912
CHIHUAHUA,CHIHUAHUA,14,99,2,115,1834
CHIHUAHUA,CHIHUAHUA,9,148,1,158,1833
CHIHUAHUA,CHIHUAHUA,15,141,0,156,1833
CHIHUAHUA,CHIHUAHUA,12,99,2,113,1358
CHIHUAHUA,CHIHUAHUA,12,80,0,92,1358
CHIHUAHUA,CHIHUAHUA,3,93,2,98,1358
CHIHUAHUA,CHIHUAHUA,16,176,1,193,1750
CHIHUAHUA,CHIHUAHUA,11,154,1,166,1750
CHIHUAHUA,CHIHUAHUA,15,175,3,193,1701
CHIHUAHUA,CHIHUAHUA,12,175,3,190,1700
CHIHUAHUA,CHIHUAHUA,21,132,3,156,1346
CHIHUAHUA,CHIHUAHUA,11,139,1,151,1346
CHIHUAHUA,CHIHUAHUA,10,148,1,159,1618
CHIHUAHUA,CHIHUAHUA,6,136,4,146,1617
CHIHUAHUA,CHIHUAHUA,13,171,3,187,1533
CHIHUAHUA,CHIHUAHUA,10,182,0,192,1533
CHIHUAHUA,CHIHUAHUA,5,108,0,113,1143
CHIHUAHUA,CHIHUAHUA,10,125,2,137,1143
CHIHUAHUA,CHIHUAHUA,12,167,2,181,1527
CHIHUAHUA,CHIHUAHUA,9,144,6,159,1527
CHIHUAHUA,CHIHUAHUA,11,148,1,160,1527
CHIHUAHUA,CHIHUAHUA,0,145,2,147,1527
CHIHUAHUA,CHIHUAHUA,11,88,2,101,1993
CHIHUAHUA,CHIHUAHUA,6,90,0,96,1993
CHIHUAHUA,CHIHUAHUA,13,79,1,93,1993
CHIHUAHUA,CHIHUAHUA,5,94,1,100,1993
CHIHUAHUA,CHIHUAHUA,29,98,0,127,1460
CHIHUAHUA,CHIHUAHUA,7,121,0,128,1460
CHIHUAHUA,CHIHUAHUA,23,105,2,130,1819
CHIHUAHUA,CHIHUAHUA,24,122,0,146,1819
CHIHUAHUA,CHIHUAHUA,22,128,2,152,1818
CHIHUAHUA,CHIHUAHUA,6,60,0,66,1603
CHIHUAHUA,CHIHUAHUA,6,61,0,67,1603
CHIHUAHUA,CHIHUAHUA,10,48,1,59,1602
CHIHUAHUA,CHIHUAHUA,6,62,2,70,1602
CHIHUAHUA,CHIHUAHUA,5,47,1,53,1602
CHIHUAHUA,CHIHUAHUA,29,94,5,128,1540
CHIHUAHUA,CHIHUAHUA,25,84,0,109,1539
CHIHUAHUA,CHIHUAHUA,24,119,1,144,1742
CHIHUAHUA,CHIHUAHUA,28,124,0,152,1742
CHIHUAHUA,CHIHUAHUA,38,74,1,113,1417
CHIHUAHUA,CHIHUAHUA,23,94,0,117,1417
CHIHUAHUA,CHIHUAHUA,7,78,2,87,1203
CHIHUAHUA,CHIHUAHUA,8,56,0,64,1202
CHIHUAHUA,CHIHUAHUA,8,104,0,112,1390
CHIHUAHUA,CHIHUAHUA,11,96,1,108,1389
CHIHUAHUA,CHIHUAHUA,9,78,1,88,1627
CHIHUAHUA,CHIHUAHUA,6,74,1,81,1627
CHIHUAHUA,CHIHUAHUA,9,79,1,89,1626
CHIHUAHUA,CHIHUAHUA,4,108,2,114,1683
CHIHUAHUA,CHIHUAHUA,15,92,0,107,1682
CHIHUAHUA,CHIHUAHUA,8,69,0,77,1643
CHIHUAHUA,CHIHUAHUA,9,77,3,89,1643
CHIHUAHUA,CHIHUAHUA,9,101,1,111,1642
CHIHUAHUA,CHIHUAHUA,18,131,1,150,1734
CHIHUAHUA,CHIHUAHUA,20,93,5,118,1734
CHIHUAHUA,CHIHUAHUA,13,99,0,112,1733
CHIHUAHUA,CHIHUAHUA,19,136,1,156,1392
CHIHUAHUA,CHIHUAHUA,22,154,2,178,1392
CHIHUAHUA,CHIHUAHUA,11,145,2,158,1347
CHIHUAHUA,CHIHUAHUA,12,141,3,156,1346
CHIHUAHUA,CHIHUAHUA,17,99,0,116,1166
CHIHUAHUA,CHIHUAHUA,14,110,0,124,1165
CHIHUAHUA,CHIHUAHUA,13,95,1,109,1337
CHIHUAHUA,CHIHUAHUA,14,113,0,127,1336
CHIHUAHUA,CHIHUAHUA,26,114,2,142,1549
CHIHUAHUA,CHIHUAHUA,17,123,2,142,1548
CHIHUAHUA,CHIHUAHUA,16,180,2,198,1948
CHIHUAHUA,CHIHUAHUA,14,150,2,166,1948
CHIHUAHUA,CHIHUAHUA,9,116,4,129,1518
CHIHUAHUA,CHIHUAHUA,6,90,2,98,1518
CHIHUAHUA,CHIHUAHUA,6,113,0,119,1632
CHIHUAHUA,CHIHUAHUA,10,89,3,102,1631
CHIHUAHUA,CHIHUAHUA,5,78,1,84,1967
CHIHUAHUA,CHIHUAHUA,6,74,1,81,1967
CHIHUAHUA,CHIHUAHUA,8,59,3,70,1967
CHIHUAHUA,CHIHUAHUA,17,109,2,128,1514
CHIHUAHUA,CHIHUAHUA,0,118,5,123,1513
CHIHUAHUA,CHIHUAHUA,7,111,2,120,1513
CHIHUAHUA,CHIHUAHUA,12,126,0,138,1382
CHIHUAHUA,CHIHUAHUA,5,112,1,118,1381
CHIHUAHUA,HIDALGO DEL PARRAL,11,133,1,145,1589
CHIHUAHUA,HIDALGO DEL PARRAL,7,115,2,124,1588
CHIHUAHUA,HIDALGO DEL PARRAL,10,109,1,120,1588
CHIHUAHUA,HIDALGO DEL PARRAL,7,136,8,151,1221
CHIHUAHUA,HIDALGO DEL PARRAL,8,138,5,151,1221
CHIHUAHUA,HIDALGO DEL PARRAL,18,141,10,169,1401
CHIHUAHUA,HIDALGO DEL PARRAL,11,129,6,146,1401
CHIHUAHUA,HIDALGO DEL PARRAL,8,123,10,141,1401
CHIHUAHUA,HIDALGO DEL PARRAL,24,251,52,327,1974
CHIHUAHUA,HIDALGO DEL PARRAL,0,337,41,378,1974
CHIHUAHUA,HIDALGO DEL PARRAL,28,253,124,405,1719
CHIHUAHUA,HIDALGO DEL PARRAL,20,276,61,357,1719
CHIHUAHUA,HIDALGO DEL PARRAL,39,303,66,408,1718
CHIHUAHUA,HIDALGO DEL PARRAL,37,436,89,562,1847
CHIHUAHUA,HIDALGO DEL PARRAL,37,490,92,619,1846
CHIHUAHUA,HIDALGO DEL PARRAL,19,207,56,282,1389
CHIHUAHUA,HIDALGO DEL PARRAL,21,332,72,425,1389
CHIHUAHUA,HIDALGO DEL PARRAL,34,294,79,407,1389
CHIHUAHUA,HIDALGO DEL PARRAL,32,369,27,428,1809
CHIHUAHUA,HIDALGO DEL PARRAL,34,397,27,458,1808
CHIHUAHUA,HIDALGO DEL PARRAL,51,335,99,485,1978
CHIHUAHUA,HIDALGO DEL PARRAL,46,355,117,518,1978
CHIHUAHUA,HIDALGO DEL PARRAL,23,299,5,327,1887
CHIHUAHUA,HIDALGO DEL PARRAL,11,257,10,278,1488
CHIHUAHUA,HIDALGO DEL PARRAL,7,231,6,244,1487
CHIHUAHUA,HIDALGO DEL PARRAL,22,165,4,191,1541
CHIHUAHUA,HIDALGO DEL PARRAL,24,182,2,208,1540
CHIHUAHUA,HIDALGO DEL PARRAL,19,197,6,222,1540
CHIHUAHUA,HIDALGO DEL PARRAL,32,215,8,255,1838
CHIHUAHUA,HIDALGO DEL PARRAL,30,216,8,254,1838
CHIHUAHUA,HIDALGO DEL PARRAL,26,175,6,207,1837
CHIHUAHUA,HIDALGO DEL PARRAL,30,189,7,226,1837
CHIHUAHUA,HIDALGO DEL PARRAL,14,175,3,192,1837
CHIHUAHUA,HIDALGO DEL PARRAL,24,247,50,321,2112
CHIHUAHUA,HIDALGO DEL PARRAL,36,314,44,394,2112
CHIHUAHUA,HIDALGO DEL PARRAL,29,243,47,319,2112
CHIHUAHUA,HIDALGO DEL PARRAL,28,221,50,299,2112
CHIHUAHUA,HIDALGO DEL PARRAL,29,196,29,254,2111
CHIHUAHUA,HIDALGO DEL PARRAL,46,261,48,355,1790
CHIHUAHUA,HIDALGO DEL PARRAL,44,242,51,337,1790
CHIHUAHUA,HIDALGO DEL PARRAL,42,270,43,355,1790
CHIHUAHUA,HIDALGO DEL PARRAL,41,307,34,382,1790
CHIHUAHUA,HIDALGO DEL PARRAL,40,252,40,332,1478
CHIHUAHUA,HIDALGO DEL PARRAL,47,287,27,361,1478
CHIHUAHUA,HIDALGO DEL PARRAL,45,240,30,315,1478
CHIHUAHUA,HIDALGO DEL PARRAL,22,226,8,256,1948
CHIHUAHUA,HIDALGO DEL PARRAL,17,307,6,330,1948
CHIHUAHUA,HIDALGO DEL PARRAL,19,274,4,297,1947
CHIHUAHUA,HIDALGO DEL PARRAL,15,146,13,174,1988
CHIHUAHUA,HIDALGO DEL PARRAL,14,162,5,181,1988
CHIHUAHUA,HIDALGO DEL PARRAL,12,124,11,147,1988
CHIHUAHUA,HIDALGO DEL PARRAL,15,155,8,178,1988
CHIHUAHUA,HIDALGO DEL PARRAL,16,121,8,145,1988
CHIHUAHUA,HIDALGO DEL PARRAL,22,141,15,178,1987
CHIHUAHUA,HIDALGO DEL PARRAL,12,164,2,178,1751
CHIHUAHUA,HIDALGO DEL PARRAL,11,126,0,137,1750
CHIHUAHUA,HIDALGO DEL PARRAL,30,382,11,423,2084
CHIHUAHUA,HIDALGO DEL PARRAL,19,345,15,379,2083
CHIHUAHUA,HIDALGO DEL PARRAL,27,231,11,269,1430
CHIHUAHUA,HIDALGO DEL PARRAL,24,296,10,330,1430
CHIHUAHUA,HIDALGO DEL PARRAL,26,215,16,257,1429
CHIHUAHUA,HIDALGO DEL PARRAL,31,270,7,308,1429
CHIHUAHUA,HIDALGO DEL PARRAL,7,164,0,171,1993
CHIHUAHUA,HIDALGO DEL PARRAL,13,161,5,179,1992
CHIHUAHUA,HIDALGO DEL PARRAL,9,161,5,175,1992
CHIHUAHUA,HIDALGO DEL PARRAL,13,150,2,165,2043
CHIHUAHUA,HIDALGO DEL PARRAL,11,146,3,160,2042
CHIHUAHUA,HIDALGO DEL PARRAL,6,66,2,74,1097
CHIHUAHUA,HIDALGO DEL PARRAL,7,71,0,78,1096
CHIHUAHUA,HIDALGO DEL PARRAL,6,73,0,79,1453
CHIHUAHUA,HIDALGO DEL PARRAL,3,85,0,88,1453
CHIHUAHUA,HIDALGO DEL PARRAL,5,123,6,134,1666
CHIHUAHUA,HIDALGO DEL PARRAL,4,144,1,149,1666
CHIHUAHUA,HIDALGO DEL PARRAL,8,125,1,134,1665
CHIHUAHUA,HIDALGO DEL PARRAL,6,104,4,114,1650
CHIHUAHUA,HIDALGO DEL PARRAL,3,105,1,109,1649
CHIHUAHUA,HIDALGO DEL PARRAL,12,67,1,80,1649
CHIHUAHUA,HIDALGO DEL PARRAL,26,368,8,402,0
CHIHUAHUA,HIDALGO DEL PARRAL,7,105,5,117,1348
CHIHUAHUA,HIDALGO DEL PARRAL,6,147,5,158,1347
CHIHUAHUA,HIDALGO DEL PARRAL,23,122,4,149,1658
CHIHUAHUA,HIDALGO DEL PARRAL,16,117,2,135,1657
CHIHUAHUA,HIDALGO DEL PARRAL,18,119,1,138,1657
CHIHUAHUA,HIDALGO DEL PARRAL,15,104,2,121,1657
CHIHUAHUA,HIDALGO DEL PARRAL,7,101,1,109,1192
CHIHUAHUA,HIDALGO DEL PARRAL,18,92,0,110,1192
CHIHUAHUA,HIDALGO DEL PARRAL,17,157,1,175,1790
CHIHUAHUA,HIDALGO DEL PARRAL,21,195,8,224,1789
CHIHUAHUA,HIDALGO DEL PARRAL,7,75,1,83,1544
CHIHUAHUA,HIDALGO DEL PARRAL,0,89,5,94,1543
CHIHUAHUA,HIDALGO DEL PARRAL,7,79,2,88,1543
CHIHUAHUA,HIDALGO DEL PARRAL,12,85,3,100,1543
CHIHUAHUA,HIDALGO DEL PARRAL,11,63,1,75,1165
CHIHUAHUA,HIDALGO DEL PARRAL,4,83,1,88,1164
CHIHUAHUA,HIDALGO DEL PARRAL,9,122,0,131,1258
CHIHUAHUA,HIDALGO DEL PARRAL,9,91,1,101,1258
CHIHUAHUA,HIDALGO DEL PARRAL,9,111,0,120,1257
CHIHUAHUA,HIDALGO DEL PARRAL,17,68,0,85,1098
CHIHUAHUA,HIDALGO DEL PARRAL,22,81,1,104,1097
CHIHUAHUA,HIDALGO DEL PARRAL,16,92,2,110,1153
CHIHUAHUA,HIDALGO DEL PARRAL,15,89,1,105,1153
CHIHUAHUA,HIDALGO DEL PARRAL,23,103,1,127,1152
CHIHUAHUA,HIDALGO DEL PARRAL,21,118,4,143,1802
CHIHUAHUA,HIDALGO DEL PARRAL,22,130,1,153,1802
CHIHUAHUA,HIDALGO DEL PARRAL,28,107,0,135,1801
CHIHUAHUA,HIDALGO DEL PARRAL,16,149,2,167,1608
CHIHUAHUA,HIDALGO DEL PARRAL,16,143,1,160,1607
CHIHUAHUA,HIDALGO DEL PARRAL,15,139,3,157,1634
CHIHUAHUA,HIDALGO DEL PARRAL,20,133,1,154,1633
CHIHUAHUA,HIDALGO DEL PARRAL,13,141,0,154,1469
CHIHUAHUA,HIDALGO DEL PARRAL,17,153,4,174,1468
CHIHUAHUA,HIDALGO DEL PARRAL,10,95,2,107,1120
CHIHUAHUA,HIDALGO DEL PARRAL,17,104,1,122,1120
CHIHUAHUA,HIDALGO DEL PARRAL,9,92,0,101,1202
CHIHUAHUA,HIDALGO DEL PARRAL,15,100,1,116,1202
CHIHUAHUA,HIDALGO DEL PARRAL,14,143,1,158,1092
CHIHUAHUA,HIDALGO DEL PARRAL,14,138,3,155,1091
CHIHUAHUA,HIDALGO DEL PARRAL,9,242,3,254,2109
CHIHUAHUA,HIDALGO DEL PARRAL,2,114,0,116,1323
CHIHUAHUA,HIDALGO DEL PARRAL,11,108,2,121,1322
CHIHUAHUA,HIDALGO DEL PARRAL,5,34,2,41,1326
CHIHUAHUA,HIDALGO DEL PARRAL,6,52,0,58,1325
CHIHUAHUA,HIDALGO DEL PARRAL,23,366,5,394,1472
CHIHUAHUA,HIDALGO DEL PARRAL,8,274,8,290,1722
CHIHUAHUA,HIDALGO DEL PARRAL,15,208,1,224,1722
CHIHUAHUA,HIDALGO DEL PARRAL,8,242,1,251,1968
CHIHUAHUA,HIDALGO DEL PARRAL,5,208,3,216,1968
CHIHUAHUA,HIDALGO DEL PARRAL,35,451,13,499,1318
CHIHUAHUA,HIDALGO DEL PARRAL,28,498,15,541,1318
CHIHUAHUA,HIDALGO DEL PARRAL,11,117,25,153,1413
CHIHUAHUA,HIDALGO DEL PARRAL,10,293,11,314,1412
CHIHUAHUA,HIDALGO DEL PARRAL,16,293,16,325,1394
CHIHUAHUA,HIDALGO DEL PARRAL,24,295,11,330,1394
CHIHUAHUA,HIDALGO DEL PARRAL,9,346,5,360,2120
CHIHUAHUA,HIDALGO DEL PARRAL,7,109,5,121,1152
CHIHUAHUA,HIDALGO DEL PARRAL,13,123,6,142,1152
CHIHUAHUA,HIDALGO DEL PARRAL,17,343,0,360,2042
CHIHUAHUA,HIDALGO DEL PARRAL,15,323,10,348,2042
CHIHUAHUA,HIDALGO DEL PARRAL,6,217,2,225,2000
CHIHUAHUA,HIDALGO DEL PARRAL,10,234,1,245,1999
CHIHUAHUA,HIDALGO DEL PARRAL,7,90,1,98,1532
CHIHUAHUA,HIDALGO DEL PARRAL,6,90,1,97,1532
CHIHUAHUA,HIDALGO DEL PARRAL,6,69,1,76,1531
CHIHUAHUA,HIDALGO DEL PARRAL,10,112,2,124,1992
CHIHUAHUA,HIDALGO DEL PARRAL,9,129,0,138,1992
CHIHUAHUA,HIDALGO DEL PARRAL,11,171,3,185,1089
CHIHUAHUA,HIDALGO DEL PARRAL,7,172,6,185,1088
CHIHUAHUA,HIDALGO DEL PARRAL,23,291,7,321,1449
CHIHUAHUA,HIDALGO DEL PARRAL,16,335,7,358,1448
CHIHUAHUA,HIDALGO DEL PARRAL,44,491,50,585,1899
CHIHUAHUA,HIDALGO DEL PARRAL,34,714,21,769,1933
CHIHUAHUA,HIDALGO DEL PARRAL,29,540,32,601,1940
CHIHUAHUA,HIDALGO DEL PARRAL,13,640,3,656,1940
CHIHUAHUA,HIDALGO DEL PARRAL,28,408,43,479,1465
CHIHUAHUA,HIDALGO DEL PARRAL,35,402,43,480,1465
CHIHUAHUA,HIDALGO DEL PARRAL,13,70,3,86,1217
CHIHUAHUA,HIDALGO DEL PARRAL,7,70,1,78,1217
CHIHUAHUA,HIDALGO DEL PARRAL,5,97,5,107,1827
CIUDAD DE MÉXICO,GUSTAVO A. MADERO,14,311,4,329,1249
CIUDAD DE MÉXICO,GUSTAVO A. MADERO,11,292,9,312,1248
CIUDAD DE MÉXICO,GUSTAVO A. MADERO,31,416,2,449,1921
CIUDAD DE MÉXICO,GUSTAVO A. MADERO,37,414,11,462,1921
CIUDAD DE MÉXICO,GUSTAVO A. MADERO,6,257,8,271,1030
CIUDAD DE MÉXICO,GUSTAVO A. MADERO,9,252,5,266,1029
CIUDAD DE MÉXICO,GUSTAVO A. MADERO,11,404,19,434,1966
CIUDAD DE MÉXICO,GUSTAVO A. MADERO,22,439,6,467,1965
CIUDAD DE MÉXICO,GUSTAVO A. MADERO,22,399,14,435,1824
CIUDAD DE MÉXICO,GUSTAVO A. MADERO,21,453,7,481,1823
CIUDAD DE MÉXICO,GUSTAVO A. MADERO,21,359,3,383,1643
CIUDAD DE MÉXICO,GUSTAVO A. MADERO,23,390,7,420,1642
CIUDAD DE MÉXICO,GUSTAVO A. MADERO,22,329,3,354,1563
CIUDAD DE MÉXICO,GUSTAVO A. MADERO,15,386,6,407,1562
CIUDAD DE MÉXICO,GUSTAVO A. MADERO,27,404,1,432,1562
CIUDAD DE MÉXICO,GUSTAVO A. MADERO,27,323,15,365,1575
CIUDAD DE MÉXICO,GUSTAVO A. MADERO,19,326,10,355,1574
CIUDAD DE MÉXICO,GUSTAVO A. MADERO,25,359,7,391,1547
CIUDAD DE MÉXICO,GUSTAVO A. MADERO,15,377,10,402,1547
CIUDAD DE MÉXICO,GUSTAVO A. MADERO,33,363,6,402,1546
CIUDAD DE MÉXICO,GUSTAVO A. MADERO,31,328,4,363,1829
CIUDAD DE MÉXICO,GUSTAVO A. MADERO,20,361,11,392,1829
CIUDAD DE MÉXICO,GUSTAVO A. MADERO,21,394,9,424,1231
CIUDAD DE MÉXICO,GUSTAVO A. MADERO,6,142,1,149,1231
CIUDAD DE MÉXICO,GUSTAVO A. MADERO,19,333,4,356,1670
CIUDAD DE MÉXICO,GUSTAVO A. MADERO,29,331,5,365,1669
CIUDAD DE MÉXICO,GUSTAVO A. MADERO,29,397,12,438,1959
CIUDAD DE MÉXICO,GUSTAVO A. MADERO,53,448,4,505,1959
CIUDAD DE MÉXICO,GUSTAVO A. MADERO,21,340,2,363,1722
CIUDAD DE MÉXICO,GUSTAVO A. MADERO,46,343,10,399,1722
CIUDAD DE MÉXICO,GUSTAVO A. MADERO,14,296,7,317,1505
CIUDAD DE MÉXICO,GUSTAVO A. MADERO,14,348,4,366,1504
CIUDAD DE MÉXICO,GUSTAVO A. MADERO,21,364,9,394,1647
CIUDAD DE MÉXICO,GUSTAVO A. MADERO,2,380,0,382,1647
CIUDAD DE MÉXICO,GUSTAVO A. MADERO,22,213,8,243,1646
CIUDAD DE MÉXICO,GUSTAVO A. MADERO,27,352,6,385,1437
CIUDAD DE MÉXICO,GUSTAVO A. MADERO,36,312,5,353,1436
CIUDAD DE MÉXICO,GUSTAVO A. MADERO,21,356,9,386,1632
CIUDAD DE MÉXICO,GUSTAVO A. MADERO,29,342,3,374,1632
CIUDAD DE MÉXICO,GUSTAVO A. MADERO,20,364,7,391,1506
CIUDAD DE MÉXICO,GUSTAVO A. MADERO,36,339,0,375,1505
CIUDAD DE MÉXICO,GUSTAVO A. MADERO,32,350,5,387,1580
CIUDAD DE MÉXICO,GUSTAVO A. MADERO,28,351,5,384,1580
CIUDAD DE MÉXICO,GUSTAVO A. MADERO,19,385,6,410,1958
CIUDAD DE MÉXICO,GUSTAVO A. MADERO,9,431,9,449,1958
CIUDAD DE MÉXICO,GUSTAVO A. MADERO,29,360,4,393,1786
CIUDAD DE MÉXICO,GUSTAVO A. MADERO,25,382,3,410,1786
CIUDAD DE MÉXICO,GUSTAVO A. MADERO,20,288,5,313,1338
CIUDAD DE MÉXICO,GUSTAVO A. MADERO,19,290,0,309,1338
CIUDAD DE MÉXICO,GUSTAVO A. MADERO,13,312,5,330,1323
CIUDAD DE MÉXICO,GUSTAVO A. MADERO,22,314,0,336,1322
CIUDAD DE MÉXICO,GUSTAVO A. MADERO,22,306,9,337,1584
CIUDAD DE MÉXICO,GUSTAVO A. MADERO,23,293,3,319,1584
CIUDAD DE MÉXICO,GUSTAVO A. MADERO,20,268,5,293,1584
CIUDAD DE MÉXICO,GUSTAVO A. MADERO,20,314,12,346,1583
CIUDAD DE MÉXICO,GUSTAVO A. MADERO,20,316,12,348,1325
CIUDAD DE MÉXICO,GUSTAVO A. MADERO,10,315,6,331,1325
CIUDAD DE MÉXICO,GUSTAVO A. MADERO,22,319,6,347,1717
CIUDAD DE MÉXICO,GUSTAVO A. MADERO,23,334,3,360,1717
CIUDAD DE MÉXICO,GUSTAVO A. MADERO,22,296,1,319,1372
CIUDAD DE MÉXICO,GUSTAVO A. MADERO,22,312,5,339,1372
CIUDAD DE MÉXICO,GUSTAVO A. MADERO,24,303,5,332,1468
CIUDAD DE MÉXICO,GUSTAVO A. MADERO,23,254,7,284,1467
CIUDAD DE MÉXICO,GUSTAVO A. MADERO,28,364,6,398,1508
CIUDAD DE MÉXICO,GUSTAVO A. MADERO,28,321,0,349,1507
CIUDAD DE MÉXICO,GUSTAVO A. MADERO,21,307,7,335,1596
CIUDAD DE MÉXICO,GUSTAVO A. MADERO,19,334,7,360,1596
CIUDAD DE MÉXICO,GUSTAVO A. MADERO,25,337,12,374,1489
CIUDAD DE MÉXICO,GUSTAVO A. MADERO,24,356,10,390,1488
CIUDAD DE MÉXICO,GUSTAVO A. MADERO,33,332,18,383,1368
CIUDAD DE MÉXICO,GUSTAVO A. MADERO,18,368,6,392,1367
CIUDAD DE MÉXICO,GUSTAVO A. MADERO,15,218,6,239,1007
CIUDAD DE MÉXICO,GUSTAVO A. MADERO,10,187,5,202,1006
CIUDAD DE MÉXICO,GUSTAVO A. MADERO,15,304,4,323,1739
CIUDAD DE MÉXICO,GUSTAVO A. MADERO,18,348,9,375,1738
CIUDAD DE MÉXICO,GUSTAVO A. MADERO,20,354,5,379,1566
CIUDAD DE MÉXICO,GUSTAVO A. MADERO,33,363,8,404,1565
CIUDAD DE MÉXICO,GUSTAVO A. MADERO,33,409,5,447,1675
CIUDAD DE MÉXICO,GUSTAVO A. MADERO,32,356,9,397,1674
CIUDAD DE MÉXICO,GUSTAVO A. MADERO,32,346,5,383,1572
CIUDAD DE MÉXICO,GUSTAVO A. MADERO,24,290,5,319,1571
CIUDAD DE MÉXICO,GUSTAVO A. MADERO,23,267,5,295,1367
CIUDAD DE MÉXICO,GUSTAVO A. MADERO,11,252,2,265,1366
CIUDAD DE MÉXICO,GUSTAVO A. MADERO,20,388,24,432,1861
CIUDAD DE MÉXICO,GUSTAVO A. MADERO,23,407,3,433,1861
CIUDAD DE MÉXICO,GUSTAVO A. MADERO,12,244,9,265,1326
CIUDAD DE MÉXICO,GUSTAVO A. MADERO,13,266,8,287,1325
CIUDAD DE MÉXICO,GUSTAVO A. MADERO,16,254,2,272,1160
CIUDAD DE MÉXICO,GUSTAVO A. MADERO,13,291,5,309,1159
CIUDAD DE MÉXICO,GUSTAVO A. MADERO,31,395,7,433,1922
CIUDAD DE MÉXICO,GUSTAVO A. MADERO,25,406,6,437,1921
CIUDAD DE MÉXICO,GUSTAVO A. MADERO,24,295,1,320,1520
CIUDAD DE MÉXICO,GUSTAVO A. MADERO,11,285,4,300,1520
CIUDAD DE MÉXICO,GUSTAVO A. MADERO,19,282,4,305,1339
CIUDAD DE MÉXICO,GUSTAVO A. MADERO,24,257,8,289,1338
CIUDAD DE MÉXICO,GUSTAVO A. MADERO,19,262,3,284,1338
CIUDAD DE MÉXICO,GUSTAVO A. MADERO,30,364,5,399,1772
CIUDAD DE MÉXICO,GUSTAVO A. MADERO,18,412,7,437,1771
CIUDAD DE MÉXICO,GUSTAVO A. MADERO,18,415,4,437,1811
CIUDAD DE MÉXICO,GUSTAVO A. MADERO,32,379,14,425,1810
CIUDAD DE MÉXICO,GUSTAVO A. MADERO,31,408,10,449,1944
CIUDAD DE MÉXICO,GUSTAVO A. MADERO,400,18,6,424,1944
CIUDAD DE MÉXICO,GUSTAVO A. MADERO,16,288,2,306,1324
CIUDAD DE MÉXICO,GUSTAVO A. MADERO,14,278,3,295,1324
CIUDAD DE MÉXICO,GUSTAVO A. MADERO,21,260,7,288,1324
CIUDAD DE MÉXICO,GUSTAVO A. MADERO,16,294,3,313,1395
CIUDAD DE MÉXICO,GUSTAVO A. MADERO,25,273,8,306,1395
CIUDAD DE MÉXICO,GUSTAVO A. MADERO,54,1007,7,1068,0
CIUDAD DE MÉXICO,GUSTAVO A. MADERO,18,266,3,287,1370
CIUDAD DE MÉXICO,GUSTAVO A. MADERO,25,288,4,317,1369
CIUDAD DE MÉXICO,GUSTAVO A. MADERO,26,384,6,416,1761
CIUDAD DE MÉXICO,GUSTAVO A. MADERO,29,357,6,392,1760
CIUDAD DE MÉXICO,GUSTAVO A. MADERO,31,435,8,474,1923
CIUDAD DE MÉXICO,GUSTAVO A. MADERO,35,429,4,468,1922
CIUDAD DE MÉXICO,GUSTAVO A. MADERO,24,283,2,309,1495
CIUDAD DE MÉXICO,GUSTAVO A. MADERO,17,297,8,322,1494
CIUDAD DE MÉXICO,GUSTAVO A. MADERO,9,261,4,274,1549
CIUDAD DE MÉXICO,GUSTAVO A. MADERO,12,299,12,323,1548
CIUDAD DE MÉXICO,GUSTAVO A. MADERO,11,245,2,258,1548
CIUDAD DE MÉXICO,GUSTAVO A. MADERO,18,298,2,318,1579
CIUDAD DE MÉXICO,GUSTAVO A. MADERO,29,282,2,313,1578
CIUDAD DE MÉXICO,GUSTAVO A. MADERO,18,251,4,273,1162
CIUDAD DE MÉXICO,GUSTAVO A. MADERO,14,220,1,235,1161
CIUDAD DE MÉXICO,GUSTAVO A. MADERO,27,296,7,330,1514
CIUDAD DE MÉXICO,GUSTAVO A. MADERO,19,295,11,325,1514
CIUDAD DE MÉXICO,GUSTAVO A. MADERO,31,358,7,396,1779
CIUDAD DE MÉXICO,GUSTAVO A. MADERO,12,308,4,324,1778
CIUDAD DE MÉXICO,GUSTAVO A. MADERO,17,380,0,397,1646
CIUDAD DE MÉXICO,GUSTAVO A. MADERO,20,384,3,407,1645
CIUDAD DE MÉXICO,GUSTAVO A. MADERO,26,306,6,338,1645
CIUDAD DE MÉXICO,GUSTAVO A. MADERO,22,326,2,350,1323
CIUDAD DE MÉXICO,GUSTAVO A. MADERO,26,308,3,337,1322
CIUDAD DE MÉXICO,GUSTAVO A. MADERO,37,428,8,473,1893
CIUDAD DE MÉXICO,GUSTAVO A. MADERO,39,398,9,446,1893
CIUDAD DE MÉXICO,GUSTAVO A. MADERO,36,338,3,377,1637
CIUDAD DE MÉXICO,GUSTAVO A. MADERO,33,302,1,336,1637
CIUDAD DE MÉXICO,GUSTAVO A. MADERO,23,368,3,394,1663
CIUDAD DE MÉXICO,GUSTAVO A. MADERO,35,376,3,414,1663
CIUDAD DE MÉXICO,GUSTAVO A. MADERO,30,318,9,357,1904
CIUDAD DE MÉXICO,GUSTAVO A. MADERO,32,321,3,356,1904
CIUDAD DE MÉXICO,GUSTAVO A. MADERO,25,383,1,409,1964
CIUDAD DE MÉXICO,GUSTAVO A. MADERO,29,402,0,431,1963
CIUDAD DE MÉXICO,GUSTAVO A. MADERO,11,312,3,326,1456
CIUDAD DE MÉXICO,GUSTAVO A. MADERO,13,295,4,312,1455
CIUDAD DE MÉXICO,GUSTAVO A. MADERO,14,275,1,290,1497
CIUDAD DE MÉXICO,GUSTAVO A. MADERO,25,292,6,323,1497
CIUDAD DE MÉXICO,GUSTAVO A. MADERO,18,295,3,316,1496
CIUDAD DE MÉXICO,GUSTAVO A. MADERO,14,267,7,288,1672
CIUDAD DE MÉXICO,GUSTAVO A. MADERO,14,308,4,326,1672
CIUDAD DE MÉXICO,GUSTAVO A. MADERO,17,327,2,346,1671
CIUDAD DE MÉXICO,GUSTAVO A. MADERO,21,318,3,342,1902
CIUDAD DE MÉXICO,GUSTAVO A. MADERO,17,367,3,387,1901
CIUDAD DE MÉXICO,GUSTAVO A. MADERO,44,262,4,310,1686
CIUDAD DE MÉXICO,GUSTAVO A. MADERO,39,284,1,324,1686
CIUDAD DE MÉXICO,GUSTAVO A. MADERO,25,214,1,240,1405
CIUDAD DE MÉXICO,GUSTAVO A. MADERO,36,225,2,263,1404
CIUDAD DE MÉXICO,GUSTAVO A. MADERO,20,244,3,267,1404
CIUDAD DE MÉXICO,GUSTAVO A. MADERO,20,225,3,248,1673
CIUDAD DE MÉXICO,GUSTAVO A. MADERO,23,251,4,278,1672
CIUDAD DE MÉXICO,GUSTAVO A. MADERO,44,258,0,302,1479
CIUDAD DE MÉXICO,GUSTAVO A. MADERO,42,252,5,299,1479
CIUDAD DE MÉXICO,GUSTAVO A. MADERO,48,259,1,308,1478
CIUDAD DE MÉXICO,GUSTAVO A. MADERO,22,195,0,217,1084
CIUDAD DE MÉXICO,GUSTAVO A. MADERO,26,201,2,229,1084
CIUDAD DE MÉXICO,GUSTAVO A. MADERO,43,285,2,330,1614
CIUDAD DE MÉXICO,GUSTAVO A. MADERO,39,239,1,279,1614
CIUDAD DE MÉXICO,GUSTAVO A. MADERO,25,258,3,286,1613
CIUDAD DE MÉXICO,GUSTAVO A. MADERO,39,299,3,341,1770
CIUDAD DE MÉXICO,GUSTAVO A. MADERO,33,316,6,355,1770
CIUDAD DE MÉXICO,GUSTAVO A. MADERO,29,281,5,315,1769
CIUDAD DE MÉXICO,GUSTAVO A. MADERO,24,307,2,333,1637
CIUDAD DE MÉXICO,GUSTAVO A. MADERO,30,361,11,402,1636
CIUDAD DE MÉXICO,GUSTAVO A. MADERO,23,409,2,434,1768
CIUDAD DE MÉXICO,GUSTAVO A. MADERO,34,375,1,410,1767
CIUDAD DE MÉXICO,GUSTAVO A. MADERO,24,249,4,277,1403
CIUDAD DE MÉXICO,GUSTAVO A. MADERO,22,203,2,227,1403
CIUDAD DE MÉXICO,GUSTAVO A. MADERO,28,289,2,319,1402
CIUDAD DE MÉXICO,GUSTAVO A. MADERO,21,355,4,380,1848
CIUDAD DE MÉXICO,GUSTAVO A. MADERO,30,333,12,375,1848
CIUDAD DE MÉXICO,GUSTAVO A. MADERO,43,415,4,462,1814
CIUDAD DE MÉXICO,GUSTAVO A. MADERO,59,336,7,402,1814
CIUDAD DE MÉXICO,GUSTAVO A. MADERO,19,240,2,261,1419
CIUDAD DE MÉXICO,GUSTAVO A. MADERO,34,259,3,296,1419
CIUDAD DE MÉXICO,GUSTAVO A. MADERO,37,260,0,297,1418
CIUDAD DE MÉXICO,GUSTAVO A. MADERO,38,285,3,326,1661
CIUDAD DE MÉXICO,GUSTAVO A. MADERO,34,291,2,327,1660
CIUDAD DE MÉXICO,GUSTAVO A. MADERO,24,270,3,297,1660
CIUDAD DE MÉXICO,GUSTAVO A. MADERO,29,318,1,348,1894
CIUDAD DE MÉXICO,GUSTAVO A. MADERO,36,293,5,334,1894
CIUDAD DE MÉXICO,GUSTAVO A. MADERO,47,291,0,338,1893
CIUDAD DE MÉXICO,GUSTAVO A. MADERO,40,217,1,258,1389
CIUDAD DE MÉXICO,GUSTAVO A. MADERO,48,204,3,255,1389
CIUDAD DE MÉXICO,GUSTAVO A. MADERO,34,236,2,272,1389
CIUDAD DE MÉXICO,GUSTAVO A. MADERO,34,266,2,302,1787
CIUDAD DE MÉXICO,GUSTAVO A. MADERO,36,255,2,293,1786
CIUDAD DE MÉXICO,GUSTAVO A. MADERO,37,295,3,335,1945
CIUDAD DE MÉXICO,GUSTAVO A. MADERO,42,292,9,343,1945
CIUDAD DE MÉXICO,GUSTAVO A. MADERO,38,257,5,300,1727
CIUDAD DE MÉXICO,GUSTAVO A. MADERO,39,302,2,343,1727
CIUDAD DE MÉXICO,GUSTAVO A. MADERO,37,256,3,296,1483
CIUDAD DE MÉXICO,GUSTAVO A. MADERO,26,264,9,299,1482
CIUDAD DE MÉXICO,GUSTAVO A. MADERO,44,363,2,409,1924
CIUDAD DE MÉXICO,GUSTAVO A. MADERO,51,384,4,439,1923
CIUDAD DE MÉXICO,GUSTAVO A. MADERO,34,334,6,374,1950
CIUDAD DE MÉXICO,GUSTAVO A. MADERO,36,326,9,371,1950
CIUDAD DE MÉXICO,GUSTAVO A. MADERO,37,255,6,298,1528
CIUDAD DE MÉXICO,GUSTAVO A. MADERO,27,272,2,301,1528
CIUDAD DE MÉXICO,GUSTAVO A. MADERO,23,294,2,319,1527
CIUDAD DE MÉXICO,GUSTAVO A. MADERO,36,197,4,237,1854
CIUDAD DE MÉXICO,GUSTAVO A. MADERO,31,191,1,223,1854
CIUDAD DE MÉXICO,GUSTAVO A. MADERO,35,190,0,225,1853
CIUDAD DE MÉXICO,GUSTAVO A. MADERO,42,196,2,240,1624
CIUDAD DE MÉXICO,GUSTAVO A. MADERO,40,204,0,244,1623
CIUDAD DE MÉXICO,GUSTAVO A. MADERO,30,199,3,232,1623
CIUDAD DE MÉXICO,GUSTAVO A. MADERO,36,163,2,201,1415
CIUDAD DE MÉXICO,GUSTAVO A. MADERO,33,210,0,243,1415
CIUDAD DE MÉXICO,GUSTAVO A. MADERO,31,191,2,224,1414
CIUDAD DE MÉXICO,GUSTAVO A. MADERO,38,177,7,222,1406
CIUDAD DE MÉXICO,GUSTAVO A. MADERO,34,189,9,232,1406
CIUDAD DE MÉXICO,GUSTAVO A. MADERO,147,1246,15,1408,0
CIUDAD DE MÉXICO,GUSTAVO A. MADERO,37,309,3,349,1866
CIUDAD DE MÉXICO,GUSTAVO A. MADERO,45,313,4,362,1865
CIUDAD DE MÉXICO,GUSTAVO A. MADERO,33,180,4,217,1668
CIUDAD DE MÉXICO,GUSTAVO A. MADERO,36,283,0,319,1668
CIUDAD DE MÉXICO,GUSTAVO A. MADERO,29,217,4,250,1668
CIUDAD DE MÉXICO,GUSTAVO A. MADERO,32,198,3,233,1352
CIUDAD DE MÉXICO,GUSTAVO A. MADERO,38,180,0,218,1351
CIUDAD DE MÉXICO,GUSTAVO A. MADERO,28,163,2,193,1351
CIUDAD DE MÉXICO,GUSTAVO A. MADERO,33,135,3,171,1046
CIUDAD DE MÉXICO,GUSTAVO A. MADERO,26,155,1,182,1046
CIUDAD DE MÉXICO,GUSTAVO A. MADERO,36,267,3,306,1973
CIUDAD DE MÉXICO,GUSTAVO A. MADERO,34,264,5,303,1972
CIUDAD DE MÉXICO,GUSTAVO A. MADERO,54,201,2,257,1606
CIUDAD DE MÉXICO,GUSTAVO A. MADERO,38,208,4,250,1606
CIUDAD DE MÉXICO,GUSTAVO A. MADERO,35,200,4,239,1605
CIUDAD DE MÉXICO,GUSTAVO A. MADERO,21,162,2,185,1392
CIUDAD DE MÉXICO,GUSTAVO A. MADERO,34,192,3,229,1392
CIUDAD DE MÉXICO,GUSTAVO A. MADERO,31,196,3,230,1391
CIUDAD DE MÉXICO,GUSTAVO A. MADERO,45,223,4,272,1745
CIUDAD DE MÉXICO,GUSTAVO A. MADERO,36,240,4,280,1745
CIUDAD DE MÉXICO,GUSTAVO A. MADERO,28,150,2,180,1017
CIUDAD DE MÉXICO,GUSTAVO A. MADERO,21,148,0,169,1017
CIUDAD DE MÉXICO,GUSTAVO A. MADERO,43,259,4,306,1897
CIUDAD DE MÉXICO,GUSTAVO A. MADERO,51,274,4,329,1896
CIUDAD DE MÉXICO,GUSTAVO A. MADERO,44,291,10,345,1557
CIUDAD DE MÉXICO,GUSTAVO A. MADERO,33,291,6,330,1557
CIUDAD DE MÉXICO,GUSTAVO A. MADERO,45,290,0,335,1556
CIUDAD DE MÉXICO,GUSTAVO A. MADERO,30,251,0,281,1927
CIUDAD DE MÉXICO,GUSTAVO A. MADERO,31,240,3,274,1926
CIUDAD DE MÉXICO,GUSTAVO A. MADERO,33,269,5,307,1704
CIUDAD DE MÉXICO,GUSTAVO A. MADERO,41,326,2,369,1704
CIUDAD DE MÉXICO,GUSTAVO A. MADERO,30,161,3,194,1034
CIUDAD DE MÉXICO,GUSTAVO A. MADERO,19,157,2,178,1034
CIUDAD DE MÉXICO,GUSTAVO A. MADERO,33,262,6,301,1693
CIUDAD DE MÉXICO,GUSTAVO A. MADERO,38,294,3,335,1692
CIUDAD DE MÉXICO,GUSTAVO A. MADERO,37,240,1,278,1415
CIUDAD DE MÉXICO,GUSTAVO A. MADERO,32,275,6,313,1414
CIUDAD DE MÉXICO,GUSTAVO A. MADERO,34,273,0,307,1414
CIUDAD DE MÉXICO,GUSTAVO A. MADERO,54,227,7,288,1988
CIUDAD DE MÉXICO,GUSTAVO A. MADERO,47,238,5,290,1987
CIUDAD DE MÉXICO,GUSTAVO A. MADERO,20,174,4,198,1051
CIUDAD DE MÉXICO,GUSTAVO A. MADERO,27,164,0,191,1051
CIUDAD DE MÉXICO,GUSTAVO A. MADERO,24,259,3,286,1817
CIUDAD DE MÉXICO,GUSTAVO A. MADERO,42,320,5,367,1817
CIUDAD DE MÉXICO,GUSTAVO A. MADERO,38,294,4,336,1641
CIUDAD DE MÉXICO,GUSTAVO A. MADERO,44,291,6,341,1641
CIUDAD DE MÉXICO,GUSTAVO A. MADERO,35,195,3,233,1221
CIUDAD DE MÉXICO,GUSTAVO A. MADERO,22,214,4,240,1221
CIUDAD DE MÉXICO,GUSTAVO A. MADERO,17,213,0,230,1630
CIUDAD DE MÉXICO,GUSTAVO A. MADERO,228,51,1,280,1630
CIUDAD DE MÉXICO,GUSTAVO A. MADERO,23,277,1,301,1690
CIUDAD DE MÉXICO,GUSTAVO A. MADERO,31,262,2,295,1690
CIUDAD DE MÉXICO,GUSTAVO A. MADERO,31,269,2,302,1689
CIUDAD DE MÉXICO,GUSTAVO A. MADERO,34,249,1,284,1683
CIUDAD DE MÉXICO,GUSTAVO A. MADERO,48,240,3,291,1682
CIUDAD DE MÉXICO,GUSTAVO A. MADERO,23,197,1,221,1186
CIUDAD DE MÉXICO,GUSTAVO A. MADERO,20,173,1,194,1185
CIUDAD DE MÉXICO,GUSTAVO A. MADERO,22,257,2,281,1761
CIUDAD DE MÉXICO,GUSTAVO A. MADERO,38,250,6,294,1760
CIUDAD DE MÉXICO,GUSTAVO A. MADERO,21,214,1,236,1198
CIUDAD DE MÉXICO,GUSTAVO A. MADERO,23,222,8,253,1197
CIUDAD DE MÉXICO,GUSTAVO A. MADERO,44,339,1,384,1793
CIUDAD DE MÉXICO,GUSTAVO A. MADERO,31,352,4,387,1793
CIUDAD DE MÉXICO,GUSTAVO A. MADERO,47,307,7,361,1831
CIUDAD DE MÉXICO,GUSTAVO A. MADERO,35,305,2,342,1831
CIUDAD DE MÉXICO,GUSTAVO A. MADERO,30,308,6,344,1704
CIUDAD DE MÉXICO,GUSTAVO A. MADERO,43,290,1,334,1704
CIUDAD DE MÉXICO,GUSTAVO A. MADERO,28,182,4,214,1096
CIUDAD DE MÉXICO,GUSTAVO A. MADERO,25,173,1,199,1096
CIUDAD DE MÉXICO,GUSTAVO A. MADERO,31,235,2,268,1415
CIUDAD DE MÉXICO,GUSTAVO A. MADERO,39,262,3,304,1415
CIUDAD DE MÉXICO,GUSTAVO A. MADERO,51,309,6,366,1841
CIUDAD DE MÉXICO,GUSTAVO A. MADERO,41,338,2,381,1841
CIUDAD DE MÉXICO,GUSTAVO A. MADERO,0,352,0,352,1764
CIUDAD DE MÉXICO,GUSTAVO A. MADERO,34,313,4,351,1764
CIUDAD DE MÉXICO,GUSTAVO A. MADERO,34,311,4,349,1784
CIUDAD DE MÉXICO,GUSTAVO A. MADERO,32,294,3,329,1783
CIUDAD DE MÉXICO,GUSTAVO A. MADERO,41,300,4,345,1505
CIUDAD DE MÉXICO,GUSTAVO A. MADERO,30,303,0,333,1505
CIUDAD DE MÉXICO,GUSTAVO A. MADERO,29,307,1,337,1505
CIUDAD DE MÉXICO,GUSTAVO A. MADERO,14,250,6,270,1331
CIUDAD DE MÉXICO,GUSTAVO A. MADERO,16,261,5,282,1330
CIUDAD DE MÉXICO,GUSTAVO A. MADERO,27,250,3,280,1634
CIUDAD DE MÉXICO,GUSTAVO A. MADERO,26,258,5,289,1634
CIUDAD DE MÉXICO,GUSTAVO A. MADERO,40,236,4,280,1633
CIUDAD DE MÉXICO,GUSTAVO A. MADERO,40,266,8,314,1516
CIUDAD DE MÉXICO,GUSTAVO A. MADERO,29,263,4,296,1516
CIUDAD DE MÉXICO,GUSTAVO A. MADERO,31,254,3,288,1516
CIUDAD DE MÉXICO,GUSTAVO A. MADERO,49,144,3,196,1688
CIUDAD DE MÉXICO,GUSTAVO A. MADERO,33,158,1,192,1688
CIUDAD DE MÉXICO,GUSTAVO A. MADERO,33,138,1,172,1688
CIUDAD DE MÉXICO,GUSTAVO A. MADERO,32,164,4,200,1687
CIUDAD DE MÉXICO,GUSTAVO A. MADERO,40,292,4,336,1776
CIUDAD DE MÉXICO,GUSTAVO A. MADERO,40,291,3,334,1775
CIUDAD DE MÉXICO,GUSTAVO A. MADERO,31,158,1,190,1868
CIUDAD DE MÉXICO,GUSTAVO A. MADERO,35,186,3,224,1868
CIUDAD DE MÉXICO,GUSTAVO A. MADERO,29,303,3,335,1933
CIUDAD DE MÉXICO,GUSTAVO A. MADERO,36,316,6,358,1933
CIUDAD DE MÉXICO,GUSTAVO A. MADERO,42,276,7,325,1706
CIUDAD DE MÉXICO,GUSTAVO A. MADERO,25,321,5,351,1706
CIUDAD DE MÉXICO,GUSTAVO A. MADERO,47,348,3,398,1705
CIUDAD DE MÉXICO,GUSTAVO A. MADERO,37,231,3,271,1370
CIUDAD DE MÉXICO,GUSTAVO A. MADERO,23,200,9,232,1369
CIUDAD DE MÉXICO,GUSTAVO A. MADERO,28,291,5,324,1735
CIUDAD DE MÉXICO,GUSTAVO A. MADERO,28,291,5,324,1735
CIUDAD DE MÉXICO,GUSTAVO A. MADERO,34,288,1,323,1734
CIUDAD DE MÉXICO,GUSTAVO A. MADERO,23,279,8,310,1890
CIUDAD DE MÉXICO,GUSTAVO A. MADERO,20,258,8,286,1890
CIUDAD DE MÉXICO,GUSTAVO A. MADERO,32,169,3,204,1718
CIUDAD DE MÉXICO,GUSTAVO A. MADERO,17,190,2,209,1718
CIUDAD DE MÉXICO,GUSTAVO A. MADERO,28,173,6,207,1915
CIUDAD DE MÉXICO,GUSTAVO A. MADERO,31,136,1,168,1914
CIUDAD DE MÉXICO,GUSTAVO A. MADERO,25,229,4,258,1349
CIUDAD DE MÉXICO,GUSTAVO A. MADERO,20,246,0,266,1349
CIUDAD DE MÉXICO,GUSTAVO A. MADERO,29,120,6,155,1006
CIUDAD DE MÉXICO,GUSTAVO A. MADERO,22,144,1,167,1006
CIUDAD DE MÉXICO,GUSTAVO A. MADERO,32,289,4,325,1513
CIUDAD DE MÉXICO,GUSTAVO A. MADERO,17,267,0,284,1513
CIUDAD DE MÉXICO,GUSTAVO A. MADERO,24,243,8,275,1180
CIUDAD DE MÉXICO,GUSTAVO A. MADERO,23,253,3,279,1180
CIUDAD DE MÉXICO,GUSTAVO A. MADERO,26,260,3,289,1396
CIUDAD DE MÉXICO,GUSTAVO A. MADERO,27,275,2,304,1395
CIUDAD DE MÉXICO,GUSTAVO A. MADERO,47,351,8,406,1808
CIUDAD DE MÉXICO,GUSTAVO A. MADERO,21,366,8,395,1808
CIUDAD DE MÉXICO,GUSTAVO A. MADERO,17,214,1,232,1036
CIUDAD DE MÉXICO,GUSTAVO A. MADERO,18,173,1,192,1036
CIUDAD DE MÉXICO,GUSTAVO A. MADERO,46,290,10,346,1899
CIUDAD DE MÉXICO,GUSTAVO A. MADERO,23,359,0,382,1898
CIUDAD DE MÉXICO,GUSTAVO A. MADERO,41,315,8,364,1538
CIUDAD DE MÉXICO,GUSTAVO A. MADERO,42,321,3,366,1538
CIUDAD DE MÉXICO,GUSTAVO A. MADERO,45,233,4,282,1588
CIUDAD DE MÉXICO,GUSTAVO A. MADERO,61,231,5,297,1587
CIUDAD DE MÉXICO,GUSTAVO A. MADERO,41,231,4,276,1456
CIUDAD DE MÉXICO,GUSTAVO A. MADERO,40,232,15,287,1455
CIUDAD DE MÉXICO,GUSTAVO A. MADERO,43,232,0,275,1604
CIUDAD DE MÉXICO,GUSTAVO A. MADERO,19,255,1,275,1604
CIUDAD DE MÉXICO,GUSTAVO A. MADERO,33,211,6,250,1603
CIUDAD DE MÉXICO,GUSTAVO A. MADERO,38,247,2,287,1580
CIUDAD DE MÉXICO,GUSTAVO A. MADERO,37,217,2,256,1579
CIUDAD DE MÉXICO,GUSTAVO A. MADERO,36,295,3,334,1868
CIUDAD DE MÉXICO,GUSTAVO A. MADERO,44,295,2,341,1868
CIUDAD DE MÉXICO,GUSTAVO A. MADERO,14,308,6,328,1734
CIUDAD DE MÉXICO,GUSTAVO A. MADERO,23,270,3,296,1733
CIUDAD DE MÉXICO,GUSTAVO A. MADERO,32,251,3,286,1335
CIUDAD DE MÉXICO,GUSTAVO A. MADERO,24,233,3,260,1335
CIUDAD DE MÉXICO,GUSTAVO A. MADERO,31,253,5,289,1335
CIUDAD DE MÉXICO,GUSTAVO A. MADERO,39,308,0,347,1873
CIUDAD DE MÉXICO,GUSTAVO A. MADERO,35,357,4,396,1872
CIUDAD DE MÉXICO,GUSTAVO A. MADERO,30,203,2,235,1600
CIUDAD DE MÉXICO,GUSTAVO A. MADERO,22,224,3,249,1600
CIUDAD DE MÉXICO,GUSTAVO A. MADERO,39,219,2,260,1599
CIUDAD DE MÉXICO,GUSTAVO A. MADERO,31,248,5,284,1413
CIUDAD DE MÉXICO,GUSTAVO A. MADERO,27,255,5,287,1412
CIUDAD DE MÉXICO,GUSTAVO A. MADERO,23,266,5,294,1412
CIUDAD DE MÉXICO,GUSTAVO A. MADERO,34,249,3,286,1556
CIUDAD DE MÉXICO,GUSTAVO A. MADERO,35,288,4,327,1555
CIUDAD DE MÉXICO,GUSTAVO A. MADERO,28,204,4,236,1051
CIUDAD DE MÉXICO,GUSTAVO A. MADERO,22,185,1,208,1051
CIUDAD DE MÉXICO,GUSTAVO A. MADERO,42,289,4,335,1655
CIUDAD DE MÉXICO,GUSTAVO A. MADERO,42,301,2,345,1655
CIUDAD DE MÉXICO,GUSTAVO A. MADERO,35,225,8,268,1870
CIUDAD DE MÉXICO,GUSTAVO A. MADERO,27,206,5,238,1869
CIUDAD DE MÉXICO,GUSTAVO A. MADERO,32,297,1,330,1878
CIUDAD DE MÉXICO,GUSTAVO A. MADERO,31,326,1,358,1877
CIUDAD DE MÉXICO,GUSTAVO A. MADERO,23,276,1,300,1409
CIUDAD DE MÉXICO,GUSTAVO A. MADERO,33,283,2,318,1409
CIUDAD DE MÉXICO,GUSTAVO A. MADERO,36,258,3,297,1398
CIUDAD DE MÉXICO,GUSTAVO A. MADERO,19,244,4,267,1398
CIUDAD DE MÉXICO,GUSTAVO A. MADERO,18,300,1,319,1397
CIUDAD DE MÉXICO,GUSTAVO A. MADERO,24,315,5,344,1638
CIUDAD DE MÉXICO,GUSTAVO A. MADERO,23,330,6,359,1637
CIUDAD DE MÉXICO,GUSTAVO A. MADERO,32,270,3,305,1565
CIUDAD DE MÉXICO,GUSTAVO A. MADERO,36,262,3,301,1565
CIUDAD DE MÉXICO,GUSTAVO A. MADERO,36,323,4,363,1829
CIUDAD DE MÉXICO,GUSTAVO A. MADERO,28,334,0,362,1828
CIUDAD DE MÉXICO,GUSTAVO A. MADERO,27,209,2,238,1303
CIUDAD DE MÉXICO,GUSTAVO A. MADERO,29,206,0,235,1303
CIUDAD DE MÉXICO,GUSTAVO A. MADERO,35,256,2,293,1782
CIUDAD DE MÉXICO,GUSTAVO A. MADERO,35,295,4,334,1781
CIUDAD DE MÉXICO,GUSTAVO A. MADERO,33,239,0,272,1781
CIUDAD DE MÉXICO,GUSTAVO A. MADERO,52,231,8,291,1781
CIUDAD DE MÉXICO,GUSTAVO A. MADERO,27,311,5,343,1517
CIUDAD DE MÉXICO,GUSTAVO A. MADERO,29,263,3,295,1516
CIUDAD DE MÉXICO,GUSTAVO A. MADERO,34,325,5,364,1660
CIUDAD DE MÉXICO,GUSTAVO A. MADERO,38,304,4,346,1660
CIUDAD DE MÉXICO,GUSTAVO A. MADERO,44,364,1,409,1849
CIUDAD DE MÉXICO,GUSTAVO A. MADERO,35,363,4,402,1848
CIUDAD DE MÉXICO,GUSTAVO A. MADERO,26,268,2,296,1438
CIUDAD DE MÉXICO,GUSTAVO A. MADERO,24,261,5,290,1438
CIUDAD DE MÉXICO,GUSTAVO A. MADERO,22,235,1,258,1438
CIUDAD DE MÉXICO,GUSTAVO A. MADERO,42,334,8,384,1931
CIUDAD DE MÉXICO,GUSTAVO A. MADERO,45,366,2,413,1930
CIUDAD DE MÉXICO,GUSTAVO A. MADERO,26,246,4,276,1407
CIUDAD DE MÉXICO,GUSTAVO A. MADERO,29,203,2,234,1406
CIUDAD DE MÉXICO,GUSTAVO A. MADERO,34,249,1,284,1406
CIUDAD DE MÉXICO,GUSTAVO A. MADERO,52,256,8,316,1843
CIUDAD DE MÉXICO,GUSTAVO A. MADERO,40,248,5,293,1843
CIUDAD DE MÉXICO,GUSTAVO A. MADERO,33,228,2,263,1578
CIUDAD DE MÉXICO,GUSTAVO A. MADERO,35,225,3,263,1578
CIUDAD DE MÉXICO,GUSTAVO A. MADERO,32,288,4,324,1903
CIUDAD DE MÉXICO,GUSTAVO A. MADERO,31,289,8,328,1902
CIUDAD DE MÉXICO,AZCAPOTZALCO,31,312,7,350,1537
CIUDAD DE MÉXICO,AZCAPOTZALCO,44,295,4,343,1537
CIUDAD DE MÉXICO,AZCAPOTZALCO,40,247,3,290,1536
CIUDAD DE MÉXICO,AZCAPOTZALCO,38,366,5,409,1824
CIUDAD DE MÉXICO,AZCAPOTZALCO,35,380,8,423,1824
CIUDAD DE MÉXICO,AZCAPOTZALCO,29,359,2,390,1823
CIUDAD DE MÉXICO,AZCAPOTZALCO,41,216,4,261,1483
CIUDAD DE MÉXICO,AZCAPOTZALCO,33,205,1,239,1483
CIUDAD DE MÉXICO,AZCAPOTZALCO,23,207,3,233,1483
CIUDAD DE MÉXICO,AZCAPOTZALCO,26,203,1,230,1394
CIUDAD DE MÉXICO,AZCAPOTZALCO,22,182,5,209,1394
CIUDAD DE MÉXICO,AZCAPOTZALCO,28,192,2,222,1394
CIUDAD DE MÉXICO,AZCAPOTZALCO,28,313,5,346,1756
CIUDAD DE MÉXICO,AZCAPOTZALCO,44,292,13,349,1755
CIUDAD DE MÉXICO,AZCAPOTZALCO,19,206,2,227,1152
CIUDAD DE MÉXICO,AZCAPOTZALCO,24,201,5,230,1152
CIUDAD DE MÉXICO,AZCAPOTZALCO,43,262,4,309,1724
CIUDAD DE MÉXICO,AZCAPOTZALCO,34,248,5,287,1723
CIUDAD DE MÉXICO,AZCAPOTZALCO,44,272,6,322,1723
CIUDAD DE MÉXICO,AZCAPOTZALCO,26,225,3,254,1358
CIUDAD DE MÉXICO,AZCAPOTZALCO,25,230,7,262,1358
CIUDAD DE MÉXICO,AZCAPOTZALCO,29,201,2,232,1357
CIUDAD DE MÉXICO,AZCAPOTZALCO,44,195,3,242,1528
CIUDAD DE MÉXICO,AZCAPOTZALCO,41,223,8,272,1528
CIUDAD DE MÉXICO,AZCAPOTZALCO,46,278,5,329,1711
CIUDAD DE MÉXICO,AZCAPOTZALCO,29,254,6,289,1711
CIUDAD DE MÉXICO,AZCAPOTZALCO,33,243,1,277,1711
CIUDAD DE MÉXICO,AZCAPOTZALCO,28,241,4,273,1450
CIUDAD DE MÉXICO,AZCAPOTZALCO,39,206,2,247,1449
CIUDAD DE MÉXICO,AZCAPOTZALCO,35,226,1,262,1328
CIUDAD DE MÉXICO,AZCAPOTZALCO,31,228,4,263,1327
CIUDAD DE MÉXICO,AZCAPOTZALCO,45,235,6,286,1327
CIUDAD DE MÉXICO,AZCAPOTZALCO,42,234,2,278,1589
CIUDAD DE MÉXICO,AZCAPOTZALCO,49,230,6,285,1589
CIUDAD DE MÉXICO,AZCAPOTZALCO,45,346,7,398,1828
CIUDAD DE MÉXICO,AZCAPOTZALCO,37,308,15,360,1828
CIUDAD DE MÉXICO,AZCAPOTZALCO,38,216,5,259,1411
CIUDAD DE MÉXICO,AZCAPOTZALCO,26,260,0,286,1411
CIUDAD DE MÉXICO,AZCAPOTZALCO,24,219,3,246,1410
CIUDAD DE MÉXICO,AZCAPOTZALCO,33,273,5,311,1397
CIUDAD DE MÉXICO,AZCAPOTZALCO,27,322,4,353,1396
CIUDAD DE MÉXICO,AZCAPOTZALCO,35,313,7,355,1720
CIUDAD DE MÉXICO,AZCAPOTZALCO,40,336,5,381,1719
CIUDAD DE MÉXICO,AZCAPOTZALCO,23,265,6,294,1368
CIUDAD DE MÉXICO,AZCAPOTZALCO,15,265,1,281,1368
CIUDAD DE MÉXICO,AZCAPOTZALCO,25,250,4,279,1368
CIUDAD DE MÉXICO,AZCAPOTZALCO,29,338,6,373,1926
CIUDAD DE MÉXICO,AZCAPOTZALCO,34,362,5,401,1926
CIUDAD DE MÉXICO,AZCAPOTZALCO,33,263,5,301,1307
CIUDAD DE MÉXICO,AZCAPOTZALCO,29,228,5,262,1306
CIUDAD DE MÉXICO,AZCAPOTZALCO,18,204,3,225,1018
CIUDAD DE MÉXICO,AZCAPOTZALCO,19,196,1,216,1018
CIUDAD DE MÉXICO,AZCAPOTZALCO,41,247,8,296,1422
CIUDAD DE MÉXICO,AZCAPOTZALCO,30,245,5,280,1422
CIUDAD DE MÉXICO,AZCAPOTZALCO,38,371,3,412,1969
CIUDAD DE MÉXICO,AZCAPOTZALCO,27,368,6,401,1969
CIUDAD DE MÉXICO,AZCAPOTZALCO,27,357,5,389,1817
CIUDAD DE MÉXICO,AZCAPOTZALCO,37,358,6,401,1817
CIUDAD DE MÉXICO,AZCAPOTZALCO,38,223,2,263,1386
CIUDAD DE MÉXICO,AZCAPOTZALCO,36,234,2,272,1386
CIUDAD DE MÉXICO,AZCAPOTZALCO,31,216,9,256,1385
CIUDAD DE MÉXICO,AZCAPOTZALCO,17,227,1,245,1280
CIUDAD DE MÉXICO,AZCAPOTZALCO,22,232,2,256,1280
CIUDAD DE MÉXICO,AZCAPOTZALCO,14,247,2,263,1526
CIUDAD DE MÉXICO,AZCAPOTZALCO,22,282,3,307,1525
CIUDAD DE MÉXICO,AZCAPOTZALCO,24,283,5,312,1525
CIUDAD DE MÉXICO,AZCAPOTZALCO,56,302,7,365,1606
CIUDAD DE MÉXICO,AZCAPOTZALCO,53,262,3,318,1605
CIUDAD DE MÉXICO,AZCAPOTZALCO,166,1386,17,1569,0
CIUDAD DE MÉXICO,AZCAPOTZALCO,33,314,3,350,1775
CIUDAD DE MÉXICO,AZCAPOTZALCO,45,326,5,376,1774
CIUDAD DE MÉXICO,AZCAPOTZALCO,23,257,4,284,1640
CIUDAD DE MÉXICO,AZCAPOTZALCO,23,266,6,295,1640
CIUDAD DE MÉXICO,AZCAPOTZALCO,35,281,2,318,1683
CIUDAD DE MÉXICO,AZCAPOTZALCO,28,324,5,357,1682
CIUDAD DE MÉXICO,AZCAPOTZALCO,40,259,7,306,1486
CIUDAD DE MÉXICO,AZCAPOTZALCO,39,295,6,340,1485
CIUDAD DE MÉXICO,AZCAPOTZALCO,24,237,2,263,1296
CIUDAD DE MÉXICO,AZCAPOTZALCO,25,281,6,312,1295
CIUDAD DE MÉXICO,AZCAPOTZALCO,36,232,1,269,1875
CIUDAD DE MÉXICO,AZCAPOTZALCO,50,256,4,310,1875
CIUDAD DE MÉXICO,AZCAPOTZALCO,40,242,3,285,1520
CIUDAD DE MÉXICO,AZCAPOTZALCO,44,249,5,298,1520
CIUDAD DE MÉXICO,AZCAPOTZALCO,32,226,3,261,1520
CIUDAD DE MÉXICO,AZCAPOTZALCO,32,269,1,302,1534
CIUDAD DE MÉXICO,AZCAPOTZALCO,34,246,3,283,1534
CIUDAD DE MÉXICO,AZCAPOTZALCO,25,276,2,303,1534
CIUDAD DE MÉXICO,AZCAPOTZALCO,40,267,4,311,1620
CIUDAD DE MÉXICO,AZCAPOTZALCO,32,270,3,305,1620
CIUDAD DE MÉXICO,AZCAPOTZALCO,37,290,0,327,1620
CIUDAD DE MÉXICO,AZCAPOTZALCO,32,243,6,281,1359
CIUDAD DE MÉXICO,AZCAPOTZALCO,24,258,3,285,1358
CIUDAD DE MÉXICO,AZCAPOTZALCO,20,176,0,196,1093
CIUDAD DE MÉXICO,AZCAPOTZALCO,34,163,0,197,1092
CIUDAD DE MÉXICO,AZCAPOTZALCO,43,297,5,345,1768
CIUDAD DE MÉXICO,AZCAPOTZALCO,39,306,2,347,1768
CIUDAD DE MÉXICO,AZCAPOTZALCO,39,218,1,258,1551
CIUDAD DE MÉXICO,AZCAPOTZALCO,28,219,2,249,1551
CIUDAD DE MÉXICO,AZCAPOTZALCO,43,246,2,291,1550
CIUDAD DE MÉXICO,AZCAPOTZALCO,44,237,7,288,1865
CIUDAD DE MÉXICO,AZCAPOTZALCO,44,223,4,271,1864
CIUDAD DE MÉXICO,AZCAPOTZALCO,34,197,7,238,1413
CIUDAD DE MÉXICO,AZCAPOTZALCO,40,207,2,249,1412
CIUDAD DE MÉXICO,AZCAPOTZALCO,45,179,4,228,1412
CIUDAD DE MÉXICO,AZCAPOTZALCO,27,250,5,282,1503
CIUDAD DE MÉXICO,AZCAPOTZALCO,19,204,1,224,1502
CIUDAD DE MÉXICO,AZCAPOTZALCO,34,235,1,270,1502
CIUDAD DE MÉXICO,AZCAPOTZALCO,31,329,6,366,1511
CIUDAD DE MÉXICO,AZCAPOTZALCO,28,302,7,337,1511
CIUDAD DE MÉXICO,AZCAPOTZALCO,24,253,3,280,1578
CIUDAD DE MÉXICO,AZCAPOTZALCO,26,269,10,305,1578
CIUDAD DE MÉXICO,AZCAPOTZALCO,26,268,5,299,1578
CIUDAD DE MÉXICO,AZCAPOTZALCO,45,378,6,429,1851
CIUDAD DE MÉXICO,AZCAPOTZALCO,43,387,1,431,1850
CIUDAD DE MÉXICO,AZCAPOTZALCO,44,308,1,353,1489
CIUDAD DE MÉXICO,AZCAPOTZALCO,21,305,5,331,1489
CIUDAD DE MÉXICO,AZCAPOTZALCO,39,350,4,393,1712
CIUDAD DE MÉXICO,AZCAPOTZALCO,24,337,3,364,1712
CIUDAD DE MÉXICO,AZCAPOTZALCO,35,321,3,359,1804
CIUDAD DE MÉXICO,AZCAPOTZALCO,22,322,1,345,1803
CIUDAD DE MÉXICO,AZCAPOTZALCO,37,221,4,262,1448
CIUDAD DE MÉXICO,AZCAPOTZALCO,31,239,2,272,1448
CIUDAD DE MÉXICO,AZCAPOTZALCO,12,208,2,222,1448
CIUDAD DE MÉXICO,AZCAPOTZALCO,50,326,5,381,1604
CIUDAD DE MÉXICO,AZCAPOTZALCO,29,312,8,349,1603
CIUDAD DE MÉXICO,AZCAPOTZALCO,44,318,0,362,1603
CIUDAD DE MÉXICO,AZCAPOTZALCO,35,391,4,430,1895
CIUDAD DE MÉXICO,AZCAPOTZALCO,34,383,0,417,1895
CIUDAD DE MÉXICO,AZCAPOTZALCO,40,294,4,338,1782
CIUDAD DE MÉXICO,AZCAPOTZALCO,28,312,2,342,1781
CIUDAD DE MÉXICO,AZCAPOTZALCO,27,255,3,285,1502
CIUDAD DE MÉXICO,AZCAPOTZALCO,24,237,4,265,1502
CIUDAD DE MÉXICO,AZCAPOTZALCO,25,252,4,281,1502
CIUDAD DE MÉXICO,AZCAPOTZALCO,40,321,6,367,1736
CIUDAD DE MÉXICO,AZCAPOTZALCO,42,280,5,327,1735
CIUDAD DE MÉXICO,AZCAPOTZALCO,26,345,1,372,1752
CIUDAD DE MÉXICO,AZCAPOTZALCO,35,341,7,383,1752
CIUDAD DE MÉXICO,AZCAPOTZALCO,36,352,4,392,1771
CIUDAD DE MÉXICO,AZCAPOTZALCO,35,377,5,417,1770
CIUDAD DE MÉXICO,AZCAPOTZALCO,36,361,12,409,1913
CIUDAD DE MÉXICO,AZCAPOTZALCO,32,364,1,397,1913
CIUDAD DE MÉXICO,AZCAPOTZALCO,60,372,7,439,1956
CIUDAD DE MÉXICO,AZCAPOTZALCO,29,225,2,256,1195
CIUDAD DE MÉXICO,AZCAPOTZALCO,24,220,6,250,1195
CIUDAD DE MÉXICO,AZCAPOTZALCO,51,322,5,378,1621
CIUDAD DE MÉXICO,AZCAPOTZALCO,43,316,4,363,1620
CIUDAD DE MÉXICO,AZCAPOTZALCO,27,230,4,261,1466
CIUDAD DE MÉXICO,AZCAPOTZALCO,28,258,3,289,1466
CIUDAD DE MÉXICO,AZCAPOTZALCO,20,245,1,266,1466
CIUDAD DE MÉXICO,AZCAPOTZALCO,27,288,2,317,1617
CIUDAD DE MÉXICO,AZCAPOTZALCO,28,317,2,347,1617
CIUDAD DE MÉXICO,AZCAPOTZALCO,30,303,5,338,1616
CIUDAD DE MÉXICO,AZCAPOTZALCO,32,295,1,328,1474
CIUDAD DE MÉXICO,AZCAPOTZALCO,19,322,2,343,1473
CIUDAD DE MÉXICO,AZCAPOTZALCO,32,337,8,377,1630
CIUDAD DE MÉXICO,AZCAPOTZALCO,28,346,4,378,1630
CIUDAD DE MÉXICO,AZCAPOTZALCO,22,290,4,316,1553
CIUDAD DE MÉXICO,AZCAPOTZALCO,23,335,1,359,1552
CIUDAD DE MÉXICO,AZCAPOTZALCO,55,321,4,380,1920
CIUDAD DE MÉXICO,AZCAPOTZALCO,39,300,4,343,1920
CIUDAD DE MÉXICO,AZCAPOTZALCO,41,344,4,389,1810
CIUDAD DE MÉXICO,AZCAPOTZALCO,38,286,6,330,1809
CIUDAD DE MÉXICO,AZCAPOTZALCO,30,328,4,362,1882
CIUDAD DE MÉXICO,AZCAPOTZALCO,34,324,6,364,1881
CIUDAD DE MÉXICO,AZCAPOTZALCO,44,348,4,396,1783
CIUDAD DE MÉXICO,AZCAPOTZALCO,32,349,1,382,1782
CIUDAD DE MÉXICO,AZCAPOTZALCO,41,230,0,271,1359
CIUDAD DE MÉXICO,AZCAPOTZALCO,43,239,5,287,1358
CIUDAD DE MÉXICO,AZCAPOTZALCO,43,273,5,321,1730
CIUDAD DE MÉXICO,AZCAPOTZALCO,25,275,4,304,1730
CIUDAD DE MÉXICO,AZCAPOTZALCO,25,200,9,234,1392
CIUDAD DE MÉXICO,AZCAPOTZALCO,31,189,3,223,1392
CIUDAD DE MÉXICO,AZCAPOTZALCO,23,288,2,313,1563
CIUDAD DE MÉXICO,AZCAPOTZALCO,27,291,4,322,1562
CIUDAD DE MÉXICO,AZCAPOTZALCO,42,350,4,396,1887
CIUDAD DE MÉXICO,AZCAPOTZALCO,33,358,9,400,1886
CIUDAD DE MÉXICO,AZCAPOTZALCO,28,210,0,238,1920
CIUDAD DE MÉXICO,AZCAPOTZALCO,36,213,5,254,1920
CIUDAD DE MÉXICO,AZCAPOTZALCO,24,293,7,324,1584
CIUDAD DE MÉXICO,AZCAPOTZALCO,29,285,3,317,1583
CIUDAD DE MÉXICO,AZCAPOTZALCO,33,313,2,348,1800
CIUDAD DE MÉXICO,AZCAPOTZALCO,24,345,0,369,1799
CIUDAD DE MÉXICO,AZCAPOTZALCO,40,382,4,426,1928
CIUDAD DE MÉXICO,AZCAPOTZALCO,31,379,10,420,1927
CIUDAD DE MÉXICO,AZCAPOTZALCO,43,308,6,357,1912
CIUDAD DE MÉXICO,AZCAPOTZALCO,27,351,4,382,1911
CIUDAD DE MÉXICO,AZCAPOTZALCO,26,247,3,276,1258
CIUDAD DE MÉXICO,AZCAPOTZALCO,16,242,10,268,1257
CIUDAD DE MÉXICO,AZCAPOTZALCO,30,368,7,405,1826
CIUDAD DE MÉXICO,AZCAPOTZALCO,26,359,2,387,1826
CIUDAD DE MÉXICO,AZCAPOTZALCO,22,253,3,278,1263
CIUDAD DE MÉXICO,AZCAPOTZALCO,7,239,7,253,1262
CIUDAD DE MÉXICO,AZCAPOTZALCO,27,312,2,341,1648
CIUDAD DE MÉXICO,AZCAPOTZALCO,32,327,4,363,1648
CIUDAD DE MÉXICO,AZCAPOTZALCO,33,319,2,354,1648
CIUDAD DE MÉXICO,AZCAPOTZALCO,29,296,2,327,1639
CIUDAD DE MÉXICO,AZCAPOTZALCO,25,304,8,337,1638
CIUDAD DE MÉXICO,AZCAPOTZALCO,34,292,2,328,1638
CIUDAD DE MÉXICO,AZCAPOTZALCO,38,299,3,340,1671
CIUDAD DE MÉXICO,AZCAPOTZALCO,25,340,3,368,1671
CIUDAD DE MÉXICO,AZCAPOTZALCO,34,314,5,353,1776
CIUDAD DE MÉXICO,AZCAPOTZALCO,24,353,5,382,1776
CIUDAD DE MÉXICO,AZCAPOTZALCO,25,336,5,366,1654
CIUDAD DE MÉXICO,AZCAPOTZALCO,23,313,2,338,1653
CIUDAD DE MÉXICO,AZCAPOTZALCO,18,226,5,249,1413
CIUDAD DE MÉXICO,AZCAPOTZALCO,20,233,6,259,1413
CIUDAD DE MÉXICO,AZCAPOTZALCO,31,251,3,285,1413
CIUDAD DE MÉXICO,AZCAPOTZALCO,36,334,0,370,1923
CIUDAD DE MÉXICO,AZCAPOTZALCO,24,277,0,301,1922
CIUDAD DE MÉXICO,AZCAPOTZALCO,27,270,21,318,1438
CIUDAD DE MÉXICO,AZCAPOTZALCO,26,251,5,282,1437
CIUDAD DE MÉXICO,AZCAPOTZALCO,38,281,2,321,1437
CIUDAD DE MÉXICO,AZCAPOTZALCO,32,303,8,343,1497
CIUDAD DE MÉXICO,AZCAPOTZALCO,49,299,2,350,1496
CIUDAD DE MÉXICO,AZCAPOTZALCO,37,299,4,340,1496
CIUDAD DE MÉXICO,AZCAPOTZALCO,42,309,3,354,1863
CIUDAD DE MÉXICO,AZCAPOTZALCO,36,330,4,370,1863
CIUDAD DE MÉXICO,AZCAPOTZALCO,37,346,8,391,1863
CIUDAD DE MÉXICO,AZCAPOTZALCO,27,362,9,398,1781
CIUDAD DE MÉXICO,AZCAPOTZALCO,29,373,6,408,1781
CIUDAD DE MÉXICO,AZCAPOTZALCO,55,314,6,375,1738
CIUDAD DE MÉXICO,AZCAPOTZALCO,37,347,1,385,1737
CIUDAD DE MÉXICO,AZCAPOTZALCO,32,265,8,305,1436
CIUDAD DE MÉXICO,AZCAPOTZALCO,31,283,3,317,1435
CIUDAD DE MÉXICO,AZCAPOTZALCO,35,238,6,279,1475
CIUDAD DE MÉXICO,AZCAPOTZALCO,31,238,3,272,1475
CIUDAD DE MÉXICO,AZCAPOTZALCO,33,353,8,394,1474
CIUDAD DE MÉXICO,AZCAPOTZALCO,26,309,6,341,1745
CIUDAD DE MÉXICO,AZCAPOTZALCO,39,327,4,370,1744
CIUDAD DE MÉXICO,AZCAPOTZALCO,26,297,3,326,1769
CIUDAD DE MÉXICO,AZCAPOTZALCO,35,340,4,379,1769
CIUDAD DE MÉXICO,AZCAPOTZALCO,59,315,2,376,1814
CIUDAD DE MÉXICO,AZCAPOTZALCO,31,348,7,386,1813
CIUDAD DE MÉXICO,IZTAPALAPA,40,352,2,394,1835
CIUDAD DE MÉXICO,IZTAPALAPA,21,325,1,347,1834
CIUDAD DE MÉXICO,IZTAPALAPA,29,213,4,246,1055
CIUDAD DE MÉXICO,IZTAPALAPA,22,214,4,240,1054
CIUDAD DE MÉXICO,IZTAPALAPA,13,250,3,266,1324
CIUDAD DE MÉXICO,IZTAPALAPA,25,245,2,272,1323
CIUDAD DE MÉXICO,IZTAPALAPA,31,325,5,361,1728
CIUDAD DE MÉXICO,IZTAPALAPA,27,295,2,324,1727
CIUDAD DE MÉXICO,IZTAPALAPA,36,296,3,335,1402
CIUDAD DE MÉXICO,IZTAPALAPA,33,279,3,315,1402
CIUDAD DE MÉXICO,IZTAPALAPA,30,256,6,292,1401
CIUDAD DE MÉXICO,IZTAPALAPA,45,358,5,408,1872
CIUDAD DE MÉXICO,IZTAPALAPA,56,328,5,389,1872
CIUDAD DE MÉXICO,IZTAPALAPA,43,366,8,417,1871
CIUDAD DE MÉXICO,IZTAPALAPA,55,357,5,417,1871
CIUDAD DE MÉXICO,IZTAPALAPA,23,204,3,230,1354
CIUDAD DE MÉXICO,IZTAPALAPA,27,220,2,249,1354
CIUDAD DE MÉXICO,IZTAPALAPA,3,302,9,314,1886
CIUDAD DE MÉXICO,IZTAPALAPA,15,324,6,345,1885
CIUDAD DE MÉXICO,IZTAPALAPA,17,291,6,314,1340
CIUDAD DE MÉXICO,IZTAPALAPA,6,243,5,254,1340
CIUDAD DE MÉXICO,IZTAPALAPA,23,255,2,280,1339
CIUDAD DE MÉXICO,IZTAPALAPA,22,249,0,271,1430
CIUDAD DE MÉXICO,IZTAPALAPA,31,231,6,268,1429
CIUDAD DE MÉXICO,IZTAPALAPA,25,294,4,323,1374
CIUDAD DE MÉXICO,IZTAPALAPA,34,268,2,304,1374
CIUDAD DE MÉXICO,IZTAPALAPA,33,257,4,294,1374
CIUDAD DE MÉXICO,IZTAPALAPA,26,339,3,368,1838
CIUDAD DE MÉXICO,IZTAPALAPA,42,303,7,352,1837
CIUDAD DE MÉXICO,IZTAPALAPA,38,292,4,334,1837
CIUDAD DE MÉXICO,IZTAPALAPA,26,268,1,295,1464
CIUDAD DE MÉXICO,IZTAPALAPA,24,315,2,341,1463
CIUDAD DE MÉXICO,IZTAPALAPA,24,283,2,309,1463
CIUDAD DE MÉXICO,IZTAPALAPA,27,287,3,317,1725
CIUDAD DE MÉXICO,IZTAPALAPA,41,311,4,356,1724
CIUDAD DE MÉXICO,IZTAPALAPA,36,325,5,366,1724
CIUDAD DE MÉXICO,IZTAPALAPA,41,363,5,409,1916
CIUDAD DE MÉXICO,IZTAPALAPA,45,374,7,426,1916
CIUDAD DE MÉXICO,IZTAPALAPA,26,235,4,265,1737
CIUDAD DE MÉXICO,IZTAPALAPA,38,231,3,272,1737
CIUDAD DE MÉXICO,IZTAPALAPA,30,146,5,181,1159
CIUDAD DE MÉXICO,IZTAPALAPA,30,155,4,189,1158
CIUDAD DE MÉXICO,IZTAPALAPA,31,348,3,382,1737
CIUDAD DE MÉXICO,IZTAPALAPA,41,316,7,364,1737
CIUDAD DE MÉXICO,IZTAPALAPA,37,329,5,371,1737
CIUDAD DE MÉXICO,IZTAPALAPA,48,342,2,392,1796
CIUDAD DE MÉXICO,IZTAPALAPA,36,337,2,375,1796
CIUDAD DE MÉXICO,IZTAPALAPA,37,337,1,375,1610
CIUDAD DE MÉXICO,IZTAPALAPA,35,318,3,356,1610
CIUDAD DE MÉXICO,IZTAPALAPA,39,427,3,469,1975
CIUDAD DE MÉXICO,IZTAPALAPA,38,424,2,464,1974
CIUDAD DE MÉXICO,IZTAPALAPA,38,378,3,419,1512
CIUDAD DE MÉXICO,IZTAPALAPA,36,362,6,404,1511
CIUDAD DE MÉXICO,IZTAPALAPA,44,361,7,412,1511
CIUDAD DE MÉXICO,IZTAPALAPA,22,328,2,352,1578
CIUDAD DE MÉXICO,IZTAPALAPA,28,339,7,374,1578
CIUDAD DE MÉXICO,IZTAPALAPA,20,356,5,381,1578
CIUDAD DE MÉXICO,IZTAPALAPA,19,262,3,284,1346
CIUDAD DE MÉXICO,IZTAPALAPA,30,263,4,297,1346
CIUDAD DE MÉXICO,IZTAPALAPA,16,269,9,294,1346
CIUDAD DE MÉXICO,IZTAPALAPA,30,311,9,350,1551
CIUDAD DE MÉXICO,IZTAPALAPA,33,328,5,366,1550
CIUDAD DE MÉXICO,IZTAPALAPA,31,347,4,382,1697
CIUDAD DE MÉXICO,IZTAPALAPA,35,364,7,406,1696
CIUDAD DE MÉXICO,IZTAPALAPA,28,296,1,325,1713
CIUDAD DE MÉXICO,IZTAPALAPA,27,265,8,300,1712
CIUDAD DE MÉXICO,IZTAPALAPA,19,203,2,224,1085
CIUDAD DE MÉXICO,IZTAPALAPA,36,201,5,242,1084
CIUDAD DE MÉXICO,IZTAPALAPA,44,291,6,341,1730
CIUDAD DE MÉXICO,IZTAPALAPA,40,318,0,358,1729
CIUDAD DE MÉXICO,IZTAPALAPA,30,363,9,402,1792
CIUDAD DE MÉXICO,IZTAPALAPA,37,369,7,413,1792
CIUDAD DE MÉXICO,IZTAPALAPA,29,363,5,397,1820
CIUDAD DE MÉXICO,IZTAPALAPA,29,409,1,439,1819
CIUDAD DE MÉXICO,IZTAPALAPA,30,341,5,376,1486
CIUDAD DE MÉXICO,IZTAPALAPA,33,213,5,251,1485
CIUDAD DE MÉXICO,IZTAPALAPA,20,267,5,292,1484
CIUDAD DE MÉXICO,IZTAPALAPA,29,289,5,323,1484
CIUDAD DE MÉXICO,IZTAPALAPA,17,252,3,272,1623
CIUDAD DE MÉXICO,IZTAPALAPA,16,275,4,295,1623
CIUDAD DE MÉXICO,IZTAPALAPA,15,288,6,309,1623
CIUDAD DE MÉXICO,IZTAPALAPA,9,291,4,304,1623
CIUDAD DE MÉXICO,IZTAPALAPA,45,298,5,348,1345
CIUDAD DE MÉXICO,IZTAPALAPA,25,278,4,307,1344
CIUDAD DE MÉXICO,IZTAPALAPA,17,278,6,301,1192
CIUDAD DE MÉXICO,IZTAPALAPA,19,266,5,290,1191
CIUDAD DE MÉXICO,IZTAPALAPA,23,370,7,400,1955
CIUDAD DE MÉXICO,IZTAPALAPA,28,325,4,357,1955
CIUDAD DE MÉXICO,IZTAPALAPA,26,364,6,396,1942
CIUDAD DE MÉXICO,IZTAPALAPA,38,402,4,444,1941
CIUDAD DE MÉXICO,IZTAPALAPA,21,280,3,304,1762
CIUDAD DE MÉXICO,IZTAPALAPA,22,297,0,319,1762
CIUDAD DE MÉXICO,IZTAPALAPA,25,288,2,315,1761
CIUDAD DE MÉXICO,IZTAPALAPA,29,244,2,275,1354
CIUDAD DE MÉXICO,IZTAPALAPA,44,252,4,300,1354
CIUDAD DE MÉXICO,IZTAPALAPA,53,228,2,283,1300
CIUDAD DE MÉXICO,IZTAPALAPA,43,206,5,254,1300
CIUDAD DE MÉXICO,IZTAPALAPA,42,253,4,299,1900
CIUDAD DE MÉXICO,IZTAPALAPA,32,281,1,314,1900
CIUDAD DE MÉXICO,IZTAPALAPA,29,242,3,274,1794
CIUDAD DE MÉXICO,IZTAPALAPA,34,257,1,292,1794
CIUDAD DE MÉXICO,IZTAPALAPA,50,263,2,315,1794
CIUDAD DE MÉXICO,IZTAPALAPA,38,318,4,360,1621
CIUDAD DE MÉXICO,IZTAPALAPA,52,268,4,324,1621
CIUDAD DE MÉXICO,IZTAPALAPA,39,282,3,324,1620
CIUDAD DE MÉXICO,IZTAPALAPA,26,328,2,356,1628
CIUDAD DE MÉXICO,IZTAPALAPA,38,287,0,325,1628
CIUDAD DE MÉXICO,IZTAPALAPA,32,304,4,340,1627
CIUDAD DE MÉXICO,IZTAPALAPA,14,372,4,390,1772
CIUDAD DE MÉXICO,IZTAPALAPA,9,334,4,347,1772
CIUDAD DE MÉXICO,IZTAPALAPA,32,426,9,467,1631
CIUDAD DE MÉXICO,IZTAPALAPA,17,384,8,409,1630
CIUDAD DE MÉXICO,IZTAPALAPA,15,319,2,336,1625
CIUDAD DE MÉXICO,IZTAPALAPA,18,294,6,318,1624
CIUDAD DE MÉXICO,IZTAPALAPA,17,309,3,329,1624
CIUDAD DE MÉXICO,IZTAPALAPA,20,259,3,282,1624
CIUDAD DE MÉXICO,IZTAPALAPA,21,271,8,300,1624
CIUDAD DE MÉXICO,IZTAPALAPA,28,363,4,395,1870
CIUDAD DE MÉXICO,IZTAPALAPA,22,375,6,403,1870
CIUDAD DE MÉXICO,IZTAPALAPA,68,957,10,1035,0
CIUDAD DE MÉXICO,IZTAPALAPA,19,311,5,335,1724
CIUDAD DE MÉXICO,IZTAPALAPA,21,359,1,381,1724
CIUDAD DE MÉXICO,IZTAPALAPA,20,357,5,382,1723
CIUDAD DE MÉXICO,IZTAPALAPA,26,302,0,328,1645
CIUDAD DE MÉXICO,IZTAPALAPA,24,330,1,355,1644
CIUDAD DE MÉXICO,IZTAPALAPA,13,348,10,371,1819
CIUDAD DE MÉXICO,IZTAPALAPA,31,370,8,409,1819
CIUDAD DE MÉXICO,IZTAPALAPA,13,328,5,346,1701
CIUDAD DE MÉXICO,IZTAPALAPA,22,322,0,344,1700
CIUDAD DE MÉXICO,IZTAPALAPA,22,374,8,404,1654
CIUDAD DE MÉXICO,IZTAPALAPA,20,395,1,416,1653
CIUDAD DE MÉXICO,IZTAPALAPA,25,299,8,332,1348
CIUDAD DE MÉXICO,IZTAPALAPA,26,260,3,289,1347
CIUDAD DE MÉXICO,IZTAPALAPA,21,282,3,306,1416
CIUDAD DE MÉXICO,IZTAPALAPA,26,264,2,292,1416
CIUDAD DE MÉXICO,IZTAPALAPA,26,369,8,403,1881
CIUDAD DE MÉXICO,IZTAPALAPA,26,325,5,356,1880
CIUDAD DE MÉXICO,IZTAPALAPA,20,307,3,330,1499
CIUDAD DE MÉXICO,IZTAPALAPA,29,303,2,334,1499
CIUDAD DE MÉXICO,IZTAPALAPA,27,278,7,312,1513
CIUDAD DE MÉXICO,IZTAPALAPA,20,332,5,357,1513
CIUDAD DE MÉXICO,IZTAPALAPA,21,297,1,319,1492
CIUDAD DE MÉXICO,IZTAPALAPA,20,339,5,364,1491
CIUDAD DE MÉXICO,IZTAPALAPA,23,289,4,316,1508
CIUDAD DE MÉXICO,IZTAPALAPA,19,309,3,331,1508
CIUDAD DE MÉXICO,IZTAPALAPA,18,309,2,329,1508
CIUDAD DE MÉXICO,IZTAPALAPA,41,396,6,443,1841
CIUDAD DE MÉXICO,IZTAPALAPA,53,449,4,506,1840
CIUDAD DE MÉXICO,IZTAPALAPA,36,351,6,393,1776
CIUDAD DE MÉXICO,IZTAPALAPA,49,375,7,431,1775
CIUDAD DE MÉXICO,IZTAPALAPA,29,352,2,383,1745
CIUDAD DE MÉXICO,IZTAPALAPA,31,399,3,433,1745
CIUDAD DE MÉXICO,IZTAPALAPA,28,338,3,369,1869
CIUDAD DE MÉXICO,IZTAPALAPA,35,319,3,357,1868
CIUDAD DE MÉXICO,IZTAPALAPA,30,415,7,452,1802
CIUDAD DE MÉXICO,IZTAPALAPA,35,394,4,433,1802
CIUDAD DE MÉXICO,IZTAPALAPA,30,456,4,490,1857
CIUDAD DE MÉXICO,IZTAPALAPA,32,456,7,495,1856
CIUDAD DE MÉXICO,IZTAPALAPA,24,314,8,346,1426
CIUDAD DE MÉXICO,IZTAPALAPA,37,312,3,352,1426
CIUDAD DE MÉXICO,IZTAPALAPA,31,315,6,352,1425
CIUDAD DE MÉXICO,IZTAPALAPA,23,325,7,355,1375
CIUDAD DE MÉXICO,IZTAPALAPA,19,325,2,346,1374
CIUDAD DE MÉXICO,IZTAPALAPA,8,357,5,370,1374
CIUDAD DE MÉXICO,IZTAPALAPA,28,371,8,407,1570
CIUDAD DE MÉXICO,IZTAPALAPA,20,362,3,385,1570
CIUDAD DE MÉXICO,IZTAPALAPA,25,426,2,453,1556
CIUDAD DE MÉXICO,IZTAPALAPA,23,393,2,418,1556
CIUDAD DE MÉXICO,IZTAPALAPA,34,432,11,477,1655
CIUDAD DE MÉXICO,IZTAPALAPA,2,440,5,447,1654
CIUDAD DE MÉXICO,IZTAPALAPA,27,438,7,472,1654
CIUDAD DE MÉXICO,IZTAPALAPA,32,424,4,460,1844
CIUDAD DE MÉXICO,IZTAPALAPA,28,370,8,406,1844
CIUDAD DE MÉXICO,IZTAPALAPA,29,339,6,374,1222
CIUDAD DE MÉXICO,IZTAPALAPA,26,337,4,367,1222
CIUDAD DE MÉXICO,IZTAPALAPA,20,378,4,402,1379
CIUDAD DE MÉXICO,IZTAPALAPA,34,386,6,426,1379
CIUDAD DE MÉXICO,TLALPAN,14,156,2,172,1077
CIUDAD DE MÉXICO,TLALPAN,24,167,2,193,1076
CIUDAD DE MÉXICO,TLALPAN,35,396,4,435,1834
CIUDAD DE MÉXICO,TLALPAN,28,379,4,411,1833
CIUDAD DE MÉXICO,TLALPAN,40,315,3,358,1793
CIUDAD DE MÉXICO,TLALPAN,40,307,6,353,1792
CIUDAD DE MÉXICO,TLALPAN,50,369,5,424,1950
CIUDAD DE MÉXICO,TLALPAN,63,351,7,421,1949
CIUDAD DE MÉXICO,TLALPAN,44,409,4,457,1760
CIUDAD DE MÉXICO,TLALPAN,40,362,4,406,1760
CIUDAD DE MÉXICO,TLALPAN,45,420,4,469,1760
CIUDAD DE MÉXICO,TLALPAN,26,286,3,315,1917
CIUDAD DE MÉXICO,TLALPAN,27,292,6,325,1916
CIUDAD DE MÉXICO,TLALPAN,31,282,4,317,1627
CIUDAD DE MÉXICO,TLALPAN,28,251,2,281,1627
CIUDAD DE MÉXICO,TLALPAN,31,291,7,329,1856
CIUDAD DE MÉXICO,TLALPAN,36,301,5,342,1856
CIUDAD DE MÉXICO,TLALPAN,29,304,4,337,1855
CIUDAD DE MÉXICO,TLALPAN,22,216,1,239,1191
CIUDAD DE MÉXICO,TLALPAN,19,209,0,228,1191
CIUDAD DE MÉXICO,TLALPAN,41,208,2,251,1684
CIUDAD DE MÉXICO,TLALPAN,33,208,4,245,1683
CIUDAD DE MÉXICO,TLALPAN,29,192,2,223,1683
CIUDAD DE MÉXICO,TLALPAN,25,258,2,285,1647
CIUDAD DE MÉXICO,TLALPAN,33,261,4,298,1646
CIUDAD DE MÉXICO,TLALPAN,18,272,6,296,1542
CIUDAD DE MÉXICO,TLALPAN,27,278,3,308,1541
CIUDAD DE MÉXICO,TLALPAN,29,84,2,115,1363
CIUDAD DE MÉXICO,TLALPAN,0,114,5,119,1363
CIUDAD DE MÉXICO,TLALPAN,26,75,0,101,1362
CIUDAD DE MÉXICO,TLALPAN,15,168,2,185,1538
CIUDAD DE MÉXICO,TLALPAN,19,161,4,184,1537
CIUDAD DE MÉXICO,TLALPAN,19,177,0,196,1537
CIUDAD DE MÉXICO,TLALPAN,23,257,1,281,1438
CIUDAD DE MÉXICO,TLALPAN,24,255,3,282,1438
CIUDAD DE MÉXICO,TLALPAN,19,202,4,225,1466
CIUDAD DE MÉXICO,TLALPAN,19,224,5,248,1466
CIUDAD DE MÉXICO,TLALPAN,25,276,2,303,1649
CIUDAD DE MÉXICO,TLALPAN,29,273,1,303,1648
CIUDAD DE MÉXICO,TLALPAN,35,169,5,209,1407
CIUDAD DE MÉXICO,TLALPAN,28,203,6,237,1407
CIUDAD DE MÉXICO,TLALPAN,25,249,3,277,1505
CIUDAD DE MÉXICO,TLALPAN,30,275,4,309,1504
CIUDAD DE MÉXICO,TLALPAN,29,300,7,336,1504
CIUDAD DE MÉXICO,TLALPAN,32,306,5,343,1796
CIUDAD DE MÉXICO,TLALPAN,38,305,7,350,1796
CIUDAD DE MÉXICO,TLALPAN,21,266,1,288,1222
CIUDAD DE MÉXICO,TLALPAN,22,234,3,259,1222
CIUDAD DE MÉXICO,TLALPAN,36,318,3,357,1808
CIUDAD DE MÉXICO,TLALPAN,35,337,3,375,1808
CIUDAD DE MÉXICO,TLALPAN,35,234,7,276,1395
CIUDAD DE MÉXICO,TLALPAN,28,229,4,261,1394
CIUDAD DE MÉXICO,TLALPAN,30,235,1,266,1394
CIUDAD DE MÉXICO,TLALPAN,19,209,5,233,1356
CIUDAD DE MÉXICO,TLALPAN,28,193,2,223,1356
CIUDAD DE MÉXICO,TLALPAN,30,264,7,301,1304
CIUDAD DE MÉXICO,TLALPAN,31,307,5,343,1303
CIUDAD DE MÉXICO,TLALPAN,26,319,2,347,1695
CIUDAD DE MÉXICO,TLALPAN,25,302,4,331,1695
CIUDAD DE MÉXICO,TLALPAN,37,394,4,435,1951
CIUDAD DE MÉXICO,TLALPAN,38,404,2,444,1950
CIUDAD DE MÉXICO,TLALPAN,27,263,7,297,1985
CIUDAD DE MÉXICO,TLALPAN,46,291,4,341,1985
CIUDAD DE MÉXICO,TLALPAN,29,279,5,313,1576
CIUDAD DE MÉXICO,TLALPAN,26,284,8,318,1576
CIUDAD DE MÉXICO,TLALPAN,23,238,2,263,1510
CIUDAD DE MÉXICO,TLALPAN,20,227,4,251,1510
CIUDAD DE MÉXICO,TLALPAN,24,227,6,257,1510
CIUDAD DE MÉXICO,TLALPAN,34,214,6,254,1128
CIUDAD DE MÉXICO,TLALPAN,21,197,6,224,1127
CIUDAD DE MÉXICO,TLALPAN,56,356,10,422,1910
CIUDAD DE MÉXICO,TLALPAN,44,344,2,390,1910
CIUDAD DE MÉXICO,TLALPAN,16,224,3,243,1246
CIUDAD DE MÉXICO,TLALPAN,24,205,4,233,1245
CIUDAD DE MÉXICO,TLALPAN,14,247,5,266,1202
CIUDAD DE MÉXICO,TLALPAN,8,219,9,236,1202
CIUDAD DE MÉXICO,TLALPAN,18,238,6,262,1199
CIUDAD DE MÉXICO,TLALPAN,15,216,3,234,1199
CIUDAD DE MÉXICO,TLALPAN,24,388,9,421,1642
CIUDAD DE MÉXICO,TLALPAN,19,380,8,407,1641
CIUDAD DE MÉXICO,TLALPAN,19,204,3,226,1317
CIUDAD DE MÉXICO,TLALPAN,8,228,5,241,1317
CIUDAD DE MÉXICO,TLALPAN,28,312,6,346,1771
CIUDAD DE MÉXICO,TLALPAN,24,278,4,306,1771
CIUDAD DE MÉXICO,TLALPAN,20,326,5,351,1771
CIUDAD DE MÉXICO,TLALPAN,15,303,8,326,1770
CIUDAD DE MÉXICO,TLALPAN,17,290,2,309,1770
CIUDAD DE MÉXICO,TLALPAN,40,320,9,369,1652
CIUDAD DE MÉXICO,TLALPAN,22,322,5,349,1652
CIUDAD DE MÉXICO,TLALPAN,16,281,8,305,1588
CIUDAD DE MÉXICO,TLALPAN,19,264,6,289,1588
CIUDAD DE MÉXICO,TLALPAN,25,236,3,264,1588
CIUDAD DE MÉXICO,TLALPAN,36,225,6,267,1588
CIUDAD DE MÉXICO,TLALPAN,20,401,7,428,1958
CIUDAD DE MÉXICO,TLALPAN,20,409,7,436,1958
CIUDAD DE MÉXICO,TLALPAN,12,254,4,270,1660
CIUDAD DE MÉXICO,TLALPAN,31,276,1,308,1660
CIUDAD DE MÉXICO,TLALPAN,22,227,2,251,1659
CIUDAD DE MÉXICO,TLALPAN,31,273,6,310,1809
CIUDAD DE MÉXICO,TLALPAN,16,288,6,310,1809
CIUDAD DE MÉXICO,TLALPAN,19,292,1,312,1809
CIUDAD DE MÉXICO,TLALPAN,22,205,5,232,1359
CIUDAD DE MÉXICO,TLALPAN,10,197,4,211,1359
CIUDAD DE MÉXICO,TLALPAN,15,173,2,190,1274
CIUDAD DE MÉXICO,TLALPAN,12,142,3,157,1273
CIUDAD DE MÉXICO,TLALPAN,26,308,0,334,1925
CIUDAD DE MÉXICO,TLALPAN,16,340,6,362,1925
CIUDAD DE MÉXICO,TLALPAN,23,321,4,348,1924
CIUDAD DE MÉXICO,TLALPAN,20,196,6,222,1634
CIUDAD DE MÉXICO,TLALPAN,17,208,3,228,1634
CIUDAD DE MÉXICO,TLALPAN,19,204,2,225,1633
CIUDAD DE MÉXICO,TLALPAN,16,197,3,216,1273
CIUDAD DE MÉXICO,TLALPAN,11,174,6,191,1273
CIUDAD DE MÉXICO,TLALPAN,28,355,12,395,1500
CIUDAD DE MÉXICO,TLALPAN,34,353,9,396,1499
CIUDAD DE MÉXICO,TLALPAN,24,132,6,162,1098
CIUDAD DE MÉXICO,TLALPAN,18,143,2,163,1097
CIUDAD DE MÉXICO,TLALPAN,31,99,1,131,1268
CIUDAD DE MÉXICO,TLALPAN,18,107,0,125,1268
CIUDAD DE MÉXICO,TLALPAN,28,184,2,214,1388
CIUDAD DE MÉXICO,TLALPAN,36,142,3,181,1388
CIUDAD DE MÉXICO,TLALPAN,45,159,2,206,1388
CIUDAD DE MÉXICO,TLALPAN,35,171,5,211,1675
CIUDAD DE MÉXICO,TLALPAN,34,168,1,203,1674
CIUDAD DE MÉXICO,TLALPAN,32,162,1,195,1657
CIUDAD DE MÉXICO,TLALPAN,24,170,1,195,1656
CIUDAD DE MÉXICO,TLALPAN,23,171,1,195,1656
CIUDAD DE MÉXICO,TLALPAN,26,156,3,185,1656
CIUDAD DE MÉXICO,TLALPAN,28,169,8,205,1689
CIUDAD DE MÉXICO,TLALPAN,33,224,1,258,1689
CIUDAD DE MÉXICO,TLALPAN,34,212,3,249,1689
CIUDAD DE MÉXICO,TLALPAN,36,211,2,249,1689
CIUDAD DE MÉXICO,TLALPAN,33,244,3,280,1846
CIUDAD DE MÉXICO,TLALPAN,31,242,2,275,1845
CIUDAD DE MÉXICO,TLALPAN,35,152,1,188,1738
CIUDAD DE MÉXICO,TLALPAN,44,151,2,197,1738
CIUDAD DE MÉXICO,TLALPAN,40,174,1,215,1767
CIUDAD DE MÉXICO,TLALPAN,40,179,4,223,1767
CIUDAD DE MÉXICO,TLALPAN,34,179,6,219,1894
CIUDAD DE MÉXICO,TLALPAN,34,184,2,220,1893
CIUDAD DE MÉXICO,TLALPAN,45,199,8,252,1720
CIUDAD DE MÉXICO,TLALPAN,58,237,3,298,1720
CIUDAD DE MÉXICO,TLALPAN,58,222,4,284,1662
CIUDAD DE MÉXICO,TLALPAN,54,243,5,302,1661
CIUDAD DE MÉXICO,TLALPAN,32,188,3,223,1401
CIUDAD DE MÉXICO,TLALPAN,38,202,5,245,1400
CIUDAD DE MÉXICO,TLALPAN,28,281,3,312,1448
CIUDAD DE MÉXICO,TLALPAN,31,293,6,330,1447
CIUDAD DE MÉXICO,TLALPAN,39,213,3,255,1640
CIUDAD DE MÉXICO,TLALPAN,19,210,5,234,1640
CIUDAD DE MÉXICO,TLALPAN,36,266,4,306,1868
CIUDAD DE MÉXICO,TLALPAN,42,234,3,279,1867
CIUDAD DE MÉXICO,TLALPAN,42,374,6,422,1932
CIUDAD DE MÉXICO,TLALPAN,46,324,2,372,1931
CIUDAD DE MÉXICO,TLALPAN,48,217,6,271,1559
CIUDAD DE MÉXICO,TLALPAN,42,242,5,289,1558
CIUDAD DE MÉXICO,TLALPAN,46,223,1,270,1558
CIUDAD DE MÉXICO,TLALPAN,54,243,3,300,1896
CIUDAD DE MÉXICO,TLALPAN,53,283,4,340,1895
CIUDAD DE MÉXICO,TLALPAN,29,209,2,240,1366
CIUDAD DE MÉXICO,TLALPAN,23,202,5,230,1366
CIUDAD DE MÉXICO,TLALPAN,210,31,3,244,1365
CIUDAD DE MÉXICO,TLALPAN,23,159,2,184,1573
CIUDAD DE MÉXICO,TLALPAN,25,185,7,217,1572
CIUDAD DE MÉXICO,TLALPAN,41,159,1,201,1572
CIUDAD DE MÉXICO,TLALPAN,39,248,4,291,1488
CIUDAD DE MÉXICO,TLALPAN,35,215,5,255,1487
CIUDAD DE MÉXICO,TLALPAN,29,244,1,274,1487
CIUDAD DE MÉXICO,TLALPAN,35,264,5,304,1432
CIUDAD DE MÉXICO,TLALPAN,30,233,8,271,1432
CIUDAD DE MÉXICO,TLALPAN,25,155,2,182,1376
CIUDAD DE MÉXICO,TLALPAN,37,175,2,214,1375
CIUDAD DE MÉXICO,TLALPAN,27,161,5,193,1375
CIUDAD DE MÉXICO,TLALPAN,31,320,3,354,1935
CIUDAD DE MÉXICO,TLALPAN,50,290,4,344,1934
CIUDAD DE MÉXICO,TLALPAN,160,1130,21,1311,0
CIUDAD DE MÉXICO,LA MAGDALENA CONTRERAS,40,195,3,238,1373
CIUDAD DE MÉXICO,LA MAGDALENA CONTRERAS,27,200,1,228,1373
CIUDAD DE MÉXICO,LA MAGDALENA CONTRERAS,32,160,1,193,1052
CIUDAD DE MÉXICO,LA MAGDALENA CONTRERAS,20,162,3,185,1051
CIUDAD DE MÉXICO,LA MAGDALENA CONTRERAS,23,130,2,155,1904
CIUDAD DE MÉXICO,LA MAGDALENA CONTRERAS,32,140,3,175,1904
CIUDAD DE MÉXICO,LA MAGDALENA CONTRERAS,39,281,8,328,1665
CIUDAD DE MÉXICO,LA MAGDALENA CONTRERAS,24,295,6,325,1665
CIUDAD DE MÉXICO,LA MAGDALENA CONTRERAS,37,269,5,311,1665
CIUDAD DE MÉXICO,LA MAGDALENA CONTRERAS,11,238,4,253,1065
CIUDAD DE MÉXICO,LA MAGDALENA CONTRERAS,21,180,5,206,1065
CIUDAD DE MÉXICO,LA MAGDALENA CONTRERAS,33,389,5,427,1751
CIUDAD DE MÉXICO,LA MAGDALENA CONTRERAS,27,331,6,364,1751
CIUDAD DE MÉXICO,LA MAGDALENA CONTRERAS,19,303,10,332,1602
CIUDAD DE MÉXICO,LA MAGDALENA CONTRERAS,28,340,6,374,1602
CIUDAD DE MÉXICO,LA MAGDALENA CONTRERAS,40,341,10,391,1601
CIUDAD DE MÉXICO,LA MAGDALENA CONTRERAS,24,352,5,381,1925
CIUDAD DE MÉXICO,LA MAGDALENA CONTRERAS,39,368,10,417,1924
CIUDAD DE MÉXICO,LA MAGDALENA CONTRERAS,17,79,2,98,1519
CIUDAD DE MÉXICO,LA MAGDALENA CONTRERAS,14,79,2,95,1518
CIUDAD DE MÉXICO,LA MAGDALENA CONTRERAS,41,147,8,196,1904
CIUDAD DE MÉXICO,LA MAGDALENA CONTRERAS,31,173,5,209,1904
CIUDAD DE MÉXICO,LA MAGDALENA CONTRERAS,14,137,1,152,1175
CIUDAD DE MÉXICO,LA MAGDALENA CONTRERAS,17,131,3,151,1175
CIUDAD DE MÉXICO,LA MAGDALENA CONTRERAS,23,341,2,366,1852
CIUDAD DE MÉXICO,LA MAGDALENA CONTRERAS,22,354,11,387,1851
CIUDAD DE MÉXICO,LA MAGDALENA CONTRERAS,26,308,2,336,1694
CIUDAD DE MÉXICO,LA MAGDALENA CONTRERAS,24,330,5,359,1694
CIUDAD DE MÉXICO,LA MAGDALENA CONTRERAS,32,286,6,324,1693
CIUDAD DE MÉXICO,LA MAGDALENA CONTRERAS,32,256,5,293,1430
CIUDAD DE MÉXICO,LA MAGDALENA CONTRERAS,17,258,3,278,1429
CIUDAD DE MÉXICO,LA MAGDALENA CONTRERAS,27,249,6,282,1429
CIUDAD DE MÉXICO,LA MAGDALENA CONTRERAS,26,318,5,349,1868
CIUDAD DE MÉXICO,LA MAGDALENA CONTRERAS,34,305,9,348,1867
CIUDAD DE MÉXICO,LA MAGDALENA CONTRERAS,25,293,5,323,1644
CIUDAD DE MÉXICO,LA MAGDALENA CONTRERAS,33,259,12,304,1644
CIUDAD DE MÉXICO,LA MAGDALENA CONTRERAS,21,340,4,365,1696
CIUDAD DE MÉXICO,LA MAGDALENA CONTRERAS,32,311,0,343,1695
CIUDAD DE MÉXICO,LA MAGDALENA CONTRERAS,26,333,8,367,1695
CIUDAD DE MÉXICO,LA MAGDALENA CONTRERAS,20,234,6,260,1752
CIUDAD DE MÉXICO,LA MAGDALENA CONTRERAS,34,222,0,256,1752
CIUDAD DE MÉXICO,LA MAGDALENA CONTRERAS,31,239,6,276,1751
CIUDAD DE MÉXICO,LA MAGDALENA CONTRERAS,45,268,3,316,1903
CIUDAD DE MÉXICO,LA MAGDALENA CONTRERAS,24,250,2,276,1902
CIUDAD DE MÉXICO,LA MAGDALENA CONTRERAS,25,267,1,293,1501
CIUDAD DE MÉXICO,LA MAGDALENA CONTRERAS,33,231,1,265,1501
CIUDAD DE MÉXICO,LA MAGDALENA CONTRERAS,27,252,4,283,1501
CIUDAD DE MÉXICO,LA MAGDALENA CONTRERAS,20,230,4,254,1387
CIUDAD DE MÉXICO,LA MAGDALENA CONTRERAS,29,241,2,272,1386
CIUDAD DE MÉXICO,LA MAGDALENA CONTRERAS,35,243,3,281,1478
CIUDAD DE MÉXICO,LA MAGDALENA CONTRERAS,32,246,4,282,1477
CIUDAD DE MÉXICO,LA MAGDALENA CONTRERAS,33,307,7,347,1905
CIUDAD DE MÉXICO,LA MAGDALENA CONTRERAS,24,351,4,379,1905
CIUDAD DE MÉXICO,LA MAGDALENA CONTRERAS,18,219,2,239,1358
CIUDAD DE MÉXICO,LA MAGDALENA CONTRERAS,18,215,1,234,1358
CIUDAD DE MÉXICO,LA MAGDALENA CONTRERAS,10,228,4,242,1357
CIUDAD DE MÉXICO,LA MAGDALENA CONTRERAS,39,369,1,409,1923
CIUDAD DE MÉXICO,LA MAGDALENA CONTRERAS,33,425,3,461,1923
CIUDAD DE MÉXICO,LA MAGDALENA CONTRERAS,28,254,8,290,1504
CIUDAD DE MÉXICO,LA MAGDALENA CONTRERAS,34,299,7,340,1504
CIUDAD DE MÉXICO,LA MAGDALENA CONTRERAS,37,287,2,326,1503
CIUDAD DE MÉXICO,LA MAGDALENA CONTRERAS,47,338,4,389,1877
CIUDAD DE MÉXICO,LA MAGDALENA CONTRERAS,52,394,4,450,1877
CIUDAD DE MÉXICO,LA MAGDALENA CONTRERAS,33,264,6,303,1436
CIUDAD DE MÉXICO,LA MAGDALENA CONTRERAS,32,249,2,283,1436
CIUDAD DE MÉXICO,LA MAGDALENA CONTRERAS,22,208,6,236,1436
CIUDAD DE MÉXICO,LA MAGDALENA CONTRERAS,44,278,6,328,1845
CIUDAD DE MÉXICO,LA MAGDALENA CONTRERAS,43,264,3,310,1844
CIUDAD DE MÉXICO,LA MAGDALENA CONTRERAS,26,217,1,244,1203
CIUDAD DE MÉXICO,LA MAGDALENA CONTRERAS,26,209,2,237,1202
CIUDAD DE MÉXICO,LA MAGDALENA CONTRERAS,32,255,4,291,1732
CIUDAD DE MÉXICO,LA MAGDALENA CONTRERAS,27,288,3,318,1731
CIUDAD DE MÉXICO,LA MAGDALENA CONTRERAS,31,216,1,248,1683
CIUDAD DE MÉXICO,LA MAGDALENA CONTRERAS,23,272,4,299,1682
CIUDAD DE MÉXICO,LA MAGDALENA CONTRERAS,25,144,1,170,1288
CIUDAD DE MÉXICO,LA MAGDALENA CONTRERAS,25,171,4,200,1288
CIUDAD DE MÉXICO,LA MAGDALENA CONTRERAS,30,202,0,232,1268
CIUDAD DE MÉXICO,LA MAGDALENA CONTRERAS,31,222,1,254,1268
CIUDAD DE MÉXICO,LA MAGDALENA CONTRERAS,27,358,6,391,1725
CIUDAD DE MÉXICO,LA MAGDALENA CONTRERAS,22,409,8,439,1725
CIUDAD DE MÉXICO,LA MAGDALENA CONTRERAS,37,334,3,374,1827
CIUDAD DE MÉXICO,LA MAGDALENA CONTRERAS,32,330,1,363,1826
CIUDAD DE MÉXICO,LA MAGDALENA CONTRERAS,39,364,2,405,1882
CIUDAD DE MÉXICO,LA MAGDALENA CONTRERAS,60,303,8,371,1881
CIUDAD DE MÉXICO,LA MAGDALENA CONTRERAS,46,427,6,479,1997
CIUDAD DE MÉXICO,LA MAGDALENA CONTRERAS,29,339,9,377,1977
CIUDAD DE MÉXICO,LA MAGDALENA CONTRERAS,37,360,9,406,1977
CIUDAD DE MÉXICO,LA MAGDALENA CONTRERAS,26,294,1,321,1807
CIUDAD DE MÉXICO,LA MAGDALENA CONTRERAS,18,312,3,333,1807
CIUDAD DE MÉXICO,LA MAGDALENA CONTRERAS,39,303,1,343,1975
CIUDAD DE MÉXICO,LA MAGDALENA CONTRERAS,45,242,7,294,1974
CIUDAD DE MÉXICO,LA MAGDALENA CONTRERAS,33,280,3,316,1841
CIUDAD DE MÉXICO,LA MAGDALENA CONTRERAS,30,269,3,302,1840
CIUDAD DE MÉXICO,LA MAGDALENA CONTRERAS,22,266,2,290,1413
CIUDAD DE MÉXICO,LA MAGDALENA CONTRERAS,22,242,3,267,1412
CIUDAD DE MÉXICO,LA MAGDALENA CONTRERAS,19,257,8,284,1551
CIUDAD DE MÉXICO,LA MAGDALENA CONTRERAS,24,276,7,307,1551
CIUDAD DE MÉXICO,LA MAGDALENA CONTRERAS,20,311,3,334,1551
CIUDAD DE MÉXICO,LA MAGDALENA CONTRERAS,29,256,1,286,1551
CIUDAD DE MÉXICO,LA MAGDALENA CONTRERAS,26,327,3,356,1768
CIUDAD DE MÉXICO,LA MAGDALENA CONTRERAS,32,331,3,366,1767
CIUDAD DE MÉXICO,LA MAGDALENA CONTRERAS,19,204,4,227,1244
CIUDAD DE MÉXICO,LA MAGDALENA CONTRERAS,14,201,4,219,1244
CIUDAD DE MÉXICO,LA MAGDALENA CONTRERAS,22,207,4,233,1388
CIUDAD DE MÉXICO,LA MAGDALENA CONTRERAS,22,178,3,203,1388
CIUDAD DE MÉXICO,LA MAGDALENA CONTRERAS,21,209,1,231,1388
CIUDAD DE MÉXICO,LA MAGDALENA CONTRERAS,24,277,7,308,1781
CIUDAD DE MÉXICO,LA MAGDALENA CONTRERAS,25,257,7,289,1780
CIUDAD DE MÉXICO,LA MAGDALENA CONTRERAS,27,375,13,415,2019
CIUDAD DE MÉXICO,LA MAGDALENA CONTRERAS,29,354,0,383,2018
CIUDAD DE MÉXICO,LA MAGDALENA CONTRERAS,16,191,3,210,1257
CIUDAD DE MÉXICO,LA MAGDALENA CONTRERAS,24,168,3,195,1257
CIUDAD DE MÉXICO,LA MAGDALENA CONTRERAS,22,364,7,393,1816
CIUDAD DE MÉXICO,LA MAGDALENA CONTRERAS,21,326,5,352,1815
CIUDAD DE MÉXICO,LA MAGDALENA CONTRERAS,40,321,4,365,1777
CIUDAD DE MÉXICO,LA MAGDALENA CONTRERAS,28,340,9,377,1776
CIUDAD DE MÉXICO,LA MAGDALENA CONTRERAS,15,286,1,302,1553
CIUDAD DE MÉXICO,LA MAGDALENA CONTRERAS,27,310,10,347,1553
CIUDAD DE MÉXICO,LA MAGDALENA CONTRERAS,14,286,2,302,1552
CIUDAD DE MÉXICO,LA MAGDALENA CONTRERAS,30,344,5,379,1682
CIUDAD DE MÉXICO,LA MAGDALENA CONTRERAS,27,284,4,315,1681
CIUDAD DE MÉXICO,LA MAGDALENA CONTRERAS,25,196,8,229,1633
CIUDAD DE MÉXICO,LA MAGDALENA CONTRERAS,36,215,6,257,1633
CIUDAD DE MÉXICO,LA MAGDALENA CONTRERAS,19,75,2,96,1779
CIUDAD DE MÉXICO,LA MAGDALENA CONTRERAS,21,94,1,116,1778
CIUDAD DE MÉXICO,LA MAGDALENA CONTRERAS,20,99,2,121,1778
CIUDAD DE MÉXICO,LA MAGDALENA CONTRERAS,3,18,1,22,1511
CIUDAD DE MÉXICO,LA MAGDALENA CONTRERAS,14,26,1,41,1511
CIUDAD DE MÉXICO,LA MAGDALENA CONTRERAS,13,31,2,46,1511
CIUDAD DE MÉXICO,LA MAGDALENA CONTRERAS,13,24,3,40,1935
CIUDAD DE MÉXICO,LA MAGDALENA CONTRERAS,14,44,0,58,1935
CIUDAD DE MÉXICO,LA MAGDALENA CONTRERAS,25,124,3,152,1980
CIUDAD DE MÉXICO,LA MAGDALENA CONTRERAS,23,115,2,140,1980
CIUDAD DE MÉXICO,LA MAGDALENA CONTRERAS,35,78,1,114,1777
CIUDAD DE MÉXICO,LA MAGDALENA CONTRERAS,25,68,1,94,1776
CIUDAD DE MÉXICO,LA MAGDALENA CONTRERAS,22,141,2,165,1521
CIUDAD DE MÉXICO,LA MAGDALENA CONTRERAS,28,138,1,167,1521
CIUDAD DE MÉXICO,LA MAGDALENA CONTRERAS,13,79,2,94,1110
CIUDAD DE MÉXICO,LA MAGDALENA CONTRERAS,12,75,1,88,1109
CIUDAD DE MÉXICO,LA MAGDALENA CONTRERAS,153,1043,16,1212,0
CIUDAD DE MÉXICO,LA MAGDALENA CONTRERAS,19,74,2,95,1252
CIUDAD DE MÉXICO,LA MAGDALENA CONTRERAS,16,69,3,88,1252
CIUDAD DE MÉXICO,LA MAGDALENA CONTRERAS,20,98,3,121,1746
CIUDAD DE MÉXICO,LA MAGDALENA CONTRERAS,16,101,2,119,1745
CIUDAD DE MÉXICO,LA MAGDALENA CONTRERAS,37,157,0,194,1407
CIUDAD DE MÉXICO,LA MAGDALENA CONTRERAS,21,186,2,209,1406
CIUDAD DE MÉXICO,LA MAGDALENA CONTRERAS,32,203,1,236,1434
CIUDAD DE MÉXICO,LA MAGDALENA CONTRERAS,36,232,3,271,1434
CIUDAD DE MÉXICO,LA MAGDALENA CONTRERAS,27,180,3,210,1607
CIUDAD DE MÉXICO,LA MAGDALENA CONTRERAS,19,194,3,216,1607
CIUDAD DE MÉXICO,LA MAGDALENA CONTRERAS,39,161,1,201,1606
CIUDAD DE MÉXICO,LA MAGDALENA CONTRERAS,29,157,5,191,1079
CIUDAD DE MÉXICO,LA MAGDALENA CONTRERAS,23,160,0,183,1078
CIUDAD DE MÉXICO,LA MAGDALENA CONTRERAS,35,223,4,262,1614
CIUDAD DE MÉXICO,LA MAGDALENA CONTRERAS,26,214,10,250,1613
CIUDAD DE MÉXICO,LA MAGDALENA CONTRERAS,31,165,1,197,1432
CIUDAD DE MÉXICO,LA MAGDALENA CONTRERAS,19,173,3,195,1431
CIUDAD DE MÉXICO,LA MAGDALENA CONTRERAS,34,282,0,316,1694
CIUDAD DE MÉXICO,LA MAGDALENA CONTRERAS,44,248,2,294,1693
CIUDAD DE MÉXICO,LA MAGDALENA CONTRERAS,22,157,3,182,1520
CIUDAD DE MÉXICO,LA MAGDALENA CONTRERAS,26,183,4,213,1519
CIUDAD DE MÉXICO,LA MAGDALENA CONTRERAS,16,68,2,86,1095
CIUDAD DE MÉXICO,LA MAGDALENA CONTRERAS,13,97,1,111,1094
CIUDAD DE MÉXICO,LA MAGDALENA CONTRERAS,35,156,4,195,1658
CIUDAD DE MÉXICO,LA MAGDALENA CONTRERAS,17,166,1,184,1657
CIUDAD DE MÉXICO,LA MAGDALENA CONTRERAS,38,334,3,375,1926
CIUDAD DE MÉXICO,LA MAGDALENA CONTRERAS,48,340,7,395,1925
CIUDAD DE MÉXICO,LA MAGDALENA CONTRERAS,32,375,8,415,1937
CIUDAD DE MÉXICO,LA MAGDALENA CONTRERAS,39,273,7,319,1937
CIUDAD DE MÉXICO,LA MAGDALENA CONTRERAS,29,191,2,222,1110
CIUDAD DE MÉXICO,LA MAGDALENA CONTRERAS,20,231,4,255,1109
CIUDAD DE MÉXICO,LA MAGDALENA CONTRERAS,19,79,6,104,1405
CIUDAD DE MÉXICO,LA MAGDALENA CONTRERAS,14,77,3,94,1404
CIUDAD DE MÉXICO,LA MAGDALENA CONTRERAS,14,227,5,246,1349
CIUDAD DE MÉXICO,LA MAGDALENA CONTRERAS,19,260,3,282,1349
CIUDAD DE MÉXICO,LA MAGDALENA CONTRERAS,19,166,0,185,1738
CIUDAD DE MÉXICO,LA MAGDALENA CONTRERAS,16,183,1,200,1737
CIUDAD DE MÉXICO,LA MAGDALENA CONTRERAS,40,294,6,340,1762
CIUDAD DE MÉXICO,LA MAGDALENA CONTRERAS,33,317,4,354,1762
CIUDAD DE MÉXICO,LA MAGDALENA CONTRERAS,13,259,7,279,1248
CIUDAD DE MÉXICO,LA MAGDALENA CONTRERAS,17,252,6,275,1248
CIUDAD DE MÉXICO,LA MAGDALENA CONTRERAS,21,260,6,287,1501
CIUDAD DE MÉXICO,LA MAGDALENA CONTRERAS,24,250,1,275,1501
CIUDAD DE MÉXICO,LA MAGDALENA CONTRERAS,29,214,4,247,1501
CIUDAD DE MÉXICO,LA MAGDALENA CONTRERAS,27,321,4,352,1740
CIUDAD DE MÉXICO,LA MAGDALENA CONTRERAS,28,297,6,331,1740
CIUDAD DE MÉXICO,LA MAGDALENA CONTRERAS,31,326,8,365,1740
CIUDAD DE MÉXICO,LA MAGDALENA CONTRERAS,13,202,3,218,1268
CIUDAD DE MÉXICO,LA MAGDALENA CONTRERAS,21,219,4,244,1268
CIUDAD DE MÉXICO,LA MAGDALENA CONTRERAS,26,236,6,268,1465
CIUDAD DE MÉXICO,LA MAGDALENA CONTRERAS,25,239,3,267,1465
CIUDAD DE MÉXICO,LA MAGDALENA CONTRERAS,24,233,1,258,1464
CIUDAD DE MÉXICO,LA MAGDALENA CONTRERAS,24,305,4,333,1824
CIUDAD DE MÉXICO,LA MAGDALENA CONTRERAS,15,267,9,291,1824
CIUDAD DE MÉXICO,LA MAGDALENA CONTRERAS,19,252,4,275,1369
CIUDAD DE MÉXICO,LA MAGDALENA CONTRERAS,28,232,4,264,1369
CIUDAD DE MÉXICO,LA MAGDALENA CONTRERAS,30,260,8,298,1368
CIUDAD DE MÉXICO,LA MAGDALENA CONTRERAS,39,421,11,471,2105
CIUDAD DE MÉXICO,LA MAGDALENA CONTRERAS,21,278,6,305,1456
CIUDAD DE MÉXICO,LA MAGDALENA CONTRERAS,22,287,9,318,1456
CIUDAD DE MÉXICO,LA MAGDALENA CONTRERAS,38,277,3,318,1456
CIUDAD DE MÉXICO,LA MAGDALENA CONTRERAS,27,357,4,388,1937
CIUDAD DE MÉXICO,LA MAGDALENA CONTRERAS,31,394,3,428,1936
CIUDAD DE MÉXICO,GUSTAVO A. MADERO,47,324,6,377,1913
CIUDAD DE MÉXICO,GUSTAVO A. MADERO,48,332,2,382,1913
CIUDAD DE MÉXICO,GUSTAVO A. MADERO,17,304,4,325,1843
CIUDAD DE MÉXICO,GUSTAVO A. MADERO,28,360,2,390,1842
CIUDAD DE MÉXICO,GUSTAVO A. MADERO,23,178,1,202,1073
CIUDAD DE MÉXICO,GUSTAVO A. MADERO,11,180,3,194,1073
CIUDAD DE MÉXICO,GUSTAVO A. MADERO,40,321,2,363,1876
CIUDAD DE MÉXICO,GUSTAVO A. MADERO,36,280,0,316,1875
CIUDAD DE MÉXICO,GUSTAVO A. MADERO,27,296,3,326,1772
CIUDAD DE MÉXICO,GUSTAVO A. MADERO,27,269,5,301,1771
CIUDAD DE MÉXICO,GUSTAVO A. MADERO,23,233,1,257,1458
CIUDAD DE MÉXICO,GUSTAVO A. MADERO,24,279,6,309,1457
CIUDAD DE MÉXICO,GUSTAVO A. MADERO,38,256,1,295,1480
CIUDAD DE MÉXICO,GUSTAVO A. MADERO,35,230,5,270,1479
CIUDAD DE MÉXICO,GUSTAVO A. MADERO,21,311,6,338,1613
CIUDAD DE MÉXICO,GUSTAVO A. MADERO,27,263,6,296,1612
CIUDAD DE MÉXICO,GUSTAVO A. MADERO,46,260,4,310,1625
CIUDAD DE MÉXICO,GUSTAVO A. MADERO,45,313,5,363,1625
CIUDAD DE MÉXICO,GUSTAVO A. MADERO,14,263,0,277,1575
CIUDAD DE MÉXICO,GUSTAVO A. MADERO,13,285,1,299,1575
CIUDAD DE MÉXICO,GUSTAVO A. MADERO,39,304,2,345,1659
CIUDAD DE MÉXICO,GUSTAVO A. MADERO,42,340,8,390,1659
CIUDAD DE MÉXICO,GUSTAVO A. MADERO,35,309,5,349,1811
CIUDAD DE MÉXICO,GUSTAVO A. MADERO,40,271,4,315,1810
CIUDAD DE MÉXICO,GUSTAVO A. MADERO,37,376,11,424,1872
CIUDAD DE MÉXICO,GUSTAVO A. MADERO,57,360,5,422,1871
CIUDAD DE MÉXICO,GUSTAVO A. MADERO,19,185,2,206,1071
CIUDAD DE MÉXICO,GUSTAVO A. MADERO,15,169,2,186,1070
CIUDAD DE MÉXICO,GUSTAVO A. MADERO,35,329,8,372,1906
CIUDAD DE MÉXICO,GUSTAVO A. MADERO,28,312,7,347,1905
CIUDAD DE MÉXICO,GUSTAVO A. MADERO,20,304,8,332,1778
CIUDAD DE MÉXICO,GUSTAVO A. MADERO,30,284,2,316,1778
CIUDAD DE MÉXICO,GUSTAVO A. MADERO,38,284,2,324,1397
CIUDAD DE MÉXICO,GUSTAVO A. MADERO,21,266,1,288,1396
CIUDAD DE MÉXICO,GUSTAVO A. MADERO,25,352,3,380,1788
CIUDAD DE MÉXICO,GUSTAVO A. MADERO,28,355,5,388,1787
CIUDAD DE MÉXICO,GUSTAVO A. MADERO,26,249,3,278,1615
CIUDAD DE MÉXICO,GUSTAVO A. MADERO,22,259,2,283,1614
CIUDAD DE MÉXICO,GUSTAVO A. MADERO,31,309,4,344,1721
CIUDAD DE MÉXICO,GUSTAVO A. MADERO,18,299,5,322,1720
CIUDAD DE MÉXICO,GUSTAVO A. MADERO,9,163,3,175,1039
CIUDAD DE MÉXICO,GUSTAVO A. MADERO,12,181,1,194,1038
CIUDAD DE MÉXICO,GUSTAVO A. MADERO,30,232,3,265,1443
CIUDAD DE MÉXICO,GUSTAVO A. MADERO,21,226,1,248,1442
CIUDAD DE MÉXICO,GUSTAVO A. MADERO,27,281,1,309,1442
CIUDAD DE MÉXICO,GUSTAVO A. MADERO,26,322,4,352,1761
CIUDAD DE MÉXICO,GUSTAVO A. MADERO,35,346,3,384,1760
CIUDAD DE MÉXICO,GUSTAVO A. MADERO,19,292,6,317,1646
CIUDAD DE MÉXICO,GUSTAVO A. MADERO,27,321,5,353,1645
CIUDAD DE MÉXICO,GUSTAVO A. MADERO,24,358,6,388,1780
CIUDAD DE MÉXICO,GUSTAVO A. MADERO,28,248,66,342,1780
CIUDAD DE MÉXICO,GUSTAVO A. MADERO,23,322,5,350,1826
CIUDAD DE MÉXICO,GUSTAVO A. MADERO,25,326,0,351,1825
CIUDAD DE MÉXICO,GUSTAVO A. MADERO,30,269,0,299,1456
CIUDAD DE MÉXICO,GUSTAVO A. MADERO,33,265,3,301,1455
CIUDAD DE MÉXICO,GUSTAVO A. MADERO,27,266,1,294,1455
CIUDAD DE MÉXICO,GUSTAVO A. MADERO,37,325,3,365,1805
CIUDAD DE MÉXICO,GUSTAVO A. MADERO,26,280,4,310,1804
CIUDAD DE MÉXICO,GUSTAVO A. MADERO,25,293,5,323,1712
CIUDAD DE MÉXICO,GUSTAVO A. MADERO,24,315,3,342,1711
CIUDAD DE MÉXICO,GUSTAVO A. MADERO,45,344,7,396,1658
CIUDAD DE MÉXICO,GUSTAVO A. MADERO,35,370,7,412,1658
CIUDAD DE MÉXICO,GUSTAVO A. MADERO,26,241,4,271,1366
CIUDAD DE MÉXICO,GUSTAVO A. MADERO,24,260,3,287,1366
CIUDAD DE MÉXICO,GUSTAVO A. MADERO,29,228,6,263,1366
CIUDAD DE MÉXICO,GUSTAVO A. MADERO,28,265,4,297,1530
CIUDAD DE MÉXICO,GUSTAVO A. MADERO,22,301,0,323,1529
CIUDAD DE MÉXICO,GUSTAVO A. MADERO,21,254,4,279,1529
CIUDAD DE MÉXICO,GUSTAVO A. MADERO,22,253,4,279,1506
CIUDAD DE MÉXICO,GUSTAVO A. MADERO,19,305,2,326,1506
CIUDAD DE MÉXICO,GUSTAVO A. MADERO,26,274,0,300,1506
CIUDAD DE MÉXICO,GUSTAVO A. MADERO,39,330,3,372,1845
CIUDAD DE MÉXICO,GUSTAVO A. MADERO,23,332,8,363,1845
CIUDAD DE MÉXICO,GUSTAVO A. MADERO,31,297,5,333,1526
CIUDAD DE MÉXICO,GUSTAVO A. MADERO,28,298,8,334,1526
CIUDAD DE MÉXICO,GUSTAVO A. MADERO,40,287,5,332,1525
CIUDAD DE MÉXICO,GUSTAVO A. MADERO,34,358,7,399,1860
CIUDAD DE MÉXICO,GUSTAVO A. MADERO,39,345,7,391,1859
CIUDAD DE MÉXICO,GUSTAVO A. MADERO,28,293,5,326,1722
CIUDAD DE MÉXICO,GUSTAVO A. MADERO,28,314,3,345,1722
CIUDAD DE MÉXICO,GUSTAVO A. MADERO,27,291,1,319,1652
CIUDAD DE MÉXICO,GUSTAVO A. MADERO,26,311,2,339,1651
CIUDAD DE MÉXICO,GUSTAVO A. MADERO,22,279,1,302,1543
CIUDAD DE MÉXICO,GUSTAVO A. MADERO,31,287,2,320,1543
CIUDAD DE MÉXICO,GUSTAVO A. MADERO,46,309,5,360,1791
CIUDAD DE MÉXICO,GUSTAVO A. MADERO,32,322,10,364,1790
CIUDAD DE MÉXICO,GUSTAVO A. MADERO,38,300,9,347,1642
CIUDAD DE MÉXICO,GUSTAVO A. MADERO,26,311,5,342,1641
CIUDAD DE MÉXICO,GUSTAVO A. MADERO,35,396,5,436,1816
CIUDAD DE MÉXICO,GUSTAVO A. MADERO,35,390,3,428,1815
CIUDAD DE MÉXICO,GUSTAVO A. MADERO,41,368,5,414,1863
CIUDAD DE MÉXICO,GUSTAVO A. MADERO,20,355,8,383,1862
CIUDAD DE MÉXICO,GUSTAVO A. MADERO,32,293,2,327,1758
CIUDAD DE MÉXICO,GUSTAVO A. MADERO,28,374,9,411,1758
CIUDAD DE MÉXICO,GUSTAVO A. MADERO,32,320,8,360,1757
CIUDAD DE MÉXICO,GUSTAVO A. MADERO,26,320,3,349,1270
CIUDAD DE MÉXICO,GUSTAVO A. MADERO,26,283,5,314,1270
CIUDAD DE MÉXICO,GUSTAVO A. MADERO,53,666,5,724,0
CIUDAD DE MÉXICO,GUSTAVO A. MADERO,48,295,5,348,1425
CIUDAD DE MÉXICO,GUSTAVO A. MADERO,33,277,4,314,1425
CIUDAD DE MÉXICO,GUSTAVO A. MADERO,34,253,3,290,1425
CIUDAD DE MÉXICO,GUSTAVO A. MADERO,37,315,3,355,1624
CIUDAD DE MÉXICO,GUSTAVO A. MADERO,41,330,2,373,1624
CIUDAD DE MÉXICO,GUSTAVO A. MADERO,50,295,0,345,1418
CIUDAD DE MÉXICO,GUSTAVO A. MADERO,28,271,2,301,1417
CIUDAD DE MÉXICO,GUSTAVO A. MADERO,37,349,3,389,1936
CIUDAD DE MÉXICO,GUSTAVO A. MADERO,45,408,3,456,1935
CIUDAD DE MÉXICO,GUSTAVO A. MADERO,32,232,4,268,1037
CIUDAD DE MÉXICO,GUSTAVO A. MADERO,30,253,5,288,1037
CIUDAD DE MÉXICO,GUSTAVO A. MADERO,40,352,2,394,1861
CIUDAD DE MÉXICO,GUSTAVO A. MADERO,28,347,5,380,1861
CIUDAD DE MÉXICO,GUSTAVO A. MADERO,30,328,6,364,1802
CIUDAD DE MÉXICO,GUSTAVO A. MADERO,31,335,4,370,1802
CIUDAD DE MÉXICO,GUSTAVO A. MADERO,28,286,4,318,1470
CIUDAD DE MÉXICO,GUSTAVO A. MADERO,43,300,4,347,1469
CIUDAD DE MÉXICO,GUSTAVO A. MADERO,28,294,7,329,1469
CIUDAD DE MÉXICO,GUSTAVO A. MADERO,42,369,4,415,1751
CIUDAD DE MÉXICO,GUSTAVO A. MADERO,32,386,3,421,1751
CIUDAD DE MÉXICO,GUSTAVO A. MADERO,33,336,3,372,1670
CIUDAD DE MÉXICO,GUSTAVO A. MADERO,31,303,8,342,1669
CIUDAD DE MÉXICO,GUSTAVO A. MADERO,34,304,5,343,1687
CIUDAD DE MÉXICO,GUSTAVO A. MADERO,35,307,10,352,1687
CIUDAD DE MÉXICO,GUSTAVO A. MADERO,33,304,6,343,1727
CIUDAD DE MÉXICO,GUSTAVO A. MADERO,17,311,3,331,1727
CIUDAD DE MÉXICO,GUSTAVO A. MADERO,28,343,7,378,1760
CIUDAD DE MÉXICO,GUSTAVO A. MADERO,48,387,8,443,1760
CIUDAD DE MÉXICO,GUSTAVO A. MADERO,32,293,7,332,1656
CIUDAD DE MÉXICO,GUSTAVO A. MADERO,44,311,4,359,1655
CIUDAD DE MÉXICO,GUSTAVO A. MADERO,43,266,4,313,1930
CIUDAD DE MÉXICO,GUSTAVO A. MADERO,37,298,5,340,1930
CIUDAD DE MÉXICO,GUSTAVO A. MADERO,49,278,7,334,1674
CIUDAD DE MÉXICO,GUSTAVO A. MADERO,45,272,4,321,1674
CIUDAD DE MÉXICO,GUSTAVO A. MADERO,40,240,1,281,1752
CIUDAD DE MÉXICO,GUSTAVO A. MADERO,31,245,4,280,1751
CIUDAD DE MÉXICO,GUSTAVO A. MADERO,40,229,1,270,1751
CIUDAD DE MÉXICO,GUSTAVO A. MADERO,34,245,5,284,1666
CIUDAD DE MÉXICO,GUSTAVO A. MADERO,31,275,3,309,1665
CIUDAD DE MÉXICO,GUSTAVO A. MADERO,48,249,4,301,1891
CIUDAD DE MÉXICO,GUSTAVO A. MADERO,49,255,11,315,1891
CIUDAD DE MÉXICO,GUSTAVO A. MADERO,44,254,4,302,1891
CIUDAD DE MÉXICO,GUSTAVO A. MADERO,33,311,5,349,1781
CIUDAD DE MÉXICO,GUSTAVO A. MADERO,24,333,9,366,1780
CIUDAD DE MÉXICO,GUSTAVO A. MADERO,23,289,6,318,1553
CIUDAD DE MÉXICO,GUSTAVO A. MADERO,19,288,5,312,1552
CIUDAD DE MÉXICO,GUSTAVO A. MADERO,38,338,6,382,1701
CIUDAD DE MÉXICO,GUSTAVO A. MADERO,27,333,4,364,1700
CIUDAD DE MÉXICO,GUSTAVO A. MADERO,41,324,4,369,1679
CIUDAD DE MÉXICO,GUSTAVO A. MADERO,27,323,5,355,1679
CIUDAD DE MÉXICO,GUSTAVO A. MADERO,45,298,4,347,1659
CIUDAD DE MÉXICO,GUSTAVO A. MADERO,43,284,4,331,1659
CIUDAD DE MÉXICO,GUSTAVO A. MADERO,25,323,5,353,1758
CIUDAD DE MÉXICO,GUSTAVO A. MADERO,23,349,3,375,1757
CIUDAD DE MÉXICO,GUSTAVO A. MADERO,24,295,5,324,1413
CIUDAD DE MÉXICO,GUSTAVO A. MADERO,17,272,9,298,1412
CIUDAD DE MÉXICO,GUSTAVO A. MADERO,16,257,1,274,1432
CIUDAD DE MÉXICO,GUSTAVO A. MADERO,18,252,3,273,1431
CIUDAD DE MÉXICO,GUSTAVO A. MADERO,35,348,7,390,1860
CIUDAD DE MÉXICO,GUSTAVO A. MADERO,38,336,3,377,1860
CIUDAD DE MÉXICO,GUSTAVO A. MADERO,45,275,9,329,1656
CIUDAD DE MÉXICO,GUSTAVO A. MADERO,43,311,6,360,1656
CIUDAD DE MÉXICO,GUSTAVO A. MADERO,31,153,1,185,1040
CIUDAD DE MÉXICO,GUSTAVO A. MADERO,27,202,1,230,1039
CIUDAD DE MÉXICO,GUSTAVO A. MADERO,28,205,4,237,1428
CIUDAD DE MÉXICO,GUSTAVO A. MADERO,37,185,2,224,1427
CIUDAD DE MÉXICO,GUSTAVO A. MADERO,39,318,3,360,1623
CIUDAD DE MÉXICO,GUSTAVO A. MADERO,43,264,2,309,1623
CIUDAD DE MÉXICO,GUSTAVO A. MADERO,30,286,3,319,1623
CIUDAD DE MÉXICO,GUSTAVO A. MADERO,42,279,6,327,1851
CIUDAD DE MÉXICO,GUSTAVO A. MADERO,46,291,2,339,1851
CIUDAD DE MÉXICO,GUSTAVO A. MADERO,42,324,0,366,1807
CIUDAD DE MÉXICO,GUSTAVO A. MADERO,32,343,3,378,1807
CIUDAD DE MÉXICO,GUSTAVO A. MADERO,35,266,2,303,1615
CIUDAD DE MÉXICO,GUSTAVO A. MADERO,41,244,7,292,1615
CIUDAD DE MÉXICO,GUSTAVO A. MADERO,24,255,1,280,1614
CIUDAD DE MÉXICO,GUSTAVO A. MADERO,47,277,5,329,1656
CIUDAD DE MÉXICO,GUSTAVO A. MADERO,39,277,2,318,1656
CIUDAD DE MÉXICO,GUSTAVO A. MADERO,21,268,1,290,1449
CIUDAD DE MÉXICO,GUSTAVO A. MADERO,19,253,4,276,1448
CIUDAD DE MÉXICO,GUSTAVO A. MADERO,36,220,1,257,1305
CIUDAD DE MÉXICO,GUSTAVO A. MADERO,22,249,3,274,1304
CIUDAD DE MÉXICO,GUSTAVO A. MADERO,49,239,4,292,1324
CIUDAD DE MÉXICO,GUSTAVO A. MADERO,26,242,2,270,1323
CIUDAD DE MÉXICO,GUSTAVO A. MADERO,47,207,3,257,1262
CIUDAD DE MÉXICO,GUSTAVO A. MADERO,33,188,2,223,1261
CIUDAD DE MÉXICO,GUSTAVO A. MADERO,45,299,9,353,1677
CIUDAD DE MÉXICO,GUSTAVO A. MADERO,27,279,8,314,1677
CIUDAD DE MÉXICO,GUSTAVO A. MADERO,35,326,4,365,1818
CIUDAD DE MÉXICO,GUSTAVO A. MADERO,39,366,8,413,1817
CIUDAD DE MÉXICO,GUSTAVO A. MADERO,40,225,1,266,1365
CIUDAD DE MÉXICO,GUSTAVO A. MADERO,45,211,0,256,1365
CIUDAD DE MÉXICO,GUSTAVO A. MADERO,50,206,4,260,1365
CIUDAD DE MÉXICO,GUSTAVO A. MADERO,42,314,10,366,1903
CIUDAD DE MÉXICO,GUSTAVO A. MADERO,58,281,4,343,1902
CIUDAD DE MÉXICO,GUSTAVO A. MADERO,47,219,4,270,1657
CIUDAD DE MÉXICO,GUSTAVO A. MADERO,44,275,1,320,1657
CIUDAD DE MÉXICO,GUSTAVO A. MADERO,26,265,4,295,1547
CIUDAD DE MÉXICO,GUSTAVO A. MADERO,21,272,5,298,1547
CIUDAD DE MÉXICO,GUSTAVO A. MADERO,32,257,3,292,1547
CIUDAD DE MÉXICO,GUSTAVO A. MADERO,39,222,7,268,1401
CIUDAD DE MÉXICO,GUSTAVO A. MADERO,29,214,2,245,1401
CIUDAD DE MÉXICO,GUSTAVO A. MADERO,32,234,4,270,1401
CIUDAD DE MÉXICO,GUSTAVO A. MADERO,65,304,10,379,1851
CIUDAD DE MÉXICO,GUSTAVO A. MADERO,47,313,8,368,1850
CIUDAD DE MÉXICO,GUSTAVO A. MADERO,33,278,4,315,1449
CIUDAD DE MÉXICO,GUSTAVO A. MADERO,27,247,4,278,1449
CIUDAD DE MÉXICO,GUSTAVO A. MADERO,40,243,3,286,1449
CIUDAD DE MÉXICO,GUSTAVO A. MADERO,39,204,0,243,1173
CIUDAD DE MÉXICO,GUSTAVO A. MADERO,34,188,3,225,1173
CIUDAD DE MÉXICO,GUSTAVO A. MADERO,37,314,1,352,1684
CIUDAD DE MÉXICO,GUSTAVO A. MADERO,32,298,5,335,1684
CIUDAD DE MÉXICO,GUSTAVO A. MADERO,31,226,2,259,1397
CIUDAD DE MÉXICO,GUSTAVO A. MADERO,32,262,0,294,1397
CIUDAD DE MÉXICO,GUSTAVO A. MADERO,29,277,1,307,1642
CIUDAD DE MÉXICO,GUSTAVO A. MADERO,33,241,2,276,1642
CIUDAD DE MÉXICO,GUSTAVO A. MADERO,32,340,12,384,1962
CIUDAD DE MÉXICO,GUSTAVO A. MADERO,50,234,6,290,1961
CIUDAD DE MÉXICO,GUSTAVO A. MADERO,26,245,3,274,1074
CIUDAD DE MÉXICO,GUSTAVO A. MADERO,25,267,4,296,1074
CIUDAD DE MÉXICO,GUSTAVO A. MADERO,15,289,9,313,1407
CIUDAD DE MÉXICO,GUSTAVO A. MADERO,16,297,1,314,1406
CIUDAD DE MÉXICO,GUSTAVO A. MADERO,17,261,2,280,1406
CIUDAD DE MÉXICO,GUSTAVO A. MADERO,23,248,2,273,1326
CIUDAD DE MÉXICO,GUSTAVO A. MADERO,24,272,1,297,1325
CIUDAD DE MÉXICO,CUAUHTEMOC,40,274,4,318,1548
CIUDAD DE MÉXICO,CUAUHTEMOC,30,252,5,287,1547
CIUDAD DE MÉXICO,CUAUHTEMOC,27,221,3,251,1350
CIUDAD DE MÉXICO,CUAUHTEMOC,20,210,2,232,1350
CIUDAD DE MÉXICO,CUAUHTEMOC,28,209,3,240,1350
CIUDAD DE MÉXICO,CUAUHTEMOC,51,287,4,342,1675
CIUDAD DE MÉXICO,CUAUHTEMOC,56,299,4,359,1674
CIUDAD DE MÉXICO,CUAUHTEMOC,39,290,4,333,1913
CIUDAD DE MÉXICO,CUAUHTEMOC,35,282,4,321,1912
CIUDAD DE MÉXICO,CUAUHTEMOC,20,269,2,291,1597
CIUDAD DE MÉXICO,CUAUHTEMOC,32,257,4,293,1596
CIUDAD DE MÉXICO,CUAUHTEMOC,29,268,7,304,1596
CIUDAD DE MÉXICO,CUAUHTEMOC,33,185,1,219,1558
CIUDAD DE MÉXICO,CUAUHTEMOC,40,272,4,316,1558
CIUDAD DE MÉXICO,CUAUHTEMOC,48,374,6,428,1949
CIUDAD DE MÉXICO,CUAUHTEMOC,25,230,6,261,1572
CIUDAD DE MÉXICO,CUAUHTEMOC,22,245,3,270,1571
CIUDAD DE MÉXICO,CUAUHTEMOC,32,244,1,277,1571
CIUDAD DE MÉXICO,CUAUHTEMOC,56,183,4,243,1436
CIUDAD DE MÉXICO,CUAUHTEMOC,33,183,3,219,1435
CIUDAD DE MÉXICO,CUAUHTEMOC,50,187,1,238,1435
CIUDAD DE MÉXICO,CUAUHTEMOC,56,295,4,355,1878
CIUDAD DE MÉXICO,CUAUHTEMOC,37,290,10,337,1878
CIUDAD DE MÉXICO,CUAUHTEMOC,28,273,7,308,1514
CIUDAD DE MÉXICO,CUAUHTEMOC,36,285,5,326,1513
CIUDAD DE MÉXICO,CUAUHTEMOC,34,312,3,349,1931
CIUDAD DE MÉXICO,CUAUHTEMOC,46,346,4,396,1930
CIUDAD DE MÉXICO,CUAUHTEMOC,32,229,3,264,1476
CIUDAD DE MÉXICO,CUAUHTEMOC,43,224,3,270,1476
CIUDAD DE MÉXICO,CUAUHTEMOC,33,255,2,290,1728
CIUDAD DE MÉXICO,CUAUHTEMOC,36,295,2,333,1727
CIUDAD DE MÉXICO,CUAUHTEMOC,36,236,4,276,1458
CIUDAD DE MÉXICO,CUAUHTEMOC,26,252,6,284,1458
CIUDAD DE MÉXICO,CUAUHTEMOC,37,255,3,295,1893
CIUDAD DE MÉXICO,CUAUHTEMOC,36,287,3,326,1892
CIUDAD DE MÉXICO,CUAUHTEMOC,44,235,3,282,1369
CIUDAD DE MÉXICO,CUAUHTEMOC,27,186,2,215,1368
CIUDAD DE MÉXICO,CUAUHTEMOC,22,239,1,262,1484
CIUDAD DE MÉXICO,CUAUHTEMOC,27,248,9,284,1484
CIUDAD DE MÉXICO,CUAUHTEMOC,39,240,2,281,1414
CIUDAD DE MÉXICO,CUAUHTEMOC,27,195,2,224,1413
CIUDAD DE MÉXICO,CUAUHTEMOC,33,207,13,253,1075
CIUDAD DE MÉXICO,CUAUHTEMOC,27,242,5,274,1075
CIUDAD DE MÉXICO,CUAUHTEMOC,40,238,8,286,1538
CIUDAD DE MÉXICO,CUAUHTEMOC,40,261,3,304,1537
CIUDAD DE MÉXICO,CUAUHTEMOC,30,192,3,225,1351
CIUDAD DE MÉXICO,CUAUHTEMOC,33,203,5,241,1351
CIUDAD DE MÉXICO,CUAUHTEMOC,18,213,1,232,1351
CIUDAD DE MÉXICO,CUAUHTEMOC,41,292,4,337,1695
CIUDAD DE MÉXICO,CUAUHTEMOC,43,293,3,339,1695
CIUDAD DE MÉXICO,CUAUHTEMOC,42,353,6,401,1886
CIUDAD DE MÉXICO,CUAUHTEMOC,46,326,6,378,1885
CIUDAD DE MÉXICO,CUAUHTEMOC,129,1152,11,1292,0
CIUDAD DE MÉXICO,CUAUHTEMOC,49,258,3,310,1731
CIUDAD DE MÉXICO,CUAUHTEMOC,36,297,6,339,1731
CIUDAD DE MÉXICO,CUAUHTEMOC,37,269,10,316,1731
CIUDAD DE MÉXICO,CUAUHTEMOC,48,302,8,358,1887
CIUDAD DE MÉXICO,CUAUHTEMOC,43,292,8,343,1887
CIUDAD DE MÉXICO,CUAUHTEMOC,35,333,7,375,1589
CIUDAD DE MÉXICO,CUAUHTEMOC,29,292,1,322,1589
CIUDAD DE MÉXICO,CUAUHTEMOC,7,257,8,272,1589
CIUDAD DE MÉXICO,CUAUHTEMOC,38,235,7,280,1533
CIUDAD DE MÉXICO,CUAUHTEMOC,40,246,6,292,1533
CIUDAD DE MÉXICO,CUAUHTEMOC,39,223,4,266,1434
CIUDAD DE MÉXICO,CUAUHTEMOC,41,230,9,280,1434
CIUDAD DE MÉXICO,CUAUHTEMOC,46,272,3,321,1434
CIUDAD DE MÉXICO,CUAUHTEMOC,43,302,4,349,1856
CIUDAD DE MÉXICO,CUAUHTEMOC,40,287,3,330,1856
CIUDAD DE MÉXICO,CUAUHTEMOC,44,361,8,413,1857
CIUDAD DE MÉXICO,CUAUHTEMOC,38,350,3,391,1857
CIUDAD DE MÉXICO,CUAUHTEMOC,31,272,5,308,1656
CIUDAD DE MÉXICO,CUAUHTEMOC,38,278,2,318,1656
CIUDAD DE MÉXICO,CUAUHTEMOC,40,269,4,313,1931
CIUDAD DE MÉXICO,CUAUHTEMOC,47,274,1,322,1930
CIUDAD DE MÉXICO,CUAUHTEMOC,30,298,12,340,1674
CIUDAD DE MÉXICO,CUAUHTEMOC,39,267,6,312,1673
CIUDAD DE MÉXICO,CUAUHTEMOC,40,230,2,272,1579
CIUDAD DE MÉXICO,CUAUHTEMOC,30,227,12,269,1578
CIUDAD DE MÉXICO,CUAUHTEMOC,24,222,9,255,1578
CIUDAD DE MÉXICO,CUAUHTEMOC,38,262,10,310,1466
CIUDAD DE MÉXICO,CUAUHTEMOC,32,260,4,296,1466
CIUDAD DE MÉXICO,CUAUHTEMOC,52,296,7,355,1951
CIUDAD DE MÉXICO,CUAUHTEMOC,38,326,0,364,1950
CIUDAD DE MÉXICO,CUAUHTEMOC,36,290,7,333,1726
CIUDAD DE MÉXICO,CUAUHTEMOC,20,274,4,298,1725
CIUDAD DE MÉXICO,CUAUHTEMOC,44,254,3,301,1725
CIUDAD DE MÉXICO,CUAUHTEMOC,43,322,6,371,1803
CIUDAD DE MÉXICO,CUAUHTEMOC,25,312,3,340,1803
CIUDAD DE MÉXICO,CUAUHTEMOC,31,329,7,367,1895
CIUDAD DE MÉXICO,CUAUHTEMOC,44,348,2,394,1895
CIUDAD DE MÉXICO,CUAUHTEMOC,20,277,8,305,1452
CIUDAD DE MÉXICO,CUAUHTEMOC,37,238,4,279,1452
CIUDAD DE MÉXICO,CUAUHTEMOC,43,293,0,336,1694
CIUDAD DE MÉXICO,CUAUHTEMOC,58,327,11,396,1694
CIUDAD DE MÉXICO,CUAUHTEMOC,19,170,0,189,1063
CIUDAD DE MÉXICO,CUAUHTEMOC,20,209,4,233,1062
CIUDAD DE MÉXICO,CUAUHTEMOC,24,248,3,275,1362
CIUDAD DE MÉXICO,CUAUHTEMOC,25,234,7,266,1361
CIUDAD DE MÉXICO,CUAUHTEMOC,28,301,8,337,1626
CIUDAD DE MÉXICO,CUAUHTEMOC,31,284,5,320,1626
CIUDAD DE MÉXICO,CUAUHTEMOC,33,280,8,321,1675
CIUDAD DE MÉXICO,CUAUHTEMOC,24,307,7,338,1675
CIUDAD DE MÉXICO,CUAUHTEMOC,40,343,7,390,1739
CIUDAD DE MÉXICO,CUAUHTEMOC,37,299,5,341,1738
CIUDAD DE MÉXICO,CUAUHTEMOC,27,301,3,331,1689
CIUDAD DE MÉXICO,CUAUHTEMOC,26,271,2,299,1689
CIUDAD DE MÉXICO,CUAUHTEMOC,30,291,5,326,1689
CIUDAD DE MÉXICO,CUAUHTEMOC,46,349,5,400,1802
CIUDAD DE MÉXICO,CUAUHTEMOC,46,321,8,375,1802
CIUDAD DE MÉXICO,CUAUHTEMOC,30,380,6,416,1802
CIUDAD DE MÉXICO,CUAUHTEMOC,65,376,8,449,1854
CIUDAD DE MÉXICO,CUAUHTEMOC,52,404,12,468,1853
CIUDAD DE MÉXICO,CUAUHTEMOC,62,292,9,363,1445
CIUDAD DE MÉXICO,CUAUHTEMOC,60,294,5,359,1445
CIUDAD DE MÉXICO,CUAUHTEMOC,34,294,8,336,1444
CIUDAD DE MÉXICO,CUAUHTEMOC,49,302,6,357,1861
CIUDAD DE MÉXICO,CUAUHTEMOC,58,318,4,380,1861
CIUDAD DE MÉXICO,CUAUHTEMOC,34,255,4,293,1534
CIUDAD DE MÉXICO,CUAUHTEMOC,36,261,7,304,1533
CIUDAD DE MÉXICO,CUAUHTEMOC,45,283,8,336,1533
CIUDAD DE MÉXICO,CUAUHTEMOC,54,299,11,364,1478
CIUDAD DE MÉXICO,CUAUHTEMOC,55,326,6,387,1478
CIUDAD DE MÉXICO,CUAUHTEMOC,28,429,14,471,1939
CIUDAD DE MÉXICO,CUAUHTEMOC,88,417,8,513,1938
CIUDAD DE MÉXICO,CUAUHTEMOC,54,304,10,368,1478
CIUDAD DE MÉXICO,CUAUHTEMOC,48,266,7,321,1478
CIUDAD DE MÉXICO,CUAUHTEMOC,61,370,5,436,1752
CIUDAD DE MÉXICO,CUAUHTEMOC,55,355,10,420,1752
CIUDAD DE MÉXICO,CUAUHTEMOC,57,382,11,450,1763
CIUDAD DE MÉXICO,CUAUHTEMOC,48,1343,5,1396,1763
CIUDAD DE MÉXICO,CUAUHTEMOC,146,274,12,432,1484
CIUDAD DE MÉXICO,CUAUHTEMOC,37,374,13,424,1483
CIUDAD DE MÉXICO,CUAUHTEMOC,70,358,14,442,1751
CIUDAD DE MÉXICO,CUAUHTEMOC,65,359,7,431,1751
CIUDAD DE MÉXICO,CUAUHTEMOC,50,331,9,390,1606
CIUDAD DE MÉXICO,CUAUHTEMOC,64,37,11,112,1605
CIUDAD DE MÉXICO,CUAUHTEMOC,58,362,7,427,1605
CIUDAD DE MÉXICO,CUAUHTEMOC,75,320,11,406,1793
CIUDAD DE MÉXICO,CUAUHTEMOC,65,374,9,448,1792
CIUDAD DE MÉXICO,CUAUHTEMOC,88,408,13,509,1869
CIUDAD DE MÉXICO,CUAUHTEMOC,68,408,13,489,1868
CIUDAD DE MÉXICO,CUAUHTEMOC,50,395,11,456,1919
CIUDAD DE MÉXICO,CUAUHTEMOC,53,398,23,474,1918
CIUDAD DE MÉXICO,CUAUHTEMOC,59,609,18,686,1647
CIUDAD DE MÉXICO,CUAUHTEMOC,62,930,16,1008,1646
CIUDAD DE MÉXICO,CUAUHTEMOC,49,496,7,552,1735
CIUDAD DE MÉXICO,CUAUHTEMOC,55,370,12,437,1735
CIUDAD DE MÉXICO,CUAUHTEMOC,64,432,9,505,1836
CIUDAD DE MÉXICO,CUAUHTEMOC,58,424,1,483,1836
CIUDAD DE MÉXICO,CUAUHTEMOC,62,516,12,590,1960
CIUDAD DE MÉXICO,CUAUHTEMOC,74,675,18,767,1959
CIUDAD DE MÉXICO,CUAUHTEMOC,64,366,9,439,1707
CIUDAD DE MÉXICO,CUAUHTEMOC,72,348,6,426,1706
CIUDAD DE MÉXICO,CUAUHTEMOC,48,293,8,349,1475
CIUDAD DE MÉXICO,CUAUHTEMOC,48,299,14,361,1475
CIUDAD DE MÉXICO,CUAUHTEMOC,57,288,8,353,1475
CIUDAD DE MÉXICO,CUAUHTEMOC,67,418,26,511,1926
CIUDAD DE MÉXICO,CUAUHTEMOC,63,461,6,530,1926
CIUDAD DE MÉXICO,CUAUHTEMOC,33,369,9,411,1781
CIUDAD DE MÉXICO,CUAUHTEMOC,39,367,17,423,1781
CIUDAD DE MÉXICO,CUAUHTEMOC,18,331,23,372,1656
CIUDAD DE MÉXICO,CUAUHTEMOC,50,325,7,382,1656
CIUDAD DE MÉXICO,CUAUHTEMOC,51,316,4,371,1656
CIUDAD DE MÉXICO,CUAUHTEMOC,62,286,14,362,1593
CIUDAD DE MÉXICO,CUAUHTEMOC,59,330,13,402,1593
CIUDAD DE MÉXICO,CUAUHTEMOC,42,277,15,334,1681
CIUDAD DE MÉXICO,CUAUHTEMOC,36,259,6,301,1680
CIUDAD DE MÉXICO,CUAUHTEMOC,47,258,9,314,1226
CIUDAD DE MÉXICO,CUAUHTEMOC,31,266,7,304,1226
CIUDAD DE MÉXICO,TLAHUAC,18,305,5,328,1422
CIUDAD DE MÉXICO,TLAHUAC,21,321,4,346,1422
CIUDAD DE MÉXICO,TLAHUAC,20,275,6,301,1289
CIUDAD DE MÉXICO,TLAHUAC,25,305,4,334,1289
CIUDAD DE MÉXICO,TLAHUAC,29,354,9,392,1893
CIUDAD DE MÉXICO,TLAHUAC,26,403,6,435,1892
CIUDAD DE MÉXICO,TLAHUAC,15,340,9,364,1682
CIUDAD DE MÉXICO,TLAHUAC,21,352,1,374,1681
CIUDAD DE MÉXICO,TLAHUAC,21,293,5,319,1587
CIUDAD DE MÉXICO,TLAHUAC,15,294,7,316,1587
CIUDAD DE MÉXICO,TLAHUAC,39,468,3,510,1899
CIUDAD DE MÉXICO,TLAHUAC,35,375,2,412,1899
CIUDAD DE MÉXICO,TLAHUAC,31,273,5,309,1288
CIUDAD DE MÉXICO,TLAHUAC,36,286,2,324,1288
CIUDAD DE MÉXICO,TLAHUAC,23,240,2,265,1252
CIUDAD DE MÉXICO,TLAHUAC,26,265,4,295,1252
CIUDAD DE MÉXICO,TLAHUAC,38,416,5,459,1642
CIUDAD DE MÉXICO,TLAHUAC,25,393,11,429,1642
CIUDAD DE MÉXICO,TLAHUAC,14,413,9,436,1641
CIUDAD DE MÉXICO,TLAHUAC,14,281,1,296,1174
CIUDAD DE MÉXICO,TLAHUAC,15,281,6,302,1174
CIUDAD DE MÉXICO,TLAHUAC,21,269,3,293,1238
CIUDAD DE MÉXICO,TLAHUAC,24,313,5,342,1237
CIUDAD DE MÉXICO,TLAHUAC,27,347,3,377,1663
CIUDAD DE MÉXICO,TLAHUAC,30,357,6,393,1663
CIUDAD DE MÉXICO,TLAHUAC,23,346,9,378,1652
CIUDAD DE MÉXICO,TLAHUAC,19,338,11,368,1651
CIUDAD DE MÉXICO,TLAHUAC,23,219,1,243,1432
CIUDAD DE MÉXICO,TLAHUAC,22,257,3,282,1431
CIUDAD DE MÉXICO,TLAHUAC,15,246,2,263,1431
CIUDAD DE MÉXICO,TLAHUAC,25,252,7,284,1774
CIUDAD DE MÉXICO,TLAHUAC,25,243,6,274,1773
CIUDAD DE MÉXICO,TLAHUAC,28,244,2,274,1773
CIUDAD DE MÉXICO,TLAHUAC,23,287,3,313,1773
CIUDAD DE MÉXICO,TLAHUAC,23,269,4,296,1773
CIUDAD DE MÉXICO,TLAHUAC,24,254,2,280,1773
CIUDAD DE MÉXICO,TLAHUAC,29,239,0,268,1773
CIUDAD DE MÉXICO,TLAHUAC,29,224,4,257,1773
CIUDAD DE MÉXICO,TLAHUAC,36,349,1,386,1826
CIUDAD DE MÉXICO,TLAHUAC,35,338,4,377,1825
CIUDAD DE MÉXICO,TLAHUAC,19,201,6,226,1034
CIUDAD DE MÉXICO,TLAHUAC,27,246,4,277,1033
CIUDAD DE MÉXICO,TLAHUAC,27,196,4,227,1078
CIUDAD DE MÉXICO,TLAHUAC,26,238,5,269,1078
CIUDAD DE MÉXICO,TLAHUAC,29,317,5,351,1606
CIUDAD DE MÉXICO,TLAHUAC,28,302,7,337,1606
CIUDAD DE MÉXICO,TLAHUAC,24,288,3,315,1573
CIUDAD DE MÉXICO,TLAHUAC,34,290,4,328,1573
CIUDAD DE MÉXICO,TLAHUAC,33,299,4,336,1573
CIUDAD DE MÉXICO,TLAHUAC,33,328,7,368,1647
CIUDAD DE MÉXICO,TLAHUAC,36,309,4,349,1646
CIUDAD DE MÉXICO,TLAHUAC,32,326,4,362,1646
CIUDAD DE MÉXICO,TLAHUAC,29,358,5,392,1864
CIUDAD DE MÉXICO,TLAHUAC,40,386,7,433,1863
CIUDAD DE MÉXICO,TLAHUAC,41,395,6,442,1878
CIUDAD DE MÉXICO,TLAHUAC,26,413,5,444,1878
CIUDAD DE MÉXICO,TLAHUAC,19,309,3,331,1664
CIUDAD DE MÉXICO,TLAHUAC,28,341,2,371,1664
CIUDAD DE MÉXICO,TLAHUAC,18,228,1,247,1077
CIUDAD DE MÉXICO,TLAHUAC,25,221,4,250,1077
CIUDAD DE MÉXICO,TLAHUAC,17,377,3,397,1502
CIUDAD DE MÉXICO,TLAHUAC,27,347,3,377,1502
CIUDAD DE MÉXICO,TLAHUAC,24,339,1,364,1729
CIUDAD DE MÉXICO,TLAHUAC,29,397,1,427,1729
CIUDAD DE MÉXICO,TLAHUAC,16,214,1,231,1071
CIUDAD DE MÉXICO,TLAHUAC,11,215,1,227,1071
CIUDAD DE MÉXICO,TLAHUAC,30,330,2,362,1685
CIUDAD DE MÉXICO,TLAHUAC,40,368,1,409,1684
CIUDAD DE MÉXICO,TLAHUAC,20,298,5,323,1439
CIUDAD DE MÉXICO,TLAHUAC,22,264,6,292,1438
CIUDAD DE MÉXICO,TLAHUAC,30,274,0,304,1522
CIUDAD DE MÉXICO,TLAHUAC,39,274,5,318,1522
CIUDAD DE MÉXICO,TLAHUAC,29,400,11,440,1665
CIUDAD DE MÉXICO,TLAHUAC,32,394,6,432,1665
CIUDAD DE MÉXICO,TLAHUAC,42,366,3,411,1664
CIUDAD DE MÉXICO,TLAHUAC,24,341,5,370,1663
CIUDAD DE MÉXICO,TLAHUAC,28,319,0,347,1668
CIUDAD DE MÉXICO,TLAHUAC,19,314,2,335,1668
CIUDAD DE MÉXICO,TLAHUAC,27,311,5,343,1667
CIUDAD DE MÉXICO,TLAHUAC,27,306,4,337,1879
CIUDAD DE MÉXICO,TLAHUAC,356,21,1,378,1878
CIUDAD DE MÉXICO,TLAHUAC,39,337,7,383,1835
CIUDAD DE MÉXICO,TLAHUAC,33,388,4,425,1835
CIUDAD DE MÉXICO,TLAHUAC,22,432,5,459,1909
CIUDAD DE MÉXICO,TLAHUAC,39,372,11,422,1909
CIUDAD DE MÉXICO,TLAHUAC,17,241,5,263,1438
CIUDAD DE MÉXICO,TLAHUAC,26,228,5,259,1438
CIUDAD DE MÉXICO,TLAHUAC,12,248,3,263,1438
CIUDAD DE MÉXICO,TLAHUAC,21,286,3,310,1369
CIUDAD DE MÉXICO,TLAHUAC,26,274,4,304,1369
CIUDAD DE MÉXICO,TLAHUAC,25,315,0,340,1369
CIUDAD DE MÉXICO,TLAHUAC,29,380,2,411,1830
CIUDAD DE MÉXICO,TLAHUAC,17,379,6,402,1829
CIUDAD DE MÉXICO,TLAHUAC,37,443,5,485,1925
CIUDAD DE MÉXICO,TLAHUAC,42,400,5,447,1925
CIUDAD DE MÉXICO,TLAHUAC,20,453,3,476,1964
CIUDAD DE MÉXICO,TLAHUAC,39,414,8,461,1964
CIUDAD DE MÉXICO,TLAHUAC,20,392,5,417,1644
CIUDAD DE MÉXICO,TLAHUAC,26,331,7,364,1643
CIUDAD DE MÉXICO,TLAHUAC,28,327,6,361,1610
CIUDAD DE MÉXICO,TLAHUAC,27,313,3,343,1609
CIUDAD DE MÉXICO,TLAHUAC,13,233,4,250,1187
CIUDAD DE MÉXICO,TLAHUAC,21,247,13,281,1186
CIUDAD DE MÉXICO,TLAHUAC,21,198,4,223,1072
CIUDAD DE MÉXICO,TLAHUAC,24,220,3,247,1071
CIUDAD DE MÉXICO,TLAHUAC,26,214,4,244,1185
CIUDAD DE MÉXICO,TLAHUAC,21,243,0,264,1185
CIUDAD DE MÉXICO,TLAHUAC,34,272,2,308,1510
CIUDAD DE MÉXICO,TLAHUAC,26,244,0,270,1510
CIUDAD DE MÉXICO,TLAHUAC,19,272,14,305,1510
CIUDAD DE MÉXICO,TLAHUAC,29,349,2,380,1873
CIUDAD DE MÉXICO,TLAHUAC,26,350,5,381,1873
CIUDAD DE MÉXICO,TLAHUAC,49,426,4,479,1780
CIUDAD DE MÉXICO,TLAHUAC,36,406,8,450,1779
CIUDAD DE MÉXICO,TLAHUAC,31,397,4,432,1656
CIUDAD DE MÉXICO,TLAHUAC,35,350,5,390,1656
CIUDAD DE MÉXICO,TLAHUAC,26,348,6,380,1655
CIUDAD DE MÉXICO,TLAHUAC,31,364,4,399,1881
CIUDAD DE MÉXICO,TLAHUAC,50,347,3,400,1881
CIUDAD DE MÉXICO,TLAHUAC,23,348,3,374,1885
CIUDAD DE MÉXICO,TLAHUAC,40,251,5,296,1884
CIUDAD DE MÉXICO,TLAHUAC,33,269,8,310,1884
CIUDAD DE MÉXICO,TLAHUAC,34,311,2,347,1884
CIUDAD DE MÉXICO,TLAHUAC,79,1167,10,1256,0
CIUDAD DE MÉXICO,TLAHUAC,28,289,5,322,1744
CIUDAD DE MÉXICO,TLAHUAC,25,305,2,332,1744
CIUDAD DE MÉXICO,TLAHUAC,12,370,4,386,1743
CIUDAD DE MÉXICO,TLAHUAC,37,326,5,368,1728
CIUDAD DE MÉXICO,TLAHUAC,36,368,6,410,1727
CIUDAD DE MÉXICO,TLAHUAC,59,340,7,406,1848
CIUDAD DE MÉXICO,TLAHUAC,32,368,7,407,1847
CIUDAD DE MÉXICO,TLAHUAC,36,376,7,419,1756
CIUDAD DE MÉXICO,TLAHUAC,44,344,13,401,1756
CIUDAD DE MÉXICO,TLAHUAC,52,392,9,453,1604
CIUDAD DE MÉXICO,TLAHUAC,42,374,5,421,1604
CIUDAD DE MÉXICO,TLAHUAC,39,404,6,449,1905
CIUDAD DE MÉXICO,TLAHUAC,39,365,6,410,1905
CIUDAD DE MÉXICO,TLAHUAC,21,283,0,304,1272
CIUDAD DE MÉXICO,TLAHUAC,29,301,2,332,1272
CIUDAD DE MÉXICO,TLAHUAC,41,222,11,274,988
CIUDAD DE MÉXICO,TLAHUAC,20,250,5,275,988
CIUDAD DE MÉXICO,TLAHUAC,26,250,6,282,1417
CIUDAD DE MÉXICO,TLAHUAC,22,249,0,271,1416
CIUDAD DE MÉXICO,TLAHUAC,32,382,5,419,1864
CIUDAD DE MÉXICO,TLAHUAC,30,348,5,383,1864
CIUDAD DE MÉXICO,TLAHUAC,24,437,7,468,1678
CIUDAD DE MÉXICO,TLAHUAC,25,334,3,362,1678
CIUDAD DE MÉXICO,TLAHUAC,21,347,7,375,1677
CIUDAD DE MÉXICO,TLAHUAC,49,386,9,444,1810
CIUDAD DE MÉXICO,TLAHUAC,38,425,5,468,1810
CIUDAD DE MÉXICO,TLAHUAC,37,372,4,413,1644
CIUDAD DE MÉXICO,TLAHUAC,35,359,10,404,1643
CIUDAD DE MÉXICO,TLAHUAC,35,334,9,378,1939
CIUDAD DE MÉXICO,TLAHUAC,43,364,4,411,1938
CIUDAD DE MÉXICO,TLAHUAC,16,298,8,322,1468
CIUDAD DE MÉXICO,TLAHUAC,23,277,3,303,1468
CIUDAD DE MÉXICO,TLAHUAC,21,294,7,322,1468
CIUDAD DE MÉXICO,TLAHUAC,19,237,2,258,1361
CIUDAD DE MÉXICO,TLAHUAC,16,246,7,269,1361
CIUDAD DE MÉXICO,TLAHUAC,17,241,1,259,1361
CIUDAD DE MÉXICO,TLAHUAC,19,359,6,384,1968
CIUDAD DE MÉXICO,TLAHUAC,26,380,4,410,1968
CIUDAD DE MÉXICO,TLAHUAC,22,343,3,368,1859
CIUDAD DE MÉXICO,TLAHUAC,30,344,3,377,1858
CIUDAD DE MÉXICO,TLAHUAC,31,343,8,382,1858
CIUDAD DE MÉXICO,TLAHUAC,28,283,5,316,1412
CIUDAD DE MÉXICO,TLAHUAC,21,309,7,337,1412
CIUDAD DE MÉXICO,TLAHUAC,16,345,1,362,1204
CIUDAD DE MÉXICO,TLAHUAC,21,349,4,374,1203
CIUDAD DE MÉXICO,TLAHUAC,42,423,5,470,1695
CIUDAD DE MÉXICO,TLAHUAC,41,372,1,414,1695
CIUDAD DE MÉXICO,TLAHUAC,25,340,8,373,1337
CIUDAD DE MÉXICO,TLAHUAC,38,366,5,409,1337
CIUDAD DE MÉXICO,TLAHUAC,28,353,2,383,1336
CIUDAD DE MÉXICO,TLAHUAC,21,329,8,358,1653
CIUDAD DE MÉXICO,TLAHUAC,29,370,10,409,1653
CIUDAD DE MÉXICO,TLAHUAC,28,368,5,401,1653
CIUDAD DE MÉXICO,TLAHUAC,28,325,9,362,1690
CIUDAD DE MÉXICO,TLAHUAC,29,279,7,315,1690
CIUDAD DE MÉXICO,TLAHUAC,43,242,3,288,1827
CIUDAD DE MÉXICO,TLAHUAC,47,238,6,291,1827
CIUDAD DE MÉXICO,TLAHUAC,36,284,3,323,1382
CIUDAD DE MÉXICO,TLAHUAC,22,279,4,305,1382
CIUDAD DE MÉXICO,TLAHUAC,28,254,7,289,1382
CIUDAD DE MÉXICO,TLAHUAC,20,349,4,373,1587
CIUDAD DE MÉXICO,TLAHUAC,29,394,3,426,1586
CIUDAD DE MÉXICO,TLAHUAC,39,328,3,370,1891
CIUDAD DE MÉXICO,TLAHUAC,16,347,7,370,1891
CIUDAD DE MÉXICO,TLAHUAC,15,262,5,282,1879
CIUDAD DE MÉXICO,TLAHUAC,23,331,3,357,1879
CIUDAD DE MÉXICO,MIGUEL HIDALGO,10,17,0,27,1147
CIUDAD DE MÉXICO,MIGUEL HIDALGO,12,28,0,40,1146
CIUDAD DE MÉXICO,MIGUEL HIDALGO,10,149,2,161,1644
CIUDAD DE MÉXICO,MIGUEL HIDALGO,15,134,2,151,1644
CIUDAD DE MÉXICO,MIGUEL HIDALGO,41,206,7,254,1821
CIUDAD DE MÉXICO,MIGUEL HIDALGO,33,234,7,274,1820
CIUDAD DE MÉXICO,MIGUEL HIDALGO,11,32,3,46,1078
CIUDAD DE MÉXICO,MIGUEL HIDALGO,17,9,0,26,1077
CIUDAD DE MÉXICO,MIGUEL HIDALGO,16,48,4,68,1722
CIUDAD DE MÉXICO,MIGUEL HIDALGO,20,56,1,77,1721
CIUDAD DE MÉXICO,MIGUEL HIDALGO,9,23,1,33,1210
CIUDAD DE MÉXICO,MIGUEL HIDALGO,15,28,1,44,1209
CIUDAD DE MÉXICO,MIGUEL HIDALGO,15,30,0,45,1047
CIUDAD DE MÉXICO,MIGUEL HIDALGO,15,33,0,48,1047
CIUDAD DE MÉXICO,MIGUEL HIDALGO,13,16,0,29,1038
CIUDAD DE MÉXICO,MIGUEL HIDALGO,9,21,1,31,1037
CIUDAD DE MÉXICO,MIGUEL HIDALGO,12,33,1,46,1427
CIUDAD DE MÉXICO,MIGUEL HIDALGO,10,41,0,51,1426
CIUDAD DE MÉXICO,MIGUEL HIDALGO,13,20,2,35,1428
CIUDAD DE MÉXICO,MIGUEL HIDALGO,5,20,1,26,1428
CIUDAD DE MÉXICO,MIGUEL HIDALGO,16,97,2,115,1116
CIUDAD DE MÉXICO,MIGUEL HIDALGO,23,90,0,113,1116
CIUDAD DE MÉXICO,MIGUEL HIDALGO,46,223,3,272,1975
CIUDAD DE MÉXICO,MIGUEL HIDALGO,50,253,3,306,1895
CIUDAD DE MÉXICO,MIGUEL HIDALGO,50,215,3,268,1894
CIUDAD DE MÉXICO,MIGUEL HIDALGO,31,147,2,180,1103
CIUDAD DE MÉXICO,MIGUEL HIDALGO,26,166,1,193,1103
CIUDAD DE MÉXICO,MIGUEL HIDALGO,35,157,4,196,1256
CIUDAD DE MÉXICO,MIGUEL HIDALGO,20,192,4,216,1255
CIUDAD DE MÉXICO,MIGUEL HIDALGO,40,146,3,189,1308
CIUDAD DE MÉXICO,MIGUEL HIDALGO,30,180,1,211,1308
CIUDAD DE MÉXICO,MIGUEL HIDALGO,34,230,3,267,1851
CIUDAD DE MÉXICO,MIGUEL HIDALGO,61,267,1,329,1850
CIUDAD DE MÉXICO,MIGUEL HIDALGO,95,455,7,557,1442
CIUDAD DE MÉXICO,MIGUEL HIDALGO,0,0,0,0,1442
CIUDAD DE MÉXICO,MIGUEL HIDALGO,10,50,4,64,1247
CIUDAD DE MÉXICO,MIGUEL HIDALGO,14,50,3,67,1246
CIUDAD DE MÉXICO,MIGUEL HIDALGO,5,24,3,32,1888
CIUDAD DE MÉXICO,MIGUEL HIDALGO,10,14,0,24,1166
CIUDAD DE MÉXICO,MIGUEL HIDALGO,6,23,0,29,1166
CIUDAD DE MÉXICO,MIGUEL HIDALGO,12,45,0,57,1949
CIUDAD DE MÉXICO,MIGUEL HIDALGO,11,38,1,50,1949
CIUDAD DE MÉXICO,MIGUEL HIDALGO,7,7,0,14,1157
CIUDAD DE MÉXICO,MIGUEL HIDALGO,11,11,1,23,1156
CIUDAD DE MÉXICO,MIGUEL HIDALGO,41,380,0,421,1835
CIUDAD DE MÉXICO,MIGUEL HIDALGO,57,329,5,391,1835
CIUDAD DE MÉXICO,MIGUEL HIDALGO,34,291,6,331,1868
CIUDAD DE MÉXICO,MIGUEL HIDALGO,35,305,7,347,1867
CIUDAD DE MÉXICO,MIGUEL HIDALGO,50,317,2,369,1934
CIUDAD DE MÉXICO,MIGUEL HIDALGO,49,281,5,335,1933
CIUDAD DE MÉXICO,MIGUEL HIDALGO,34,226,5,265,1380
CIUDAD DE MÉXICO,MIGUEL HIDALGO,31,235,2,268,1380
CIUDAD DE MÉXICO,MIGUEL HIDALGO,33,230,3,266,1380
CIUDAD DE MÉXICO,MIGUEL HIDALGO,39,237,5,281,1749
CIUDAD DE MÉXICO,MIGUEL HIDALGO,25,255,1,281,1748
CIUDAD DE MÉXICO,MIGUEL HIDALGO,206,1365,19,1590,0
CIUDAD DE MÉXICO,MIGUEL HIDALGO,41,272,6,319,1666
CIUDAD DE MÉXICO,MIGUEL HIDALGO,41,291,5,337,1666
CIUDAD DE MÉXICO,MIGUEL HIDALGO,43,256,4,303,1494
CIUDAD DE MÉXICO,MIGUEL HIDALGO,55,264,10,329,1494
CIUDAD DE MÉXICO,MIGUEL HIDALGO,35,300,6,341,1534
CIUDAD DE MÉXICO,MIGUEL HIDALGO,52,271,11,334,1533
CIUDAD DE MÉXICO,MIGUEL HIDALGO,48,300,4,352,1620
CIUDAD DE MÉXICO,MIGUEL HIDALGO,42,265,3,310,1620
CIUDAD DE MÉXICO,MIGUEL HIDALGO,51,277,6,334,1737
CIUDAD DE MÉXICO,MIGUEL HIDALGO,34,289,1,324,1736
CIUDAD DE MÉXICO,MIGUEL HIDALGO,22,148,1,171,1088
CIUDAD DE MÉXICO,MIGUEL HIDALGO,25,121,2,148,1087
CIUDAD DE MÉXICO,MIGUEL HIDALGO,26,119,2,147,1226
CIUDAD DE MÉXICO,MIGUEL HIDALGO,37,105,6,148,1226
CIUDAD DE MÉXICO,MIGUEL HIDALGO,22,122,1,145,1086
CIUDAD DE MÉXICO,MIGUEL HIDALGO,20,155,0,175,1086
CIUDAD DE MÉXICO,MIGUEL HIDALGO,26,110,2,138,1100
CIUDAD DE MÉXICO,MIGUEL HIDALGO,18,127,0,145,1099
CIUDAD DE MÉXICO,MIGUEL HIDALGO,43,190,5,238,1696
CIUDAD DE MÉXICO,MIGUEL HIDALGO,51,220,3,274,1695
CIUDAD DE MÉXICO,MIGUEL HIDALGO,46,198,4,248,1878
CIUDAD DE MÉXICO,MIGUEL HIDALGO,46,240,4,290,1878
CIUDAD DE MÉXICO,MIGUEL HIDALGO,50,210,6,266,1704
CIUDAD DE MÉXICO,MIGUEL HIDALGO,44,228,3,275,1704
CIUDAD DE MÉXICO,MIGUEL HIDALGO,38,328,6,372,1809
CIUDAD DE MÉXICO,MIGUEL HIDALGO,54,294,3,351,1809
CIUDAD DE MÉXICO,MIGUEL HIDALGO,29,177,1,207,1329
CIUDAD DE MÉXICO,MIGUEL HIDALGO,35,237,2,274,1329
CIUDAD DE MÉXICO,MIGUEL HIDALGO,16,129,31,176,1099
CIUDAD DE MÉXICO,MIGUEL HIDALGO,34,154,4,192,1099
CIUDAD DE MÉXICO,MIGUEL HIDALGO,29,265,5,299,1438
CIUDAD DE MÉXICO,MIGUEL HIDALGO,28,260,3,291,1438
CIUDAD DE MÉXICO,MIGUEL HIDALGO,50,244,6,300,1633
CIUDAD DE MÉXICO,MIGUEL HIDALGO,50,280,5,335,1633
CIUDAD DE MÉXICO,MIGUEL HIDALGO,56,281,5,342,1850
CIUDAD DE MÉXICO,MIGUEL HIDALGO,45,313,13,371,1849
CIUDAD DE MÉXICO,MIGUEL HIDALGO,30,208,4,242,1200
CIUDAD DE MÉXICO,MIGUEL HIDALGO,39,186,5,230,1199
CIUDAD DE MÉXICO,MIGUEL HIDALGO,35,220,6,261,1503
CIUDAD DE MÉXICO,MIGUEL HIDALGO,40,294,3,337,1670
CIUDAD DE MÉXICO,MIGUEL HIDALGO,55,250,2,307,1669
CIUDAD DE MÉXICO,MIGUEL HIDALGO,55,325,4,384,1852
CIUDAD DE MÉXICO,MIGUEL HIDALGO,44,308,0,352,1852
CIUDAD DE MÉXICO,MIGUEL HIDALGO,25,232,3,260,1277
CIUDAD DE MÉXICO,MIGUEL HIDALGO,21,248,4,273,1276
CIUDAD DE MÉXICO,MIGUEL HIDALGO,37,332,10,379,1951
CIUDAD DE MÉXICO,MIGUEL HIDALGO,39,336,4,379,1950
CIUDAD DE MÉXICO,MIGUEL HIDALGO,31,302,4,337,1804
CIUDAD DE MÉXICO,MIGUEL HIDALGO,38,300,3,341,1725
CIUDAD DE MÉXICO,MIGUEL HIDALGO,28,322,5,355,1724
CIUDAD DE MÉXICO,MIGUEL HIDALGO,19,269,6,294,1664
CIUDAD DE MÉXICO,MIGUEL HIDALGO,34,261,8,303,1663
CIUDAD DE MÉXICO,MIGUEL HIDALGO,40,288,0,328,1893
CIUDAD DE MÉXICO,MIGUEL HIDALGO,34,278,8,320,1892
CIUDAD DE MÉXICO,MIGUEL HIDALGO,44,301,3,348,1578
CIUDAD DE MÉXICO,MIGUEL HIDALGO,35,292,2,329,1577
CIUDAD DE MÉXICO,MIGUEL HIDALGO,57,397,8,462,1826
CIUDAD DE MÉXICO,MIGUEL HIDALGO,56,387,9,452,1825
CIUDAD DE MÉXICO,MIGUEL HIDALGO,35,212,2,249,1848
CIUDAD DE MÉXICO,MIGUEL HIDALGO,27,225,1,253,1848
CIUDAD DE MÉXICO,MIGUEL HIDALGO,30,145,2,177,1942
CIUDAD DE MÉXICO,MIGUEL HIDALGO,27,152,1,180,1941
CIUDAD DE MÉXICO,MIGUEL HIDALGO,20,210,5,235,1016
CIUDAD DE MÉXICO,MIGUEL HIDALGO,10,216,3,229,1015
CIUDAD DE MÉXICO,MIGUEL HIDALGO,33,303,6,342,1589
CIUDAD DE MÉXICO,MIGUEL HIDALGO,24,325,4,353,1588
CIUDAD DE MÉXICO,MIGUEL HIDALGO,53,371,7,431,1737
CIUDAD DE MÉXICO,MIGUEL HIDALGO,48,353,7,408,1737
CIUDAD DE MÉXICO,MIGUEL HIDALGO,50,352,6,408,1848
CIUDAD DE MÉXICO,MIGUEL HIDALGO,27,66,1,94,1744
CIUDAD DE MÉXICO,MIGUEL HIDALGO,18,63,1,82,1743
CIUDAD DE MÉXICO,MIGUEL HIDALGO,42,194,3,239,1717
CIUDAD DE MÉXICO,MIGUEL HIDALGO,48,220,1,269,1717
CIUDAD DE MÉXICO,MIGUEL HIDALGO,44,226,4,274,1915
CIUDAD DE MÉXICO,MIGUEL HIDALGO,51,213,1,265,1915
CIUDAD DE MÉXICO,MIGUEL HIDALGO,33,290,2,325,1489
CIUDAD DE MÉXICO,MIGUEL HIDALGO,31,382,4,417,1488
CIUDAD DE MÉXICO,MIGUEL HIDALGO,44,243,2,289,2022
CIUDAD DE MÉXICO,MIGUEL HIDALGO,41,229,2,272,2022
CIUDAD DE MÉXICO,MIGUEL HIDALGO,56,254,2,312,2021
CIUDAD DE MÉXICO,MIGUEL HIDALGO,65,323,9,397,1824
CIUDAD DE MÉXICO,MIGUEL HIDALGO,56,317,3,376,1823
CIUDAD DE MÉXICO,MIGUEL HIDALGO,34,347,6,387,1977
CIUDAD DE MÉXICO,MIGUEL HIDALGO,61,395,2,458,1976
CIUDAD DE MÉXICO,MIGUEL HIDALGO,45,288,10,343,1477
CIUDAD DE MÉXICO,MIGUEL HIDALGO,33,333,10,376,1476
CIUDAD DE MÉXICO,MIGUEL HIDALGO,32,252,4,288,1626
CIUDAD DE MÉXICO,MIGUEL HIDALGO,34,294,3,331,1625
CIUDAD DE MÉXICO,MIGUEL HIDALGO,27,293,1,321,1324
CIUDAD DE MÉXICO,MIGUEL HIDALGO,27,241,7,275,1324
CIUDAD DE MÉXICO,MIGUEL HIDALGO,17,236,1,254,1132
CIUDAD DE MÉXICO,MIGUEL HIDALGO,21,212,4,237,1131
CIUDAD DE MÉXICO,MIGUEL HIDALGO,30,253,1,284,1668
CIUDAD DE MÉXICO,MIGUEL HIDALGO,30,253,4,287,1668
CIUDAD DE MÉXICO,MIGUEL HIDALGO,50,252,8,310,1730
CIUDAD DE MÉXICO,MIGUEL HIDALGO,49,280,6,335,1729
CIUDAD DE MÉXICO,MIGUEL HIDALGO,32,207,2,241,1452
CIUDAD DE MÉXICO,MIGUEL HIDALGO,43,206,2,251,1452
CIUDAD DE MÉXICO,MIGUEL HIDALGO,36,254,2,292,1604
CIUDAD DE MÉXICO,MIGUEL HIDALGO,51,220,1,272,1603
CIUDAD DE MÉXICO,MIGUEL HIDALGO,31,254,3,288,1443
CIUDAD DE MÉXICO,MIGUEL HIDALGO,17,225,8,250,1442
CIUDAD DE MÉXICO,MIGUEL HIDALGO,31,266,3,300,1798
CIUDAD DE MÉXICO,MIGUEL HIDALGO,43,301,8,352,1798
CIUDAD DE MÉXICO,MIGUEL HIDALGO,37,269,3,309,1468
CIUDAD DE MÉXICO,MIGUEL HIDALGO,23,274,3,300,1467
CIUDAD DE MÉXICO,MIGUEL HIDALGO,37,291,3,331,1530
CIUDAD DE MÉXICO,MIGUEL HIDALGO,36,245,1,282,1530
CIUDAD DE MÉXICO,MIGUEL HIDALGO,37,302,6,345,1506
CIUDAD DE MÉXICO,MIGUEL HIDALGO,24,256,9,289,1505
CIUDAD DE MÉXICO,MIGUEL HIDALGO,27,205,3,235,1188
CIUDAD DE MÉXICO,MIGUEL HIDALGO,32,216,3,251,1188
CIUDAD DE MÉXICO,MIGUEL HIDALGO,39,178,1,218,1252
CIUDAD DE MÉXICO,MIGUEL HIDALGO,34,202,2,238,1251
CIUDAD DE MÉXICO,MIGUEL HIDALGO,32,167,3,202,1001
CIUDAD DE MÉXICO,MIGUEL HIDALGO,30,160,0,190,1001
CIUDAD DE MÉXICO,MIGUEL HIDALGO,51,309,13,373,1769
CIUDAD DE MÉXICO,MIGUEL HIDALGO,39,305,7,351,1768
CIUDAD DE MÉXICO,MIGUEL HIDALGO,36,262,5,303,1446
CIUDAD DE MÉXICO,MIGUEL HIDALGO,39,281,7,327,1446
CIUDAD DE MÉXICO,MIGUEL HIDALGO,22,173,4,199,1046
CIUDAD DE MÉXICO,MIGUEL HIDALGO,21,212,8,241,1045
CIUDAD DE MÉXICO,MIGUEL HIDALGO,35,294,7,336,1646
CIUDAD DE MÉXICO,MIGUEL HIDALGO,20,330,4,354,1646
CIUDAD DE MÉXICO,MIGUEL HIDALGO,44,315,3,362,1522
CIUDAD DE MÉXICO,MIGUEL HIDALGO,49,264,3,316,1522
CIUDAD DE MÉXICO,MIGUEL HIDALGO,36,287,6,329,1151
CIUDAD DE MÉXICO,MIGUEL HIDALGO,34,272,1,307,1151
CIUDAD DE MÉXICO,MIGUEL HIDALGO,36,309,4,349,1840
CIUDAD DE MÉXICO,MIGUEL HIDALGO,31,298,14,343,1839
CIUDAD DE MÉXICO,MIGUEL HIDALGO,32,289,4,325,1728
CIUDAD DE MÉXICO,MIGUEL HIDALGO,32,310,4,346,1728
CIUDAD DE MÉXICO,MIGUEL HIDALGO,51,215,11,277,1453
CIUDAD DE MÉXICO,MIGUEL HIDALGO,66,216,11,293,1453
CIUDAD DE MÉXICO,MIGUEL HIDALGO,47,119,2,168,1437
CIUDAD DE MÉXICO,MIGUEL HIDALGO,32,118,2,152,1436
CIUDAD DE MÉXICO,MIGUEL HIDALGO,23,143,2,168,1472
CIUDAD DE MÉXICO,MIGUEL HIDALGO,26,128,1,155,1472
CIUDAD DE MÉXICO,MIGUEL HIDALGO,14,134,7,155,1472
CIUDAD DE MÉXICO,MIGUEL HIDALGO,36,164,1,201,1862
CIUDAD DE MÉXICO,MIGUEL HIDALGO,32,121,0,153,1862
CIUDAD DE MÉXICO,MIGUEL HIDALGO,27,70,3,100,1915
CIUDAD DE MÉXICO,MIGUEL HIDALGO,28,84,0,112,1915
CIUDAD DE MÉXICO,MIGUEL HIDALGO,16,67,3,86,1569
CIUDAD DE MÉXICO,MIGUEL HIDALGO,22,77,0,99,1569
CIUDAD DE MÉXICO,MIGUEL HIDALGO,30,79,2,111,2014
CIUDAD DE MÉXICO,MIGUEL HIDALGO,30,114,0,144,1679
CIUDAD DE MÉXICO,MIGUEL HIDALGO,31,102,3,136,1679
CIUDAD DE MÉXICO,MIGUEL HIDALGO,34,142,3,179,1642
CIUDAD DE MÉXICO,MIGUEL HIDALGO,56,132,2,190,1641
CIUDAD DE MÉXICO,VENUSTIANO CARRANZA,56,458,12,526,1903
CIUDAD DE MÉXICO,VENUSTIANO CARRANZA,76,474,12,562,1902
CIUDAD DE MÉXICO,VENUSTIANO CARRANZA,61,348,17,426,1414
CIUDAD DE MÉXICO,VENUSTIANO CARRANZA,34,388,19,441,1413
CIUDAD DE MÉXICO,VENUSTIANO CARRANZA,52,368,13,433,1413
CIUDAD DE MÉXICO,VENUSTIANO CARRANZA,58,300,16,374,1186
CIUDAD DE MÉXICO,VENUSTIANO CARRANZA,73,461,31,565,1185
CIUDAD DE MÉXICO,VENUSTIANO CARRANZA,64,487,21,572,1458
CIUDAD DE MÉXICO,VENUSTIANO CARRANZA,51,365,6,422,1458
CIUDAD DE MÉXICO,VENUSTIANO CARRANZA,95,532,18,645,1898
CIUDAD DE MÉXICO,VENUSTIANO CARRANZA,70,375,14,459,1898
CIUDAD DE MÉXICO,VENUSTIANO CARRANZA,70,412,21,503,1715
CIUDAD DE MÉXICO,VENUSTIANO CARRANZA,68,481,8,557,1714
CIUDAD DE MÉXICO,VENUSTIANO CARRANZA,63,325,9,397,1665
CIUDAD DE MÉXICO,VENUSTIANO CARRANZA,68,353,11,432,1665
CIUDAD DE MÉXICO,VENUSTIANO CARRANZA,56,292,3,351,1360
CIUDAD DE MÉXICO,VENUSTIANO CARRANZA,65,278,5,348,1360
CIUDAD DE MÉXICO,VENUSTIANO CARRANZA,45,288,3,336,1359
CIUDAD DE MÉXICO,VENUSTIANO CARRANZA,42,280,4,326,1125
CIUDAD DE MÉXICO,VENUSTIANO CARRANZA,64,561,14,639,1124
CIUDAD DE MÉXICO,VENUSTIANO CARRANZA,51,292,3,346,1474
CIUDAD DE MÉXICO,VENUSTIANO CARRANZA,34,332,4,370,1473
CIUDAD DE MÉXICO,VENUSTIANO CARRANZA,61,513,4,578,1473
CIUDAD DE MÉXICO,VENUSTIANO CARRANZA,49,311,9,369,1405
CIUDAD DE MÉXICO,VENUSTIANO CARRANZA,52,338,5,395,1404
CIUDAD DE MÉXICO,VENUSTIANO CARRANZA,38,193,4,235,1232
CIUDAD DE MÉXICO,VENUSTIANO CARRANZA,34,207,3,244,1232
CIUDAD DE MÉXICO,VENUSTIANO CARRANZA,25,226,9,260,1024
CIUDAD DE MÉXICO,VENUSTIANO CARRANZA,42,212,0,254,1024
CIUDAD DE MÉXICO,VENUSTIANO CARRANZA,73,359,2,434,1763
CIUDAD DE MÉXICO,VENUSTIANO CARRANZA,57,358,6,421,1762
CIUDAD DE MÉXICO,VENUSTIANO CARRANZA,58,327,11,396,1724
CIUDAD DE MÉXICO,VENUSTIANO CARRANZA,57,309,6,372,1724
CIUDAD DE MÉXICO,VENUSTIANO CARRANZA,39,328,8,375,1561
CIUDAD DE MÉXICO,VENUSTIANO CARRANZA,45,295,5,345,1561
CIUDAD DE MÉXICO,VENUSTIANO CARRANZA,47,331,3,381,1815
CIUDAD DE MÉXICO,VENUSTIANO CARRANZA,43,350,2,395,1815
CIUDAD DE MÉXICO,VENUSTIANO CARRANZA,29,230,2,261,1125
CIUDAD DE MÉXICO,VENUSTIANO CARRANZA,35,207,3,245,1124
CIUDAD DE MÉXICO,VENUSTIANO CARRANZA,61,332,7,400,1858
CIUDAD DE MÉXICO,VENUSTIANO CARRANZA,77,298,2,377,1857
CIUDAD DE MÉXICO,VENUSTIANO CARRANZA,40,238,4,282,1267
CIUDAD DE MÉXICO,VENUSTIANO CARRANZA,60,227,3,290,1266
CIUDAD DE MÉXICO,VENUSTIANO CARRANZA,58,280,5,343,1617
CIUDAD DE MÉXICO,VENUSTIANO CARRANZA,56,309,9,374,1616
CIUDAD DE MÉXICO,VENUSTIANO CARRANZA,85,358,9,452,1843
CIUDAD DE MÉXICO,VENUSTIANO CARRANZA,68,326,9,403,1842
CIUDAD DE MÉXICO,VENUSTIANO CARRANZA,87,381,10,478,1933
CIUDAD DE MÉXICO,VENUSTIANO CARRANZA,76,360,10,446,1932
CIUDAD DE MÉXICO,VENUSTIANO CARRANZA,91,215,7,313,1501
CIUDAD DE MÉXICO,VENUSTIANO CARRANZA,50,285,5,340,1501
CIUDAD DE MÉXICO,VENUSTIANO CARRANZA,79,345,10,434,1676
CIUDAD DE MÉXICO,VENUSTIANO CARRANZA,64,320,10,394,1675
CIUDAD DE MÉXICO,VENUSTIANO CARRANZA,60,303,8,371,1904
CIUDAD DE MÉXICO,VENUSTIANO CARRANZA,66,443,4,513,1904
CIUDAD DE MÉXICO,VENUSTIANO CARRANZA,45,394,0,439,1903
CIUDAD DE MÉXICO,VENUSTIANO CARRANZA,71,379,2,452,1788
CIUDAD DE MÉXICO,VENUSTIANO CARRANZA,56,373,8,437,1787
CIUDAD DE MÉXICO,VENUSTIANO CARRANZA,78,232,13,323,1658
CIUDAD DE MÉXICO,VENUSTIANO CARRANZA,55,225,9,289,1657
CIUDAD DE MÉXICO,VENUSTIANO CARRANZA,44,192,5,241,1693
CIUDAD DE MÉXICO,VENUSTIANO CARRANZA,46,166,3,215,1692
CIUDAD DE MÉXICO,VENUSTIANO CARRANZA,37,189,4,230,1692
CIUDAD DE MÉXICO,VENUSTIANO CARRANZA,73,226,2,301,1483
CIUDAD DE MÉXICO,VENUSTIANO CARRANZA,45,246,10,301,1482
CIUDAD DE MÉXICO,VENUSTIANO CARRANZA,34,191,7,232,1435
CIUDAD DE MÉXICO,VENUSTIANO CARRANZA,32,208,10,250,1435
CIUDAD DE MÉXICO,VENUSTIANO CARRANZA,61,215,6,282,1457
CIUDAD DE MÉXICO,VENUSTIANO CARRANZA,49,248,8,305,1457
CIUDAD DE MÉXICO,VENUSTIANO CARRANZA,37,192,0,229,1484
CIUDAD DE MÉXICO,VENUSTIANO CARRANZA,41,200,2,243,1484
CIUDAD DE MÉXICO,VENUSTIANO CARRANZA,32,197,3,232,1484
CIUDAD DE MÉXICO,VENUSTIANO CARRANZA,46,215,3,264,1780
CIUDAD DE MÉXICO,VENUSTIANO CARRANZA,44,218,3,265,1779
CIUDAD DE MÉXICO,VENUSTIANO CARRANZA,46,189,9,244,1783
CIUDAD DE MÉXICO,VENUSTIANO CARRANZA,51,215,5,271,1782
CIUDAD DE MÉXICO,VENUSTIANO CARRANZA,55,260,4,319,1760
CIUDAD DE MÉXICO,VENUSTIANO CARRANZA,56,246,4,306,1759
CIUDAD DE MÉXICO,VENUSTIANO CARRANZA,62,234,4,300,1602
CIUDAD DE MÉXICO,VENUSTIANO CARRANZA,58,218,9,285,1601
CIUDAD DE MÉXICO,VENUSTIANO CARRANZA,50,304,5,359,1801
CIUDAD DE MÉXICO,VENUSTIANO CARRANZA,54,315,10,379,1800
CIUDAD DE MÉXICO,VENUSTIANO CARRANZA,44,193,3,240,1634
CIUDAD DE MÉXICO,VENUSTIANO CARRANZA,45,241,2,288,1633
CIUDAD DE MÉXICO,VENUSTIANO CARRANZA,40,276,3,319,1628
CIUDAD DE MÉXICO,VENUSTIANO CARRANZA,45,357,6,408,1628
CIUDAD DE MÉXICO,VENUSTIANO CARRANZA,63,407,11,481,1784
CIUDAD DE MÉXICO,VENUSTIANO CARRANZA,46,392,9,447,1783
CIUDAD DE MÉXICO,VENUSTIANO CARRANZA,40,350,8,398,1737
CIUDAD DE MÉXICO,VENUSTIANO CARRANZA,50,381,12,443,1737
CIUDAD DE MÉXICO,VENUSTIANO CARRANZA,37,298,4,339,1403
CIUDAD DE MÉXICO,VENUSTIANO CARRANZA,47,297,6,350,1402
CIUDAD DE MÉXICO,VENUSTIANO CARRANZA,40,264,9,313,1331
CIUDAD DE MÉXICO,VENUSTIANO CARRANZA,24,256,5,285,1330
CIUDAD DE MÉXICO,VENUSTIANO CARRANZA,47,268,0,315,1501
CIUDAD DE MÉXICO,VENUSTIANO CARRANZA,38,279,15,332,1500
CIUDAD DE MÉXICO,VENUSTIANO CARRANZA,46,296,7,349,1500
CIUDAD DE MÉXICO,VENUSTIANO CARRANZA,50,338,7,395,1566
CIUDAD DE MÉXICO,VENUSTIANO CARRANZA,61,321,7,389,1566
CIUDAD DE MÉXICO,VENUSTIANO CARRANZA,46,270,5,321,1293
CIUDAD DE MÉXICO,VENUSTIANO CARRANZA,44,267,8,319,1293
CIUDAD DE MÉXICO,VENUSTIANO CARRANZA,78,350,6,434,1660
CIUDAD DE MÉXICO,VENUSTIANO CARRANZA,61,384,7,452,1659
CIUDAD DE MÉXICO,VENUSTIANO CARRANZA,93,677,9,779,1920
CIUDAD DE MÉXICO,VENUSTIANO CARRANZA,58,369,9,436,1920
CIUDAD DE MÉXICO,VENUSTIANO CARRANZA,57,461,7,525,1892
CIUDAD DE MÉXICO,VENUSTIANO CARRANZA,56,759,7,822,1892
CIUDAD DE MÉXICO,VENUSTIANO CARRANZA,50,338,7,395,1372
CIUDAD DE MÉXICO,VENUSTIANO CARRANZA,45,346,6,397,1372
CIUDAD DE MÉXICO,VENUSTIANO CARRANZA,49,291,9,349,1416
CIUDAD DE MÉXICO,VENUSTIANO CARRANZA,48,288,4,340,1416
CIUDAD DE MÉXICO,VENUSTIANO CARRANZA,72,368,10,450,1496
CIUDAD DE MÉXICO,VENUSTIANO CARRANZA,70,364,10,444,1495
CIUDAD DE MÉXICO,VENUSTIANO CARRANZA,50,320,9,379,1763
CIUDAD DE MÉXICO,VENUSTIANO CARRANZA,68,303,7,378,1763
CIUDAD DE MÉXICO,VENUSTIANO CARRANZA,31,209,3,243,1054
CIUDAD DE MÉXICO,VENUSTIANO CARRANZA,22,217,4,243,1053
CIUDAD DE MÉXICO,VENUSTIANO CARRANZA,40,262,3,305,1249
CIUDAD DE MÉXICO,VENUSTIANO CARRANZA,35,303,5,343,1249
CIUDAD DE MÉXICO,VENUSTIANO CARRANZA,83,606,11,700,1854
CIUDAD DE MÉXICO,VENUSTIANO CARRANZA,37,421,8,466,1854
CIUDAD DE MÉXICO,VENUSTIANO CARRANZA,264,1167,6,1437,0
CIUDAD DE MÉXICO,VENUSTIANO CARRANZA,60,410,13,483,1647
CIUDAD DE MÉXICO,VENUSTIANO CARRANZA,63,389,18,470,1646
CIUDAD DE MÉXICO,VENUSTIANO CARRANZA,63,384,8,455,1496
CIUDAD DE MÉXICO,VENUSTIANO CARRANZA,46,408,9,463,1496
CIUDAD DE MÉXICO,VENUSTIANO CARRANZA,46,351,5,402,1495
CIUDAD DE MÉXICO,VENUSTIANO CARRANZA,37,321,4,362,1400
CIUDAD DE MÉXICO,VENUSTIANO CARRANZA,54,337,4,395,1399
CIUDAD DE MÉXICO,VENUSTIANO CARRANZA,79,433,19,531,1845
CIUDAD DE MÉXICO,VENUSTIANO CARRANZA,73,443,14,530,1845
CIUDAD DE MÉXICO,VENUSTIANO CARRANZA,65,384,6,455,1528
CIUDAD DE MÉXICO,VENUSTIANO CARRANZA,46,368,4,418,1528
CIUDAD DE MÉXICO,VENUSTIANO CARRANZA,60,382,5,447,1528
CIUDAD DE MÉXICO,VENUSTIANO CARRANZA,66,479,6,551,1937
CIUDAD DE MÉXICO,VENUSTIANO CARRANZA,66,470,11,547,1936
CIUDAD DE MÉXICO,VENUSTIANO CARRANZA,31,292,6,329,1396
CIUDAD DE MÉXICO,VENUSTIANO CARRANZA,34,300,5,339,1396
CIUDAD DE MÉXICO,VENUSTIANO CARRANZA,26,300,4,330,1395
CIUDAD DE MÉXICO,VENUSTIANO CARRANZA,40,357,7,404,1662
CIUDAD DE MÉXICO,VENUSTIANO CARRANZA,43,337,3,383,1662
CIUDAD DE MÉXICO,VENUSTIANO CARRANZA,52,325,5,382,1662
CIUDAD DE MÉXICO,VENUSTIANO CARRANZA,66,314,4,384,1848
CIUDAD DE MÉXICO,VENUSTIANO CARRANZA,50,395,6,451,1847
CIUDAD DE MÉXICO,VENUSTIANO CARRANZA,43,281,3,327,1434
CIUDAD DE MÉXICO,VENUSTIANO CARRANZA,49,309,12,370,1433
CIUDAD DE MÉXICO,VENUSTIANO CARRANZA,39,396,9,444,1886
CIUDAD DE MÉXICO,VENUSTIANO CARRANZA,49,403,5,457,1886
CIUDAD DE MÉXICO,VENUSTIANO CARRANZA,51,376,4,431,1899
CIUDAD DE MÉXICO,VENUSTIANO CARRANZA,49,339,5,393,1898
CIUDAD DE MÉXICO,VENUSTIANO CARRANZA,30,273,6,309,1384
CIUDAD DE MÉXICO,VENUSTIANO CARRANZA,47,234,7,288,1384
CIUDAD DE MÉXICO,VENUSTIANO CARRANZA,33,239,6,278,1384
CIUDAD DE MÉXICO,VENUSTIANO CARRANZA,61,283,8,352,1723
CIUDAD DE MÉXICO,VENUSTIANO CARRANZA,53,303,5,361,1723
CIUDAD DE MÉXICO,VENUSTIANO CARRANZA,40,294,1,335,1809
CIUDAD DE MÉXICO,VENUSTIANO CARRANZA,53,292,1,346,1809
CIUDAD DE MÉXICO,VENUSTIANO CARRANZA,44,236,3,283,1373
CIUDAD DE MÉXICO,VENUSTIANO CARRANZA,41,296,3,340,1372
CIUDAD DE MÉXICO,VENUSTIANO CARRANZA,54,313,5,372,1610
CIUDAD DE MÉXICO,VENUSTIANO CARRANZA,55,273,3,331,1609
CIUDAD DE MÉXICO,VENUSTIANO CARRANZA,51,232,8,291,1229
CIUDAD DE MÉXICO,VENUSTIANO CARRANZA,43,234,1,278,1228
CIUDAD DE MÉXICO,VENUSTIANO CARRANZA,34,267,1,302,1335
CIUDAD DE MÉXICO,VENUSTIANO CARRANZA,45,256,2,303,1334
CIUDAD DE MÉXICO,VENUSTIANO CARRANZA,61,308,3,372,1666
CIUDAD DE MÉXICO,VENUSTIANO CARRANZA,63,319,7,389,1665
CIUDAD DE MÉXICO,VENUSTIANO CARRANZA,56,356,6,418,1931
CIUDAD DE MÉXICO,VENUSTIANO CARRANZA,80,421,2,503,1931
CIUDAD DE MÉXICO,VENUSTIANO CARRANZA,46,279,5,330,1583
CIUDAD DE MÉXICO,VENUSTIANO CARRANZA,45,285,5,335,1583
CIUDAD DE MÉXICO,VENUSTIANO CARRANZA,44,321,7,372,1583
CIUDAD DE MÉXICO,VENUSTIANO CARRANZA,45,279,7,331,1418
CIUDAD DE MÉXICO,VENUSTIANO CARRANZA,60,290,9,359,1418
CIUDAD DE MÉXICO,VENUSTIANO CARRANZA,42,211,4,257,1048
CIUDAD DE MÉXICO,VENUSTIANO CARRANZA,64,368,9,441,1047
CIUDAD DE MÉXICO,VENUSTIANO CARRANZA,64,379,9,452,1790
CIUDAD DE MÉXICO,VENUSTIANO CARRANZA,63,355,6,424,1790
CIUDAD DE MÉXICO,VENUSTIANO CARRANZA,56,299,8,363,1476
CIUDAD DE MÉXICO,VENUSTIANO CARRANZA,56,277,7,340,1476
CIUDAD DE MÉXICO,VENUSTIANO CARRANZA,48,260,12,320,1806
CIUDAD DE MÉXICO,VENUSTIANO CARRANZA,53,264,4,321,1805
CIUDAD DE MÉXICO,VENUSTIANO CARRANZA,28,204,3,235,1046
CIUDAD DE MÉXICO,VENUSTIANO CARRANZA,34,230,6,270,1046
CIUDAD DE MÉXICO,VENUSTIANO CARRANZA,50,317,6,373,1791
CIUDAD DE MÉXICO,VENUSTIANO CARRANZA,66,418,5,489,1790
CIUDAD DE MÉXICO,VENUSTIANO CARRANZA,25,242,1,268,1464
CIUDAD DE MÉXICO,VENUSTIANO CARRANZA,22,243,2,267,1464
CIUDAD DE MÉXICO,VENUSTIANO CARRANZA,42,280,3,325,1632
CIUDAD DE MÉXICO,VENUSTIANO CARRANZA,53,289,6,348,1632
CIUDAD DE MÉXICO,CUAUHTEMOC,24,154,2,180,1437
CIUDAD DE MÉXICO,CUAUHTEMOC,29,146,3,178,1437
CIUDAD DE MÉXICO,CUAUHTEMOC,27,182,5,214,1902
CIUDAD DE MÉXICO,CUAUHTEMOC,34,170,1,205,1902
CIUDAD DE MÉXICO,CUAUHTEMOC,39,169,3,211,1892
CIUDAD DE MÉXICO,CUAUHTEMOC,40,175,5,220,1892
CIUDAD DE MÉXICO,CUAUHTEMOC,26,113,2,141,1234
CIUDAD DE MÉXICO,CUAUHTEMOC,22,123,2,147,1233
CIUDAD DE MÉXICO,CUAUHTEMOC,31,153,0,184,1663
CIUDAD DE MÉXICO,CUAUHTEMOC,26,163,2,191,1663
CIUDAD DE MÉXICO,CUAUHTEMOC,33,146,4,183,1879
CIUDAD DE MÉXICO,CUAUHTEMOC,31,169,0,200,1879
CIUDAD DE MÉXICO,CUAUHTEMOC,36,258,4,298,1902
CIUDAD DE MÉXICO,CUAUHTEMOC,46,272,5,323,1901
CIUDAD DE MÉXICO,CUAUHTEMOC,35,225,1,261,1752
CIUDAD DE MÉXICO,CUAUHTEMOC,32,172,3,207,1752
CIUDAD DE MÉXICO,CUAUHTEMOC,39,178,6,223,1461
CIUDAD DE MÉXICO,CUAUHTEMOC,34,181,6,221,1460
CIUDAD DE MÉXICO,CUAUHTEMOC,27,148,1,176,1524
CIUDAD DE MÉXICO,CUAUHTEMOC,19,167,7,193,1524
CIUDAD DE MÉXICO,CUAUHTEMOC,34,227,1,262,1796
CIUDAD DE MÉXICO,CUAUHTEMOC,38,236,4,278,1795
CIUDAD DE MÉXICO,CUAUHTEMOC,34,222,2,258,1735
CIUDAD DE MÉXICO,CUAUHTEMOC,36,225,3,264,1735
CIUDAD DE MÉXICO,CUAUHTEMOC,44,147,1,192,1716
CIUDAD DE MÉXICO,CUAUHTEMOC,39,150,1,190,1715
CIUDAD DE MÉXICO,CUAUHTEMOC,32,176,4,212,1904
CIUDAD DE MÉXICO,CUAUHTEMOC,42,158,2,202,1904
CIUDAD DE MÉXICO,CUAUHTEMOC,48,233,5,286,1847
CIUDAD DE MÉXICO,CUAUHTEMOC,43,232,8,283,1847
CIUDAD DE MÉXICO,CUAUHTEMOC,60,215,6,281,1684
CIUDAD DE MÉXICO,CUAUHTEMOC,49,188,4,241,1684
CIUDAD DE MÉXICO,CUAUHTEMOC,34,186,2,222,1642
CIUDAD DE MÉXICO,CUAUHTEMOC,38,164,2,204,1641
CIUDAD DE MÉXICO,CUAUHTEMOC,42,157,4,203,1273
CIUDAD DE MÉXICO,CUAUHTEMOC,25,91,3,119,1273
CIUDAD DE MÉXICO,CUAUHTEMOC,45,275,1,321,1925
CIUDAD DE MÉXICO,CUAUHTEMOC,44,301,4,349,1924
CIUDAD DE MÉXICO,CUAUHTEMOC,32,253,3,288,1737
CIUDAD DE MÉXICO,CUAUHTEMOC,21,241,5,267,1736
CIUDAD DE MÉXICO,CUAUHTEMOC,27,212,6,245,1435
CIUDAD DE MÉXICO,CUAUHTEMOC,33,210,3,246,1435
CIUDAD DE MÉXICO,CUAUHTEMOC,31,214,6,251,1435
CIUDAD DE MÉXICO,CUAUHTEMOC,34,292,6,332,1896
CIUDAD DE MÉXICO,CUAUHTEMOC,45,271,6,322,1895
CIUDAD DE MÉXICO,CUAUHTEMOC,38,229,3,270,1489
CIUDAD DE MÉXICO,CUAUHTEMOC,36,263,3,302,1489
CIUDAD DE MÉXICO,CUAUHTEMOC,40,170,1,211,1334
CIUDAD DE MÉXICO,CUAUHTEMOC,40,181,3,224,1334
CIUDAD DE MÉXICO,CUAUHTEMOC,45,342,4,391,1928
CIUDAD DE MÉXICO,CUAUHTEMOC,40,330,4,374,1928
CIUDAD DE MÉXICO,CUAUHTEMOC,29,267,12,308,1774
CIUDAD DE MÉXICO,CUAUHTEMOC,34,286,4,324,1774
CIUDAD DE MÉXICO,CUAUHTEMOC,45,297,4,346,1933
CIUDAD DE MÉXICO,CUAUHTEMOC,38,301,5,344,1932
CIUDAD DE MÉXICO,CUAUHTEMOC,45,232,6,283,1560
CIUDAD DE MÉXICO,CUAUHTEMOC,34,228,3,265,1560
CIUDAD DE MÉXICO,CUAUHTEMOC,27,208,4,239,1368
CIUDAD DE MÉXICO,CUAUHTEMOC,30,229,5,264,1368
CIUDAD DE MÉXICO,CUAUHTEMOC,29,287,4,320,1365
CIUDAD DE MÉXICO,CUAUHTEMOC,48,289,6,343,1365
CIUDAD DE MÉXICO,CUAUHTEMOC,42,271,3,316,1364
CIUDAD DE MÉXICO,CUAUHTEMOC,131,1850,25,2006,0
CIUDAD DE MÉXICO,CUAUHTEMOC,25,281,6,312,1657
CIUDAD DE MÉXICO,CUAUHTEMOC,32,255,7,294,1657
CIUDAD DE MÉXICO,CUAUHTEMOC,15,266,9,290,1657
CIUDAD DE MÉXICO,CUAUHTEMOC,24,213,5,242,1351
CIUDAD DE MÉXICO,CUAUHTEMOC,29,182,4,215,1351
CIUDAD DE MÉXICO,CUAUHTEMOC,22,187,5,214,1350
CIUDAD DE MÉXICO,CUAUHTEMOC,38,243,7,288,1481
CIUDAD DE MÉXICO,CUAUHTEMOC,41,234,6,281,1480
CIUDAD DE MÉXICO,CUAUHTEMOC,27,282,5,314,1712
CIUDAD DE MÉXICO,CUAUHTEMOC,38,257,4,299,1712
CIUDAD DE MÉXICO,CUAUHTEMOC,46,302,5,353,1897
CIUDAD DE MÉXICO,CUAUHTEMOC,45,303,1,349,1897
CIUDAD DE MÉXICO,CUAUHTEMOC,44,293,4,341,1532
CIUDAD DE MÉXICO,CUAUHTEMOC,46,251,4,301,1532
CIUDAD DE MÉXICO,CUAUHTEMOC,27,186,0,213,1017
CIUDAD DE MÉXICO,CUAUHTEMOC,28,176,3,207,1017
CIUDAD DE MÉXICO,CUAUHTEMOC,21,155,0,176,1123
CIUDAD DE MÉXICO,CUAUHTEMOC,33,165,1,199,1122
CIUDAD DE MÉXICO,CUAUHTEMOC,57,291,6,354,1932
CIUDAD DE MÉXICO,CUAUHTEMOC,46,300,4,350,1932
CIUDAD DE MÉXICO,CUAUHTEMOC,43,323,3,369,1954
CIUDAD DE MÉXICO,CUAUHTEMOC,41,308,4,353,1953
CIUDAD DE MÉXICO,CUAUHTEMOC,52,283,8,343,1793
CIUDAD DE MÉXICO,CUAUHTEMOC,44,309,4,357,1793
CIUDAD DE MÉXICO,CUAUHTEMOC,42,216,6,264,1388
CIUDAD DE MÉXICO,CUAUHTEMOC,36,221,1,258,1387
CIUDAD DE MÉXICO,CUAUHTEMOC,50,217,3,270,1792
CIUDAD DE MÉXICO,CUAUHTEMOC,38,289,5,332,1792
CIUDAD DE MÉXICO,CUAUHTEMOC,47,276,4,327,1915
CIUDAD DE MÉXICO,CUAUHTEMOC,33,301,3,337,1914
CIUDAD DE MÉXICO,CUAUHTEMOC,44,253,1,298,1627
CIUDAD DE MÉXICO,CUAUHTEMOC,41,254,4,299,1626
CIUDAD DE MÉXICO,CUAUHTEMOC,46,209,2,257,1626
CIUDAD DE MÉXICO,CUAUHTEMOC,42,318,3,363,1883
CIUDAD DE MÉXICO,CUAUHTEMOC,45,282,2,329,1883
CIUDAD DE MÉXICO,CUAUHTEMOC,35,301,2,338,1819
CIUDAD DE MÉXICO,CUAUHTEMOC,30,311,4,345,1818
CIUDAD DE MÉXICO,CUAUHTEMOC,34,215,9,258,1474
CIUDAD DE MÉXICO,CUAUHTEMOC,29,235,1,265,1473
CIUDAD DE MÉXICO,CUAUHTEMOC,32,251,1,284,1473
CIUDAD DE MÉXICO,CUAUHTEMOC,40,325,7,372,1804
CIUDAD DE MÉXICO,CUAUHTEMOC,41,303,2,346,1804
CIUDAD DE MÉXICO,CUAUHTEMOC,50,330,5,385,1903
CIUDAD DE MÉXICO,CUAUHTEMOC,47,334,2,383,1902
CIUDAD DE MÉXICO,CUAUHTEMOC,44,301,4,349,1604
CIUDAD DE MÉXICO,CUAUHTEMOC,26,271,3,300,1603
CIUDAD DE MÉXICO,CUAUHTEMOC,35,195,1,231,1278
CIUDAD DE MÉXICO,CUAUHTEMOC,22,196,2,220,1278
CIUDAD DE MÉXICO,CUAUHTEMOC,28,190,1,219,1470
CIUDAD DE MÉXICO,CUAUHTEMOC,22,172,3,197,1470
CIUDAD DE MÉXICO,CUAUHTEMOC,36,237,7,280,1740
CIUDAD DE MÉXICO,CUAUHTEMOC,26,264,3,293,1740
CIUDAD DE MÉXICO,CUAUHTEMOC,36,196,2,234,1403
CIUDAD DE MÉXICO,CUAUHTEMOC,31,215,2,248,1403
CIUDAD DE MÉXICO,CUAUHTEMOC,51,311,8,370,1834
CIUDAD DE MÉXICO,CUAUHTEMOC,38,274,4,316,1834
CIUDAD DE MÉXICO,CUAUHTEMOC,31,165,2,198,1200
CIUDAD DE MÉXICO,CUAUHTEMOC,25,169,1,195,1199
CIUDAD DE MÉXICO,CUAUHTEMOC,43,243,4,290,1826
CIUDAD DE MÉXICO,CUAUHTEMOC,44,248,3,295,1826
CIUDAD DE MÉXICO,CUAUHTEMOC,32,218,3,253,1555
CIUDAD DE MÉXICO,CUAUHTEMOC,35,231,3,269,1554
CIUDAD DE MÉXICO,CUAUHTEMOC,21,234,6,261,1401
CIUDAD DE MÉXICO,CUAUHTEMOC,29,229,10,268,1400
CIUDAD DE MÉXICO,CUAUHTEMOC,25,259,11,295,1400
CIUDAD DE MÉXICO,CUAUHTEMOC,33,235,0,268,1589
CIUDAD DE MÉXICO,CUAUHTEMOC,14,249,0,263,1588
CIUDAD DE MÉXICO,CUAUHTEMOC,24,170,5,199,1495
CIUDAD DE MÉXICO,CUAUHTEMOC,32,176,3,211,1495
CIUDAD DE MÉXICO,CUAUHTEMOC,25,154,0,179,1495
CIUDAD DE MÉXICO,CUAUHTEMOC,44,250,1,295,1795
CIUDAD DE MÉXICO,CUAUHTEMOC,41,275,6,322,1794
CIUDAD DE MÉXICO,CUAUHTEMOC,41,317,4,362,1874
CIUDAD DE MÉXICO,CUAUHTEMOC,40,316,4,360,1873
CIUDAD DE MÉXICO,CUAUHTEMOC,29,166,3,198,1755
CIUDAD DE MÉXICO,CUAUHTEMOC,33,147,3,183,1755
CIUDAD DE MÉXICO,CUAUHTEMOC,40,178,2,220,1754
CIUDAD DE MÉXICO,CUAUHTEMOC,33,285,2,320,1854
CIUDAD DE MÉXICO,CUAUHTEMOC,34,245,3,282,1854
CIUDAD DE MÉXICO,CUAUHTEMOC,37,249,5,291,1900
CIUDAD DE MÉXICO,CUAUHTEMOC,42,278,8,328,1900
CIUDAD DE MÉXICO,CUAUHTEMOC,53,318,5,376,1969
CIUDAD DE MÉXICO,CUAUHTEMOC,44,326,12,382,1968
CIUDAD DE MÉXICO,CUAUHTEMOC,25,229,3,257,1254
CIUDAD DE MÉXICO,CUAUHTEMOC,25,235,5,265,1254
CIUDAD DE MÉXICO,CUAUHTEMOC,29,128,2,159,1642
CIUDAD DE MÉXICO,CUAUHTEMOC,22,149,0,171,1641
CIUDAD DE MÉXICO,CUAUHTEMOC,41,216,2,259,1827
CIUDAD DE MÉXICO,CUAUHTEMOC,31,203,2,236,1826
CIUDAD DE MÉXICO,CUAUHTEMOC,29,160,1,190,1788
CIUDAD DE MÉXICO,CUAUHTEMOC,16,138,1,155,1788
CIUDAD DE MÉXICO,CUAUHTEMOC,33,130,2,165,1837
CIUDAD DE MÉXICO,CUAUHTEMOC,44,176,3,223,1836
CIUDAD DE MÉXICO,CUAUHTEMOC,37,273,8,318,1914
CIUDAD DE MÉXICO,CUAUHTEMOC,22,247,4,273,1913
CIUDAD DE MÉXICO,CUAUHTEMOC,39,258,2,299,1500
CIUDAD DE MÉXICO,CUAUHTEMOC,56,234,7,297,1499
CIUDAD DE MÉXICO,CUAUHTEMOC,19,281,1,301,1378
CIUDAD DE MÉXICO,CUAUHTEMOC,29,288,3,320,1378
CIUDAD DE MÉXICO,CUAUHTEMOC,40,276,1,317,1409
CIUDAD DE MÉXICO,CUAUHTEMOC,40,286,9,335,1409
CIUDAD DE MÉXICO,CUAUHTEMOC,37,291,9,337,1408
CIUDAD DE MÉXICO,CUAUHTEMOC,48,302,7,357,1875
CIUDAD DE MÉXICO,CUAUHTEMOC,52,306,7,365,1874
CIUDAD DE MÉXICO,CUAUHTEMOC,33,207,6,246,1334
CIUDAD DE MÉXICO,CUAUHTEMOC,41,171,5,217,1333
CIUDAD DE MÉXICO,CUAUHTEMOC,46,280,3,329,1812
CIUDAD DE MÉXICO,CUAUHTEMOC,44,294,3,341,1811
CIUDAD DE MÉXICO,CUAUHTEMOC,66,372,7,445,1902
CIUDAD DE MÉXICO,CUAUHTEMOC,71,353,6,430,1901
CIUDAD DE MÉXICO,CUAUHTEMOC,31,252,5,288,1787
CIUDAD DE MÉXICO,CUAUHTEMOC,47,260,4,311,1786
CIUDAD DE MÉXICO,CUAUHTEMOC,22,155,1,178,1160
CIUDAD DE MÉXICO,CUAUHTEMOC,20,178,3,201,1159
CIUDAD DE MÉXICO,CUAUHTEMOC,27,283,6,316,1620
CIUDAD DE MÉXICO,CUAUHTEMOC,31,277,8,316,1619
CIUDAD DE MÉXICO,CUAUHTEMOC,25,260,2,287,1583
CIUDAD DE MÉXICO,CUAUHTEMOC,28,300,3,331,1582
CIUDAD DE MÉXICO,IZTACALCO,27,256,5,288,1670
CIUDAD DE MÉXICO,IZTACALCO,37,260,5,302,1670
CIUDAD DE MÉXICO,IZTACALCO,48,242,3,293,1670
CIUDAD DE MÉXICO,IZTACALCO,49,305,6,360,1749
CIUDAD DE MÉXICO,IZTACALCO,35,291,8,334,1749
CIUDAD DE MÉXICO,IZTACALCO,37,267,3,307,1885
CIUDAD DE MÉXICO,IZTACALCO,26,235,3,264,1885
CIUDAD DE MÉXICO,IZTACALCO,35,269,6,310,1614
CIUDAD DE MÉXICO,IZTACALCO,38,309,5,352,1614
CIUDAD DE MÉXICO,IZTACALCO,33,206,4,243,1188
CIUDAD DE MÉXICO,IZTACALCO,21,201,2,224,1188
CIUDAD DE MÉXICO,IZTACALCO,34,227,1,262,1316
CIUDAD DE MÉXICO,IZTACALCO,44,197,19,260,1315
CIUDAD DE MÉXICO,IZTACALCO,36,223,1,260,1315
CIUDAD DE MÉXICO,IZTACALCO,28,325,7,360,1609
CIUDAD DE MÉXICO,IZTACALCO,25,295,9,329,1608
CIUDAD DE MÉXICO,IZTACALCO,41,269,1,311,1673
CIUDAD DE MÉXICO,IZTACALCO,33,264,2,299,1673
CIUDAD DE MÉXICO,IZTACALCO,46,285,3,334,1753
CIUDAD DE MÉXICO,IZTACALCO,37,333,2,372,1752
CIUDAD DE MÉXICO,IZTACALCO,30,350,5,385,1815
CIUDAD DE MÉXICO,IZTACALCO,28,320,8,356,1815
CIUDAD DE MÉXICO,IZTACALCO,29,309,5,343,1664
CIUDAD DE MÉXICO,IZTACALCO,30,304,7,341,1664
CIUDAD DE MÉXICO,IZTACALCO,25,306,7,338,1556
CIUDAD DE MÉXICO,IZTACALCO,34,300,5,339,1556
CIUDAD DE MÉXICO,IZTACALCO,110,1026,9,1145,0
CIUDAD DE MÉXICO,IZTACALCO,20,314,4,338,1700
CIUDAD DE MÉXICO,IZTACALCO,34,337,4,375,1700
CIUDAD DE MÉXICO,IZTACALCO,36,295,4,335,1700
CIUDAD DE MÉXICO,IZTACALCO,33,202,4,239,1213
CIUDAD DE MÉXICO,IZTACALCO,24,242,2,268,1213
CIUDAD DE MÉXICO,IZTACALCO,45,176,3,224,1005
CIUDAD DE MÉXICO,IZTACALCO,37,199,2,238,1004
CIUDAD DE MÉXICO,IZTACALCO,35,344,4,383,1762
CIUDAD DE MÉXICO,IZTACALCO,25,289,56,370,1762
CIUDAD DE MÉXICO,IZTACALCO,25,344,3,372,1682
CIUDAD DE MÉXICO,IZTACALCO,27,337,3,367,1682
CIUDAD DE MÉXICO,IZTACALCO,31,202,1,234,1289
CIUDAD DE MÉXICO,IZTACALCO,27,251,3,281,1289
CIUDAD DE MÉXICO,IZTACALCO,37,341,9,387,1864
CIUDAD DE MÉXICO,IZTACALCO,52,373,5,430,1864
CIUDAD DE MÉXICO,IZTACALCO,26,307,4,337,1604
CIUDAD DE MÉXICO,IZTACALCO,23,273,2,298,1604
CIUDAD DE MÉXICO,IZTACALCO,34,292,3,329,1529
CIUDAD DE MÉXICO,IZTACALCO,39,262,9,310,1529
CIUDAD DE MÉXICO,IZTACALCO,29,253,3,285,1529
CIUDAD DE MÉXICO,IZTACALCO,32,300,2,334,1772
CIUDAD DE MÉXICO,IZTACALCO,41,310,6,357,1771
CIUDAD DE MÉXICO,IZTACALCO,22,261,7,290,1341
CIUDAD DE MÉXICO,IZTACALCO,30,273,10,313,1341
CIUDAD DE MÉXICO,IZTACALCO,34,279,1,314,1517
CIUDAD DE MÉXICO,IZTACALCO,25,301,1,327,1516
CIUDAD DE MÉXICO,IZTACALCO,34,222,6,262,1516
CIUDAD DE MÉXICO,IZTACALCO,38,387,2,427,1827
CIUDAD DE MÉXICO,IZTACALCO,44,416,7,467,1826
CIUDAD DE MÉXICO,IZTACALCO,26,295,11,332,1638
CIUDAD DE MÉXICO,IZTACALCO,25,307,2,334,1637
CIUDAD DE MÉXICO,IZTACALCO,33,368,3,404,1964
CIUDAD DE MÉXICO,IZTACALCO,31,347,6,384,1964
CIUDAD DE MÉXICO,IZTACALCO,38,378,9,425,1865
CIUDAD DE MÉXICO,IZTACALCO,31,358,4,393,1865
CIUDAD DE MÉXICO,IZTACALCO,24,287,1,312,1423
CIUDAD DE MÉXICO,IZTACALCO,34,268,3,305,1423
CIUDAD DE MÉXICO,IZTACALCO,41,298,3,342,1423
CIUDAD DE MÉXICO,IZTACALCO,41,328,89,458,1907
CIUDAD DE MÉXICO,IZTACALCO,31,395,4,430,1907
CIUDAD DE MÉXICO,IZTACALCO,40,361,8,409,1632
CIUDAD DE MÉXICO,IZTACALCO,47,335,7,389,1632
CIUDAD DE MÉXICO,IZTACALCO,22,245,2,269,1357
CIUDAD DE MÉXICO,IZTACALCO,18,249,7,274,1356
CIUDAD DE MÉXICO,IZTACALCO,26,325,4,355,1574
CIUDAD DE MÉXICO,IZTACALCO,25,247,4,276,1573
CIUDAD DE MÉXICO,IZTACALCO,36,294,7,337,1573
CIUDAD DE MÉXICO,IZTACALCO,19,233,6,258,1385
CIUDAD DE MÉXICO,IZTACALCO,36,248,2,286,1385
CIUDAD DE MÉXICO,IZTACALCO,36,213,5,254,1384
CIUDAD DE MÉXICO,IZTACALCO,35,351,3,389,1867
CIUDAD DE MÉXICO,IZTACALCO,39,257,7,303,1866
CIUDAD DE MÉXICO,IZTACALCO,40,209,1,250,1328
CIUDAD DE MÉXICO,IZTACALCO,40,200,3,243,1328
CIUDAD DE MÉXICO,IZTACALCO,37,219,4,260,1327
CIUDAD DE MÉXICO,IZTACALCO,25,228,3,256,1483
CIUDAD DE MÉXICO,IZTACALCO,35,270,2,307,1483
CIUDAD DE MÉXICO,IZTACALCO,32,251,1,284,1465
CIUDAD DE MÉXICO,IZTACALCO,32,270,1,303,1465
CIUDAD DE MÉXICO,IZTACALCO,45,301,6,352,1763
CIUDAD DE MÉXICO,IZTACALCO,39,266,6,311,1762
CIUDAD DE MÉXICO,IZTACALCO,25,257,3,285,1497
CIUDAD DE MÉXICO,IZTACALCO,25,266,8,299,1497
CIUDAD DE MÉXICO,IZTACALCO,35,235,6,276,1496
CIUDAD DE MÉXICO,IZTACALCO,44,240,2,286,1339
CIUDAD DE MÉXICO,IZTACALCO,40,215,4,259,1339
CIUDAD DE MÉXICO,IZTACALCO,32,261,4,297,1338
CIUDAD DE MÉXICO,IZTACALCO,36,254,10,300,1654
CIUDAD DE MÉXICO,IZTACALCO,38,266,4,308,1653
CIUDAD DE MÉXICO,IZTACALCO,47,331,6,384,1822
CIUDAD DE MÉXICO,IZTACALCO,49,349,6,404,1822
CIUDAD DE MÉXICO,IZTACALCO,33,293,5,331,1530
CIUDAD DE MÉXICO,IZTACALCO,39,313,5,357,1530
CIUDAD DE MÉXICO,IZTACALCO,30,329,9,368,1801
CIUDAD DE MÉXICO,IZTACALCO,35,369,6,410,1801
CIUDAD DE MÉXICO,IZTACALCO,62,368,0,430,1831
CIUDAD DE MÉXICO,IZTACALCO,43,349,2,394,1830
CIUDAD DE MÉXICO,IZTACALCO,21,272,3,296,1216
CIUDAD DE MÉXICO,IZTACALCO,20,250,3,273,1215
CIUDAD DE MÉXICO,IZTACALCO,23,168,3,194,1041
CIUDAD DE MÉXICO,IZTACALCO,32,134,5,171,1040
CIUDAD DE MÉXICO,IZTACALCO,33,216,4,253,1768
CIUDAD DE MÉXICO,IZTACALCO,34,191,4,229,1768
CIUDAD DE MÉXICO,IZTACALCO,28,186,0,214,1768
CIUDAD DE MÉXICO,IZTACALCO,53,203,1,257,1703
CIUDAD DE MÉXICO,IZTACALCO,38,220,5,263,1702
CIUDAD DE MÉXICO,IZTACALCO,36,169,1,206,1630
CIUDAD DE MÉXICO,IZTACALCO,38,160,3,201,1629
CIUDAD DE MÉXICO,IZTACALCO,34,295,7,336,1584
CIUDAD DE MÉXICO,IZTACALCO,39,283,4,326,1583
CIUDAD DE MÉXICO,IZTACALCO,37,266,3,306,1583
CIUDAD DE MÉXICO,IZTACALCO,39,258,8,305,1767
CIUDAD DE MÉXICO,IZTACALCO,49,285,8,342,1766
CIUDAD DE MÉXICO,IZTACALCO,31,230,1,262,1378
CIUDAD DE MÉXICO,IZTACALCO,38,233,2,273,1377
CIUDAD DE MÉXICO,IZTACALCO,19,255,3,277,1377
CIUDAD DE MÉXICO,IZTACALCO,65,336,9,410,1876
CIUDAD DE MÉXICO,IZTACALCO,47,379,4,430,1875
CIUDAD DE MÉXICO,IZTACALCO,37,380,7,424,1899
CIUDAD DE MÉXICO,IZTACALCO,48,312,5,365,1898
CIUDAD DE MÉXICO,IZTACALCO,31,324,4,359,1631
CIUDAD DE MÉXICO,IZTACALCO,34,326,1,361,1630
CIUDAD DE MÉXICO,IZTACALCO,39,298,2,339,1792
CIUDAD DE MÉXICO,IZTACALCO,31,291,6,328,1792
CIUDAD DE MÉXICO,IZTACALCO,17,274,2,293,1459
CIUDAD DE MÉXICO,IZTACALCO,27,257,3,287,1459
CIUDAD DE MÉXICO,IZTACALCO,19,277,0,296,1458
CIUDAD DE MÉXICO,IZTACALCO,37,262,1,300,1226
CIUDAD DE MÉXICO,IZTACALCO,24,220,2,246,1225
CIUDAD DE MÉXICO,IZTACALCO,43,373,5,421,1954
CIUDAD DE MÉXICO,IZTACALCO,40,393,1,434,1954
CIUDAD DE MÉXICO,IZTACALCO,27,293,4,324,1547
CIUDAD DE MÉXICO,IZTACALCO,36,304,2,342,1546
CIUDAD DE MÉXICO,IZTACALCO,31,298,6,335,1704
CIUDAD DE MÉXICO,IZTACALCO,44,390,7,441,1704
CIUDAD DE MÉXICO,IZTACALCO,53,347,6,406,1859
CIUDAD DE MÉXICO,IZTACALCO,39,322,4,365,1859
CIUDAD DE MÉXICO,IZTACALCO,30,279,6,315,1556
CIUDAD DE MÉXICO,IZTACALCO,23,274,4,301,1556
CIUDAD DE MÉXICO,IZTACALCO,48,336,3,387,1805
CIUDAD DE MÉXICO,IZTACALCO,53,326,2,381,1804
CIUDAD DE MÉXICO,IZTACALCO,48,309,2,359,1816
CIUDAD DE MÉXICO,IZTACALCO,34,291,4,329,1815
CIUDAD DE MÉXICO,IZTACALCO,34,284,3,321,1459
CIUDAD DE MÉXICO,IZTACALCO,31,291,4,326,1459
CIUDAD DE MÉXICO,IZTACALCO,31,259,5,295,1295
CIUDAD DE MÉXICO,IZTACALCO,25,238,2,265,1294
CIUDAD DE MÉXICO,IZTACALCO,44,342,3,389,1886
CIUDAD DE MÉXICO,IZTACALCO,28,369,5,402,1885
CIUDAD DE MÉXICO,IZTACALCO,35,244,3,282,1232
CIUDAD DE MÉXICO,IZTACALCO,34,264,5,303,1232
CIUDAD DE MÉXICO,IZTACALCO,48,349,10,407,1783
CIUDAD DE MÉXICO,IZTACALCO,34,310,9,353,1782
CIUDAD DE MÉXICO,IZTACALCO,34,356,5,395,1785
CIUDAD DE MÉXICO,IZTACALCO,35,366,1,402,1784
CIUDAD DE MÉXICO,IZTACALCO,21,221,2,244,1331
CIUDAD DE MÉXICO,IZTACALCO,22,237,5,264,1331
CIUDAD DE MÉXICO,IZTACALCO,38,270,0,308,1534
CIUDAD DE MÉXICO,IZTACALCO,34,247,1,282,1534
CIUDAD DE MÉXICO,IZTACALCO,30,276,0,306,1534
CIUDAD DE MÉXICO,IZTACALCO,44,275,2,321,1497
CIUDAD DE MÉXICO,IZTACALCO,28,312,2,342,1497
CIUDAD DE MÉXICO,IZTACALCO,28,233,4,265,1385
CIUDAD DE MÉXICO,IZTACALCO,23,211,4,238,1385
CIUDAD DE MÉXICO,IZTACALCO,40,209,1,250,1195
CIUDAD DE MÉXICO,IZTACALCO,31,200,1,232,1194
CIUDAD DE MÉXICO,IZTACALCO,36,303,5,344,1919
CIUDAD DE MÉXICO,IZTACALCO,38,305,4,347,1919
CIUDAD DE MÉXICO,IZTACALCO,29,337,8,374,1939
CIUDAD DE MÉXICO,IZTACALCO,36,350,4,390,1939
CIUDAD DE MÉXICO,IZTACALCO,44,275,4,323,1497
CIUDAD DE MÉXICO,IZTACALCO,25,282,7,314,1496
CIUDAD DE MÉXICO,IZTACALCO,40,297,7,344,1496
CIUDAD DE MÉXICO,IZTACALCO,30,270,2,302,1482
CIUDAD DE MÉXICO,IZTACALCO,20,253,1,274,1481
CIUDAD DE MÉXICO,IZTACALCO,29,256,3,288,1481
CIUDAD DE MÉXICO,IZTACALCO,18,243,1,262,1284
CIUDAD DE MÉXICO,IZTACALCO,28,214,5,247,1283
CIUDAD DE MÉXICO,IZTACALCO,59,322,4,385,1677
CIUDAD DE MÉXICO,IZTACALCO,43,291,4,338,1676
CIUDAD DE MÉXICO,IZTACALCO,28,199,2,229,1325
CIUDAD DE MÉXICO,IZTACALCO,27,219,1,247,1324
CIUDAD DE MÉXICO,IZTACALCO,29,207,5,241,1324
CIUDAD DE MÉXICO,IZTACALCO,32,264,8,304,1378
CIUDAD DE MÉXICO,IZTACALCO,34,237,2,273,1378
CIUDAD DE MÉXICO,IZTACALCO,27,233,4,264,1378
CIUDAD DE MÉXICO,IZTACALCO,47,258,2,307,1538
CIUDAD DE MÉXICO,IZTACALCO,47,223,1,271,1538
CIUDAD DE MÉXICO,IZTACALCO,36,270,5,311,1673
CIUDAD DE MÉXICO,IZTACALCO,40,274,5,319,1673
CIUDAD DE MÉXICO,IZTACALCO,40,302,11,353,1776
CIUDAD DE MÉXICO,IZTACALCO,36,304,3,343,1776
CIUDAD DE MÉXICO,IZTACALCO,47,281,0,328,1546
CIUDAD DE MÉXICO,IZTACALCO,43,242,1,286,1546
CIUDAD DE MÉXICO,IZTACALCO,45,277,2,324,1546
CIUDAD DE MÉXICO,IZTACALCO,36,320,6,362,1868
CIUDAD DE MÉXICO,IZTACALCO,30,331,5,366,1867
CIUDAD DE MÉXICO,IZTACALCO,25,224,3,252,1579
CIUDAD DE MÉXICO,IZTACALCO,33,281,0,314,1578
CIUDAD DE MÉXICO,IZTACALCO,44,318,8,370,1865
CIUDAD DE MÉXICO,IZTACALCO,44,302,3,349,1864
CIUDAD DE MÉXICO,IZTACALCO,33,251,4,288,1939
CIUDAD DE MÉXICO,IZTACALCO,45,212,5,262,1939
CIUDAD DE MÉXICO,IZTACALCO,28,215,7,250,1400
CIUDAD DE MÉXICO,IZTACALCO,28,190,8,226,1400
CIUDAD DE MÉXICO,IZTACALCO,41,186,5,232,1400
CIUDAD DE MÉXICO,IZTACALCO,40,246,4,290,1605
CIUDAD DE MÉXICO,IZTACALCO,34,259,2,295,1605
CIUDAD DE MÉXICO,IZTACALCO,27,208,10,245,1757
CIUDAD DE MÉXICO,IZTACALCO,30,250,2,282,1756
CIUDAD DE MÉXICO,IZTACALCO,40,261,6,307,1611
CIUDAD DE MÉXICO,IZTACALCO,35,248,1,284,1611
CIUDAD DE MÉXICO,IZTACALCO,50,280,5,335,1828
CIUDAD DE MÉXICO,IZTACALCO,32,280,6,318,1827
CIUDAD DE MÉXICO,TLALPAN,29,405,10,444,1915
CIUDAD DE MÉXICO,TLALPAN,42,377,2,421,1915
CIUDAD DE MÉXICO,TLALPAN,40,393,6,439,1889
CIUDAD DE MÉXICO,TLALPAN,39,372,4,415,1888
CIUDAD DE MÉXICO,TLALPAN,57,396,10,463,1957
CIUDAD DE MÉXICO,TLALPAN,58,374,5,437,1957
CIUDAD DE MÉXICO,TLALPAN,47,386,6,439,1872
CIUDAD DE MÉXICO,TLALPAN,46,367,6,419,1871
CIUDAD DE MÉXICO,TLALPAN,7,271,5,283,1533
CIUDAD DE MÉXICO,TLALPAN,27,294,6,327,1533
CIUDAD DE MÉXICO,TLALPAN,31,271,10,312,1532
CIUDAD DE MÉXICO,TLALPAN,39,354,2,395,1709
CIUDAD DE MÉXICO,TLALPAN,41,326,7,374,1708
CIUDAD DE MÉXICO,TLALPAN,39,140,0,179,1750
CIUDAD DE MÉXICO,TLALPAN,30,142,2,174,1749
CIUDAD DE MÉXICO,TLALPAN,21,230,5,256,1482
CIUDAD DE MÉXICO,TLALPAN,29,246,4,279,1481
CIUDAD DE MÉXICO,TLALPAN,32,252,4,288,1481
CIUDAD DE MÉXICO,TLALPAN,15,54,0,69,1647
CIUDAD DE MÉXICO,TLALPAN,32,47,3,82,1647
CIUDAD DE MÉXICO,TLALPAN,26,305,2,333,1702
CIUDAD DE MÉXICO,TLALPAN,26,303,3,332,1702
CIUDAD DE MÉXICO,TLALPAN,31,133,2,166,1477
CIUDAD DE MÉXICO,TLALPAN,26,139,2,167,1476
CIUDAD DE MÉXICO,TLALPAN,29,32,3,64,1515
CIUDAD DE MÉXICO,TLALPAN,28,37,0,65,1514
CIUDAD DE MÉXICO,TLALPAN,29,265,8,302,1624
CIUDAD DE MÉXICO,TLALPAN,33,279,6,318,1623
CIUDAD DE MÉXICO,TLALPAN,31,271,5,307,1534
CIUDAD DE MÉXICO,TLALPAN,27,286,2,315,1534
CIUDAD DE MÉXICO,TLALPAN,51,344,6,401,1576
CIUDAD DE MÉXICO,TLALPAN,30,329,8,367,1576
CIUDAD DE MÉXICO,TLALPAN,37,330,8,375,1883
CIUDAD DE MÉXICO,TLALPAN,35,343,7,385,1882
CIUDAD DE MÉXICO,TLALPAN,21,358,2,381,1618
CIUDAD DE MÉXICO,TLALPAN,34,304,3,341,1617
CIUDAD DE MÉXICO,TLALPAN,28,341,5,374,1568
CIUDAD DE MÉXICO,TLALPAN,23,330,4,357,1567
CIUDAD DE MÉXICO,TLALPAN,38,306,2,346,1567
CIUDAD DE MÉXICO,TLALPAN,51,312,3,366,1532
CIUDAD DE MÉXICO,TLALPAN,37,282,1,320,1531
CIUDAD DE MÉXICO,TLALPAN,37,284,7,328,1624
CIUDAD DE MÉXICO,TLALPAN,40,346,2,388,1624
CIUDAD DE MÉXICO,TLALPAN,35,323,3,361,1793
CIUDAD DE MÉXICO,TLALPAN,36,372,10,418,1793
CIUDAD DE MÉXICO,TLALPAN,30,289,2,321,1568
CIUDAD DE MÉXICO,TLALPAN,27,308,4,339,1568
CIUDAD DE MÉXICO,TLALPAN,28,272,8,308,1522
CIUDAD DE MÉXICO,TLALPAN,24,348,6,378,1522
CIUDAD DE MÉXICO,TLALPAN,32,293,7,332,1521
CIUDAD DE MÉXICO,TLALPAN,38,337,4,379,1651
CIUDAD DE MÉXICO,TLALPAN,34,328,8,370,1650
CIUDAD DE MÉXICO,TLALPAN,119,1170,19,1308,0
CIUDAD DE MÉXICO,TLALPAN,20,159,1,180,1394
CIUDAD DE MÉXICO,TLALPAN,26,171,2,199,1394
CIUDAD DE MÉXICO,TLALPAN,17,163,1,181,1393
CIUDAD DE MÉXICO,TLALPAN,26,356,9,391,1847
CIUDAD DE MÉXICO,TLALPAN,31,375,3,409,1846
CIUDAD DE MÉXICO,TLALPAN,39,366,6,411,1922
CIUDAD DE MÉXICO,TLALPAN,41,418,4,463,1921
CIUDAD DE MÉXICO,TLALPAN,26,367,4,397,1889
CIUDAD DE MÉXICO,TLALPAN,22,372,1,395,1888
CIUDAD DE MÉXICO,TLALPAN,31,322,3,356,1597
CIUDAD DE MÉXICO,TLALPAN,31,282,5,318,1597
CIUDAD DE MÉXICO,TLALPAN,22,319,4,345,1597
CIUDAD DE MÉXICO,TLALPAN,37,331,5,373,1965
CIUDAD DE MÉXICO,TLALPAN,39,380,6,425,1964
CIUDAD DE MÉXICO,TLALPAN,33,264,4,301,1520
CIUDAD DE MÉXICO,TLALPAN,36,295,3,334,1520
CIUDAD DE MÉXICO,TLALPAN,38,260,1,299,1519
CIUDAD DE MÉXICO,TLALPAN,33,240,6,279,1716
CIUDAD DE MÉXICO,TLALPAN,27,315,2,344,1716
CIUDAD DE MÉXICO,TLALPAN,23,196,1,220,1508
CIUDAD DE MÉXICO,TLALPAN,32,194,2,228,1508
CIUDAD DE MÉXICO,TLALPAN,20,225,4,249,1507
CIUDAD DE MÉXICO,TLALPAN,59,250,3,312,1600
CIUDAD DE MÉXICO,TLALPAN,44,227,5,276,1599
CIUDAD DE MÉXICO,TLALPAN,25,243,0,268,1440
CIUDAD DE MÉXICO,TLALPAN,27,263,2,292,1440
CIUDAD DE MÉXICO,TLALPAN,30,254,5,289,1440
CIUDAD DE MÉXICO,TLALPAN,28,215,5,248,1393
CIUDAD DE MÉXICO,TLALPAN,37,224,0,261,1393
CIUDAD DE MÉXICO,TLALPAN,27,207,3,237,1393
CIUDAD DE MÉXICO,TLALPAN,42,360,6,408,1868
CIUDAD DE MÉXICO,TLALPAN,31,339,4,374,1867
CIUDAD DE MÉXICO,TLALPAN,232,27,6,265,1441
CIUDAD DE MÉXICO,TLALPAN,28,262,0,290,1441
CIUDAD DE MÉXICO,TLALPAN,22,221,4,247,1440
CIUDAD DE MÉXICO,TLALPAN,35,288,4,327,1380
CIUDAD DE MÉXICO,TLALPAN,37,264,6,307,1379
CIUDAD DE MÉXICO,TLALPAN,43,225,2,270,1443
CIUDAD DE MÉXICO,TLALPAN,19,231,3,253,1442
CIUDAD DE MÉXICO,TLALPAN,13,256,4,273,1442
CIUDAD DE MÉXICO,TLALPAN,47,344,4,395,1974
CIUDAD DE MÉXICO,TLALPAN,46,326,6,378,1974
CIUDAD DE MÉXICO,TLALPAN,43,351,8,402,1966
CIUDAD DE MÉXICO,TLALPAN,40,356,6,402,1966
CIUDAD DE MÉXICO,TLALPAN,30,264,3,297,1616
CIUDAD DE MÉXICO,TLALPAN,29,269,8,306,1616
CIUDAD DE MÉXICO,TLALPAN,19,269,13,301,1531
CIUDAD DE MÉXICO,TLALPAN,20,281,4,305,1531
CIUDAD DE MÉXICO,TLALPAN,25,297,7,329,1531
CIUDAD DE MÉXICO,TLALPAN,49,437,8,494,1908
CIUDAD DE MÉXICO,TLALPAN,32,406,2,440,1908
CIUDAD DE MÉXICO,TLALPAN,8,236,1,245,1090
CIUDAD DE MÉXICO,TLALPAN,13,246,3,262,1089
CIUDAD DE MÉXICO,TLALPAN,18,268,0,286,1193
CIUDAD DE MÉXICO,TLALPAN,25,297,3,325,1192
CIUDAD DE MÉXICO,TLALPAN,21,221,5,247,1110
CIUDAD DE MÉXICO,TLALPAN,24,199,4,227,1110
CIUDAD DE MÉXICO,TLALPAN,51,382,8,441,1732
CIUDAD DE MÉXICO,TLALPAN,29,342,3,374,1732
CIUDAD DE MÉXICO,TLALPAN,18,206,1,225,1002
CIUDAD DE MÉXICO,TLALPAN,13,188,0,201,1002
CIUDAD DE MÉXICO,TLALPAN,41,422,5,468,1914
CIUDAD DE MÉXICO,TLALPAN,38,455,3,496,1914
CIUDAD DE MÉXICO,TLALPAN,34,370,7,411,1734
CIUDAD DE MÉXICO,TLALPAN,23,331,4,358,1734
CIUDAD DE MÉXICO,TLALPAN,43,313,7,363,1737
CIUDAD DE MÉXICO,TLALPAN,48,360,3,411,1736
CIUDAD DE MÉXICO,TLALPAN,43,290,5,338,1615
CIUDAD DE MÉXICO,TLALPAN,21,285,6,312,1615
CIUDAD DE MÉXICO,TLALPAN,24,303,11,338,1692
CIUDAD DE MÉXICO,TLALPAN,23,270,1,294,1692
CIUDAD DE MÉXICO,TLALPAN,34,355,5,394,1468
CIUDAD DE MÉXICO,TLALPAN,34,325,3,362,1468
CIUDAD DE MÉXICO,TLALPAN,32,334,5,371,1468
CIUDAD DE MÉXICO,TLALPAN,37,283,5,325,1608
CIUDAD DE MÉXICO,TLALPAN,34,262,2,298,1607
CIUDAD DE MÉXICO,TLALPAN,37,246,6,289,1853
CIUDAD DE MÉXICO,TLALPAN,45,296,3,344,1852
CIUDAD DE MÉXICO,TLALPAN,29,241,1,271,1912
CIUDAD DE MÉXICO,TLALPAN,33,221,0,254,1911
CIUDAD DE MÉXICO,TLALPAN,37,266,3,306,1763
CIUDAD DE MÉXICO,TLALPAN,24,251,4,279,1763
CIUDAD DE MÉXICO,TLALPAN,27,249,10,286,1824
CIUDAD DE MÉXICO,TLALPAN,27,373,10,410,1823
CIUDAD DE MÉXICO,TLALPAN,30,288,3,321,1494
CIUDAD DE MÉXICO,TLALPAN,25,249,7,281,1493
CIUDAD DE MÉXICO,TLALPAN,31,294,6,331,1674
CIUDAD DE MÉXICO,TLALPAN,41,323,3,367,1673
CIUDAD DE MÉXICO,TLALPAN,26,283,9,318,1476
CIUDAD DE MÉXICO,TLALPAN,28,299,7,334,1476
CIUDAD DE MÉXICO,TLALPAN,24,242,1,267,1252
CIUDAD DE MÉXICO,TLALPAN,27,245,3,275,1252
CIUDAD DE MÉXICO,TLALPAN,26,246,3,275,1639
CIUDAD DE MÉXICO,TLALPAN,27,271,5,303,1639
CIUDAD DE MÉXICO,TLALPAN,23,269,3,295,1639
CIUDAD DE MÉXICO,TLALPAN,29,403,7,439,1817
CIUDAD DE MÉXICO,TLALPAN,29,407,5,441,1816
CIUDAD DE MÉXICO,TLALPAN,12,248,2,262,1030
CIUDAD DE MÉXICO,TLALPAN,17,234,4,255,1030
CIUDAD DE MÉXICO,TLALPAN,23,354,7,384,1903
CIUDAD DE MÉXICO,TLALPAN,24,365,5,394,1903
CIUDAD DE MÉXICO,TLALPAN,17,196,4,217,1015
CIUDAD DE MÉXICO,TLALPAN,23,252,5,280,1014
CIUDAD DE MÉXICO,TLALPAN,17,343,6,366,1379
CIUDAD DE MÉXICO,TLALPAN,20,293,3,316,1379
CIUDAD DE MÉXICO,TLALPAN,17,307,3,327,1378
CIUDAD DE MÉXICO,TLALPAN,29,299,3,331,1620
CIUDAD DE MÉXICO,TLALPAN,23,313,10,346,1619
CIUDAD DE MÉXICO,TLALPAN,20,308,7,335,1619
CIUDAD DE MÉXICO,TLALPAN,36,379,10,425,1967
CIUDAD DE MÉXICO,TLALPAN,26,389,6,421,1967
CIUDAD DE MÉXICO,TLALPAN,19,319,9,347,1574
CIUDAD DE MÉXICO,TLALPAN,28,328,4,360,1574
CIUDAD DE MÉXICO,TLALPAN,29,312,3,344,1573
CIUDAD DE MÉXICO,TLALPAN,28,363,1,392,1635
CIUDAD DE MÉXICO,TLALPAN,36,337,4,377,1634
CIUDAD DE MÉXICO,TLALPAN,27,387,11,425,1861
CIUDAD DE MÉXICO,TLALPAN,38,377,6,421,1860
CIUDAD DE MÉXICO,BENITO JUAREZ,42,171,2,215,1450
CIUDAD DE MÉXICO,BENITO JUAREZ,37,176,1,214,1449
CIUDAD DE MÉXICO,BENITO JUAREZ,34,217,3,254,1856
CIUDAD DE MÉXICO,BENITO JUAREZ,42,203,2,247,1855
CIUDAD DE MÉXICO,BENITO JUAREZ,29,263,3,295,1710
CIUDAD DE MÉXICO,BENITO JUAREZ,42,150,3,195,1709
CIUDAD DE MÉXICO,BENITO JUAREZ,28,132,3,163,1417
CIUDAD DE MÉXICO,BENITO JUAREZ,32,120,2,154,1416
CIUDAD DE MÉXICO,BENITO JUAREZ,42,148,4,194,1416
CIUDAD DE MÉXICO,BENITO JUAREZ,26,151,1,178,1335
CIUDAD DE MÉXICO,BENITO JUAREZ,31,132,1,164,1334
CIUDAD DE MÉXICO,BENITO JUAREZ,38,208,1,247,1795
CIUDAD DE MÉXICO,BENITO JUAREZ,44,223,5,272,1794
CIUDAD DE MÉXICO,BENITO JUAREZ,37,230,4,271,1783
CIUDAD DE MÉXICO,BENITO JUAREZ,40,215,0,255,1782
CIUDAD DE MÉXICO,BENITO JUAREZ,43,222,1,266,1707
CIUDAD DE MÉXICO,BENITO JUAREZ,47,204,3,254,1707
CIUDAD DE MÉXICO,BENITO JUAREZ,42,147,2,191,1423
CIUDAD DE MÉXICO,BENITO JUAREZ,33,184,1,218,1422
CIUDAD DE MÉXICO,BENITO JUAREZ,30,179,1,210,1435
CIUDAD DE MÉXICO,BENITO JUAREZ,31,147,2,180,1434
CIUDAD DE MÉXICO,BENITO JUAREZ,30,136,1,167,1434
CIUDAD DE MÉXICO,BENITO JUAREZ,32,151,1,184,1573
CIUDAD DE MÉXICO,BENITO JUAREZ,37,185,4,226,1573
CIUDAD DE MÉXICO,BENITO JUAREZ,33,148,5,186,1459
CIUDAD DE MÉXICO,BENITO JUAREZ,36,150,2,188,1459
CIUDAD DE MÉXICO,BENITO JUAREZ,59,291,2,352,1923
CIUDAD DE MÉXICO,BENITO JUAREZ,27,230,2,259,1922
CIUDAD DE MÉXICO,BENITO JUAREZ,46,173,3,222,1664
CIUDAD DE MÉXICO,BENITO JUAREZ,32,185,2,219,1664
CIUDAD DE MÉXICO,BENITO JUAREZ,36,139,2,177,1303
CIUDAD DE MÉXICO,BENITO JUAREZ,31,130,3,164,1302
CIUDAD DE MÉXICO,BENITO JUAREZ,34,97,1,132,1028
CIUDAD DE MÉXICO,BENITO JUAREZ,33,99,4,136,1027
CIUDAD DE MÉXICO,BENITO JUAREZ,41,173,4,218,1827
CIUDAD DE MÉXICO,BENITO JUAREZ,39,169,0,208,1826
CIUDAD DE MÉXICO,BENITO JUAREZ,44,163,0,207,1777
CIUDAD DE MÉXICO,BENITO JUAREZ,31,184,6,221,1776
CIUDAD DE MÉXICO,BENITO JUAREZ,37,163,6,206,1874
CIUDAD DE MÉXICO,BENITO JUAREZ,47,178,1,226,1873
CIUDAD DE MÉXICO,BENITO JUAREZ,50,258,3,311,1920
CIUDAD DE MÉXICO,BENITO JUAREZ,45,292,3,340,1919
CIUDAD DE MÉXICO,BENITO JUAREZ,42,214,3,259,1753
CIUDAD DE MÉXICO,BENITO JUAREZ,25,203,3,231,1752
CIUDAD DE MÉXICO,BENITO JUAREZ,20,139,1,160,1374
CIUDAD DE MÉXICO,BENITO JUAREZ,25,142,3,170,1373
CIUDAD DE MÉXICO,BENITO JUAREZ,30,124,2,156,1363
CIUDAD DE MÉXICO,BENITO JUAREZ,31,137,3,171,1362
CIUDAD DE MÉXICO,BENITO JUAREZ,20,134,4,158,1582
CIUDAD DE MÉXICO,BENITO JUAREZ,24,139,2,165,1581
CIUDAD DE MÉXICO,BENITO JUAREZ,42,266,3,311,1932
CIUDAD DE MÉXICO,BENITO JUAREZ,43,262,3,308,1931
CIUDAD DE MÉXICO,BENITO JUAREZ,27,101,0,128,998
CIUDAD DE MÉXICO,BENITO JUAREZ,24,104,0,128,997
CIUDAD DE MÉXICO,BENITO JUAREZ,40,152,1,193,1887
CIUDAD DE MÉXICO,BENITO JUAREZ,41,135,5,181,1886
CIUDAD DE MÉXICO,BENITO JUAREZ,33,128,2,163,1440
CIUDAD DE MÉXICO,BENITO JUAREZ,29,129,2,160,1439
CIUDAD DE MÉXICO,BENITO JUAREZ,22,130,1,153,1932
CIUDAD DE MÉXICO,BENITO JUAREZ,32,125,1,158,1932
CIUDAD DE MÉXICO,BENITO JUAREZ,27,115,0,142,1936
CIUDAD DE MÉXICO,BENITO JUAREZ,22,108,1,131,1936
CIUDAD DE MÉXICO,BENITO JUAREZ,35,121,3,159,1469
CIUDAD DE MÉXICO,BENITO JUAREZ,30,107,2,139,1469
CIUDAD DE MÉXICO,BENITO JUAREZ,26,110,3,139,1468
CIUDAD DE MÉXICO,BENITO JUAREZ,28,82,2,112,1395
CIUDAD DE MÉXICO,BENITO JUAREZ,30,99,0,129,1395
CIUDAD DE MÉXICO,BENITO JUAREZ,26,92,3,121,1395
CIUDAD DE MÉXICO,BENITO JUAREZ,49,170,1,220,1922
CIUDAD DE MÉXICO,BENITO JUAREZ,37,166,3,206,1922
CIUDAD DE MÉXICO,BENITO JUAREZ,30,203,5,238,1901
CIUDAD DE MÉXICO,BENITO JUAREZ,40,246,2,288,1901
CIUDAD DE MÉXICO,BENITO JUAREZ,48,246,1,295,1901
CIUDAD DE MÉXICO,BENITO JUAREZ,41,239,6,286,1825
CIUDAD DE MÉXICO,BENITO JUAREZ,39,234,3,276,1824
CIUDAD DE MÉXICO,BENITO JUAREZ,45,230,4,279,1835
CIUDAD DE MÉXICO,BENITO JUAREZ,39,233,7,279,1834
CIUDAD DE MÉXICO,BENITO JUAREZ,44,197,0,241,1646
CIUDAD DE MÉXICO,BENITO JUAREZ,42,200,1,243,1646
CIUDAD DE MÉXICO,BENITO JUAREZ,30,92,1,123,1568
CIUDAD DE MÉXICO,BENITO JUAREZ,31,106,3,140,1568
CIUDAD DE MÉXICO,BENITO JUAREZ,27,119,2,148,1567
CIUDAD DE MÉXICO,BENITO JUAREZ,22,86,1,109,1574
CIUDAD DE MÉXICO,BENITO JUAREZ,27,84,1,112,1574
CIUDAD DE MÉXICO,BENITO JUAREZ,27,88,0,115,1574
CIUDAD DE MÉXICO,BENITO JUAREZ,27,97,1,125,1580
CIUDAD DE MÉXICO,BENITO JUAREZ,35,112,1,148,1580
CIUDAD DE MÉXICO,BENITO JUAREZ,31,96,1,128,1580
CIUDAD DE MÉXICO,BENITO JUAREZ,24,110,0,134,1552
CIUDAD DE MÉXICO,BENITO JUAREZ,33,87,0,120,1551
CIUDAD DE MÉXICO,BENITO JUAREZ,26,93,2,121,1379
CIUDAD DE MÉXICO,BENITO JUAREZ,30,74,1,105,1379
CIUDAD DE MÉXICO,BENITO JUAREZ,27,83,1,111,1378
CIUDAD DE MÉXICO,BENITO JUAREZ,32,108,1,141,1511
CIUDAD DE MÉXICO,BENITO JUAREZ,34,130,0,164,1511
CIUDAD DE MÉXICO,BENITO JUAREZ,31,142,2,175,1511
CIUDAD DE MÉXICO,BENITO JUAREZ,34,173,2,209,1517
CIUDAD DE MÉXICO,BENITO JUAREZ,27,143,4,174,1516
CIUDAD DE MÉXICO,BENITO JUAREZ,53,230,2,285,1936
CIUDAD DE MÉXICO,BENITO JUAREZ,49,218,2,269,1936
CIUDAD DE MÉXICO,BENITO JUAREZ,45,245,5,295,1657
CIUDAD DE MÉXICO,BENITO JUAREZ,46,269,3,318,1657
CIUDAD DE MÉXICO,BENITO JUAREZ,38,178,3,219,1677
CIUDAD DE MÉXICO,BENITO JUAREZ,31,190,2,223,1676
CIUDAD DE MÉXICO,BENITO JUAREZ,32,141,1,174,1348
CIUDAD DE MÉXICO,BENITO JUAREZ,24,150,3,177,1347
CIUDAD DE MÉXICO,BENITO JUAREZ,28,128,1,157,1347
CIUDAD DE MÉXICO,BENITO JUAREZ,34,149,3,186,1710
CIUDAD DE MÉXICO,BENITO JUAREZ,31,147,1,179,1709
CIUDAD DE MÉXICO,BENITO JUAREZ,25,122,4,151,1882
CIUDAD DE MÉXICO,BENITO JUAREZ,26,95,2,123,1881
CIUDAD DE MÉXICO,BENITO JUAREZ,279,1546,25,1850,0
CIUDAD DE MÉXICO,BENITO JUAREZ,41,113,4,158,1906
CIUDAD DE MÉXICO,BENITO JUAREZ,32,128,1,161,1905
CIUDAD DE MÉXICO,BENITO JUAREZ,20,110,2,132,1477
CIUDAD DE MÉXICO,BENITO JUAREZ,27,119,2,148,1476
CIUDAD DE MÉXICO,BENITO JUAREZ,45,242,3,290,1924
CIUDAD DE MÉXICO,BENITO JUAREZ,49,296,6,351,1924
CIUDAD DE MÉXICO,BENITO JUAREZ,36,183,0,219,1344
CIUDAD DE MÉXICO,BENITO JUAREZ,33,168,1,202,1344
CIUDAD DE MÉXICO,BENITO JUAREZ,32,160,0,192,1344
CIUDAD DE MÉXICO,BENITO JUAREZ,52,270,10,332,1924
CIUDAD DE MÉXICO,BENITO JUAREZ,53,219,4,276,1923
CIUDAD DE MÉXICO,BENITO JUAREZ,70,214,3,287,1923
CIUDAD DE MÉXICO,BENITO JUAREZ,30,129,0,159,1717
CIUDAD DE MÉXICO,BENITO JUAREZ,34,126,2,162,1716
CIUDAD DE MÉXICO,BENITO JUAREZ,30,137,3,170,1352
CIUDAD DE MÉXICO,BENITO JUAREZ,16,110,1,127,1352
CIUDAD DE MÉXICO,BENITO JUAREZ,36,121,3,160,1351
CIUDAD DE MÉXICO,BENITO JUAREZ,33,155,0,188,1767
CIUDAD DE MÉXICO,BENITO JUAREZ,32,138,3,173,1766
CIUDAD DE MÉXICO,BENITO JUAREZ,21,66,0,87,1232
CIUDAD DE MÉXICO,BENITO JUAREZ,17,69,3,89,1232
CIUDAD DE MÉXICO,BENITO JUAREZ,30,127,4,161,1797
CIUDAD DE MÉXICO,BENITO JUAREZ,22,134,2,158,1797
CIUDAD DE MÉXICO,BENITO JUAREZ,29,142,2,173,1377
CIUDAD DE MÉXICO,BENITO JUAREZ,33,164,4,201,1377
CIUDAD DE MÉXICO,BENITO JUAREZ,23,154,1,178,1377
CIUDAD DE MÉXICO,BENITO JUAREZ,34,156,2,192,1788
CIUDAD DE MÉXICO,BENITO JUAREZ,30,164,0,194,1788
CIUDAD DE MÉXICO,BENITO JUAREZ,27,128,3,158,1766
CIUDAD DE MÉXICO,BENITO JUAREZ,21,137,2,160,1766
CIUDAD DE MÉXICO,BENITO JUAREZ,21,88,1,110,1336
CIUDAD DE MÉXICO,BENITO JUAREZ,26,72,1,99,1335
CIUDAD DE MÉXICO,BENITO JUAREZ,16,163,3,182,1388
CIUDAD DE MÉXICO,BENITO JUAREZ,37,162,7,206,1387
CIUDAD DE MÉXICO,BENITO JUAREZ,41,231,3,275,1821
CIUDAD DE MÉXICO,BENITO JUAREZ,61,217,3,281,1820
CIUDAD DE MÉXICO,BENITO JUAREZ,37,191,2,230,1635
CIUDAD DE MÉXICO,BENITO JUAREZ,36,237,3,276,1634
CIUDAD DE MÉXICO,BENITO JUAREZ,53,207,5,265,1634
CIUDAD DE MÉXICO,BENITO JUAREZ,35,176,2,213,1395
CIUDAD DE MÉXICO,BENITO JUAREZ,31,141,3,175,1395
CIUDAD DE MÉXICO,BENITO JUAREZ,43,138,2,183,1417
CIUDAD DE MÉXICO,BENITO JUAREZ,36,192,3,231,1416
CIUDAD DE MÉXICO,BENITO JUAREZ,37,179,5,221,1416
CIUDAD DE MÉXICO,BENITO JUAREZ,35,191,3,229,1431
CIUDAD DE MÉXICO,BENITO JUAREZ,37,194,3,234,1430
CIUDAD DE MÉXICO,BENITO JUAREZ,35,235,4,274,1465
CIUDAD DE MÉXICO,BENITO JUAREZ,36,215,4,255,1465
CIUDAD DE MÉXICO,BENITO JUAREZ,41,234,4,279,1465
CIUDAD DE MÉXICO,BENITO JUAREZ,40,199,0,239,1925
CIUDAD DE MÉXICO,BENITO JUAREZ,35,193,0,228,1924
CIUDAD DE MÉXICO,BENITO JUAREZ,28,120,3,151,1026
CIUDAD DE MÉXICO,BENITO JUAREZ,22,144,3,169,1026
CIUDAD DE MÉXICO,BENITO JUAREZ,19,100,0,119,1045
CIUDAD DE MÉXICO,BENITO JUAREZ,24,86,2,112,1044
CIUDAD DE MÉXICO,BENITO JUAREZ,41,196,6,243,1856
CIUDAD DE MÉXICO,BENITO JUAREZ,45,195,6,246,1856
CIUDAD DE MÉXICO,BENITO JUAREZ,34,122,3,159,1593
CIUDAD DE MÉXICO,BENITO JUAREZ,42,115,1,158,1593
CIUDAD DE MÉXICO,BENITO JUAREZ,30,113,3,146,1593
CIUDAD DE MÉXICO,BENITO JUAREZ,31,148,3,182,1391
CIUDAD DE MÉXICO,BENITO JUAREZ,30,177,5,212,1390
CIUDAD DE MÉXICO,BENITO JUAREZ,20,98,1,119,1068
CIUDAD DE MÉXICO,BENITO JUAREZ,13,90,2,105,1067
CIUDAD DE MÉXICO,BENITO JUAREZ,16,89,2,107,1067
CIUDAD DE MÉXICO,BENITO JUAREZ,41,113,2,156,1865
CIUDAD DE MÉXICO,BENITO JUAREZ,37,123,0,160,1865
CIUDAD DE MÉXICO,BENITO JUAREZ,26,101,2,129,1388
CIUDAD DE MÉXICO,BENITO JUAREZ,25,93,1,119,1387
CIUDAD DE MÉXICO,BENITO JUAREZ,24,116,1,141,1387
CIUDAD DE MÉXICO,BENITO JUAREZ,39,233,3,275,1934
CIUDAD DE MÉXICO,BENITO JUAREZ,38,193,2,233,1933
CIUDAD DE MÉXICO,BENITO JUAREZ,35,133,0,168,1843
CIUDAD DE MÉXICO,BENITO JUAREZ,44,132,1,177,1843
CIUDAD DE MÉXICO,BENITO JUAREZ,39,150,3,192,1843
CIUDAD DE MÉXICO,BENITO JUAREZ,27,113,1,141,1916
CIUDAD DE MÉXICO,BENITO JUAREZ,32,148,0,180,1916
CIUDAD DE MÉXICO,BENITO JUAREZ,23,84,1,108,1392
CIUDAD DE MÉXICO,BENITO JUAREZ,31,105,2,138,1392
CIUDAD DE MÉXICO,BENITO JUAREZ,18,84,1,103,1392
CIUDAD DE MÉXICO,BENITO JUAREZ,33,155,3,191,1782
CIUDAD DE MÉXICO,BENITO JUAREZ,36,145,4,185,1782
CIUDAD DE MÉXICO,BENITO JUAREZ,19,55,1,75,1017
CIUDAD DE MÉXICO,BENITO JUAREZ,17,53,0,70,1017
CIUDAD DE MÉXICO,BENITO JUAREZ,34,211,1,246,1627
CIUDAD DE MÉXICO,BENITO JUAREZ,43,182,1,226,1627
CIUDAD DE MÉXICO,BENITO JUAREZ,31,203,2,236,1626
CIUDAD DE MÉXICO,BENITO JUAREZ,24,159,6,189,1830
CIUDAD DE MÉXICO,BENITO JUAREZ,39,155,3,197,1830
CIUDAD DE MÉXICO,BENITO JUAREZ,30,214,1,245,1527
CIUDAD DE MÉXICO,BENITO JUAREZ,32,182,6,220,1527
CIUDAD DE MÉXICO,BENITO JUAREZ,52,186,6,244,1527
CIUDAD DE MÉXICO,BENITO JUAREZ,52,273,5,330,1946
CIUDAD DE MÉXICO,BENITO JUAREZ,46,232,4,282,1946
CIUDAD DE MÉXICO,BENITO JUAREZ,19,109,0,128,1001
CIUDAD DE MÉXICO,BENITO JUAREZ,22,150,2,174,1001
CIUDAD DE MÉXICO,BENITO JUAREZ,22,95,3,120,1086
CIUDAD DE MÉXICO,BENITO JUAREZ,28,91,0,119,1086
CIUDAD DE MÉXICO,BENITO JUAREZ,39,139,2,180,1605
CIUDAD DE MÉXICO,BENITO JUAREZ,15,145,2,162,1605
CIUDAD DE MÉXICO,BENITO JUAREZ,58,228,7,293,1805
CIUDAD DE MÉXICO,BENITO JUAREZ,51,253,8,312,1805
CIUDAD DE MÉXICO,BENITO JUAREZ,41,185,2,228,1546
CIUDAD DE MÉXICO,BENITO JUAREZ,40,178,2,220,1546
CIUDAD DE MÉXICO,BENITO JUAREZ,36,182,5,223,1546
CIUDAD DE MÉXICO,BENITO JUAREZ,40,219,2,261,1782
CIUDAD DE MÉXICO,BENITO JUAREZ,31,196,0,227,1782
CIUDAD DE MÉXICO,BENITO JUAREZ,39,167,2,208,1529
CIUDAD DE MÉXICO,BENITO JUAREZ,54,196,1,251,1529
CIUDAD DE MÉXICO,BENITO JUAREZ,38,182,3,223,1529
CIUDAD DE MÉXICO,BENITO JUAREZ,25,152,2,179,1495
CIUDAD DE MÉXICO,BENITO JUAREZ,21,146,1,168,1495
CIUDAD DE MÉXICO,BENITO JUAREZ,32,144,2,178,1495
CIUDAD DE MÉXICO,BENITO JUAREZ,47,200,0,247,1724
CIUDAD DE MÉXICO,BENITO JUAREZ,33,221,0,254,1723
CIUDAD DE MÉXICO,BENITO JUAREZ,48,209,5,262,1739
CIUDAD DE MÉXICO,BENITO JUAREZ,54,183,3,240,1739
CIUDAD DE MÉXICO,BENITO JUAREZ,45,202,8,255,1694
CIUDAD DE MÉXICO,BENITO JUAREZ,39,229,4,272,1693
CIUDAD DE MÉXICO,BENITO JUAREZ,39,121,2,162,1448
CIUDAD DE MÉXICO,BENITO JUAREZ,37,143,1,181,1448
CIUDAD DE MÉXICO,ALVARO OBREGON,30,262,2,294,1508
CIUDAD DE MÉXICO,ALVARO OBREGON,48,214,4,266,1508
CIUDAD DE MÉXICO,ALVARO OBREGON,25,222,3,250,1134
CIUDAD DE MÉXICO,ALVARO OBREGON,21,243,5,269,1133
CIUDAD DE MÉXICO,ALVARO OBREGON,31,323,6,360,1815
CIUDAD DE MÉXICO,ALVARO OBREGON,25,298,3,326,1814
CIUDAD DE MÉXICO,ALVARO OBREGON,36,214,7,257,1763
CIUDAD DE MÉXICO,ALVARO OBREGON,26,219,5,250,1762
CIUDAD DE MÉXICO,ALVARO OBREGON,26,235,3,264,1819
CIUDAD DE MÉXICO,ALVARO OBREGON,26,247,2,275,1819
CIUDAD DE MÉXICO,ALVARO OBREGON,41,291,6,338,1865
CIUDAD DE MÉXICO,ALVARO OBREGON,27,300,5,332,1865
CIUDAD DE MÉXICO,ALVARO OBREGON,32,260,3,295,1670
CIUDAD DE MÉXICO,ALVARO OBREGON,25,315,4,344,1670
CIUDAD DE MÉXICO,ALVARO OBREGON,41,170,2,213,1283
CIUDAD DE MÉXICO,ALVARO OBREGON,41,183,3,227,1283
CIUDAD DE MÉXICO,ALVARO OBREGON,32,290,2,324,1857
CIUDAD DE MÉXICO,ALVARO OBREGON,29,299,5,333,1857
CIUDAD DE MÉXICO,ALVARO OBREGON,37,227,8,272,1353
CIUDAD DE MÉXICO,ALVARO OBREGON,24,215,6,245,1353
CIUDAD DE MÉXICO,ALVARO OBREGON,26,235,2,263,1353
CIUDAD DE MÉXICO,ALVARO OBREGON,37,363,4,404,1976
CIUDAD DE MÉXICO,ALVARO OBREGON,22,217,2,241,1442
CIUDAD DE MÉXICO,ALVARO OBREGON,22,248,6,276,1442
CIUDAD DE MÉXICO,ALVARO OBREGON,28,236,2,266,1442
CIUDAD DE MÉXICO,ALVARO OBREGON,23,212,3,238,1494
CIUDAD DE MÉXICO,ALVARO OBREGON,23,231,4,258,1494
CIUDAD DE MÉXICO,ALVARO OBREGON,23,258,3,284,1494
CIUDAD DE MÉXICO,ALVARO OBREGON,26,272,0,298,1252
CIUDAD DE MÉXICO,ALVARO OBREGON,30,239,5,274,1252
CIUDAD DE MÉXICO,ALVARO OBREGON,21,252,6,279,1717
CIUDAD DE MÉXICO,ALVARO OBREGON,20,248,4,272,1716
CIUDAD DE MÉXICO,ALVARO OBREGON,24,157,12,193,1141
CIUDAD DE MÉXICO,ALVARO OBREGON,18,187,2,207,1141
CIUDAD DE MÉXICO,ALVARO OBREGON,30,219,4,253,1664
CIUDAD DE MÉXICO,ALVARO OBREGON,43,236,3,282,1663
CIUDAD DE MÉXICO,ALVARO OBREGON,29,222,6,257,1282
CIUDAD DE MÉXICO,ALVARO OBREGON,33,228,3,264,1281
CIUDAD DE MÉXICO,ALVARO OBREGON,19,168,2,189,1063
CIUDAD DE MÉXICO,ALVARO OBREGON,22,183,3,208,1062
CIUDAD DE MÉXICO,ALVARO OBREGON,21,181,3,205,1488
CIUDAD DE MÉXICO,ALVARO OBREGON,36,163,1,200,1488
CIUDAD DE MÉXICO,ALVARO OBREGON,37,186,5,228,1487
CIUDAD DE MÉXICO,ALVARO OBREGON,28,214,5,247,1373
CIUDAD DE MÉXICO,ALVARO OBREGON,24,224,3,251,1372
CIUDAD DE MÉXICO,ALVARO OBREGON,27,311,3,341,1908
CIUDAD DE MÉXICO,ALVARO OBREGON,29,342,8,379,1908
CIUDAD DE MÉXICO,ALVARO OBREGON,24,308,4,336,1907
CIUDAD DE MÉXICO,ALVARO OBREGON,20,282,2,304,1572
CIUDAD DE MÉXICO,ALVARO OBREGON,24,276,2,302,1571
CIUDAD DE MÉXICO,ALVARO OBREGON,18,289,4,311,1674
CIUDAD DE MÉXICO,ALVARO OBREGON,17,260,4,281,1674
CIUDAD DE MÉXICO,ALVARO OBREGON,34,312,5,351,1836
CIUDAD DE MÉXICO,ALVARO OBREGON,45,242,7,294,1835
CIUDAD DE MÉXICO,ALVARO OBREGON,39,227,3,269,1510
CIUDAD DE MÉXICO,ALVARO OBREGON,26,222,10,258,1510
CIUDAD DE MÉXICO,ALVARO OBREGON,31,241,3,275,1509
CIUDAD DE MÉXICO,ALVARO OBREGON,29,275,4,308,1494
CIUDAD DE MÉXICO,ALVARO OBREGON,34,254,7,295,1494
CIUDAD DE MÉXICO,ALVARO OBREGON,35,259,2,296,1493
CIUDAD DE MÉXICO,ALVARO OBREGON,42,321,5,368,1890
CIUDAD DE MÉXICO,ALVARO OBREGON,43,349,8,400,1889
CIUDAD DE MÉXICO,ALVARO OBREGON,16,216,2,234,1183
CIUDAD DE MÉXICO,ALVARO OBREGON,14,223,3,240,1182
CIUDAD DE MÉXICO,ALVARO OBREGON,14,243,0,257,1365
CIUDAD DE MÉXICO,ALVARO OBREGON,27,234,3,264,1365
CIUDAD DE MÉXICO,ALVARO OBREGON,8,272,3,283,1427
CIUDAD DE MÉXICO,ALVARO OBREGON,15,243,3,261,1427
CIUDAD DE MÉXICO,ALVARO OBREGON,10,216,1,227,1426
CIUDAD DE MÉXICO,ALVARO OBREGON,21,249,6,276,1530
CIUDAD DE MÉXICO,ALVARO OBREGON,22,231,3,256,1529
CIUDAD DE MÉXICO,ALVARO OBREGON,18,256,17,291,1644
CIUDAD DE MÉXICO,ALVARO OBREGON,23,273,2,298,1643
CIUDAD DE MÉXICO,ALVARO OBREGON,14,249,5,268,1348
CIUDAD DE MÉXICO,ALVARO OBREGON,26,273,3,302,1347
CIUDAD DE MÉXICO,ALVARO OBREGON,9,239,8,256,1347
CIUDAD DE MÉXICO,ALVARO OBREGON,26,277,8,311,1640
CIUDAD DE MÉXICO,ALVARO OBREGON,18,282,9,309,1640
CIUDAD DE MÉXICO,ALVARO OBREGON,33,346,8,387,1944
CIUDAD DE MÉXICO,ALVARO OBREGON,25,335,4,364,1943
CIUDAD DE MÉXICO,ALVARO OBREGON,20,310,7,337,1550
CIUDAD DE MÉXICO,ALVARO OBREGON,19,255,7,281,1550
CIUDAD DE MÉXICO,ALVARO OBREGON,15,242,3,260,1549
CIUDAD DE MÉXICO,ALVARO OBREGON,26,240,4,270,1440
CIUDAD DE MÉXICO,ALVARO OBREGON,30,206,2,238,1440
CIUDAD DE MÉXICO,ALVARO OBREGON,24,147,0,171,1959
CIUDAD DE MÉXICO,ALVARO OBREGON,38,152,2,192,1959
CIUDAD DE MÉXICO,ALVARO OBREGON,30,152,1,183,1958
CIUDAD DE MÉXICO,ALVARO OBREGON,17,179,0,196,1958
CIUDAD DE MÉXICO,ALVARO OBREGON,31,281,6,318,1919
CIUDAD DE MÉXICO,ALVARO OBREGON,31,300,5,336,1918
CIUDAD DE MÉXICO,ALVARO OBREGON,11,253,4,268,1424
CIUDAD DE MÉXICO,ALVARO OBREGON,18,220,5,243,1423
CIUDAD DE MÉXICO,ALVARO OBREGON,23,326,3,352,1736
CIUDAD DE MÉXICO,ALVARO OBREGON,20,324,6,350,1735
CIUDAD DE MÉXICO,ALVARO OBREGON,24,316,7,347,1784
CIUDAD DE MÉXICO,ALVARO OBREGON,28,313,0,341,1784
CIUDAD DE MÉXICO,ALVARO OBREGON,27,304,5,336,1821
CIUDAD DE MÉXICO,ALVARO OBREGON,17,330,10,357,1820
CIUDAD DE MÉXICO,ALVARO OBREGON,24,298,4,326,1820
CIUDAD DE MÉXICO,ALVARO OBREGON,29,322,4,355,1922
CIUDAD DE MÉXICO,ALVARO OBREGON,29,304,2,335,1922
CIUDAD DE MÉXICO,ALVARO OBREGON,22,306,3,331,1551
CIUDAD DE MÉXICO,ALVARO OBREGON,20,266,4,290,1551
CIUDAD DE MÉXICO,ALVARO OBREGON,23,293,7,323,1550
CIUDAD DE MÉXICO,ALVARO OBREGON,16,351,7,374,1663
CIUDAD DE MÉXICO,ALVARO OBREGON,20,323,4,347,1662
CIUDAD DE MÉXICO,ALVARO OBREGON,27,165,0,192,1089
CIUDAD DE MÉXICO,ALVARO OBREGON,30,202,3,235,1089
CIUDAD DE MÉXICO,ALVARO OBREGON,24,347,2,373,1855
CIUDAD DE MÉXICO,ALVARO OBREGON,34,307,1,342,1854
CIUDAD DE MÉXICO,ALVARO OBREGON,24,244,5,273,1529
CIUDAD DE MÉXICO,ALVARO OBREGON,34,266,4,304,1528
CIUDAD DE MÉXICO,ALVARO OBREGON,30,235,2,267,1528
CIUDAD DE MÉXICO,ALVARO OBREGON,26,240,2,268,1600
CIUDAD DE MÉXICO,ALVARO OBREGON,32,295,2,329,1599
CIUDAD DE MÉXICO,ALVARO OBREGON,19,231,3,253,1323
CIUDAD DE MÉXICO,ALVARO OBREGON,20,234,1,255,1322
CIUDAD DE MÉXICO,ALVARO OBREGON,8,226,3,237,1322
CIUDAD DE MÉXICO,ALVARO OBREGON,29,370,8,407,1923
CIUDAD DE MÉXICO,ALVARO OBREGON,30,352,7,389,1922
CIUDAD DE MÉXICO,ALVARO OBREGON,37,284,5,326,1861
CIUDAD DE MÉXICO,ALVARO OBREGON,28,265,3,296,1860
CIUDAD DE MÉXICO,ALVARO OBREGON,20,330,2,352,1778
CIUDAD DE MÉXICO,ALVARO OBREGON,21,318,4,343,1777
CIUDAD DE MÉXICO,ALVARO OBREGON,27,249,1,277,1553
CIUDAD DE MÉXICO,ALVARO OBREGON,25,266,3,294,1553
CIUDAD DE MÉXICO,ALVARO OBREGON,29,284,6,319,1579
CIUDAD DE MÉXICO,ALVARO OBREGON,36,273,2,311,1578
CIUDAD DE MÉXICO,ALVARO OBREGON,33,246,6,285,1782
CIUDAD DE MÉXICO,ALVARO OBREGON,36,231,9,276,1782
CIUDAD DE MÉXICO,ALVARO OBREGON,45,248,4,297,1782
CIUDAD DE MÉXICO,ALVARO OBREGON,42,311,9,362,1826
CIUDAD DE MÉXICO,ALVARO OBREGON,50,302,2,354,1826
CIUDAD DE MÉXICO,ALVARO OBREGON,43,312,5,360,1826
CIUDAD DE MÉXICO,ALVARO OBREGON,40,183,5,228,1905
CIUDAD DE MÉXICO,ALVARO OBREGON,45,186,3,234,1905
CIUDAD DE MÉXICO,ALVARO OBREGON,35,185,2,222,1565
CIUDAD DE MÉXICO,ALVARO OBREGON,43,173,4,220,1565
CIUDAD DE MÉXICO,ALVARO OBREGON,20,176,2,198,1417
CIUDAD DE MÉXICO,ALVARO OBREGON,37,171,1,209,1417
CIUDAD DE MÉXICO,ALVARO OBREGON,29,172,3,204,1416
CIUDAD DE MÉXICO,ALVARO OBREGON,53,297,5,355,1771
CIUDAD DE MÉXICO,ALVARO OBREGON,34,311,4,349,1771
CIUDAD DE MÉXICO,ALVARO OBREGON,46,250,1,297,1910
CIUDAD DE MÉXICO,ALVARO OBREGON,45,259,1,305,1910
CIUDAD DE MÉXICO,ALVARO OBREGON,144,1144,10,1298,0
CIUDAD DE MÉXICO,ALVARO OBREGON,43,270,9,322,1527
CIUDAD DE MÉXICO,ALVARO OBREGON,34,222,5,261,1526
CIUDAD DE MÉXICO,ALVARO OBREGON,31,191,1,223,1048
CIUDAD DE MÉXICO,ALVARO OBREGON,21,196,0,217,1048
CIUDAD DE MÉXICO,ALVARO OBREGON,35,298,2,335,1860
CIUDAD DE MÉXICO,ALVARO OBREGON,36,311,5,352,1859
CIUDAD DE MÉXICO,ALVARO OBREGON,26,262,6,294,1719
CIUDAD DE MÉXICO,ALVARO OBREGON,35,253,3,291,1718
CIUDAD DE MÉXICO,ALVARO OBREGON,48,252,9,309,1811
CIUDAD DE MÉXICO,ALVARO OBREGON,46,235,4,285,1811
CIUDAD DE MÉXICO,ALVARO OBREGON,42,253,1,296,1811
CIUDAD DE MÉXICO,ALVARO OBREGON,43,228,29,300,1827
CIUDAD DE MÉXICO,ALVARO OBREGON,27,215,5,247,1827
CIUDAD DE MÉXICO,ALVARO OBREGON,38,212,4,254,1423
CIUDAD DE MÉXICO,ALVARO OBREGON,38,222,4,264,1423
CIUDAD DE MÉXICO,ALVARO OBREGON,35,225,4,264,1422
CIUDAD DE MÉXICO,ALVARO OBREGON,49,252,8,309,1434
CIUDAD DE MÉXICO,ALVARO OBREGON,37,235,5,277,1433
CIUDAD DE MÉXICO,ALVARO OBREGON,56,251,5,312,1274
CIUDAD DE MÉXICO,ALVARO OBREGON,43,243,1,287,1274
CIUDAD DE MÉXICO,ALVARO OBREGON,34,226,3,263,1788
CIUDAD DE MÉXICO,ALVARO OBREGON,40,217,5,262,1788
CIUDAD DE MÉXICO,ALVARO OBREGON,25,126,6,157,1452
CIUDAD DE MÉXICO,ALVARO OBREGON,24,96,4,124,1451
CIUDAD DE MÉXICO,ALVARO OBREGON,24,224,1,249,1353
CIUDAD DE MÉXICO,ALVARO OBREGON,24,201,3,228,1352
CIUDAD DE MÉXICO,ALVARO OBREGON,25,283,2,310,1399
CIUDAD DE MÉXICO,ALVARO OBREGON,33,290,6,329,1399
CIUDAD DE MÉXICO,ALVARO OBREGON,45,381,3,429,1780
CIUDAD DE MÉXICO,ALVARO OBREGON,55,390,8,453,1779
CIUDAD DE MÉXICO,ALVARO OBREGON,26,195,2,223,1540
CIUDAD DE MÉXICO,ALVARO OBREGON,237,28,4,269,1540
CIUDAD DE MÉXICO,ALVARO OBREGON,27,215,7,249,1539
CIUDAD DE MÉXICO,ALVARO OBREGON,29,158,2,189,1876
CIUDAD DE MÉXICO,ALVARO OBREGON,30,185,5,220,1876
CIUDAD DE MÉXICO,ALVARO OBREGON,20,121,1,142,1405
CIUDAD DE MÉXICO,ALVARO OBREGON,21,107,2,130,1405
CIUDAD DE MÉXICO,ALVARO OBREGON,35,233,5,273,1884
CIUDAD DE MÉXICO,ALVARO OBREGON,32,214,6,252,1883
CIUDAD DE MÉXICO,ALVARO OBREGON,33,265,2,300,1946
CIUDAD DE MÉXICO,ALVARO OBREGON,28,262,2,292,1946
CIUDAD DE MÉXICO,ALVARO OBREGON,24,277,33,334,1945
CIUDAD DE MÉXICO,ALVARO OBREGON,27,318,2,347,1945
CIUDAD DE MÉXICO,ALVARO OBREGON,61,323,11,395,1312
CIUDAD DE MÉXICO,ALVARO OBREGON,81,321,18,420,1312
CIUDAD DE MÉXICO,ALVARO OBREGON,22,224,2,248,1451
CIUDAD DE MÉXICO,ALVARO OBREGON,26,211,4,241,1451
CIUDAD DE MÉXICO,ALVARO OBREGON,14,109,2,125,1151
CIUDAD DE MÉXICO,ALVARO OBREGON,17,104,2,123,1150
CIUDAD DE MÉXICO,ALVARO OBREGON,21,147,2,170,1442
CIUDAD DE MÉXICO,ALVARO OBREGON,12,202,2,216,1442
CIUDAD DE MÉXICO,ALVARO OBREGON,22,214,6,242,1580
CIUDAD DE MÉXICO,ALVARO OBREGON,25,257,6,288,1579
CIUDAD DE MÉXICO,ALVARO OBREGON,15,246,6,267,1579
CIUDAD DE MÉXICO,ALVARO OBREGON,28,189,2,219,1659
CIUDAD DE MÉXICO,ALVARO OBREGON,29,185,4,218,1658
CIUDAD DE MÉXICO,CUAJIMALPA DE MORELOS,30,415,12,457,1901
CIUDAD DE MÉXICO,CUAJIMALPA DE MORELOS,33,389,7,429,1900
CIUDAD DE MÉXICO,CUAJIMALPA DE MORELOS,18,118,0,136,1906
CIUDAD DE MÉXICO,CUAJIMALPA DE MORELOS,22,153,2,177,1906
CIUDAD DE MÉXICO,CUAJIMALPA DE MORELOS,11,8,1,20,1128
CIUDAD DE MÉXICO,CUAJIMALPA DE MORELOS,6,9,0,15,1127
CIUDAD DE MÉXICO,CUAJIMALPA DE MORELOS,18,150,0,168,1842
CIUDAD DE MÉXICO,CUAJIMALPA DE MORELOS,16,129,3,148,1841
CIUDAD DE MÉXICO,CUAJIMALPA DE MORELOS,10,95,0,105,1024
CIUDAD DE MÉXICO,CUAJIMALPA DE MORELOS,10,97,1,108,1023
CIUDAD DE MÉXICO,CUAJIMALPA DE MORELOS,4,28,0,32,1449
CIUDAD DE MÉXICO,CUAJIMALPA DE MORELOS,5,42,2,49,1449
CIUDAD DE MÉXICO,CUAJIMALPA DE MORELOS,10,24,0,34,1449
CIUDAD DE MÉXICO,CUAJIMALPA DE MORELOS,15,253,4,272,1291
CIUDAD DE MÉXICO,CUAJIMALPA DE MORELOS,19,234,10,263,1290
CIUDAD DE MÉXICO,CUAJIMALPA DE MORELOS,43,330,13,386,1673
CIUDAD DE MÉXICO,CUAJIMALPA DE MORELOS,28,319,10,357,1672
CIUDAD DE MÉXICO,CUAJIMALPA DE MORELOS,35,219,5,259,1276
CIUDAD DE MÉXICO,CUAJIMALPA DE MORELOS,34,175,7,216,1275
CIUDAD DE MÉXICO,CUAJIMALPA DE MORELOS,13,20,1,34,1352
CIUDAD DE MÉXICO,CUAJIMALPA DE MORELOS,8,29,0,37,1352
CIUDAD DE MÉXICO,CUAJIMALPA DE MORELOS,5,10,0,15,1518
CIUDAD DE MÉXICO,CUAJIMALPA DE MORELOS,10,10,0,20,1518
CIUDAD DE MÉXICO,CUAJIMALPA DE MORELOS,23,261,2,286,1134
CIUDAD DE MÉXICO,CUAJIMALPA DE MORELOS,6,204,6,216,1133
CIUDAD DE MÉXICO,CUAJIMALPA DE MORELOS,37,256,10,303,1585
CIUDAD DE MÉXICO,CUAJIMALPA DE MORELOS,27,291,5,323,1585
CIUDAD DE MÉXICO,CUAJIMALPA DE MORELOS,32,232,9,273,1745
CIUDAD DE MÉXICO,CUAJIMALPA DE MORELOS,35,232,4,271,1745
CIUDAD DE MÉXICO,CUAJIMALPA DE MORELOS,33,162,1,196,1363
CIUDAD DE MÉXICO,CUAJIMALPA DE MORELOS,25,133,9,167,1363
CIUDAD DE MÉXICO,CUAJIMALPA DE MORELOS,18,223,11,252,1736
CIUDAD DE MÉXICO,CUAJIMALPA DE MORELOS,39,240,9,288,1735
CIUDAD DE MÉXICO,CUAJIMALPA DE MORELOS,29,355,6,390,1704
CIUDAD DE MÉXICO,CUAJIMALPA DE MORELOS,39,354,11,404,1703
CIUDAD DE MÉXICO,CUAJIMALPA DE MORELOS,17,210,3,230,1141
CIUDAD DE MÉXICO,CUAJIMALPA DE MORELOS,21,212,1,234,1140
CIUDAD DE MÉXICO,CUAJIMALPA DE MORELOS,23,323,9,355,1545
CIUDAD DE MÉXICO,CUAJIMALPA DE MORELOS,32,311,4,347,1544
CIUDAD DE MÉXICO,CUAJIMALPA DE MORELOS,23,211,3,237,1695
CIUDAD DE MÉXICO,CUAJIMALPA DE MORELOS,21,235,6,262,1694
CIUDAD DE MÉXICO,CUAJIMALPA DE MORELOS,16,123,1,140,1783
CIUDAD DE MÉXICO,CUAJIMALPA DE MORELOS,16,158,1,175,1783
CIUDAD DE MÉXICO,CUAJIMALPA DE MORELOS,14,38,0,52,1388
CIUDAD DE MÉXICO,CUAJIMALPA DE MORELOS,11,25,0,36,1388
CIUDAD DE MÉXICO,CUAJIMALPA DE MORELOS,11,21,3,35,1387
CIUDAD DE MÉXICO,CUAJIMALPA DE MORELOS,14,164,1,179,1198
CIUDAD DE MÉXICO,CUAJIMALPA DE MORELOS,24,160,1,185,1198
CIUDAD DE MÉXICO,CUAJIMALPA DE MORELOS,21,201,3,225,1209
CIUDAD DE MÉXICO,CUAJIMALPA DE MORELOS,23,231,3,257,1209
CIUDAD DE MÉXICO,CUAJIMALPA DE MORELOS,25,223,8,256,1617
CIUDAD DE MÉXICO,CUAJIMALPA DE MORELOS,14,227,4,245,1616
CIUDAD DE MÉXICO,CUAJIMALPA DE MORELOS,48,275,3,326,1937
CIUDAD DE MÉXICO,CUAJIMALPA DE MORELOS,40,306,3,349,1937
CIUDAD DE MÉXICO,CUAJIMALPA DE MORELOS,24,317,3,344,1701
CIUDAD DE MÉXICO,CUAJIMALPA DE MORELOS,21,288,2,311,1701
CIUDAD DE MÉXICO,CUAJIMALPA DE MORELOS,11,119,1,131,1465
CIUDAD DE MÉXICO,CUAJIMALPA DE MORELOS,14,130,1,145,1465
CIUDAD DE MÉXICO,CUAJIMALPA DE MORELOS,7,133,4,144,1464
CIUDAD DE MÉXICO,CUAJIMALPA DE MORELOS,28,136,2,166,1069
CIUDAD DE MÉXICO,CUAJIMALPA DE MORELOS,18,146,2,166,1068
CIUDAD DE MÉXICO,CUAJIMALPA DE MORELOS,31,178,2,211,1705
CIUDAD DE MÉXICO,CUAJIMALPA DE MORELOS,32,151,3,186,1705
CIUDAD DE MÉXICO,CUAJIMALPA DE MORELOS,13,115,2,130,1012
CIUDAD DE MÉXICO,CUAJIMALPA DE MORELOS,22,122,3,147,1012
CIUDAD DE MÉXICO,CUAJIMALPA DE MORELOS,36,306,2,344,1910
CIUDAD DE MÉXICO,CUAJIMALPA DE MORELOS,42,352,1,395,1909
CIUDAD DE MÉXICO,CUAJIMALPA DE MORELOS,22,204,5,231,1272
CIUDAD DE MÉXICO,CUAJIMALPA DE MORELOS,13,193,5,211,1272
CIUDAD DE MÉXICO,CUAJIMALPA DE MORELOS,10,192,7,209,1164
CIUDAD DE MÉXICO,CUAJIMALPA DE MORELOS,5,185,4,194,1164
CIUDAD DE MÉXICO,CUAJIMALPA DE MORELOS,13,214,1,228,1569
CIUDAD DE MÉXICO,CUAJIMALPA DE MORELOS,14,247,8,269,1569
CIUDAD DE MÉXICO,CUAJIMALPA DE MORELOS,22,221,8,251,1294
CIUDAD DE MÉXICO,CUAJIMALPA DE MORELOS,17,230,3,250,1293
CIUDAD DE MÉXICO,CUAJIMALPA DE MORELOS,20,345,4,369,1700
CIUDAD DE MÉXICO,CUAJIMALPA DE MORELOS,18,292,5,315,1699
CIUDAD DE MÉXICO,CUAJIMALPA DE MORELOS,22,311,11,344,1795
CIUDAD DE MÉXICO,CUAJIMALPA DE MORELOS,35,309,6,350,1794
CIUDAD DE MÉXICO,CUAJIMALPA DE MORELOS,21,319,13,353,1868
CIUDAD DE MÉXICO,CUAJIMALPA DE MORELOS,19,297,13,329,1868
CIUDAD DE MÉXICO,CUAJIMALPA DE MORELOS,22,263,5,290,1880
CIUDAD DE MÉXICO,CUAJIMALPA DE MORELOS,0,266,2,268,1879
CIUDAD DE MÉXICO,CUAJIMALPA DE MORELOS,25,261,1,287,1557
CIUDAD DE MÉXICO,CUAJIMALPA DE MORELOS,33,227,10,270,1557
CIUDAD DE MÉXICO,CUAJIMALPA DE MORELOS,26,246,7,279,1557
CIUDAD DE MÉXICO,CUAJIMALPA DE MORELOS,26,123,0,149,1606
CIUDAD DE MÉXICO,CUAJIMALPA DE MORELOS,32,187,4,223,1606
CIUDAD DE MÉXICO,CUAJIMALPA DE MORELOS,27,132,3,162,1606
CIUDAD DE MÉXICO,CUAJIMALPA DE MORELOS,20,482,27,529,1885
CIUDAD DE MÉXICO,CUAJIMALPA DE MORELOS,17,518,18,553,1885
CIUDAD DE MÉXICO,CUAJIMALPA DE MORELOS,29,554,20,603,1884
CIUDAD DE MÉXICO,CUAJIMALPA DE MORELOS,27,326,6,359,1587
CIUDAD DE MÉXICO,CUAJIMALPA DE MORELOS,22,327,12,361,1587
CIUDAD DE MÉXICO,CUAJIMALPA DE MORELOS,24,319,5,348,1587
CIUDAD DE MÉXICO,CUAJIMALPA DE MORELOS,29,372,8,409,1991
CIUDAD DE MÉXICO,CUAJIMALPA DE MORELOS,0,382,10,392,1990
CIUDAD DE MÉXICO,CUAJIMALPA DE MORELOS,22,258,3,283,1511
CIUDAD DE MÉXICO,CUAJIMALPA DE MORELOS,16,243,7,266,1510
CIUDAD DE MÉXICO,CUAJIMALPA DE MORELOS,49,375,8,432,0
CIUDAD DE MÉXICO,CUAJIMALPA DE MORELOS,30,457,5,492,1923
CIUDAD DE MÉXICO,CUAJIMALPA DE MORELOS,35,434,14,483,1923
CIUDAD DE MÉXICO,CUAJIMALPA DE MORELOS,31,329,13,373,1729
CIUDAD DE MÉXICO,CUAJIMALPA DE MORELOS,30,338,6,374,1728
CIUDAD DE MÉXICO,CUAJIMALPA DE MORELOS,23,182,6,211,1356
CIUDAD DE MÉXICO,CUAJIMALPA DE MORELOS,24,190,3,217,1355
CIUDAD DE MÉXICO,CUAJIMALPA DE MORELOS,25,251,8,284,1307
CIUDAD DE MÉXICO,CUAJIMALPA DE MORELOS,29,232,7,268,1307
CIUDAD DE MÉXICO,CUAJIMALPA DE MORELOS,23,318,4,345,1334
CIUDAD DE MÉXICO,CUAJIMALPA DE MORELOS,34,240,5,279,1333
CIUDAD DE MÉXICO,CUAJIMALPA DE MORELOS,22,342,8,372,1333
CIUDAD DE MÉXICO,CUAJIMALPA DE MORELOS,44,282,3,329,1942
CIUDAD DE MÉXICO,CUAJIMALPA DE MORELOS,34,317,4,355,1941
CIUDAD DE MÉXICO,CUAJIMALPA DE MORELOS,26,225,5,256,1443
CIUDAD DE MÉXICO,CUAJIMALPA DE MORELOS,33,194,1,228,1443
CIUDAD DE MÉXICO,CUAJIMALPA DE MORELOS,13,260,5,278,1933
CIUDAD DE MÉXICO,CUAJIMALPA DE MORELOS,15,255,8,278,1933
CIUDAD DE MÉXICO,CUAJIMALPA DE MORELOS,19,222,5,246,1176
CIUDAD DE MÉXICO,CUAJIMALPA DE MORELOS,21,231,4,256,1175
CIUDAD DE MÉXICO,CUAJIMALPA DE MORELOS,15,195,5,215,1323
CIUDAD DE MÉXICO,CUAJIMALPA DE MORELOS,13,216,1,230,1323
CIUDAD DE MÉXICO,CUAJIMALPA DE MORELOS,17,257,3,277,1317
CIUDAD DE MÉXICO,CUAJIMALPA DE MORELOS,26,254,3,283,1317
CIUDAD DE MÉXICO,CUAJIMALPA DE MORELOS,29,258,4,291,1569
CIUDAD DE MÉXICO,CUAJIMALPA DE MORELOS,33,292,0,325,1569
CIUDAD DE MÉXICO,CUAJIMALPA DE MORELOS,22,233,6,261,1364
CIUDAD DE MÉXICO,CUAJIMALPA DE MORELOS,18,235,3,256,1364
CIUDAD DE MÉXICO,CUAJIMALPA DE MORELOS,27,340,11,378,1741
CIUDAD DE MÉXICO,CUAJIMALPA DE MORELOS,17,348,7,372,1740
CIUDAD DE MÉXICO,CUAJIMALPA DE MORELOS,20,198,2,220,1248
CIUDAD DE MÉXICO,CUAJIMALPA DE MORELOS,25,187,7,219,1248
CIUDAD DE MÉXICO,CUAJIMALPA DE MORELOS,18,281,3,302,1484
CIUDAD DE MÉXICO,CUAJIMALPA DE MORELOS,29,270,4,303,1483
CIUDAD DE MÉXICO,CUAJIMALPA DE MORELOS,19,80,1,100,1550
CIUDAD DE MÉXICO,CUAJIMALPA DE MORELOS,18,92,2,112,1550
CIUDAD DE MÉXICO,CUAJIMALPA DE MORELOS,19,77,0,96,1549
CIUDAD DE MÉXICO,CUAJIMALPA DE MORELOS,15,353,6,374,1794
CIUDAD DE MÉXICO,CUAJIMALPA DE MORELOS,27,316,7,350,1794
CIUDAD DE MÉXICO,CUAJIMALPA DE MORELOS,40,249,5,294,1530
CIUDAD DE MÉXICO,CUAJIMALPA DE MORELOS,27,280,7,314,1529
CIUDAD DE MÉXICO,CUAJIMALPA DE MORELOS,38,274,4,316,1529
CIUDAD DE MÉXICO,CUAJIMALPA DE MORELOS,21,238,3,262,1552
CIUDAD DE MÉXICO,CUAJIMALPA DE MORELOS,23,240,5,268,1551
CIUDAD DE MÉXICO,CUAJIMALPA DE MORELOS,37,292,4,333,1847
CIUDAD DE MÉXICO,CUAJIMALPA DE MORELOS,37,291,6,334,1847
CIUDAD DE MÉXICO,CUAJIMALPA DE MORELOS,22,197,4,223,1373
CIUDAD DE MÉXICO,CUAJIMALPA DE MORELOS,25,201,5,231,1372
CIUDAD DE MÉXICO,CUAJIMALPA DE MORELOS,17,201,3,221,1234
CIUDAD DE MÉXICO,CUAJIMALPA DE MORELOS,21,172,0,193,1233
CIUDAD DE MÉXICO,CUAJIMALPA DE MORELOS,33,133,0,166,1378
CIUDAD DE MÉXICO,CUAJIMALPA DE MORELOS,37,243,6,286,1377
CIUDAD DE MÉXICO,CUAJIMALPA DE MORELOS,18,246,4,268,1607
CIUDAD DE MÉXICO,CUAJIMALPA DE MORELOS,21,233,4,258,1607
CIUDAD DE MÉXICO,CUAJIMALPA DE MORELOS,34,239,8,281,1634
CIUDAD DE MÉXICO,CUAJIMALPA DE MORELOS,26,276,3,305,1634
CIUDAD DE MÉXICO,CUAJIMALPA DE MORELOS,22,300,1,323,1819
CIUDAD DE MÉXICO,CUAJIMALPA DE MORELOS,33,301,4,338,1819
CIUDAD DE MÉXICO,CUAJIMALPA DE MORELOS,32,217,6,255,1332
CIUDAD DE MÉXICO,CUAJIMALPA DE MORELOS,20,185,4,209,1331
CIUDAD DE MÉXICO,CUAJIMALPA DE MORELOS,23,185,11,219,1331
CIUDAD DE MÉXICO,CUAJIMALPA DE MORELOS,20,299,5,324,1960
CIUDAD DE MÉXICO,CUAJIMALPA DE MORELOS,32,341,9,382,1960
CIUDAD DE MÉXICO,CUAJIMALPA DE MORELOS,29,349,4,382,1862
CIUDAD DE MÉXICO,CUAJIMALPA DE MORELOS,20,348,8,376,1862
CIUDAD DE MÉXICO,CUAJIMALPA DE MORELOS,15,251,6,272,1604
CIUDAD DE MÉXICO,CUAJIMALPA DE MORELOS,23,269,0,292,1604
CIUDAD DE MÉXICO,CUAJIMALPA DE MORELOS,25,253,4,282,1603
CIUDAD DE MÉXICO,CUAJIMALPA DE MORELOS,22,208,0,230,1414
CIUDAD DE MÉXICO,CUAJIMALPA DE MORELOS,18,218,3,239,1413
CIUDAD DE MÉXICO,CUAJIMALPA DE MORELOS,14,243,2,259,1691
CIUDAD DE MÉXICO,CUAJIMALPA DE MORELOS,19,279,3,301,1691
CIUDAD DE MÉXICO,CUAJIMALPA DE MORELOS,23,94,0,117,1570
CIUDAD DE MÉXICO,CUAJIMALPA DE MORELOS,20,105,1,126,1570
CIUDAD DE MÉXICO,CUAJIMALPA DE MORELOS,28,105,1,134,1570
CIUDAD DE MÉXICO,CUAJIMALPA DE MORELOS,21,302,6,329,1619
CIUDAD DE MÉXICO,CUAJIMALPA DE MORELOS,30,310,9,349,1618
CIUDAD DE MÉXICO,CUAJIMALPA DE MORELOS,27,383,6,416,1618
CIUDAD DE MÉXICO,CUAJIMALPA DE MORELOS,27,225,5,257,1426
CIUDAD DE MÉXICO,CUAJIMALPA DE MORELOS,30,247,5,282,1426
CIUDAD DE MÉXICO,CUAJIMALPA DE MORELOS,22,241,3,266,1426
CIUDAD DE MÉXICO,CUAJIMALPA DE MORELOS,26,130,5,161,1944
CIUDAD DE MÉXICO,CUAJIMALPA DE MORELOS,35,136,2,173,1944
CIUDAD DE MÉXICO,CUAJIMALPA DE MORELOS,24,196,4,224,1342
CIUDAD DE MÉXICO,CUAJIMALPA DE MORELOS,25,232,3,260,1342
CIUDAD DE MÉXICO,CUAJIMALPA DE MORELOS,20,209,5,234,1385
CIUDAD DE MÉXICO,CUAJIMALPA DE MORELOS,20,234,1,255,1385
CIUDAD DE MÉXICO,CUAJIMALPA DE MORELOS,26,186,2,214,1577
CIUDAD DE MÉXICO,CUAJIMALPA DE MORELOS,25,200,5,230,1577
CIUDAD DE MÉXICO,CUAJIMALPA DE MORELOS,31,174,6,211,1576
CIUDAD DE MÉXICO,CUAJIMALPA DE MORELOS,27,171,0,198,1708
CIUDAD DE MÉXICO,CUAJIMALPA DE MORELOS,28,185,1,214,1707
CIUDAD DE MÉXICO,CUAJIMALPA DE MORELOS,38,295,4,337,1555
CIUDAD DE MÉXICO,CUAJIMALPA DE MORELOS,30,255,3,288,1555
CIUDAD DE MÉXICO,CUAJIMALPA DE MORELOS,28,236,1,265,1588
CIUDAD DE MÉXICO,CUAJIMALPA DE MORELOS,22,204,6,232,1587
CIUDAD DE MÉXICO,CUAJIMALPA DE MORELOS,23,74,1,98,1413
CIUDAD DE MÉXICO,CUAJIMALPA DE MORELOS,16,85,0,101,1412
CIUDAD DE MÉXICO,CUAJIMALPA DE MORELOS,21,215,1,237,1345
CIUDAD DE MÉXICO,CUAJIMALPA DE MORELOS,24,188,2,214,1345
CIUDAD DE MÉXICO,CUAJIMALPA DE MORELOS,12,212,1,225,1345
CIUDAD DE MÉXICO,CUAJIMALPA DE MORELOS,36,219,4,259,1359
CIUDAD DE MÉXICO,CUAJIMALPA DE MORELOS,20,223,3,246,1358
CIUDAD DE MÉXICO,CUAJIMALPA DE MORELOS,26,309,2,337,1757
CIUDAD DE MÉXICO,CUAJIMALPA DE MORELOS,31,277,9,317,1756
CIUDAD DE MÉXICO,CUAJIMALPA DE MORELOS,23,250,5,278,1594
CIUDAD DE MÉXICO,CUAJIMALPA DE MORELOS,29,220,2,251,1594
CIUDAD DE MÉXICO,CUAJIMALPA DE MORELOS,26,178,0,204,1130
CIUDAD DE MÉXICO,CUAJIMALPA DE MORELOS,22,225,4,251,1130
CIUDAD DE MÉXICO,CUAJIMALPA DE MORELOS,16,165,3,184,1034
CIUDAD DE MÉXICO,CUAJIMALPA DE MORELOS,14,132,1,147,1033
CIUDAD DE MÉXICO,CUAJIMALPA DE MORELOS,18,204,2,224,1425
CIUDAD DE MÉXICO,CUAJIMALPA DE MORELOS,9,229,4,242,1424
CIUDAD DE MÉXICO,CUAJIMALPA DE MORELOS,20,204,0,224,1155
CIUDAD DE MÉXICO,CUAJIMALPA DE MORELOS,26,173,5,204,1154
CIUDAD DE MÉXICO,CUAJIMALPA DE MORELOS,12,152,1,165,1068
CIUDAD DE MÉXICO,CUAJIMALPA DE MORELOS,15,137,3,155,1068
CIUDAD DE MÉXICO,CUAJIMALPA DE MORELOS,31,327,4,362,1766
CIUDAD DE MÉXICO,CUAJIMALPA DE MORELOS,45,306,10,361,1766
CIUDAD DE MÉXICO,IZTAPALAPA,52,316,6,374,1923
CIUDAD DE MÉXICO,IZTAPALAPA,41,340,8,389,1922
CIUDAD DE MÉXICO,IZTAPALAPA,50,221,4,275,1942
CIUDAD DE MÉXICO,IZTAPALAPA,35,228,5,268,1941
CIUDAD DE MÉXICO,IZTAPALAPA,49,290,4,343,1782
CIUDAD DE MÉXICO,IZTAPALAPA,50,260,5,315,1782
CIUDAD DE MÉXICO,IZTAPALAPA,36,200,1,237,1828
CIUDAD DE MÉXICO,IZTAPALAPA,45,200,0,245,1827
CIUDAD DE MÉXICO,IZTAPALAPA,30,296,3,329,1848
CIUDAD DE MÉXICO,IZTAPALAPA,36,291,1,328,1847
CIUDAD DE MÉXICO,IZTAPALAPA,33,342,5,380,1788
CIUDAD DE MÉXICO,IZTAPALAPA,28,361,4,393,1788
CIUDAD DE MÉXICO,IZTAPALAPA,38,336,4,378,1787
CIUDAD DE MÉXICO,IZTAPALAPA,30,371,5,406,1946
CIUDAD DE MÉXICO,IZTAPALAPA,30,349,8,387,1946
CIUDAD DE MÉXICO,IZTAPALAPA,33,262,1,296,1490
CIUDAD DE MÉXICO,IZTAPALAPA,22,270,4,296,1489
CIUDAD DE MÉXICO,IZTAPALAPA,17,252,1,270,1489
CIUDAD DE MÉXICO,IZTAPALAPA,239,1698,63,2000,0
CIUDAD DE MÉXICO,IZTAPALAPA,36,289,3,328,1516
CIUDAD DE MÉXICO,IZTAPALAPA,43,327,2,372,1515
CIUDAD DE MÉXICO,IZTAPALAPA,32,280,4,316,1646
CIUDAD DE MÉXICO,IZTAPALAPA,31,300,8,339,1646
CIUDAD DE MÉXICO,IZTAPALAPA,28,284,2,314,1646
CIUDAD DE MÉXICO,IZTAPALAPA,39,172,2,213,1015
CIUDAD DE MÉXICO,IZTAPALAPA,33,193,2,228,1014
CIUDAD DE MÉXICO,IZTAPALAPA,46,323,5,374,1873
CIUDAD DE MÉXICO,IZTAPALAPA,34,311,12,357,1873
CIUDAD DE MÉXICO,IZTAPALAPA,30,291,10,331,1820
CIUDAD DE MÉXICO,IZTAPALAPA,25,280,5,310,1819
CIUDAD DE MÉXICO,IZTAPALAPA,20,267,0,287,1418
CIUDAD DE MÉXICO,IZTAPALAPA,24,255,4,283,1418
CIUDAD DE MÉXICO,IZTAPALAPA,23,322,7,352,1768
CIUDAD DE MÉXICO,IZTAPALAPA,28,272,3,303,1767
CIUDAD DE MÉXICO,IZTAPALAPA,23,208,3,234,1196
CIUDAD DE MÉXICO,IZTAPALAPA,20,237,3,260,1196
CIUDAD DE MÉXICO,IZTAPALAPA,37,266,2,305,1360
CIUDAD DE MÉXICO,IZTAPALAPA,41,261,3,305,1359
CIUDAD DE MÉXICO,IZTAPALAPA,38,392,8,438,1872
CIUDAD DE MÉXICO,IZTAPALAPA,38,376,11,425,1872
CIUDAD DE MÉXICO,IZTAPALAPA,33,269,2,304,1377
CIUDAD DE MÉXICO,IZTAPALAPA,26,284,2,312,1377
CIUDAD DE MÉXICO,IZTAPALAPA,24,271,2,297,1377
CIUDAD DE MÉXICO,IZTAPALAPA,44,260,10,314,1882
CIUDAD DE MÉXICO,IZTAPALAPA,33,285,6,324,1881
CIUDAD DE MÉXICO,IZTAPALAPA,34,308,4,346,1807
CIUDAD DE MÉXICO,IZTAPALAPA,32,286,8,326,1807
CIUDAD DE MÉXICO,IZTAPALAPA,18,205,7,230,1332
CIUDAD DE MÉXICO,IZTAPALAPA,27,208,3,238,1332
CIUDAD DE MÉXICO,IZTAPALAPA,42,176,2,220,1331
CIUDAD DE MÉXICO,IZTAPALAPA,20,303,4,327,1646
CIUDAD DE MÉXICO,IZTAPALAPA,42,253,8,303,1646
CIUDAD DE MÉXICO,IZTAPALAPA,29,247,4,280,1354
CIUDAD DE MÉXICO,IZTAPALAPA,28,274,3,305,1354
CIUDAD DE MÉXICO,IZTAPALAPA,37,265,9,311,1353
CIUDAD DE MÉXICO,IZTAPALAPA,29,185,0,214,1364
CIUDAD DE MÉXICO,IZTAPALAPA,39,202,3,244,1364
CIUDAD DE MÉXICO,IZTAPALAPA,34,208,4,246,1363
CIUDAD DE MÉXICO,IZTAPALAPA,40,342,3,385,1889
CIUDAD DE MÉXICO,IZTAPALAPA,48,351,2,401,1888
CIUDAD DE MÉXICO,IZTAPALAPA,35,339,6,380,1627
CIUDAD DE MÉXICO,IZTAPALAPA,30,362,7,399,1627
CIUDAD DE MÉXICO,IZTAPALAPA,30,244,0,274,1502
CIUDAD DE MÉXICO,IZTAPALAPA,32,282,7,321,1501
CIUDAD DE MÉXICO,IZTAPALAPA,43,334,7,384,1803
CIUDAD DE MÉXICO,IZTAPALAPA,59,325,7,391,1802
CIUDAD DE MÉXICO,IZTAPALAPA,39,230,1,270,1539
CIUDAD DE MÉXICO,IZTAPALAPA,41,269,5,315,1539
CIUDAD DE MÉXICO,IZTAPALAPA,33,290,8,331,1800
CIUDAD DE MÉXICO,IZTAPALAPA,22,339,2,363,1800
CIUDAD DE MÉXICO,IZTAPALAPA,16,226,3,245,1332
CIUDAD DE MÉXICO,IZTAPALAPA,22,274,3,299,1331
CIUDAD DE MÉXICO,IZTAPALAPA,45,366,6,417,1933
CIUDAD DE MÉXICO,IZTAPALAPA,43,371,6,420,1932
CIUDAD DE MÉXICO,IZTAPALAPA,31,375,3,409,1688
CIUDAD DE MÉXICO,IZTAPALAPA,28,425,3,456,1687
CIUDAD DE MÉXICO,IZTAPALAPA,25,298,3,326,1565
CIUDAD DE MÉXICO,IZTAPALAPA,31,345,12,388,1565
CIUDAD DE MÉXICO,IZTAPALAPA,25,314,2,341,1565
CIUDAD DE MÉXICO,IZTAPALAPA,34,405,1,440,1970
CIUDAD DE MÉXICO,IZTAPALAPA,31,371,8,410,1969
CIUDAD DE MÉXICO,IZTAPALAPA,48,435,11,494,1893
CIUDAD DE MÉXICO,IZTAPALAPA,45,458,14,517,1892
CIUDAD DE MÉXICO,IZTAPALAPA,50,353,7,410,1920
CIUDAD DE MÉXICO,IZTAPALAPA,38,348,8,394,1919
CIUDAD DE MÉXICO,IZTAPALAPA,34,308,2,344,1750
CIUDAD DE MÉXICO,IZTAPALAPA,40,314,7,361,1750
CIUDAD DE MÉXICO,IZTAPALAPA,26,256,4,286,1750
CIUDAD DE MÉXICO,IZTAPALAPA,30,228,7,265,1422
CIUDAD DE MÉXICO,IZTAPALAPA,24,235,3,262,1422
CIUDAD DE MÉXICO,IZTAPALAPA,30,223,5,258,1422
CIUDAD DE MÉXICO,IZTAPALAPA,37,276,3,316,1347
CIUDAD DE MÉXICO,IZTAPALAPA,37,267,4,308,1347
CIUDAD DE MÉXICO,IZTAPALAPA,19,250,3,272,1401
CIUDAD DE MÉXICO,IZTAPALAPA,25,267,4,296,1401
CIUDAD DE MÉXICO,IZTAPALAPA,26,278,3,307,1586
CIUDAD DE MÉXICO,IZTAPALAPA,28,260,3,291,1585
CIUDAD DE MÉXICO,IZTAPALAPA,24,299,5,328,1585
CIUDAD DE MÉXICO,IZTAPALAPA,31,297,9,337,1594
CIUDAD DE MÉXICO,IZTAPALAPA,36,310,4,350,1594
CIUDAD DE MÉXICO,IZTAPALAPA,33,295,5,333,1788
CIUDAD DE MÉXICO,IZTAPALAPA,36,318,5,359,1787
CIUDAD DE MÉXICO,IZTAPALAPA,34,287,5,326,1863
CIUDAD DE MÉXICO,IZTAPALAPA,52,325,2,379,1863
CIUDAD DE MÉXICO,IZTAPALAPA,39,319,0,358,1643
CIUDAD DE MÉXICO,IZTAPALAPA,33,315,6,354,1642
CIUDAD DE MÉXICO,IZTAPALAPA,40,315,5,360,1774
CIUDAD DE MÉXICO,IZTAPALAPA,36,348,5,389,1774
CIUDAD DE MÉXICO,IZTAPALAPA,32,236,2,270,1607
CIUDAD DE MÉXICO,IZTAPALAPA,15,273,8,296,1606
CIUDAD DE MÉXICO,IZTAPALAPA,40,296,5,341,1568
CIUDAD DE MÉXICO,IZTAPALAPA,44,230,3,277,1568
CIUDAD DE MÉXICO,IZTAPALAPA,51,378,6,435,1883
CIUDAD DE MÉXICO,IZTAPALAPA,59,382,5,446,1882
CIUDAD DE MÉXICO,IZTAPALAPA,35,330,5,370,1930
CIUDAD DE MÉXICO,IZTAPALAPA,39,336,6,381,1929
CIUDAD DE MÉXICO,IZTAPALAPA,34,374,5,413,1936
CIUDAD DE MÉXICO,IZTAPALAPA,53,376,4,433,1935
CIUDAD DE MÉXICO,IZTAPALAPA,46,283,13,342,1705
CIUDAD DE MÉXICO,IZTAPALAPA,47,284,8,339,1705
CIUDAD DE MÉXICO,IZTAPALAPA,37,271,5,313,1681
CIUDAD DE MÉXICO,IZTAPALAPA,34,274,3,311,1680
CIUDAD DE MÉXICO,IZTAPALAPA,31,289,3,323,1680
CIUDAD DE MÉXICO,IZTAPALAPA,34,292,5,331,1706
CIUDAD DE MÉXICO,IZTAPALAPA,41,232,4,277,1705
CIUDAD DE MÉXICO,IZTAPALAPA,37,228,7,272,1239
CIUDAD DE MÉXICO,IZTAPALAPA,22,229,3,254,1239
CIUDAD DE MÉXICO,IZTAPALAPA,34,174,4,212,1144
CIUDAD DE MÉXICO,IZTAPALAPA,35,180,2,217,1144
CIUDAD DE MÉXICO,IZTAPALAPA,34,225,1,260,1562
CIUDAD DE MÉXICO,IZTAPALAPA,34,222,3,259,1562
CIUDAD DE MÉXICO,IZTAPALAPA,20,132,1,153,1323
CIUDAD DE MÉXICO,IZTAPALAPA,34,124,4,162,1322
CIUDAD DE MÉXICO,IZTAPALAPA,24,137,1,162,1322
CIUDAD DE MÉXICO,IZTAPALAPA,31,243,3,277,1686
CIUDAD DE MÉXICO,IZTAPALAPA,46,270,0,316,1686
CIUDAD DE MÉXICO,IZTAPALAPA,50,318,6,374,1816
CIUDAD DE MÉXICO,IZTAPALAPA,35,337,7,379,1816
CIUDAD DE MÉXICO,IZTAPALAPA,39,321,1,361,1903
CIUDAD DE MÉXICO,IZTAPALAPA,45,341,9,395,1903
CIUDAD DE MÉXICO,IZTAPALAPA,29,197,1,227,1082
CIUDAD DE MÉXICO,IZTAPALAPA,33,177,3,213,1081
CIUDAD DE MÉXICO,IZTAPALAPA,44,285,2,331,1432
CIUDAD DE MÉXICO,IZTAPALAPA,37,285,5,327,1432
CIUDAD DE MÉXICO,IZTAPALAPA,33,269,5,307,1432
CIUDAD DE MÉXICO,IZTAPALAPA,36,267,7,310,1584
CIUDAD DE MÉXICO,IZTAPALAPA,37,311,3,351,1583
CIUDAD DE MÉXICO,IZTAPALAPA,40,172,1,213,1472
CIUDAD DE MÉXICO,IZTAPALAPA,41,148,0,189,1472
CIUDAD DE MÉXICO,IZTAPALAPA,32,181,6,219,1471
CIUDAD DE MÉXICO,IZTAPALAPA,57,260,0,317,1877
CIUDAD DE MÉXICO,IZTAPALAPA,47,232,4,283,1877
CIUDAD DE MÉXICO,IZTAPALAPA,39,326,2,367,1923
CIUDAD DE MÉXICO,IZTAPALAPA,48,305,7,360,1923
CIUDAD DE MÉXICO,IZTAPALAPA,42,231,2,275,1600
CIUDAD DE MÉXICO,IZTAPALAPA,53,268,4,325,1599
CIUDAD DE MÉXICO,IZTAPALAPA,26,215,3,244,1495
CIUDAD DE MÉXICO,IZTAPALAPA,33,253,2,288,1495
CIUDAD DE MÉXICO,IZTAPALAPA,37,249,3,289,1529
CIUDAD DE MÉXICO,IZTAPALAPA,36,248,5,289,1528
CIUDAD DE MÉXICO,IZTAPALAPA,43,222,5,270,1528
CIUDAD DE MÉXICO,IZTAPALAPA,27,283,4,314,1490
CIUDAD DE MÉXICO,IZTAPALAPA,37,301,0,338,1490
CIUDAD DE MÉXICO,IZTAPALAPA,27,245,2,274,1430
CIUDAD DE MÉXICO,IZTAPALAPA,24,238,3,265,1430
CIUDAD DE MÉXICO,IZTAPALAPA,18,222,2,242,1429
CIUDAD DE MÉXICO,IZTAPALAPA,26,240,8,274,1440
CIUDAD DE MÉXICO,IZTAPALAPA,24,278,7,309,1440
CIUDAD DE MÉXICO,IZTAPALAPA,56,305,3,364,1950
CIUDAD DE MÉXICO,IZTAPALAPA,29,334,1,364,1950
CIUDAD DE MÉXICO,IZTAPALAPA,30,325,4,359,1608
CIUDAD DE MÉXICO,IZTAPALAPA,34,315,5,354,1607
CIUDAD DE MÉXICO,IZTAPALAPA,14,275,5,294,1496
CIUDAD DE MÉXICO,IZTAPALAPA,19,256,6,281,1496
CIUDAD DE MÉXICO,IZTAPALAPA,24,258,9,291,1495
CIUDAD DE MÉXICO,IZTAPALAPA,28,352,0,380,1655
CIUDAD DE MÉXICO,IZTAPALAPA,37,344,3,384,1654
CIUDAD DE MÉXICO,IZTAPALAPA,20,255,6,281,1417
CIUDAD DE MÉXICO,IZTAPALAPA,24,240,5,269,1416
CIUDAD DE MÉXICO,IZTAPALAPA,41,310,2,353,1853
CIUDAD DE MÉXICO,IZTAPALAPA,29,350,4,383,1853
CIUDAD DE MÉXICO,IZTAPALAPA,23,290,0,313,1383
CIUDAD DE MÉXICO,IZTAPALAPA,29,303,1,333,1382
CIUDAD DE MÉXICO,IZTAPALAPA,38,400,15,453,1854
CIUDAD DE MÉXICO,IZTAPALAPA,43,363,5,411,1853
CIUDAD DE MÉXICO,IZTAPALAPA,15,281,3,299,1544
CIUDAD DE MÉXICO,IZTAPALAPA,25,276,2,303,1544
CIUDAD DE MÉXICO,IZTAPALAPA,21,315,6,342,1544
CIUDAD DE MÉXICO,IZTAPALAPA,34,376,6,416,1785
CIUDAD DE MÉXICO,IZTAPALAPA,25,374,9,408,1784
CIUDAD DE MÉXICO,IZTAPALAPA,18,399,5,422,1787
CIUDAD DE MÉXICO,IZTAPALAPA,26,409,14,449,1787
CIUDAD DE MÉXICO,IZTAPALAPA,23,334,4,361,1631
CIUDAD DE MÉXICO,IZTAPALAPA,32,385,3,420,1631
CIUDAD DE MÉXICO,IZTAPALAPA,28,322,6,356,1636
CIUDAD DE MÉXICO,IZTAPALAPA,26,335,8,369,1635
CIUDAD DE MÉXICO,IZTAPALAPA,39,303,2,344,1636
CIUDAD DE MÉXICO,IZTAPALAPA,34,300,1,335,1635
CIUDAD DE MÉXICO,IZTAPALAPA,29,294,4,327,1635
CIUDAD DE MÉXICO,IZTAPALAPA,46,364,3,413,1638
CIUDAD DE MÉXICO,IZTAPALAPA,28,321,3,352,1637
CIUDAD DE MÉXICO,IZTAPALAPA,35,362,7,404,1637
CIUDAD DE MÉXICO,IZTAPALAPA,34,263,7,304,1528
CIUDAD DE MÉXICO,IZTAPALAPA,18,270,5,293,1527
CIUDAD DE MÉXICO,IZTAPALAPA,25,258,5,288,1527
CIUDAD DE MÉXICO,IZTAPALAPA,44,386,3,433,1927
CIUDAD DE MÉXICO,IZTAPALAPA,44,392,9,445,1926
CIUDAD DE MÉXICO,IZTAPALAPA,30,352,5,387,1787
CIUDAD DE MÉXICO,IZTAPALAPA,28,383,5,416,1786
CIUDAD DE MÉXICO,IZTAPALAPA,30,265,3,298,1551
CIUDAD DE MÉXICO,IZTAPALAPA,24,289,2,315,1550
CIUDAD DE MÉXICO,IZTAPALAPA,30,292,3,325,1550
CIUDAD DE MÉXICO,IZTAPALAPA,58,283,2,343,1787
CIUDAD DE MÉXICO,IZTAPALAPA,9,305,6,320,1787
CIUDAD DE MÉXICO,IZTAPALAPA,39,275,4,318,1787
CIUDAD DE MÉXICO,IZTAPALAPA,32,323,4,359,1575
CIUDAD DE MÉXICO,IZTAPALAPA,44,329,4,377,1575
CIUDAD DE MÉXICO,IZTAPALAPA,24,305,5,334,1725
CIUDAD DE MÉXICO,IZTAPALAPA,28,303,3,334,1725
CIUDAD DE MÉXICO,IZTAPALAPA,37,335,6,378,1803
CIUDAD DE MÉXICO,IZTAPALAPA,41,387,1,429,1802
CIUDAD DE MÉXICO,IZTAPALAPA,25,362,3,390,1819
CIUDAD DE MÉXICO,IZTAPALAPA,32,354,7,393,1819
CIUDAD DE MÉXICO,IZTAPALAPA,44,369,4,417,1930
CIUDAD DE MÉXICO,IZTAPALAPA,31,375,5,411,1929
CIUDAD DE MÉXICO,IZTAPALAPA,24,323,1,348,1683
CIUDAD DE MÉXICO,IZTAPALAPA,30,288,2,320,1683
CIUDAD DE MÉXICO,IZTAPALAPA,29,288,3,320,1323
CIUDAD DE MÉXICO,IZTAPALAPA,26,267,3,296,1323
CIUDAD DE MÉXICO,IZTAPALAPA,21,237,3,261,1322
CIUDAD DE MÉXICO,IZTAPALAPA,39,321,3,363,1758
CIUDAD DE MÉXICO,IZTAPALAPA,31,340,7,378,1757
CIUDAD DE MÉXICO,IZTAPALAPA,27,233,2,262,1143
CIUDAD DE MÉXICO,IZTAPALAPA,26,239,4,269,1143
CIUDAD DE MÉXICO,IZTAPALAPA,27,323,9,359,1739
CIUDAD DE MÉXICO,IZTAPALAPA,40,377,7,424,1738
CIUDAD DE MÉXICO,IZTAPALAPA,22,274,6,302,1466
CIUDAD DE MÉXICO,IZTAPALAPA,32,266,10,308,1465
CIUDAD DE MÉXICO,IZTAPALAPA,37,308,0,345,1501
CIUDAD DE MÉXICO,IZTAPALAPA,35,251,2,288,1500
CIUDAD DE MÉXICO,IZTAPALAPA,20,291,5,316,1602
CIUDAD DE MÉXICO,IZTAPALAPA,18,294,9,321,1602
CIUDAD DE MÉXICO,IZTAPALAPA,33,262,3,298,1602
CIUDAD DE MÉXICO,IZTAPALAPA,34,303,7,344,1589
CIUDAD DE MÉXICO,IZTAPALAPA,25,319,3,347,1589
CIUDAD DE MÉXICO,IZTAPALAPA,22,267,9,298,1364
CIUDAD DE MÉXICO,IZTAPALAPA,29,303,5,337,1363
CIUDAD DE MÉXICO,IZTAPALAPA,35,327,6,368,1542
CIUDAD DE MÉXICO,IZTAPALAPA,34,280,10,324,1542
CIUDAD DE MÉXICO,IZTAPALAPA,19,364,8,391,1727
CIUDAD DE MÉXICO,IZTAPALAPA,29,355,6,390,1726
CIUDAD DE MÉXICO,IZTAPALAPA,29,287,8,324,1624
CIUDAD DE MÉXICO,IZTAPALAPA,40,317,4,361,1623
CIUDAD DE MÉXICO,IZTAPALAPA,15,239,6,260,1318
CIUDAD DE MÉXICO,IZTAPALAPA,15,241,4,260,1318
CIUDAD DE MÉXICO,IZTAPALAPA,22,245,2,269,1167
CIUDAD DE MÉXICO,IZTAPALAPA,29,231,4,264,1167
CIUDAD DE MÉXICO,IZTAPALAPA,24,243,4,271,1364
CIUDAD DE MÉXICO,IZTAPALAPA,38,225,1,264,1363
CIUDAD DE MÉXICO,IZTAPALAPA,36,227,3,266,1363
CIUDAD DE MÉXICO,IZTAPALAPA,52,299,3,354,1698
CIUDAD DE MÉXICO,IZTAPALAPA,49,306,6,361,1697
CIUDAD DE MÉXICO,IZTAPALAPA,41,210,3,254,1446
CIUDAD DE MÉXICO,IZTAPALAPA,31,223,3,257,1445
CIUDAD DE MÉXICO,IZTAPALAPA,20,262,2,284,1168
CIUDAD DE MÉXICO,IZTAPALAPA,23,216,1,240,1168
CIUDAD DE MÉXICO,IZTAPALAPA,30,336,5,371,1575
CIUDAD DE MÉXICO,IZTAPALAPA,31,302,5,338,1575
CIUDAD DE MÉXICO,IZTAPALAPA,99,1211,16,1326,0
CIUDAD DE MÉXICO,IZTAPALAPA,30,333,4,367,1586
CIUDAD DE MÉXICO,IZTAPALAPA,35,356,2,393,1585
CIUDAD DE MÉXICO,IZTAPALAPA,28,179,3,210,1245
CIUDAD DE MÉXICO,IZTAPALAPA,15,212,2,229,1244
CIUDAD DE MÉXICO,IZTAPALAPA,28,348,4,380,1556
CIUDAD DE MÉXICO,IZTAPALAPA,25,283,4,312,1556
CIUDAD DE MÉXICO,IZTAPALAPA,33,327,2,362,1741
CIUDAD DE MÉXICO,IZTAPALAPA,27,376,3,406,1741
CIUDAD DE MÉXICO,IZTAPALAPA,37,352,4,393,1740
CIUDAD DE MÉXICO,IZTAPALAPA,31,241,4,276,1336
CIUDAD DE MÉXICO,IZTAPALAPA,25,245,4,274,1335
CIUDAD DE MÉXICO,IZTAPALAPA,24,256,4,284,1335
CIUDAD DE MÉXICO,IZTAPALAPA,26,206,6,238,1328
CIUDAD DE MÉXICO,IZTAPALAPA,26,204,1,231,1327
CIUDAD DE MÉXICO,IZTAPALAPA,42,347,8,397,1971
CIUDAD DE MÉXICO,IZTAPALAPA,65,349,11,425,1971
CIUDAD DE MÉXICO,IZTAPALAPA,48,379,6,433,1902
CIUDAD DE MÉXICO,IZTAPALAPA,38,336,6,380,1902
CIUDAD DE MÉXICO,IZTAPALAPA,38,301,1,340,1644
CIUDAD DE MÉXICO,IZTAPALAPA,40,322,4,366,1643
CIUDAD DE MÉXICO,IZTAPALAPA,40,281,5,326,1742
CIUDAD DE MÉXICO,IZTAPALAPA,27,303,3,333,1742
CIUDAD DE MÉXICO,IZTAPALAPA,63,384,10,457,1764
CIUDAD DE MÉXICO,IZTAPALAPA,37,441,6,484,1764
CIUDAD DE MÉXICO,IZTAPALAPA,29,225,3,257,1344
CIUDAD DE MÉXICO,IZTAPALAPA,39,271,3,313,1344
CIUDAD DE MÉXICO,IZTAPALAPA,35,237,7,279,1343
CIUDAD DE MÉXICO,IZTAPALAPA,47,311,0,358,1830
CIUDAD DE MÉXICO,IZTAPALAPA,50,331,8,389,1830
CIUDAD DE MÉXICO,IZTAPALAPA,33,316,15,364,1670
CIUDAD DE MÉXICO,IZTAPALAPA,33,357,8,398,1670
CIUDAD DE MÉXICO,IZTAPALAPA,32,349,4,385,1670
CIUDAD DE MÉXICO,IZTAPALAPA,33,392,1,426,1790
CIUDAD DE MÉXICO,IZTAPALAPA,40,394,7,441,1790
CIUDAD DE MÉXICO,IZTAPALAPA,39,256,3,298,1325
CIUDAD DE MÉXICO,IZTAPALAPA,26,271,6,303,1324
CIUDAD DE MÉXICO,IZTAPALAPA,29,353,5,387,1809
CIUDAD DE MÉXICO,IZTAPALAPA,35,382,10,427,1808
CIUDAD DE MÉXICO,IZTAPALAPA,35,330,5,370,1747
CIUDAD DE MÉXICO,IZTAPALAPA,37,331,6,374,1747
CIUDAD DE MÉXICO,IZTAPALAPA,40,264,9,313,1556
CIUDAD DE MÉXICO,IZTAPALAPA,33,288,4,325,1556
CIUDAD DE MÉXICO,IZTAPALAPA,23,240,5,268,1291
CIUDAD DE MÉXICO,IZTAPALAPA,23,259,2,284,1291
CIUDAD DE MÉXICO,IZTAPALAPA,28,436,5,469,1954
CIUDAD DE MÉXICO,IZTAPALAPA,37,384,2,423,1954
CIUDAD DE MÉXICO,IZTAPALAPA,29,288,4,321,1241
CIUDAD DE MÉXICO,IZTAPALAPA,27,228,2,257,1240
CIUDAD DE MÉXICO,IZTAPALAPA,26,282,6,314,1666
CIUDAD DE MÉXICO,IZTAPALAPA,18,325,7,350,1666
CIUDAD DE MÉXICO,IZTAPALAPA,28,289,2,319,1582
CIUDAD DE MÉXICO,IZTAPALAPA,30,307,3,340,1582
CIUDAD DE MÉXICO,IZTAPALAPA,23,386,4,413,1706
CIUDAD DE MÉXICO,IZTAPALAPA,21,383,5,409,1705
CIUDAD DE MÉXICO,IZTAPALAPA,26,388,7,421,1843
CIUDAD DE MÉXICO,IZTAPALAPA,30,371,4,405,1843
CIUDAD DE MÉXICO,IZTAPALAPA,18,250,6,274,1370
CIUDAD DE MÉXICO,IZTAPALAPA,19,260,3,282,1369
CIUDAD DE MÉXICO,IZTAPALAPA,24,269,4,297,1463
CIUDAD DE MÉXICO,IZTAPALAPA,27,280,5,312,1463
CIUDAD DE MÉXICO,IZTAPALAPA,34,363,6,403,1593
CIUDAD DE MÉXICO,IZTAPALAPA,28,339,5,372,1592
CIUDAD DE MÉXICO,IZTAPALAPA,24,258,4,286,1416
CIUDAD DE MÉXICO,IZTAPALAPA,23,303,3,329,1416
CIUDAD DE MÉXICO,IZTAPALAPA,27,276,5,308,1414
CIUDAD DE MÉXICO,IZTAPALAPA,26,258,5,289,1414
CIUDAD DE MÉXICO,IZTAPALAPA,35,388,5,428,1833
CIUDAD DE MÉXICO,IZTAPALAPA,29,376,5,410,1832
CIUDAD DE MÉXICO,IZTAPALAPA,21,236,5,262,1093
CIUDAD DE MÉXICO,IZTAPALAPA,28,229,1,258,1093
CIUDAD DE MÉXICO,IZTAPALAPA,37,349,4,390,1883
CIUDAD DE MÉXICO,IZTAPALAPA,25,358,4,387,1882
CIUDAD DE MÉXICO,IZTAPALAPA,23,291,5,319,1463
CIUDAD DE MÉXICO,IZTAPALAPA,24,296,3,323,1462
CIUDAD DE MÉXICO,IZTAPALAPA,37,352,4,393,1581
CIUDAD DE MÉXICO,IZTAPALAPA,30,336,2,368,1580
CIUDAD DE MÉXICO,IZTAPALAPA,21,431,2,454,1951
CIUDAD DE MÉXICO,IZTAPALAPA,21,419,5,445,1951
CIUDAD DE MÉXICO,IZTAPALAPA,38,397,3,438,1869
CIUDAD DE MÉXICO,IZTAPALAPA,38,424,5,467,1868
CIUDAD DE MÉXICO,IZTAPALAPA,22,346,5,373,1619
CIUDAD DE MÉXICO,IZTAPALAPA,23,331,6,360,1619
CIUDAD DE MÉXICO,IZTAPALAPA,30,380,3,413,1864
CIUDAD DE MÉXICO,IZTAPALAPA,29,381,3,413,1864
CIUDAD DE MÉXICO,IZTAPALAPA,11,330,5,346,1516
CIUDAD DE MÉXICO,IZTAPALAPA,23,302,7,332,1515
CIUDAD DE MÉXICO,IZTAPALAPA,21,310,3,334,1504
CIUDAD DE MÉXICO,IZTAPALAPA,18,295,4,317,1504
CIUDAD DE MÉXICO,IZTAPALAPA,20,300,4,324,1504
CIUDAD DE MÉXICO,IZTAPALAPA,24,351,1,376,1474
CIUDAD DE MÉXICO,IZTAPALAPA,17,333,3,353,1474
CIUDAD DE MÉXICO,IZTAPALAPA,34,317,0,351,1573
CIUDAD DE MÉXICO,IZTAPALAPA,44,332,2,378,1572
CIUDAD DE MÉXICO,IZTAPALAPA,30,291,4,325,1303
CIUDAD DE MÉXICO,IZTAPALAPA,20,240,2,262,1302
CIUDAD DE MÉXICO,IZTAPALAPA,27,429,9,465,1846
CIUDAD DE MÉXICO,IZTAPALAPA,28,399,6,433,1845
CIUDAD DE MÉXICO,IZTAPALAPA,28,333,3,364,1580
CIUDAD DE MÉXICO,IZTAPALAPA,35,347,3,385,1580
CIUDAD DE MÉXICO,IZTAPALAPA,23,334,5,362,1383
CIUDAD DE MÉXICO,IZTAPALAPA,17,314,4,335,1383
CIUDAD DE MÉXICO,IZTAPALAPA,25,297,4,326,1382
CIUDAD DE MÉXICO,IZTAPALAPA,21,329,4,354,1654
CIUDAD DE MÉXICO,IZTAPALAPA,18,347,1,366,1654
CIUDAD DE MÉXICO,IZTAPALAPA,23,264,2,289,1310
CIUDAD DE MÉXICO,IZTAPALAPA,25,292,3,320,1310
CIUDAD DE MÉXICO,IZTAPALAPA,14,327,4,345,1825
CIUDAD DE MÉXICO,IZTAPALAPA,25,384,2,411,1824
CIUDAD DE MÉXICO,IZTAPALAPA,15,326,5,346,1461
CIUDAD DE MÉXICO,IZTAPALAPA,23,325,4,352,1460
CIUDAD DE MÉXICO,IZTAPALAPA,19,288,3,310,1618
CIUDAD DE MÉXICO,IZTAPALAPA,24,309,3,336,1618
CIUDAD DE MÉXICO,IZTAPALAPA,16,292,9,317,1374
CIUDAD DE MÉXICO,IZTAPALAPA,24,293,6,323,1374
CIUDAD DE MÉXICO,IZTAPALAPA,23,233,3,259,1322
CIUDAD DE MÉXICO,IZTAPALAPA,29,252,3,284,1321
CIUDAD DE MÉXICO,IZTAPALAPA,23,238,2,263,1321
CIUDAD DE MÉXICO,IZTAPALAPA,32,332,3,367,1903
CIUDAD DE MÉXICO,IZTAPALAPA,29,347,7,383,1902
CIUDAD DE MÉXICO,IZTAPALAPA,49,371,3,423,1899
CIUDAD DE MÉXICO,IZTAPALAPA,38,395,2,435,1898
CIUDAD DE MÉXICO,IZTAPALAPA,40,317,3,360,1568
CIUDAD DE MÉXICO,IZTAPALAPA,32,305,3,340,1568
CIUDAD DE MÉXICO,IZTAPALAPA,25,305,1,331,1631
CIUDAD DE MÉXICO,IZTAPALAPA,25,273,8,306,1631
CIUDAD DE MÉXICO,IZTAPALAPA,29,240,5,274,1197
CIUDAD DE MÉXICO,IZTAPALAPA,23,216,1,240,1197
CIUDAD DE MÉXICO,IZTAPALAPA,32,342,8,382,1482
CIUDAD DE MÉXICO,IZTAPALAPA,20,277,7,304,1482
CIUDAD DE MÉXICO,IZTAPALAPA,23,248,1,272,1409
CIUDAD DE MÉXICO,IZTAPALAPA,19,221,2,242,1409
CIUDAD DE MÉXICO,IZTAPALAPA,19,262,0,281,1408
CIUDAD DE MÉXICO,IZTAPALAPA,31,349,3,383,1670
CIUDAD DE MÉXICO,IZTAPALAPA,21,337,3,361,1670
CIUDAD DE MÉXICO,IZTAPALAPA,37,285,5,327,1506
CIUDAD DE MÉXICO,IZTAPALAPA,24,280,4,308,1505
CIUDAD DE MÉXICO,IZTAPALAPA,37,363,3,403,1700
CIUDAD DE MÉXICO,IZTAPALAPA,41,318,5,364,1700
CIUDAD DE MÉXICO,IZTAPALAPA,43,343,14,400,1626
CIUDAD DE MÉXICO,IZTAPALAPA,33,348,8,389,1626
CIUDAD DE MÉXICO,IZTAPALAPA,40,368,7,415,1928
CIUDAD DE MÉXICO,IZTAPALAPA,47,348,11,406,1928
CIUDAD DE MÉXICO,IZTAPALAPA,77,901,18,996,0
CIUDAD DE MÉXICO,IZTAPALAPA,46,340,4,390,1731
CIUDAD DE MÉXICO,IZTAPALAPA,44,336,1,381,1731
CIUDAD DE MÉXICO,IZTAPALAPA,40,377,1,418,1808
CIUDAD DE MÉXICO,IZTAPALAPA,42,393,10,445,1808
CIUDAD DE MÉXICO,IZTAPALAPA,39,401,8,448,1807
CIUDAD DE MÉXICO,IZTAPALAPA,28,344,4,376,1772
CIUDAD DE MÉXICO,IZTAPALAPA,31,356,6,393,1771
CIUDAD DE MÉXICO,IZTAPALAPA,18,302,7,327,1511
CIUDAD DE MÉXICO,IZTAPALAPA,35,288,4,327,1511
CIUDAD DE MÉXICO,IZTAPALAPA,35,278,2,315,1170
CIUDAD DE MÉXICO,IZTAPALAPA,41,253,7,301,1170
CIUDAD DE MÉXICO,IZTAPALAPA,16,312,0,328,1753
CIUDAD DE MÉXICO,IZTAPALAPA,32,258,3,293,1753
CIUDAD DE MÉXICO,IZTAPALAPA,24,343,13,380,1375
CIUDAD DE MÉXICO,IZTAPALAPA,35,336,3,374,1375
CIUDAD DE MÉXICO,IZTAPALAPA,34,336,2,372,1375
CIUDAD DE MÉXICO,IZTAPALAPA,43,367,5,415,1809
CIUDAD DE MÉXICO,IZTAPALAPA,36,382,6,424,1808
CIUDAD DE MÉXICO,IZTAPALAPA,37,282,6,325,1556
CIUDAD DE MÉXICO,IZTAPALAPA,31,315,4,350,1556
CIUDAD DE MÉXICO,IZTAPALAPA,39,282,3,324,1556
CIUDAD DE MÉXICO,IZTAPALAPA,32,437,6,475,1930
CIUDAD DE MÉXICO,IZTAPALAPA,32,407,5,444,1930
CIUDAD DE MÉXICO,IZTAPALAPA,24,315,5,344,1516
CIUDAD DE MÉXICO,IZTAPALAPA,23,317,4,344,1516
CIUDAD DE MÉXICO,IZTAPALAPA,23,301,4,328,1515
CIUDAD DE MÉXICO,IZTAPALAPA,30,285,1,316,1407
CIUDAD DE MÉXICO,IZTAPALAPA,25,255,1,281,1406
CIUDAD DE MÉXICO,IZTAPALAPA,20,230,0,250,1082
CIUDAD DE MÉXICO,IZTAPALAPA,20,216,6,242,1081
CIUDAD DE MÉXICO,IZTAPALAPA,27,330,2,359,1463
CIUDAD DE MÉXICO,IZTAPALAPA,22,332,3,357,1463
CIUDAD DE MÉXICO,IZTAPALAPA,27,280,3,310,1462
CIUDAD DE MÉXICO,IZTAPALAPA,33,322,7,362,1560
CIUDAD DE MÉXICO,IZTAPALAPA,25,328,5,358,1559
CIUDAD DE MÉXICO,IZTAPALAPA,23,355,6,384,1559
CIUDAD DE MÉXICO,IZTAPALAPA,32,300,3,335,1614
CIUDAD DE MÉXICO,IZTAPALAPA,37,293,6,336,1614
CIUDAD DE MÉXICO,IZTAPALAPA,21,285,12,318,1613
CIUDAD DE MÉXICO,IZTAPALAPA,20,334,0,354,1398
CIUDAD DE MÉXICO,IZTAPALAPA,26,312,5,343,1397
CIUDAD DE MÉXICO,IZTAPALAPA,16,302,13,331,1397
CIUDAD DE MÉXICO,IZTAPALAPA,36,339,7,382,1701
CIUDAD DE MÉXICO,IZTAPALAPA,37,309,6,352,1701
CIUDAD DE MÉXICO,IZTAPALAPA,26,412,5,443,1975
CIUDAD DE MÉXICO,IZTAPALAPA,21,452,3,476,1975
CIUDAD DE MÉXICO,IZTAPALAPA,31,371,6,408,1619
CIUDAD DE MÉXICO,IZTAPALAPA,32,312,1,345,1619
CIUDAD DE MÉXICO,IZTAPALAPA,21,372,4,397,1619
CIUDAD DE MÉXICO,IZTAPALAPA,26,297,3,326,1582
CIUDAD DE MÉXICO,IZTAPALAPA,28,340,7,375,1581
CIUDAD DE MÉXICO,IZTAPALAPA,27,292,2,321,1581
CIUDAD DE MÉXICO,IZTAPALAPA,30,250,1,281,1303
CIUDAD DE MÉXICO,IZTAPALAPA,22,233,1,256,1303
CIUDAD DE MÉXICO,IZTAPALAPA,18,284,1,303,1286
CIUDAD DE MÉXICO,IZTAPALAPA,31,327,4,362,1285
CIUDAD DE MÉXICO,IZTAPALAPA,31,460,11,502,1946
CIUDAD DE MÉXICO,IZTAPALAPA,32,449,1,482,1946
CIUDAD DE MÉXICO,IZTAPALAPA,30,278,5,313,1652
CIUDAD DE MÉXICO,IZTAPALAPA,29,275,3,307,1652
CIUDAD DE MÉXICO,IZTAPALAPA,25,259,1,285,1651
CIUDAD DE MÉXICO,IZTAPALAPA,20,301,7,328,1778
CIUDAD DE MÉXICO,IZTAPALAPA,18,322,6,346,1777
CIUDAD DE MÉXICO,IZTAPALAPA,41,369,4,414,1759
CIUDAD DE MÉXICO,IZTAPALAPA,45,383,4,432,1758
CIUDAD DE MÉXICO,IZTAPALAPA,42,356,6,404,1655
CIUDAD DE MÉXICO,IZTAPALAPA,46,334,12,392,1655
CIUDAD DE MÉXICO,IZTAPALAPA,23,257,5,285,1426
CIUDAD DE MÉXICO,IZTAPALAPA,25,282,4,311,1425
CIUDAD DE MÉXICO,IZTAPALAPA,24,269,2,295,1425
CIUDAD DE MÉXICO,IZTAPALAPA,21,425,7,453,1917
CIUDAD DE MÉXICO,IZTAPALAPA,51,427,3,481,1917
CIUDAD DE MÉXICO,IZTAPALAPA,23,288,9,320,1653
CIUDAD DE MÉXICO,IZTAPALAPA,28,340,14,382,1652
CIUDAD DE MÉXICO,IZTAPALAPA,21,264,2,287,1309
CIUDAD DE MÉXICO,IZTAPALAPA,25,253,7,285,1309
CIUDAD DE MÉXICO,IZTAPALAPA,24,372,8,404,1829
CIUDAD DE MÉXICO,IZTAPALAPA,30,389,10,429,1829
CIUDAD DE MÉXICO,IZTAPALAPA,29,381,5,415,1731
CIUDAD DE MÉXICO,IZTAPALAPA,41,341,11,393,1730
CIUDAD DE MÉXICO,IZTAPALAPA,33,251,7,291,1240
CIUDAD DE MÉXICO,IZTAPALAPA,19,258,6,283,1240
CIUDAD DE MÉXICO,IZTAPALAPA,32,361,5,398,1806
CIUDAD DE MÉXICO,IZTAPALAPA,37,297,13,347,1806
CIUDAD DE MÉXICO,IZTAPALAPA,21,354,5,380,1595
CIUDAD DE MÉXICO,IZTAPALAPA,18,361,2,381,1594
CIUDAD DE MÉXICO,IZTAPALAPA,22,306,3,331,1618
CIUDAD DE MÉXICO,IZTAPALAPA,29,320,5,354,1617
CIUDAD DE MÉXICO,IZTAPALAPA,17,429,3,449,1948
CIUDAD DE MÉXICO,IZTAPALAPA,24,420,4,448,1947
CIUDAD DE MÉXICO,IZTAPALAPA,35,372,8,415,1768
CIUDAD DE MÉXICO,IZTAPALAPA,42,396,7,445,1767
CIUDAD DE MÉXICO,IZTAPALAPA,15,402,5,422,1767
CIUDAD DE MÉXICO,IZTAPALAPA,33,347,3,383,1494
CIUDAD DE MÉXICO,IZTAPALAPA,30,343,5,378,1493
CIUDAD DE MÉXICO,IZTAPALAPA,27,336,4,367,1493
CIUDAD DE MÉXICO,IZTAPALAPA,22,305,10,337,1581
CIUDAD DE MÉXICO,IZTAPALAPA,26,366,6,398,1581
CIUDAD DE MÉXICO,IZTAPALAPA,21,221,4,246,1338
CIUDAD DE MÉXICO,IZTAPALAPA,16,221,1,238,1337
CIUDAD DE MÉXICO,IZTAPALAPA,27,390,13,430,1767
CIUDAD DE MÉXICO,IZTAPALAPA,41,401,6,448,1766
CIUDAD DE MÉXICO,IZTAPALAPA,20,414,15,449,1766
CIUDAD DE MÉXICO,IZTAPALAPA,45,378,9,432,1942
CIUDAD DE MÉXICO,IZTAPALAPA,27,383,15,425,1795
CIUDAD DE MÉXICO,IZTAPALAPA,33,409,3,445,1795
CIUDAD DE MÉXICO,IZTAPALAPA,19,266,3,288,1367
CIUDAD DE MÉXICO,IZTAPALAPA,10,294,0,304,1366
CIUDAD DE MÉXICO,IZTAPALAPA,20,299,9,328,1366
CIUDAD DE MÉXICO,IZTAPALAPA,29,375,3,407,1664
CIUDAD DE MÉXICO,IZTAPALAPA,28,262,5,295,1664
CIUDAD DE MÉXICO,IZTAPALAPA,26,255,7,288,1664
CIUDAD DE MÉXICO,IZTAPALAPA,38,276,10,324,1383
CIUDAD DE MÉXICO,IZTAPALAPA,42,297,7,346,1383
CIUDAD DE MÉXICO,IZTAPALAPA,36,263,11,310,1383
CIUDAD DE MÉXICO,IZTAPALAPA,30,384,8,422,1955
CIUDAD DE MÉXICO,IZTAPALAPA,31,362,6,399,1955
CIUDAD DE MÉXICO,IZTAPALAPA,17,274,3,294,1754
CIUDAD DE MÉXICO,IZTAPALAPA,12,266,4,282,1754
CIUDAD DE MÉXICO,IZTAPALAPA,18,250,3,271,1753
CIUDAD DE MÉXICO,IZTAPALAPA,23,335,2,360,1858
CIUDAD DE MÉXICO,IZTAPALAPA,23,344,8,375,1858
CIUDAD DE MÉXICO,IZTAPALAPA,24,356,8,388,1858
CIUDAD DE MÉXICO,IZTAPALAPA,41,338,8,387,1820
CIUDAD DE MÉXICO,IZTAPALAPA,14,371,14,399,1819
CIUDAD DE MÉXICO,IZTAPALAPA,20,269,1,290,1632
CIUDAD DE MÉXICO,IZTAPALAPA,28,284,5,317,1631
CIUDAD DE MÉXICO,IZTAPALAPA,22,292,8,322,1631
CIUDAD DE MÉXICO,IZTAPALAPA,23,272,6,301,1362
CIUDAD DE MÉXICO,IZTAPALAPA,16,230,2,248,1361
CIUDAD DE MÉXICO,IZTAPALAPA,23,283,3,309,1361
CIUDAD DE MÉXICO,IZTAPALAPA,21,363,11,395,1749
CIUDAD DE MÉXICO,IZTAPALAPA,30,340,6,376,1748
CIUDAD DE MÉXICO,IZTAPALAPA,23,306,3,332,1378
CIUDAD DE MÉXICO,IZTAPALAPA,22,319,2,343,1377
CIUDAD DE MÉXICO,IZTAPALAPA,26,382,4,412,1675
CIUDAD DE MÉXICO,IZTAPALAPA,26,362,4,392,1675
CIUDAD DE MÉXICO,IZTAPALAPA,27,260,5,292,1211
CIUDAD DE MÉXICO,IZTAPALAPA,17,237,7,261,1211
CIUDAD DE MÉXICO,IZTAPALAPA,26,343,4,373,1480
CIUDAD DE MÉXICO,IZTAPALAPA,17,289,2,308,1480
CIUDAD DE MÉXICO,IZTAPALAPA,29,346,2,377,1545
CIUDAD DE MÉXICO,IZTAPALAPA,17,322,5,344,1544
CIUDAD DE MÉXICO,IZTAPALAPA,21,452,6,479,1823
CIUDAD DE MÉXICO,IZTAPALAPA,28,378,3,409,1823
CIUDAD DE MÉXICO,IZTAPALAPA,39,326,5,370,1544
CIUDAD DE MÉXICO,IZTAPALAPA,40,360,3,403,1544
CIUDAD DE MÉXICO,IZTAPALAPA,26,348,5,379,1544
CIUDAD DE MÉXICO,IZTAPALAPA,37,315,4,356,1947
CIUDAD DE MÉXICO,IZTAPALAPA,36,302,7,345,1946
CIUDAD DE MÉXICO,IZTAPALAPA,42,309,3,354,1946
CIUDAD DE MÉXICO,XOCHIMILCO,44,390,3,437,1800
CIUDAD DE MÉXICO,XOCHIMILCO,39,366,7,412,1800
CIUDAD DE MÉXICO,XOCHIMILCO,33,364,2,399,1471
CIUDAD DE MÉXICO,XOCHIMILCO,40,340,6,386,1471
CIUDAD DE MÉXICO,XOCHIMILCO,32,355,4,391,1470
CIUDAD DE MÉXICO,XOCHIMILCO,24,324,7,355,1409
CIUDAD DE MÉXICO,XOCHIMILCO,23,272,5,300,1409
CIUDAD DE MÉXICO,XOCHIMILCO,37,265,4,306,1104
CIUDAD DE MÉXICO,XOCHIMILCO,24,268,5,297,1103
CIUDAD DE MÉXICO,XOCHIMILCO,33,407,4,444,1771
CIUDAD DE MÉXICO,XOCHIMILCO,37,336,3,376,1771
CIUDAD DE MÉXICO,XOCHIMILCO,36,350,7,393,1770
CIUDAD DE MÉXICO,XOCHIMILCO,30,232,5,267,1098
CIUDAD DE MÉXICO,XOCHIMILCO,23,243,3,269,1097
CIUDAD DE MÉXICO,XOCHIMILCO,25,309,3,337,1445
CIUDAD DE MÉXICO,XOCHIMILCO,44,306,7,357,1444
CIUDAD DE MÉXICO,XOCHIMILCO,22,273,4,299,1444
CIUDAD DE MÉXICO,XOCHIMILCO,31,479,12,522,1893
CIUDAD DE MÉXICO,XOCHIMILCO,53,469,12,534,1892
CIUDAD DE MÉXICO,XOCHIMILCO,26,280,5,311,1245
CIUDAD DE MÉXICO,XOCHIMILCO,17,249,3,269,1244
CIUDAD DE MÉXICO,XOCHIMILCO,16,207,3,226,1043
CIUDAD DE MÉXICO,XOCHIMILCO,13,219,1,233,1043
CIUDAD DE MÉXICO,XOCHIMILCO,25,364,5,394,1694
CIUDAD DE MÉXICO,XOCHIMILCO,25,352,4,381,1693
CIUDAD DE MÉXICO,XOCHIMILCO,27,355,8,390,1270
CIUDAD DE MÉXICO,XOCHIMILCO,35,355,6,396,1269
CIUDAD DE MÉXICO,XOCHIMILCO,47,389,8,444,1755
CIUDAD DE MÉXICO,XOCHIMILCO,57,380,9,446,1755
CIUDAD DE MÉXICO,XOCHIMILCO,31,437,6,474,1956
CIUDAD DE MÉXICO,XOCHIMILCO,27,472,6,505,1955
CIUDAD DE MÉXICO,XOCHIMILCO,19,286,2,307,1526
CIUDAD DE MÉXICO,XOCHIMILCO,25,314,3,342,1526
CIUDAD DE MÉXICO,XOCHIMILCO,26,303,2,331,1956
CIUDAD DE MÉXICO,XOCHIMILCO,16,316,7,339,1956
CIUDAD DE MÉXICO,XOCHIMILCO,11,240,6,257,1018
CIUDAD DE MÉXICO,XOCHIMILCO,2,231,5,238,1017
CIUDAD DE MÉXICO,XOCHIMILCO,24,256,4,284,1216
CIUDAD DE MÉXICO,XOCHIMILCO,10,284,3,297,1215
CIUDAD DE MÉXICO,XOCHIMILCO,33,554,5,592,1978
CIUDAD DE MÉXICO,XOCHIMILCO,37,561,14,612,1977
CIUDAD DE MÉXICO,XOCHIMILCO,23,258,7,288,1201
CIUDAD DE MÉXICO,XOCHIMILCO,18,291,4,313,1200
CIUDAD DE MÉXICO,XOCHIMILCO,17,311,7,335,1076
CIUDAD DE MÉXICO,XOCHIMILCO,26,300,3,329,1075
CIUDAD DE MÉXICO,XOCHIMILCO,41,435,12,488,1824
CIUDAD DE MÉXICO,XOCHIMILCO,33,522,5,560,1823
CIUDAD DE MÉXICO,XOCHIMILCO,22,225,6,253,1191
CIUDAD DE MÉXICO,XOCHIMILCO,20,220,5,245,1190
CIUDAD DE MÉXICO,XOCHIMILCO,9,234,6,249,1319
CIUDAD DE MÉXICO,XOCHIMILCO,13,265,2,280,1318
CIUDAD DE MÉXICO,XOCHIMILCO,26,436,9,471,1820
CIUDAD DE MÉXICO,XOCHIMILCO,22,370,5,397,1819
CIUDAD DE MÉXICO,XOCHIMILCO,25,308,5,338,1216
CIUDAD DE MÉXICO,XOCHIMILCO,35,334,8,377,1216
CIUDAD DE MÉXICO,XOCHIMILCO,30,327,5,362,1099
CIUDAD DE MÉXICO,XOCHIMILCO,28,330,7,365,1099
CIUDAD DE MÉXICO,XOCHIMILCO,40,365,2,407,1849
CIUDAD DE MÉXICO,XOCHIMILCO,31,378,9,418,1849
CIUDAD DE MÉXICO,XOCHIMILCO,33,463,6,502,1982
CIUDAD DE MÉXICO,XOCHIMILCO,23,318,3,344,1553
CIUDAD DE MÉXICO,XOCHIMILCO,26,293,8,327,1553
CIUDAD DE MÉXICO,XOCHIMILCO,16,352,8,376,1568
CIUDAD DE MÉXICO,XOCHIMILCO,32,396,9,437,1568
CIUDAD DE MÉXICO,XOCHIMILCO,29,407,8,444,1740
CIUDAD DE MÉXICO,XOCHIMILCO,30,407,6,443,1739
CIUDAD DE MÉXICO,XOCHIMILCO,35,350,6,391,1772
CIUDAD DE MÉXICO,XOCHIMILCO,21,308,6,335,1771
CIUDAD DE MÉXICO,XOCHIMILCO,37,349,2,388,1771
CIUDAD DE MÉXICO,XOCHIMILCO,22,310,3,335,1752
CIUDAD DE MÉXICO,XOCHIMILCO,16,290,3,309,1752
CIUDAD DE MÉXICO,XOCHIMILCO,29,303,2,334,1751
CIUDAD DE MÉXICO,XOCHIMILCO,27,236,3,266,988
CIUDAD DE MÉXICO,XOCHIMILCO,20,203,3,226,987
CIUDAD DE MÉXICO,XOCHIMILCO,37,291,10,338,1601
CIUDAD DE MÉXICO,XOCHIMILCO,32,309,12,353,1601
CIUDAD DE MÉXICO,XOCHIMILCO,34,290,4,328,1600
CIUDAD DE MÉXICO,XOCHIMILCO,40,338,8,386,1794
CIUDAD DE MÉXICO,XOCHIMILCO,31,313,3,347,1794
CIUDAD DE MÉXICO,XOCHIMILCO,22,328,2,352,1463
CIUDAD DE MÉXICO,XOCHIMILCO,29,296,4,329,1462
CIUDAD DE MÉXICO,XOCHIMILCO,22,354,1,377,1678
CIUDAD DE MÉXICO,XOCHIMILCO,34,309,2,345,1677
CIUDAD DE MÉXICO,XOCHIMILCO,20,259,4,283,1496
CIUDAD DE MÉXICO,XOCHIMILCO,24,278,3,305,1495
CIUDAD DE MÉXICO,XOCHIMILCO,18,287,3,308,1495
CIUDAD DE MÉXICO,XOCHIMILCO,23,276,4,303,1466
CIUDAD DE MÉXICO,XOCHIMILCO,27,317,9,353,1466
CIUDAD DE MÉXICO,XOCHIMILCO,16,293,2,311,1553
CIUDAD DE MÉXICO,XOCHIMILCO,15,243,8,266,1553
CIUDAD DE MÉXICO,XOCHIMILCO,11,253,5,269,1552
CIUDAD DE MÉXICO,XOCHIMILCO,20,277,6,303,1621
CIUDAD DE MÉXICO,XOCHIMILCO,26,296,4,326,1620
CIUDAD DE MÉXICO,XOCHIMILCO,20,334,2,356,1620
CIUDAD DE MÉXICO,XOCHIMILCO,20,242,1,263,1508
CIUDAD DE MÉXICO,XOCHIMILCO,22,244,5,271,1507
CIUDAD DE MÉXICO,XOCHIMILCO,14,295,7,316,1483
CIUDAD DE MÉXICO,XOCHIMILCO,19,336,3,358,1483
CIUDAD DE MÉXICO,XOCHIMILCO,29,252,1,282,1239
CIUDAD DE MÉXICO,XOCHIMILCO,39,251,1,291,1239
CIUDAD DE MÉXICO,XOCHIMILCO,12,290,7,309,1624
CIUDAD DE MÉXICO,XOCHIMILCO,22,235,10,267,1623
CIUDAD DE MÉXICO,XOCHIMILCO,28,279,4,311,1623
CIUDAD DE MÉXICO,XOCHIMILCO,15,282,3,300,1420
CIUDAD DE MÉXICO,XOCHIMILCO,21,271,1,293,1420
CIUDAD DE MÉXICO,XOCHIMILCO,11,186,1,198,1132
CIUDAD DE MÉXICO,XOCHIMILCO,21,187,3,211,1131
CIUDAD DE MÉXICO,XOCHIMILCO,30,316,4,350,1797
CIUDAD DE MÉXICO,XOCHIMILCO,26,309,4,339,1797
CIUDAD DE MÉXICO,XOCHIMILCO,19,309,6,334,1445
CIUDAD DE MÉXICO,XOCHIMILCO,25,258,2,285,1444
CIUDAD DE MÉXICO,XOCHIMILCO,12,202,4,218,1260
CIUDAD DE MÉXICO,XOCHIMILCO,25,217,9,251,1260
CIUDAD DE MÉXICO,XOCHIMILCO,17,255,0,272,1504
CIUDAD DE MÉXICO,XOCHIMILCO,14,258,5,277,1503
CIUDAD DE MÉXICO,XOCHIMILCO,29,290,5,324,1826
CIUDAD DE MÉXICO,XOCHIMILCO,24,361,6,391,1825
CIUDAD DE MÉXICO,XOCHIMILCO,33,283,7,323,1892
CIUDAD DE MÉXICO,XOCHIMILCO,26,302,7,335,1892
CIUDAD DE MÉXICO,XOCHIMILCO,13,330,2,345,1718
CIUDAD DE MÉXICO,XOCHIMILCO,27,275,2,304,1717
CIUDAD DE MÉXICO,XOCHIMILCO,19,269,4,292,1706
CIUDAD DE MÉXICO,XOCHIMILCO,27,289,3,319,1706
CIUDAD DE MÉXICO,XOCHIMILCO,27,305,2,334,1705
CIUDAD DE MÉXICO,XOCHIMILCO,19,269,3,291,1504
CIUDAD DE MÉXICO,XOCHIMILCO,18,272,8,298,1503
CIUDAD DE MÉXICO,XOCHIMILCO,34,319,4,357,1694
CIUDAD DE MÉXICO,XOCHIMILCO,27,322,7,356,1693
CIUDAD DE MÉXICO,XOCHIMILCO,32,232,3,267,1541
CIUDAD DE MÉXICO,XOCHIMILCO,31,274,13,318,1541
CIUDAD DE MÉXICO,XOCHIMILCO,20,271,6,297,1541
CIUDAD DE MÉXICO,XOCHIMILCO,10,278,5,293,1734
CIUDAD DE MÉXICO,XOCHIMILCO,27,314,4,345,1733
CIUDAD DE MÉXICO,XOCHIMILCO,60,376,2,438,1973
CIUDAD DE MÉXICO,XOCHIMILCO,31,313,4,348,1656
CIUDAD DE MÉXICO,XOCHIMILCO,28,270,2,300,1656
CIUDAD DE MÉXICO,XOCHIMILCO,47,420,5,472,1981
CIUDAD DE MÉXICO,XOCHIMILCO,45,390,9,444,1981
CIUDAD DE MÉXICO,XOCHIMILCO,21,221,7,249,1825
CIUDAD DE MÉXICO,XOCHIMILCO,17,221,10,248,1825
CIUDAD DE MÉXICO,XOCHIMILCO,15,218,7,240,1824
CIUDAD DE MÉXICO,XOCHIMILCO,17,207,0,224,1493
CIUDAD DE MÉXICO,XOCHIMILCO,22,203,1,226,1493
CIUDAD DE MÉXICO,XOCHIMILCO,19,213,6,238,1492
CIUDAD DE MÉXICO,XOCHIMILCO,27,208,7,242,1255
CIUDAD DE MÉXICO,XOCHIMILCO,17,218,8,243,1254
CIUDAD DE MÉXICO,XOCHIMILCO,26,167,4,197,1023
CIUDAD DE MÉXICO,XOCHIMILCO,19,200,0,219,1022
CIUDAD DE MÉXICO,XOCHIMILCO,23,225,4,252,1360
CIUDAD DE MÉXICO,XOCHIMILCO,21,210,3,234,1359
CIUDAD DE MÉXICO,XOCHIMILCO,35,223,3,261,1251
CIUDAD DE MÉXICO,XOCHIMILCO,38,224,1,263,1251
CIUDAD DE MÉXICO,XOCHIMILCO,32,323,4,359,1769
CIUDAD DE MÉXICO,XOCHIMILCO,43,321,3,367,1768
CIUDAD DE MÉXICO,XOCHIMILCO,32,282,2,316,1532
CIUDAD DE MÉXICO,XOCHIMILCO,28,295,7,330,1532
CIUDAD DE MÉXICO,XOCHIMILCO,38,226,3,267,1090
CIUDAD DE MÉXICO,XOCHIMILCO,22,234,5,261,1090
CIUDAD DE MÉXICO,XOCHIMILCO,30,348,3,381,1748
CIUDAD DE MÉXICO,XOCHIMILCO,42,313,5,360,1747
CIUDAD DE MÉXICO,XOCHIMILCO,26,308,3,337,1610
CIUDAD DE MÉXICO,XOCHIMILCO,23,318,5,346,1609
CIUDAD DE MÉXICO,XOCHIMILCO,20,269,3,292,1183
CIUDAD DE MÉXICO,XOCHIMILCO,23,240,3,266,1182
CIUDAD DE MÉXICO,XOCHIMILCO,32,205,3,240,1353
CIUDAD DE MÉXICO,XOCHIMILCO,27,231,0,258,1353
CIUDAD DE MÉXICO,XOCHIMILCO,28,235,1,264,1353
CIUDAD DE MÉXICO,XOCHIMILCO,72,434,5,511,0
CIUDAD DE MÉXICO,XOCHIMILCO,26,195,4,225,1175
CIUDAD DE MÉXICO,XOCHIMILCO,17,187,3,207,1175
CIUDAD DE MÉXICO,XOCHIMILCO,23,263,3,289,1719
CIUDAD DE MÉXICO,XOCHIMILCO,23,263,4,290,1718
CIUDAD DE MÉXICO,XOCHIMILCO,16,296,9,321,1768
CIUDAD DE MÉXICO,XOCHIMILCO,23,248,6,277,1767
CIUDAD DE MÉXICO,XOCHIMILCO,25,244,15,284,1767
CIUDAD DE MÉXICO,XOCHIMILCO,14,291,9,314,1767
CIUDAD DE MÉXICO,XOCHIMILCO,29,268,4,301,1767
CIUDAD DE MÉXICO,XOCHIMILCO,16,284,3,303,1767
CIUDAD DE MÉXICO,XOCHIMILCO,22,192,2,216,1074
CIUDAD DE MÉXICO,XOCHIMILCO,17,156,1,174,1073
CIUDAD DE MÉXICO,XOCHIMILCO,20,195,4,219,1333
CIUDAD DE MÉXICO,XOCHIMILCO,24,219,6,249,1332
CIUDAD DE MÉXICO,XOCHIMILCO,37,344,8,389,1911
CIUDAD DE MÉXICO,XOCHIMILCO,28,322,3,353,1911
CIUDAD DE MÉXICO,XOCHIMILCO,19,227,5,251,1218
CIUDAD DE MÉXICO,XOCHIMILCO,16,196,2,214,1218
CIUDAD DE MÉXICO,XOCHIMILCO,18,231,6,255,1426
CIUDAD DE MÉXICO,XOCHIMILCO,16,237,10,263,1426
CIUDAD DE MÉXICO,XOCHIMILCO,34,223,3,260,1297
CIUDAD DE MÉXICO,XOCHIMILCO,20,228,2,250,1297
CIUDAD DE MÉXICO,XOCHIMILCO,8,180,2,190,1056
CIUDAD DE MÉXICO,XOCHIMILCO,18,176,3,197,1055
CIUDAD DE MÉXICO,XOCHIMILCO,17,222,5,244,1126
CIUDAD DE MÉXICO,XOCHIMILCO,15,219,4,238,1125
CIUDAD DE MÉXICO,XOCHIMILCO,28,263,3,294,1689
CIUDAD DE MÉXICO,XOCHIMILCO,22,232,4,258,1689
CIUDAD DE MÉXICO,XOCHIMILCO,41,320,4,365,1886
CIUDAD DE MÉXICO,XOCHIMILCO,40,342,5,387,1885
CIUDAD DE MÉXICO,XOCHIMILCO,29,176,2,207,1113
CIUDAD DE MÉXICO,XOCHIMILCO,23,167,1,191,1112
CIUDAD DE MÉXICO,XOCHIMILCO,25,280,10,315,1597
CIUDAD DE MÉXICO,XOCHIMILCO,23,314,6,343,1596
CIUDAD DE MÉXICO,XOCHIMILCO,12,264,4,280,1601
CIUDAD DE MÉXICO,XOCHIMILCO,17,222,2,241,1601
CIUDAD DE MÉXICO,XOCHIMILCO,24,241,3,268,1600
CIUDAD DE MÉXICO,XOCHIMILCO,22,242,2,266,1600
CIUDAD DE MÉXICO,XOCHIMILCO,18,287,2,307,1464
CIUDAD DE MÉXICO,XOCHIMILCO,23,227,7,257,1463
CIUDAD DE MÉXICO,XOCHIMILCO,22,264,0,286,1444
CIUDAD DE MÉXICO,XOCHIMILCO,16,252,2,270,1443
CIUDAD DE MÉXICO,XOCHIMILCO,32,223,6,261,1256
CIUDAD DE MÉXICO,XOCHIMILCO,20,233,6,259,1255
CIUDAD DE MÉXICO,XOCHIMILCO,25,304,11,340,1909
CIUDAD DE MÉXICO,XOCHIMILCO,28,298,0,326,1909
CIUDAD DE MÉXICO,XOCHIMILCO,30,312,3,345,1687
CIUDAD DE MÉXICO,XOCHIMILCO,36,264,3,303,1687
CIUDAD DE MÉXICO,XOCHIMILCO,22,180,6,208,1245
CIUDAD DE MÉXICO,XOCHIMILCO,14,201,4,219,1245
CIUDAD DE MÉXICO,IZTAPALAPA,35,296,6,337,1574
CIUDAD DE MÉXICO,IZTAPALAPA,21,278,5,304,1574
CIUDAD DE MÉXICO,IZTAPALAPA,26,325,7,358,1574
CIUDAD DE MÉXICO,IZTAPALAPA,21,342,8,371,1937
CIUDAD DE MÉXICO,IZTAPALAPA,36,340,7,383,1937
CIUDAD DE MÉXICO,IZTAPALAPA,19,337,3,359,1528
CIUDAD DE MÉXICO,IZTAPALAPA,15,309,2,326,1528
CIUDAD DE MÉXICO,IZTAPALAPA,28,297,3,328,1434
CIUDAD DE MÉXICO,IZTAPALAPA,16,304,0,320,1433
CIUDAD DE MÉXICO,IZTAPALAPA,13,302,4,319,1433
CIUDAD DE MÉXICO,IZTAPALAPA,25,302,5,332,1360
CIUDAD DE MÉXICO,IZTAPALAPA,26,305,2,333,1360
CIUDAD DE MÉXICO,IZTAPALAPA,18,353,6,377,1809
CIUDAD DE MÉXICO,IZTAPALAPA,21,411,8,440,1808
CIUDAD DE MÉXICO,IZTAPALAPA,24,428,2,454,1707
CIUDAD DE MÉXICO,IZTAPALAPA,23,375,7,405,1707
CIUDAD DE MÉXICO,IZTAPALAPA,29,355,3,387,1501
CIUDAD DE MÉXICO,IZTAPALAPA,30,342,3,375,1501
CIUDAD DE MÉXICO,IZTAPALAPA,27,380,6,413,1731
CIUDAD DE MÉXICO,IZTAPALAPA,35,392,6,433,1730
CIUDAD DE MÉXICO,IZTAPALAPA,26,292,7,325,1548
CIUDAD DE MÉXICO,IZTAPALAPA,15,297,4,316,1548
CIUDAD DE MÉXICO,IZTAPALAPA,22,276,4,302,1548
CIUDAD DE MÉXICO,IZTAPALAPA,28,339,2,369,1656
CIUDAD DE MÉXICO,IZTAPALAPA,35,320,3,358,1655
CIUDAD DE MÉXICO,IZTAPALAPA,18,280,4,302,1434
CIUDAD DE MÉXICO,IZTAPALAPA,24,287,7,318,1434
CIUDAD DE MÉXICO,IZTAPALAPA,24,291,5,320,1434
CIUDAD DE MÉXICO,IZTAPALAPA,15,280,2,297,1463
CIUDAD DE MÉXICO,IZTAPALAPA,8,285,7,300,1462
CIUDAD DE MÉXICO,IZTAPALAPA,30,295,9,334,1424
CIUDAD DE MÉXICO,IZTAPALAPA,30,361,8,399,1424
CIUDAD DE MÉXICO,IZTAPALAPA,25,355,10,390,1505
CIUDAD DE MÉXICO,IZTAPALAPA,10,335,9,354,1504
CIUDAD DE MÉXICO,IZTAPALAPA,27,332,14,373,1501
CIUDAD DE MÉXICO,IZTAPALAPA,15,309,9,333,1500
CIUDAD DE MÉXICO,IZTAPALAPA,13,351,5,369,1465
CIUDAD DE MÉXICO,IZTAPALAPA,14,312,3,329,1465
CIUDAD DE MÉXICO,IZTAPALAPA,27,405,4,436,1543
CIUDAD DE MÉXICO,IZTAPALAPA,20,398,9,427,1543
CIUDAD DE MÉXICO,IZTAPALAPA,17,250,6,273,1410
CIUDAD DE MÉXICO,IZTAPALAPA,20,279,5,304,1409
CIUDAD DE MÉXICO,IZTAPALAPA,15,289,5,309,1409
CIUDAD DE MÉXICO,IZTAPALAPA,34,641,11,686,0
CIUDAD DE MÉXICO,IZTAPALAPA,23,387,13,423,1593
CIUDAD DE MÉXICO,IZTAPALAPA,21,383,8,412,1593
CIUDAD DE MÉXICO,IZTAPALAPA,17,335,7,359,1401
CIUDAD DE MÉXICO,IZTAPALAPA,19,354,5,378,1401
CIUDAD DE MÉXICO,IZTAPALAPA,19,338,3,360,1401
CIUDAD DE MÉXICO,IZTAPALAPA,19,283,2,304,1404
CIUDAD DE MÉXICO,IZTAPALAPA,15,295,3,313,1404
CIUDAD DE MÉXICO,IZTAPALAPA,20,327,3,350,1753
CIUDAD DE MÉXICO,IZTAPALAPA,24,377,7,408,1753
CIUDAD DE MÉXICO,IZTAPALAPA,26,374,5,405,1861
CIUDAD DE MÉXICO,IZTAPALAPA,18,375,6,399,1860
CIUDAD DE MÉXICO,IZTAPALAPA,23,389,7,419,1669
CIUDAD DE MÉXICO,IZTAPALAPA,17,359,12,388,1669
CIUDAD DE MÉXICO,IZTAPALAPA,38,347,3,388,1882
CIUDAD DE MÉXICO,IZTAPALAPA,19,341,5,365,1881
CIUDAD DE MÉXICO,IZTAPALAPA,33,309,0,342,1625
CIUDAD DE MÉXICO,IZTAPALAPA,42,306,1,349,1624
CIUDAD DE MÉXICO,IZTAPALAPA,31,252,5,288,1383
CIUDAD DE MÉXICO,IZTAPALAPA,26,268,6,300,1383
CIUDAD DE MÉXICO,IZTAPALAPA,16,264,6,286,1382
CIUDAD DE MÉXICO,IZTAPALAPA,16,379,5,400,1618
CIUDAD DE MÉXICO,IZTAPALAPA,28,342,5,375,1617
CIUDAD DE MÉXICO,IZTAPALAPA,20,382,5,407,1924
CIUDAD DE MÉXICO,IZTAPALAPA,24,369,6,399,1923
CIUDAD DE MÉXICO,IZTAPALAPA,21,344,3,368,1335
CIUDAD DE MÉXICO,IZTAPALAPA,18,316,0,334,1334
CIUDAD DE MÉXICO,IZTAPALAPA,10,278,2,290,1322
CIUDAD DE MÉXICO,IZTAPALAPA,9,274,10,293,1322
CIUDAD DE MÉXICO,IZTAPALAPA,28,339,7,374,1645
CIUDAD DE MÉXICO,IZTAPALAPA,25,341,4,370,1645
CIUDAD DE MÉXICO,IZTAPALAPA,13,366,3,382,1545
CIUDAD DE MÉXICO,IZTAPALAPA,24,349,8,381,1545
CIUDAD DE MÉXICO,IZTAPALAPA,24,371,10,405,1659
CIUDAD DE MÉXICO,IZTAPALAPA,28,416,7,451,1659
CIUDAD DE MÉXICO,IZTAPALAPA,20,405,4,429,1769
CIUDAD DE MÉXICO,IZTAPALAPA,24,373,10,407,1769
CIUDAD DE MÉXICO,IZTAPALAPA,24,303,5,332,1613
CIUDAD DE MÉXICO,IZTAPALAPA,17,329,16,362,1612
CIUDAD DE MÉXICO,IZTAPALAPA,20,242,4,266,1438
CIUDAD DE MÉXICO,IZTAPALAPA,12,272,4,288,1437
CIUDAD DE MÉXICO,IZTAPALAPA,16,263,4,283,1417
CIUDAD DE MÉXICO,IZTAPALAPA,11,307,11,329,1417
CIUDAD DE MÉXICO,IZTAPALAPA,16,268,3,287,1363
CIUDAD DE MÉXICO,IZTAPALAPA,20,284,4,308,1363
CIUDAD DE MÉXICO,IZTAPALAPA,15,301,3,319,1362
CIUDAD DE MÉXICO,IZTAPALAPA,16,333,9,358,1667
CIUDAD DE MÉXICO,IZTAPALAPA,19,336,5,360,1666
CIUDAD DE MÉXICO,IZTAPALAPA,24,339,4,367,1666
CIUDAD DE MÉXICO,IZTAPALAPA,30,352,6,388,1800
CIUDAD DE MÉXICO,IZTAPALAPA,30,358,4,392,1799
CIUDAD DE MÉXICO,IZTAPALAPA,25,363,11,399,1600
CIUDAD DE MÉXICO,IZTAPALAPA,21,355,5,381,1600
CIUDAD DE MÉXICO,IZTAPALAPA,17,392,5,414,1600
CIUDAD DE MÉXICO,IZTAPALAPA,28,338,9,375,1479
CIUDAD DE MÉXICO,IZTAPALAPA,17,301,8,326,1479
CIUDAD DE MÉXICO,IZTAPALAPA,17,256,3,276,1236
CIUDAD DE MÉXICO,IZTAPALAPA,11,265,6,282,1236
CIUDAD DE MÉXICO,IZTAPALAPA,7,332,4,343,1620
CIUDAD DE MÉXICO,IZTAPALAPA,306,18,5,329,1620
CIUDAD DE MÉXICO,IZTAPALAPA,14,306,9,329,1620
CIUDAD DE MÉXICO,IZTAPALAPA,23,396,3,422,1600
CIUDAD DE MÉXICO,IZTAPALAPA,17,425,6,448,1599
CIUDAD DE MÉXICO,IZTAPALAPA,25,450,1,476,1938
CIUDAD DE MÉXICO,IZTAPALAPA,19,431,6,456,1937
CIUDAD DE MÉXICO,IZTAPALAPA,13,333,5,351,1719
CIUDAD DE MÉXICO,IZTAPALAPA,22,350,7,379,1718
CIUDAD DE MÉXICO,IZTAPALAPA,36,399,10,445,1772
CIUDAD DE MÉXICO,IZTAPALAPA,25,422,9,456,1772
CIUDAD DE MÉXICO,IZTAPALAPA,25,330,9,364,1563
CIUDAD DE MÉXICO,IZTAPALAPA,28,350,6,384,1563
CIUDAD DE MÉXICO,IZTAPALAPA,15,276,7,298,1519
CIUDAD DE MÉXICO,IZTAPALAPA,23,334,12,369,1519
CIUDAD DE MÉXICO,IZTAPALAPA,14,388,3,405,1468
CIUDAD DE MÉXICO,IZTAPALAPA,10,394,6,410,1467
CIUDAD DE MÉXICO,IZTAPALAPA,21,343,1,365,1504
CIUDAD DE MÉXICO,IZTAPALAPA,26,314,5,345,1504
CIUDAD DE MÉXICO,IZTAPALAPA,37,424,12,473,1958
CIUDAD DE MÉXICO,IZTAPALAPA,12,408,4,424,1958
CIUDAD DE MÉXICO,IZTAPALAPA,29,427,9,465,1759
CIUDAD DE MÉXICO,IZTAPALAPA,18,437,7,462,1759
CIUDAD DE MÉXICO,IZTAPALAPA,30,394,5,429,1759
CIUDAD DE MÉXICO,IZTAPALAPA,18,418,8,444,1478
CIUDAD DE MÉXICO,IZTAPALAPA,26,349,5,380,1478
CIUDAD DE MÉXICO,IZTAPALAPA,350,14,10,374,1553
CIUDAD DE MÉXICO,IZTAPALAPA,9,300,8,317,1553
CIUDAD DE MÉXICO,IZTAPALAPA,13,318,7,338,1552
CIUDAD DE MÉXICO,IZTAPALAPA,17,361,11,389,1487
CIUDAD DE MÉXICO,IZTAPALAPA,16,360,5,381,1487
CIUDAD DE MÉXICO,IZTAPALAPA,15,241,5,261,1078
CIUDAD DE MÉXICO,IZTAPALAPA,17,249,4,270,1077
CIUDAD DE MÉXICO,IZTAPALAPA,35,356,7,398,1930
CIUDAD DE MÉXICO,IZTAPALAPA,30,382,12,424,1930
CIUDAD DE MÉXICO,IZTAPALAPA,14,280,2,296,1364
CIUDAD DE MÉXICO,IZTAPALAPA,11,280,4,295,1364
CIUDAD DE MÉXICO,IZTAPALAPA,18,248,11,277,1363
CIUDAD DE MÉXICO,IZTAPALAPA,16,258,5,279,1463
CIUDAD DE MÉXICO,IZTAPALAPA,21,268,7,296,1463
CIUDAD DE MÉXICO,IZTAPALAPA,18,260,6,284,1336
CIUDAD DE MÉXICO,IZTAPALAPA,20,274,4,298,1336
CIUDAD DE MÉXICO,IZTAPALAPA,19,262,3,284,1336
CIUDAD DE MÉXICO,IZTAPALAPA,19,259,8,286,1336
CIUDAD DE MÉXICO,IZTAPALAPA,18,290,6,314,1336
CIUDAD DE MÉXICO,IZTAPALAPA,22,395,9,426,1768
CIUDAD DE MÉXICO,IZTAPALAPA,30,355,5,390,1767
CIUDAD DE MÉXICO,IZTAPALAPA,35,416,8,459,1839
CIUDAD DE MÉXICO,IZTAPALAPA,21,396,4,421,1839
CIUDAD DE MÉXICO,IZTAPALAPA,19,403,5,427,1946
CIUDAD DE MÉXICO,IZTAPALAPA,26,386,5,417,1946
CIUDAD DE MÉXICO,IZTAPALAPA,13,218,8,239,1155
CIUDAD DE MÉXICO,IZTAPALAPA,18,245,1,264,1154
CIUDAD DE MÉXICO,IZTAPALAPA,25,334,3,362,1718
CIUDAD DE MÉXICO,IZTAPALAPA,12,363,5,380,1718
CIUDAD DE MÉXICO,IZTAPALAPA,13,233,1,247,1269
CIUDAD DE MÉXICO,IZTAPALAPA,18,259,1,278,1269
CIUDAD DE MÉXICO,IZTAPALAPA,19,334,7,360,1646
CIUDAD DE MÉXICO,IZTAPALAPA,24,354,7,385,1646
CIUDAD DE MÉXICO,IZTAPALAPA,14,219,5,238,1054
CIUDAD DE MÉXICO,IZTAPALAPA,17,191,5,213,1054
CIUDAD DE MÉXICO,IZTAPALAPA,23,321,2,346,1765
CIUDAD DE MÉXICO,IZTAPALAPA,28,321,5,354,1765
CIUDAD DE MÉXICO,IZTAPALAPA,17,357,4,378,1765
CIUDAD DE MÉXICO,IZTAPALAPA,12,281,3,296,1764
CIUDAD DE MÉXICO,IZTAPALAPA,26,333,9,368,1764
CIUDAD DE MÉXICO,IZTAPALAPA,21,441,7,469,1941
CIUDAD DE MÉXICO,IZTAPALAPA,22,407,3,432,1941
CIUDAD DE MÉXICO,IZTAPALAPA,28,311,5,344,1835
CIUDAD DE MÉXICO,IZTAPALAPA,22,288,3,313,1835
CIUDAD DE MÉXICO,IZTAPALAPA,17,308,5,330,1835
CIUDAD DE MÉXICO,IZTAPALAPA,10,291,6,307,1834
CIUDAD DE MÉXICO,IZTAPALAPA,10,281,2,293,1834
CIUDAD DE MÉXICO,IZTAPALAPA,11,291,2,304,1834
CIUDAD DE MÉXICO,IZTAPALAPA,10,294,8,312,1834
CIUDAD DE MÉXICO,IZTAPALAPA,23,301,6,330,1724
CIUDAD DE MÉXICO,IZTAPALAPA,20,298,5,323,1723
CIUDAD DE MÉXICO,IZTAPALAPA,21,333,10,364,1720
CIUDAD DE MÉXICO,IZTAPALAPA,26,355,8,389,1720
CIUDAD DE MÉXICO,IZTAPALAPA,15,356,9,380,1720
CIUDAD DE MÉXICO,COYOACAN,23,155,0,178,1573
CIUDAD DE MÉXICO,COYOACAN,24,178,1,203,1573
CIUDAD DE MÉXICO,COYOACAN,18,121,3,142,1572
CIUDAD DE MÉXICO,COYOACAN,26,166,2,194,1478
CIUDAD DE MÉXICO,COYOACAN,30,190,2,222,1477
CIUDAD DE MÉXICO,COYOACAN,26,185,1,212,1477
CIUDAD DE MÉXICO,COYOACAN,33,224,6,263,1667
CIUDAD DE MÉXICO,COYOACAN,26,213,1,240,1666
CIUDAD DE MÉXICO,COYOACAN,31,194,4,229,1666
CIUDAD DE MÉXICO,COYOACAN,21,168,1,190,1257
CIUDAD DE MÉXICO,COYOACAN,20,152,2,174,1256
CIUDAD DE MÉXICO,COYOACAN,45,281,7,333,1771
CIUDAD DE MÉXICO,COYOACAN,38,283,5,326,1771
CIUDAD DE MÉXICO,COYOACAN,35,301,4,340,1771
CIUDAD DE MÉXICO,COYOACAN,27,298,6,331,1770
CIUDAD DE MÉXICO,COYOACAN,35,317,4,356,1770
CIUDAD DE MÉXICO,COYOACAN,24,277,1,302,1563
CIUDAD DE MÉXICO,COYOACAN,30,244,2,276,1563
CIUDAD DE MÉXICO,COYOACAN,34,267,1,302,1563
CIUDAD DE MÉXICO,COYOACAN,32,262,8,302,1456
CIUDAD DE MÉXICO,COYOACAN,29,244,8,281,1456
CIUDAD DE MÉXICO,COYOACAN,16,237,2,255,1084
CIUDAD DE MÉXICO,COYOACAN,19,194,4,217,1084
CIUDAD DE MÉXICO,COYOACAN,44,359,4,407,1953
CIUDAD DE MÉXICO,COYOACAN,50,398,12,460,1953
CIUDAD DE MÉXICO,COYOACAN,35,306,4,345,1531
CIUDAD DE MÉXICO,COYOACAN,27,285,5,317,1531
CIUDAD DE MÉXICO,COYOACAN,24,294,4,322,1531
CIUDAD DE MÉXICO,COYOACAN,356,37,10,403,1838
CIUDAD DE MÉXICO,COYOACAN,31,335,5,371,1838
CIUDAD DE MÉXICO,COYOACAN,27,303,3,333,1300
CIUDAD DE MÉXICO,COYOACAN,22,316,2,340,1299
CIUDAD DE MÉXICO,COYOACAN,27,175,2,204,1039
CIUDAD DE MÉXICO,COYOACAN,28,187,3,218,1038
CIUDAD DE MÉXICO,COYOACAN,19,319,6,344,1535
CIUDAD DE MÉXICO,COYOACAN,19,272,6,297,1535
CIUDAD DE MÉXICO,COYOACAN,34,226,6,266,1535
CIUDAD DE MÉXICO,COYOACAN,40,239,3,282,1803
CIUDAD DE MÉXICO,COYOACAN,27,261,1,289,1803
CIUDAD DE MÉXICO,COYOACAN,35,267,4,306,1754
CIUDAD DE MÉXICO,COYOACAN,39,298,2,339,1754
CIUDAD DE MÉXICO,COYOACAN,35,357,4,396,1861
CIUDAD DE MÉXICO,COYOACAN,35,389,4,428,1861
CIUDAD DE MÉXICO,COYOACAN,35,316,1,352,1855
CIUDAD DE MÉXICO,COYOACAN,40,307,4,351,1854
CIUDAD DE MÉXICO,COYOACAN,29,301,4,334,1357
CIUDAD DE MÉXICO,COYOACAN,20,245,0,265,1357
CIUDAD DE MÉXICO,COYOACAN,23,245,5,273,1357
CIUDAD DE MÉXICO,COYOACAN,39,356,5,400,1799
CIUDAD DE MÉXICO,COYOACAN,34,359,3,396,1798
CIUDAD DE MÉXICO,COYOACAN,22,230,2,254,1133
CIUDAD DE MÉXICO,COYOACAN,25,236,1,262,1133
CIUDAD DE MÉXICO,COYOACAN,19,252,4,275,1226
CIUDAD DE MÉXICO,COYOACAN,17,232,3,252,1226
CIUDAD DE MÉXICO,COYOACAN,19,189,5,213,1060
CIUDAD DE MÉXICO,COYOACAN,18,177,1,196,1059
CIUDAD DE MÉXICO,COYOACAN,30,244,2,276,1158
CIUDAD DE MÉXICO,COYOACAN,15,250,3,268,1158
CIUDAD DE MÉXICO,COYOACAN,28,383,6,417,1931
CIUDAD DE MÉXICO,COYOACAN,29,430,1,460,1931
CIUDAD DE MÉXICO,COYOACAN,34,355,6,395,1821
CIUDAD DE MÉXICO,COYOACAN,28,364,3,395,1821
CIUDAD DE MÉXICO,COYOACAN,36,404,4,444,1821
CIUDAD DE MÉXICO,COYOACAN,41,320,7,368,1832
CIUDAD DE MÉXICO,COYOACAN,35,390,9,434,1832
CIUDAD DE MÉXICO,COYOACAN,37,304,5,346,1845
CIUDAD DE MÉXICO,COYOACAN,32,356,3,391,1844
CIUDAD DE MÉXICO,COYOACAN,29,435,3,467,1901
CIUDAD DE MÉXICO,COYOACAN,24,377,0,401,1900
CIUDAD DE MÉXICO,COYOACAN,21,194,2,217,1102
CIUDAD DE MÉXICO,COYOACAN,27,236,2,265,1102
CIUDAD DE MÉXICO,COYOACAN,47,329,8,384,1659
CIUDAD DE MÉXICO,COYOACAN,31,348,1,380,1659
CIUDAD DE MÉXICO,COYOACAN,44,227,2,273,1840
CIUDAD DE MÉXICO,COYOACAN,26,253,4,283,1840
CIUDAD DE MÉXICO,COYOACAN,25,219,3,247,1475
CIUDAD DE MÉXICO,COYOACAN,21,251,3,275,1475
CIUDAD DE MÉXICO,COYOACAN,29,297,3,329,1489
CIUDAD DE MÉXICO,COYOACAN,35,270,5,310,1488
CIUDAD DE MÉXICO,COYOACAN,25,292,3,320,1488
CIUDAD DE MÉXICO,COYOACAN,39,395,5,439,1815
CIUDAD DE MÉXICO,COYOACAN,38,405,9,452,1814
CIUDAD DE MÉXICO,COYOACAN,39,353,8,400,1666
CIUDAD DE MÉXICO,COYOACAN,42,352,2,396,1665
CIUDAD DE MÉXICO,COYOACAN,33,362,6,401,1665
CIUDAD DE MÉXICO,COYOACAN,34,342,5,381,1780
CIUDAD DE MÉXICO,COYOACAN,36,332,5,373,1780
CIUDAD DE MÉXICO,COYOACAN,20,72,1,93,1455
CIUDAD DE MÉXICO,COYOACAN,17,70,1,88,1454
CIUDAD DE MÉXICO,COYOACAN,20,280,7,307,1426
CIUDAD DE MÉXICO,COYOACAN,22,280,6,308,1426
CIUDAD DE MÉXICO,COYOACAN,21,305,7,333,1426
CIUDAD DE MÉXICO,COYOACAN,24,262,1,287,1378
CIUDAD DE MÉXICO,COYOACAN,21,253,5,279,1378
CIUDAD DE MÉXICO,COYOACAN,23,253,3,279,1378
CIUDAD DE MÉXICO,COYOACAN,26,357,4,387,1799
CIUDAD DE MÉXICO,COYOACAN,34,318,10,362,1798
CIUDAD DE MÉXICO,COYOACAN,44,384,3,431,1959
CIUDAD DE MÉXICO,COYOACAN,51,374,3,428,1958
CIUDAD DE MÉXICO,COYOACAN,30,391,8,429,1807
CIUDAD DE MÉXICO,COYOACAN,37,378,11,426,1806
CIUDAD DE MÉXICO,COYOACAN,32,349,5,386,1792
CIUDAD DE MÉXICO,COYOACAN,32,324,6,362,1792
CIUDAD DE MÉXICO,COYOACAN,40,273,10,323,1496
CIUDAD DE MÉXICO,COYOACAN,26,286,7,319,1496
CIUDAD DE MÉXICO,COYOACAN,33,297,3,333,1495
CIUDAD DE MÉXICO,COYOACAN,23,205,0,228,1486
CIUDAD DE MÉXICO,COYOACAN,29,184,3,216,1486
CIUDAD DE MÉXICO,COYOACAN,24,215,2,241,1485
CIUDAD DE MÉXICO,COYOACAN,38,293,4,335,1736
CIUDAD DE MÉXICO,COYOACAN,26,296,3,325,1735
CIUDAD DE MÉXICO,COYOACAN,45,333,1,379,1718
CIUDAD DE MÉXICO,COYOACAN,31,339,8,378,1718
CIUDAD DE MÉXICO,COYOACAN,34,315,6,355,1925
CIUDAD DE MÉXICO,COYOACAN,29,370,2,401,1924
CIUDAD DE MÉXICO,COYOACAN,33,388,3,424,1879
CIUDAD DE MÉXICO,COYOACAN,35,343,5,383,1879
CIUDAD DE MÉXICO,COYOACAN,44,284,6,334,1485
CIUDAD DE MÉXICO,COYOACAN,34,300,4,338,1484
CIUDAD DE MÉXICO,COYOACAN,38,329,3,370,2003
CIUDAD DE MÉXICO,COYOACAN,42,313,7,362,1889
CIUDAD DE MÉXICO,COYOACAN,28,329,11,368,1888
CIUDAD DE MÉXICO,COYOACAN,26,285,9,320,1594
CIUDAD DE MÉXICO,COYOACAN,34,317,4,355,1594
CIUDAD DE MÉXICO,COYOACAN,32,309,3,344,1593
CIUDAD DE MÉXICO,COYOACAN,30,333,7,370,1659
CIUDAD DE MÉXICO,COYOACAN,19,308,4,331,1658
CIUDAD DE MÉXICO,COYOACAN,45,333,4,382,1805
CIUDAD DE MÉXICO,COYOACAN,34,363,2,399,1805
CIUDAD DE MÉXICO,COYOACAN,22,228,1,251,1412
CIUDAD DE MÉXICO,COYOACAN,25,220,2,247,1412
CIUDAD DE MÉXICO,COYOACAN,27,216,1,244,1412
CIUDAD DE MÉXICO,COYOACAN,44,302,6,352,1805
CIUDAD DE MÉXICO,COYOACAN,36,269,6,311,1805
CIUDAD DE MÉXICO,COYOACAN,33,322,7,362,1688
CIUDAD DE MÉXICO,COYOACAN,36,332,3,371,1687
CIUDAD DE MÉXICO,COYOACAN,48,367,9,424,1856
CIUDAD DE MÉXICO,COYOACAN,38,376,6,420,1855
CIUDAD DE MÉXICO,COYOACAN,41,263,10,314,1607
CIUDAD DE MÉXICO,COYOACAN,35,278,6,319,1606
CIUDAD DE MÉXICO,COYOACAN,32,350,3,385,1929
CIUDAD DE MÉXICO,COYOACAN,343,29,4,376,1928
CIUDAD DE MÉXICO,COYOACAN,34,249,5,288,1339
CIUDAD DE MÉXICO,COYOACAN,28,255,1,284,1339
CIUDAD DE MÉXICO,COYOACAN,29,259,2,290,1452
CIUDAD DE MÉXICO,COYOACAN,29,310,6,345,1451
CIUDAD DE MÉXICO,COYOACAN,40,252,0,292,1678
CIUDAD DE MÉXICO,COYOACAN,41,267,1,309,1677
CIUDAD DE MÉXICO,COYOACAN,32,255,2,289,1839
CIUDAD DE MÉXICO,COYOACAN,50,257,5,312,1838
CIUDAD DE MÉXICO,COYOACAN,48,274,5,327,1961
CIUDAD DE MÉXICO,COYOACAN,32,298,0,330,1910
CIUDAD DE MÉXICO,COYOACAN,44,243,2,289,1909
CIUDAD DE MÉXICO,COYOACAN,18,83,2,103,1332
CIUDAD DE MÉXICO,COYOACAN,25,104,1,130,1332
CIUDAD DE MÉXICO,COYOACAN,26,231,10,267,1472
CIUDAD DE MÉXICO,COYOACAN,44,216,1,261,1472
CIUDAD DE MÉXICO,COYOACAN,26,240,2,268,1472
CIUDAD DE MÉXICO,COYOACAN,52,220,6,278,1614
CIUDAD DE MÉXICO,COYOACAN,37,239,5,281,1614
CIUDAD DE MÉXICO,COYOACAN,42,260,4,306,1613
CIUDAD DE MÉXICO,COYOACAN,43,296,4,343,1880
CIUDAD DE MÉXICO,COYOACAN,21,350,4,375,1880
CIUDAD DE MÉXICO,COYOACAN,151,1374,17,1542,0
CIUDAD DE MÉXICO,COYOACAN,28,355,6,389,1448
CIUDAD DE MÉXICO,COYOACAN,19,311,3,333,1448
CIUDAD DE MÉXICO,COYOACAN,28,174,2,204,1556
CIUDAD DE MÉXICO,COYOACAN,32,177,3,212,1555
CIUDAD DE MÉXICO,COYOACAN,30,251,6,287,1362
CIUDAD DE MÉXICO,COYOACAN,22,248,3,273,1362
CIUDAD DE MÉXICO,COYOACAN,30,324,2,356,1766
CIUDAD DE MÉXICO,COYOACAN,26,363,2,391,1766
CIUDAD DE MÉXICO,COYOACAN,24,123,2,149,1236
CIUDAD DE MÉXICO,COYOACAN,27,128,1,156,1236
CIUDAD DE MÉXICO,COYOACAN,37,181,3,221,1665
CIUDAD DE MÉXICO,COYOACAN,27,203,6,236,1665
CIUDAD DE MÉXICO,COYOACAN,39,174,1,214,1496
CIUDAD DE MÉXICO,COYOACAN,22,174,1,197,1495
CIUDAD DE MÉXICO,COYOACAN,41,206,1,248,1445
CIUDAD DE MÉXICO,COYOACAN,29,206,3,238,1444
CIUDAD DE MÉXICO,COYOACAN,26,182,1,209,1586
CIUDAD DE MÉXICO,COYOACAN,44,222,4,270,1586
CIUDAD DE MÉXICO,COYOACAN,32,141,0,173,1505
CIUDAD DE MÉXICO,COYOACAN,33,157,1,191,1505
CIUDAD DE MÉXICO,COYOACAN,41,142,0,183,1505
CIUDAD DE MÉXICO,COYOACAN,32,318,3,353,1942
CIUDAD DE MÉXICO,COYOACAN,43,325,4,372,1942
CIUDAD DE MÉXICO,COYOACAN,27,188,1,216,1114
CIUDAD DE MÉXICO,COYOACAN,31,157,2,190,1113
CIUDAD DE MÉXICO,COYOACAN,35,173,2,210,1470
CIUDAD DE MÉXICO,COYOACAN,29,156,1,186,1470
CIUDAD DE MÉXICO,COYOACAN,27,209,4,240,1886
CIUDAD DE MÉXICO,COYOACAN,38,206,1,245,1885
CIUDAD DE MÉXICO,COYOACAN,23,167,0,190,1324
CIUDAD DE MÉXICO,COYOACAN,35,194,0,229,1324
CIUDAD DE MÉXICO,COYOACAN,28,175,2,205,1323
CIUDAD DE MÉXICO,COYOACAN,30,182,2,214,1517
CIUDAD DE MÉXICO,COYOACAN,26,186,2,214,1517
CIUDAD DE MÉXICO,COYOACAN,32,174,4,210,1516
CIUDAD DE MÉXICO,COYOACAN,23,147,3,173,1364
CIUDAD DE MÉXICO,COYOACAN,23,147,1,171,1364
CIUDAD DE MÉXICO,COYOACAN,31,129,0,160,1421
CIUDAD DE MÉXICO,COYOACAN,25,148,4,177,1420
CIUDAD DE MÉXICO,COYOACAN,30,205,4,239,1639
CIUDAD DE MÉXICO,COYOACAN,34,189,3,226,1639
CIUDAD DE MÉXICO,COYOACAN,40,201,0,241,1638
CIUDAD DE MÉXICO,COYOACAN,20,202,5,227,1529
CIUDAD DE MÉXICO,COYOACAN,20,197,6,223,1529
CIUDAD DE MÉXICO,COYOACAN,32,198,1,231,1528
CIUDAD DE MÉXICO,COYOACAN,38,163,0,201,1639
CIUDAD DE MÉXICO,COYOACAN,27,179,0,206,1639
CIUDAD DE MÉXICO,COYOACAN,25,178,2,205,1639
CIUDAD DE MÉXICO,COYOACAN,33,232,2,267,1690
CIUDAD DE MÉXICO,COYOACAN,26,253,2,281,1690
CIUDAD DE MÉXICO,COYOACAN,24,243,2,269,1690
CIUDAD DE MÉXICO,COYOACAN,23,197,3,223,1627
CIUDAD DE MÉXICO,COYOACAN,29,246,3,278,1627
CIUDAD DE MÉXICO,COYOACAN,21,204,1,226,1626
CIUDAD DE MÉXICO,COYOACAN,32,214,1,247,1476
CIUDAD DE MÉXICO,COYOACAN,28,187,1,216,1476
CIUDAD DE MÉXICO,COYOACAN,22,201,1,224,1475
CIUDAD DE MÉXICO,COYOACAN,34,288,3,325,1890
CIUDAD DE MÉXICO,COYOACAN,47,308,4,359,1889
CIUDAD DE MÉXICO,COYOACAN,38,51,3,92,1473
CIUDAD DE MÉXICO,COYOACAN,39,169,1,209,1473
CIUDAD DE MÉXICO,COYOACAN,33,140,1,174,1473
CIUDAD DE MÉXICO,COYOACAN,47,227,4,278,1766
CIUDAD DE MÉXICO,COYOACAN,50,230,0,280,1765
CIUDAD DE MÉXICO,COYOACAN,33,153,1,187,1383
CIUDAD DE MÉXICO,COYOACAN,39,127,1,167,1383
CIUDAD DE MÉXICO,COYOACAN,36,135,2,173,1607
CIUDAD DE MÉXICO,COYOACAN,35,168,1,204,1606
CIUDAD DE MÉXICO,COYOACAN,28,79,1,108,1235
CIUDAD DE MÉXICO,COYOACAN,23,91,1,115,1234
CIUDAD DE MÉXICO,COYOACAN,23,242,2,267,1627
CIUDAD DE MÉXICO,COYOACAN,33,234,3,270,1627
CIUDAD DE MÉXICO,COYOACAN,55,146,0,201,1865
CIUDAD DE MÉXICO,COYOACAN,45,134,3,182,1865
CIUDAD DE MÉXICO,COYOACAN,35,272,2,309,1835
CIUDAD DE MÉXICO,COYOACAN,34,316,8,358,1835
CIUDAD DE MÉXICO,COYOACAN,39,184,1,224,1863
CIUDAD DE MÉXICO,COYOACAN,32,160,4,196,1862
CIUDAD DE MÉXICO,COYOACAN,25,246,4,275,1506
CIUDAD DE MÉXICO,COYOACAN,22,264,8,294,1506
CIUDAD DE MÉXICO,COYOACAN,20,292,7,319,1726
CIUDAD DE MÉXICO,COYOACAN,21,331,3,355,1725
CIUDAD DE MÉXICO,COYOACAN,29,297,5,331,1645
CIUDAD DE MÉXICO,COYOACAN,32,295,5,332,1645
CIUDAD DE MÉXICO,COYOACAN,32,292,4,328,1644
CIUDAD DE MÉXICO,COYOACAN,16,246,2,264,1477
CIUDAD DE MÉXICO,COYOACAN,17,248,3,268,1477
CIUDAD DE MÉXICO,COYOACAN,24,225,1,250,1476
CIUDAD DE MÉXICO,COYOACAN,32,189,0,221,1667
CIUDAD DE MÉXICO,COYOACAN,21,184,1,206,1667
CIUDAD DE MÉXICO,COYOACAN,42,193,2,237,1667
CIUDAD DE MÉXICO,COYOACAN,38,200,2,240,1886
CIUDAD DE MÉXICO,COYOACAN,30,229,2,261,1885
CIUDAD DE MÉXICO,COYOACAN,40,236,3,279,1710
CIUDAD DE MÉXICO,COYOACAN,39,224,0,263,1710
CIUDAD DE MÉXICO,COYOACAN,32,245,3,280,1443
CIUDAD DE MÉXICO,COYOACAN,30,218,1,249,1443
CIUDAD DE MÉXICO,COYOACAN,21,267,4,292,1442
CIUDAD DE MÉXICO,COYOACAN,40,252,5,297,1723
CIUDAD DE MÉXICO,COYOACAN,33,246,7,286,1723
CIUDAD DE MÉXICO,COYOACAN,36,284,2,322,1723
CIUDAD DE MÉXICO,COYOACAN,53,312,7,372,1871
CIUDAD DE MÉXICO,COYOACAN,48,344,6,398,1871
CIUDAD DE MÉXICO,COYOACAN,27,209,2,238,1271
CIUDAD DE MÉXICO,COYOACAN,36,198,2,236,1270
CIUDAD DE MÉXICO,COYOACAN,45,221,0,266,1652
CIUDAD DE MÉXICO,COYOACAN,35,233,4,272,1652
CIUDAD DE MÉXICO,COYOACAN,44,228,2,274,1693
CIUDAD DE MÉXICO,COYOACAN,61,232,3,296,1692
CIUDAD DE MÉXICO,COYOACAN,30,175,1,206,1267
CIUDAD DE MÉXICO,COYOACAN,28,175,0,203,1266
CIUDAD DE MÉXICO,COYOACAN,39,189,2,230,1776
CIUDAD DE MÉXICO,COYOACAN,36,203,4,243,1776
CIUDAD DE MÉXICO,COYOACAN,31,219,2,252,1236
CIUDAD DE MÉXICO,COYOACAN,26,202,2,230,1236
CIUDAD DE MÉXICO,COYOACAN,39,206,3,248,1305
CIUDAD DE MÉXICO,COYOACAN,39,196,3,238,1305
CIUDAD DE MÉXICO,COYOACAN,34,233,4,271,1414
CIUDAD DE MÉXICO,COYOACAN,34,239,7,280,1413
CIUDAD DE MÉXICO,COYOACAN,40,217,1,258,1413
CIUDAD DE MÉXICO,COYOACAN,50,314,2,366,1865
CIUDAD DE MÉXICO,COYOACAN,38,345,2,385,1864
CIUDAD DE MÉXICO,COYOACAN,34,174,0,208,1430
CIUDAD DE MÉXICO,COYOACAN,30,169,1,200,1430
CIUDAD DE MÉXICO,COYOACAN,33,105,0,138,1432
CIUDAD DE MÉXICO,COYOACAN,31,155,0,186,1432
CIUDAD DE MÉXICO,COYOACAN,26,152,1,179,1431
CIUDAD DE MÉXICO,COYOACAN,35,259,4,298,1521
CIUDAD DE MÉXICO,COYOACAN,22,225,2,249,1521
CIUDAD DE MÉXICO,COYOACAN,33,214,2,249,1645
CIUDAD DE MÉXICO,COYOACAN,30,259,1,290,1645
CIUDAD DE MÉXICO,COYOACAN,32,230,3,265,1424
CIUDAD DE MÉXICO,COYOACAN,41,242,3,286,1424
CIUDAD DE MÉXICO,COYOACAN,30,253,1,284,1424
CIUDAD DE MÉXICO,COYOACAN,42,282,2,326,1475
CIUDAD DE MÉXICO,COYOACAN,36,321,2,359,1475
CIUDAD DE MÉXICO,COYOACAN,41,317,7,365,1755
CIUDAD DE MÉXICO,COYOACAN,32,375,9,416,1755
CIUDAD DE MÉXICO,COYOACAN,48,249,4,301,1839
CIUDAD DE MÉXICO,COYOACAN,36,281,0,317,1839
CIUDAD DE MÉXICO,COYOACAN,34,200,2,236,1734
CIUDAD DE MÉXICO,COYOACAN,36,213,5,254,1734
CIUDAD DE MÉXICO,COYOACAN,34,203,3,240,1733
CIUDAD DE MÉXICO,COYOACAN,31,182,0,213,1799
CIUDAD DE MÉXICO,COYOACAN,38,201,0,239,1799
CIUDAD DE MÉXICO,COYOACAN,26,314,5,345,1767
CIUDAD DE MÉXICO,COYOACAN,42,321,6,369,1767
CIUDAD DE MÉXICO,COYOACAN,34,332,3,369,1855
CIUDAD DE MÉXICO,COYOACAN,38,323,4,365,1854
CIUDAD DE MÉXICO,COYOACAN,24,258,6,288,1591
CIUDAD DE MÉXICO,COYOACAN,22,263,10,295,1591
CIUDAD DE MÉXICO,COYOACAN,32,223,3,258,1590
CIUDAD DE MÉXICO,COYOACAN,27,169,2,198,1060
CIUDAD DE MÉXICO,COYOACAN,23,136,2,161,1059
CIUDAD DE MÉXICO,COYOACAN,23,174,6,203,1563
CIUDAD DE MÉXICO,COYOACAN,26,191,0,217,1563
CIUDAD DE MÉXICO,COYOACAN,29,172,0,201,1563
CIUDAD DE MÉXICO,COYOACAN,31,156,1,188,1492
CIUDAD DE MÉXICO,COYOACAN,30,142,1,173,1491
CIUDAD DE MÉXICO,COYOACAN,43,292,4,339,1789
CIUDAD DE MÉXICO,COYOACAN,42,293,2,337,1789
CIUDAD DE MÉXICO,COYOACAN,39,223,2,264,1388
CIUDAD DE MÉXICO,COYOACAN,32,208,4,244,1388
CIUDAD DE MÉXICO,COYOACAN,39,232,6,277,1387
CIUDAD DE MÉXICO,COYOACAN,31,338,5,374,1822
CIUDAD DE MÉXICO,COYOACAN,43,278,5,326,1821
CIUDAD DE MÉXICO,COYOACAN,36,304,4,344,1871
CIUDAD DE MÉXICO,COYOACAN,21,282,3,306,1871
CIUDAD DE MÉXICO,COYOACAN,19,216,3,238,1592
CIUDAD DE MÉXICO,COYOACAN,44,230,3,277,1591
CIUDAD DE MÉXICO,COYOACAN,38,245,2,285,1591
CIUDAD DE MÉXICO,COYOACAN,31,236,4,271,1694
CIUDAD DE MÉXICO,COYOACAN,35,251,4,290,1693
CIUDAD DE MÉXICO,COYOACAN,36,201,3,240,1859
CIUDAD DE MÉXICO,COYOACAN,34,241,0,275,1859
CIUDAD DE MÉXICO,COYOACAN,36,178,1,215,1671
CIUDAD DE MÉXICO,COYOACAN,29,184,2,215,1670
CIUDAD DE MÉXICO,COYOACAN,16,132,0,148,1156
CIUDAD DE MÉXICO,COYOACAN,18,123,1,142,1156
CIUDAD DE MÉXICO,COYOACAN,25,305,7,337,1400
CIUDAD DE MÉXICO,COYOACAN,31,233,4,268,1399
CIUDAD DE MÉXICO,COYOACAN,34,308,1,343,1399
CIUDAD DE MÉXICO,COYOACAN,27,272,7,306,1691
CIUDAD DE MÉXICO,COYOACAN,29,307,4,340,1690
CIUDAD DE MÉXICO,COYOACAN,27,305,5,337,1690
CIUDAD DE MÉXICO,COYOACAN,32,208,2,242,1446
CIUDAD DE MÉXICO,COYOACAN,30,243,5,278,1446
CIUDAD DE MÉXICO,COYOACAN,30,245,3,278,1851
CIUDAD DE MÉXICO,COYOACAN,32,237,2,271,1851
CIUDAD DE MÉXICO,COYOACAN,29,123,1,153,1267
CIUDAD DE MÉXICO,COYOACAN,29,125,2,156,1267
CIUDAD DE MÉXICO,COYOACAN,36,325,5,366,1670
CIUDAD DE MÉXICO,COYOACAN,37,288,3,328,1670
CIUDAD DE MÉXICO,COYOACAN,25,281,7,313,1301
CIUDAD DE MÉXICO,COYOACAN,22,274,5,301,1301
CIUDAD DE MÉXICO,COYOACAN,26,262,3,291,1555
CIUDAD DE MÉXICO,COYOACAN,26,262,7,295,1555
CIUDAD DE MÉXICO,COYOACAN,40,237,3,280,1425
CIUDAD DE MÉXICO,COYOACAN,30,250,2,282,1425
CIUDAD DE MÉXICO,COYOACAN,24,264,4,292,1424
CIUDAD DE MÉXICO,COYOACAN,32,267,3,302,1772
CIUDAD DE MÉXICO,COYOACAN,40,258,1,299,1771
CIUDAD DE MÉXICO,COYOACAN,35,245,2,282,1771
CIUDAD DE MÉXICO,COYOACAN,31,244,4,279,1771
CIUDAD DE MÉXICO,COYOACAN,51,306,9,366,1747
CIUDAD DE MÉXICO,COYOACAN,42,330,6,378,1746
CIUDAD DE MÉXICO,COYOACAN,23,256,2,281,1261
CIUDAD DE MÉXICO,COYOACAN,16,206,4,226,1260
CIUDAD DE MÉXICO,COYOACAN,30,311,11,352,1836
CIUDAD DE MÉXICO,COYOACAN,34,564,7,605,1835
CIUDAD DE MÉXICO,COYOACAN,42,379,3,424,1718
CIUDAD DE MÉXICO,COYOACAN,54,295,8,357,1717
CIUDAD DE MÉXICO,COYOACAN,40,314,7,361,1879
CIUDAD DE MÉXICO,COYOACAN,23,324,7,354,1879
CIUDAD DE MÉXICO,COYOACAN,21,229,1,251,1702
CIUDAD DE MÉXICO,COYOACAN,26,233,5,264,1701
CIUDAD DE MÉXICO,COYOACAN,27,243,1,271,1251
CIUDAD DE MÉXICO,COYOACAN,21,233,3,257,1251
CIUDAD DE MÉXICO,COYOACAN,27,202,1,230,1493
CIUDAD DE MÉXICO,COYOACAN,25,166,3,194,1493
CIUDAD DE MÉXICO,COYOACAN,35,211,7,253,1462
CIUDAD DE MÉXICO,COYOACAN,26,255,5,286,1461
CIUDAD DE MÉXICO,COYOACAN,32,242,5,279,1476
CIUDAD DE MÉXICO,COYOACAN,30,259,5,294,1476
CIUDAD DE MÉXICO,COYOACAN,43,264,5,312,1665
CIUDAD DE MÉXICO,COYOACAN,38,299,4,341,1665
CIUDAD DE MÉXICO,COYOACAN,30,157,3,190,1163
CIUDAD DE MÉXICO,COYOACAN,29,170,1,200,1162
CIUDAD DE MÉXICO,COYOACAN,20,174,4,198,1395
CIUDAD DE MÉXICO,COYOACAN,19,223,1,243,1394
CIUDAD DE MÉXICO,COYOACAN,31,158,0,189,1394
CIUDAD DE MÉXICO,COYOACAN,75,672,11,758,0
CIUDAD DE MÉXICO,COYOACAN,20,250,4,274,1366
CIUDAD DE MÉXICO,COYOACAN,29,229,2,260,1366
CIUDAD DE MÉXICO,COYOACAN,30,230,6,266,1366
CIUDAD DE MÉXICO,COYOACAN,17,236,2,255,1355
CIUDAD DE MÉXICO,COYOACAN,21,213,1,235,1355
CIUDAD DE MÉXICO,COYOACAN,21,232,5,258,1355
CIUDAD DE MÉXICO,COYOACAN,19,380,7,406,1953
CIUDAD DE MÉXICO,COYOACAN,24,350,3,377,1953
CIUDAD DE MÉXICO,COYOACAN,14,280,1,295,1254
CIUDAD DE MÉXICO,COYOACAN,15,295,5,315,1253
CIUDAD DE MÉXICO,COYOACAN,24,379,3,406,1641
CIUDAD DE MÉXICO,COYOACAN,35,348,11,394,1641
CIUDAD DE MÉXICO,COYOACAN,25,253,3,281,1253
CIUDAD DE MÉXICO,COYOACAN,26,236,4,266,1253
CIUDAD DE MÉXICO,COYOACAN,37,293,1,331,1743
CIUDAD DE MÉXICO,COYOACAN,38,337,2,377,1743
CIUDAD DE MÉXICO,COYOACAN,46,353,1,400,1812
CIUDAD DE MÉXICO,COYOACAN,31,329,6,366,1812
CIUDAD DE MÉXICO,COYOACAN,24,267,3,294,1924
CIUDAD DE MÉXICO,COYOACAN,26,270,3,299,1924
CIUDAD DE MÉXICO,COYOACAN,34,244,0,278,1784
CIUDAD DE MÉXICO,COYOACAN,33,284,2,319,1783
CIUDAD DE MÉXICO,COYOACAN,43,204,2,249,1445
CIUDAD DE MÉXICO,COYOACAN,48,184,2,234,1445
CIUDAD DE MÉXICO,COYOACAN,32,259,5,296,1800
CIUDAD DE MÉXICO,COYOACAN,39,307,6,352,1800
CIUDAD DE MÉXICO,COYOACAN,47,296,12,355,1772
CIUDAD DE MÉXICO,COYOACAN,29,303,5,337,1772
CIUDAD DE MÉXICO,COYOACAN,48,293,9,350,1709
CIUDAD DE MÉXICO,COYOACAN,42,330,5,377,1709
CIUDAD DE MÉXICO,COYOACAN,50,345,9,404,1899
CIUDAD DE MÉXICO,COYOACAN,55,370,6,431,1898
CIUDAD DE MÉXICO,COYOACAN,21,185,1,207,1491
CIUDAD DE MÉXICO,COYOACAN,20,184,0,204,1491
CIUDAD DE MÉXICO,COYOACAN,27,203,3,233,1490
CIUDAD DE MÉXICO,COYOACAN,27,213,6,246,1459
CIUDAD DE MÉXICO,COYOACAN,41,200,1,242,1459
DURANGO,VICTORIA DE DURANGO,4,162,2,168,1533
DURANGO,VICTORIA DE DURANGO,7,152,2,161,1533
DURANGO,VICTORIA DE DURANGO,15,140,1,156,2145
DURANGO,VICTORIA DE DURANGO,29,147,2,178,2144
DURANGO,VICTORIA DE DURANGO,24,133,3,160,2144
DURANGO,VICTORIA DE DURANGO,16,190,1,207,2254
DURANGO,VICTORIA DE DURANGO,19,165,1,185,2253
DURANGO,VICTORIA DE DURANGO,23,213,3,239,2253
DURANGO,VICTORIA DE DURANGO,32,266,0,298,2289
DURANGO,VICTORIA DE DURANGO,29,242,4,275,2288
DURANGO,VICTORIA DE DURANGO,31,174,4,209,1772
DURANGO,VICTORIA DE DURANGO,29,162,1,192,1771
DURANGO,VICTORIA DE DURANGO,22,154,2,178,1885
DURANGO,VICTORIA DE DURANGO,17,157,2,176,1885
DURANGO,VICTORIA DE DURANGO,19,187,1,207,1884
DURANGO,VICTORIA DE DURANGO,15,65,4,84,1344
DURANGO,VICTORIA DE DURANGO,10,70,0,80,1344
DURANGO,VICTORIA DE DURANGO,19,124,0,143,2082
DURANGO,VICTORIA DE DURANGO,14,137,0,151,2082
DURANGO,VICTORIA DE DURANGO,23,160,1,184,2082
DURANGO,VICTORIA DE DURANGO,22,147,0,169,1776
DURANGO,VICTORIA DE DURANGO,13,126,1,140,1776
DURANGO,VICTORIA DE DURANGO,12,147,0,159,1776
DURANGO,VICTORIA DE DURANGO,21,143,3,167,1775
DURANGO,VICTORIA DE DURANGO,38,269,3,310,2322
DURANGO,VICTORIA DE DURANGO,30,164,4,198,1617
DURANGO,VICTORIA DE DURANGO,24,165,2,191,1617
DURANGO,VICTORIA DE DURANGO,25,224,0,249,1925
DURANGO,VICTORIA DE DURANGO,24,175,4,203,1924
DURANGO,VICTORIA DE DURANGO,39,212,1,252,2109
DURANGO,VICTORIA DE DURANGO,34,212,3,249,2109
DURANGO,VICTORIA DE DURANGO,21,244,3,268,2174
DURANGO,VICTORIA DE DURANGO,25,199,0,224,2173
DURANGO,VICTORIA DE DURANGO,28,124,0,152,1685
DURANGO,VICTORIA DE DURANGO,29,134,0,163,1684
DURANGO,VICTORIA DE DURANGO,19,165,2,186,1684
DURANGO,VICTORIA DE DURANGO,18,141,0,159,1683
DURANGO,VICTORIA DE DURANGO,14,155,3,172,1682
DURANGO,VICTORIA DE DURANGO,8,191,3,202,1551
DURANGO,VICTORIA DE DURANGO,9,162,1,172,1550
DURANGO,VICTORIA DE DURANGO,27,202,6,235,1998
DURANGO,VICTORIA DE DURANGO,28,224,0,252,1998
DURANGO,VICTORIA DE DURANGO,8,127,2,137,1832
DURANGO,VICTORIA DE DURANGO,12,114,2,128,1831
DURANGO,VICTORIA DE DURANGO,17,173,1,191,2152
DURANGO,VICTORIA DE DURANGO,15,174,2,191,2152
DURANGO,VICTORIA DE DURANGO,17,163,2,182,2208
DURANGO,VICTORIA DE DURANGO,18,132,2,152,2207
DURANGO,VICTORIA DE DURANGO,14,106,1,121,1794
DURANGO,VICTORIA DE DURANGO,10,134,2,146,1794
DURANGO,VICTORIA DE DURANGO,17,125,1,143,1794
DURANGO,VICTORIA DE DURANGO,8,106,0,114,1596
DURANGO,VICTORIA DE DURANGO,9,106,2,117,1595
DURANGO,VICTORIA DE DURANGO,9,73,1,83,1515
DURANGO,VICTORIA DE DURANGO,5,64,0,69,1514
DURANGO,VICTORIA DE DURANGO,16,155,0,171,1630
DURANGO,VICTORIA DE DURANGO,15,149,3,167,1629
DURANGO,VICTORIA DE DURANGO,21,165,2,188,1578
DURANGO,VICTORIA DE DURANGO,24,138,2,164,1577
DURANGO,VICTORIA DE DURANGO,62,649,10,721,0
DURANGO,VICTORIA DE DURANGO,9,109,0,118,1804
DURANGO,VICTORIA DE DURANGO,11,130,2,143,1804
DURANGO,VICTORIA DE DURANGO,10,99,2,111,1623
DURANGO,VICTORIA DE DURANGO,16,102,1,119,1622
DURANGO,VICTORIA DE DURANGO,3,85,1,89,1622
DURANGO,VICTORIA DE DURANGO,25,65,1,91,1619
DURANGO,VICTORIA DE DURANGO,19,51,0,70,1618
DURANGO,VICTORIA DE DURANGO,23,49,0,72,1618
DURANGO,VICTORIA DE DURANGO,12,119,2,133,1891
DURANGO,VICTORIA DE DURANGO,13,108,5,126,1891
DURANGO,VICTORIA DE DURANGO,5,109,1,115,1891
DURANGO,VICTORIA DE DURANGO,37,141,5,183,2284
DURANGO,VICTORIA DE DURANGO,32,147,3,182,2283
DURANGO,VICTORIA DE DURANGO,11,100,1,112,1746
DURANGO,VICTORIA DE DURANGO,9,85,1,95,1745
DURANGO,VICTORIA DE DURANGO,11,60,3,74,1898
DURANGO,VICTORIA DE DURANGO,10,50,2,62,1898
DURANGO,VICTORIA DE DURANGO,8,90,3,101,2082
DURANGO,VICTORIA DE DURANGO,6,76,0,82,2082
DURANGO,VICTORIA DE DURANGO,15,100,3,118,2082
DURANGO,VICTORIA DE DURANGO,9,44,0,53,1654
DURANGO,VICTORIA DE DURANGO,3,44,0,47,1653
DURANGO,VICTORIA DE DURANGO,12,77,3,92,1987
DURANGO,VICTORIA DE DURANGO,6,69,1,76,1987
DURANGO,VICTORIA DE DURANGO,4,30,0,34,1402
DURANGO,VICTORIA DE DURANGO,8,43,1,52,1401
DURANGO,VICTORIA DE DURANGO,3,135,0,138,2533
DURANGO,VICTORIA DE DURANGO,2,150,0,152,1658
DURANGO,VICTORIA DE DURANGO,9,131,4,144,1658
DURANGO,VICTORIA DE DURANGO,14,90,7,111,1823
DURANGO,VICTORIA DE DURANGO,11,77,8,96,1417
DURANGO,VICTORIA DE DURANGO,14,76,13,103,1417
DURANGO,VICTORIA DE DURANGO,15,192,6,213,1921
DURANGO,VICTORIA DE DURANGO,21,170,11,202,1920
DURANGO,VICTORIA DE DURANGO,11,144,5,160,2250
DURANGO,VICTORIA DE DURANGO,9,136,5,150,2250
DURANGO,VICTORIA DE DURANGO,19,66,8,93,2215
DURANGO,VICTORIA DE DURANGO,14,90,10,114,2214
DURANGO,VICTORIA DE DURANGO,0,229,14,243,2312
DURANGO,VICTORIA DE DURANGO,31,255,29,315,2311
DURANGO,VICTORIA DE DURANGO,24,230,14,268,1849
DURANGO,VICTORIA DE DURANGO,10,410,11,431,1849
DURANGO,VICTORIA DE DURANGO,16,267,5,288,1869
DURANGO,VICTORIA DE DURANGO,13,311,14,338,1868
DURANGO,VICTORIA DE DURANGO,11,142,3,156,1972
DURANGO,VICTORIA DE DURANGO,11,157,4,172,1972
DURANGO,VICTORIA DE DURANGO,18,154,4,176,1652
DURANGO,VICTORIA DE DURANGO,12,136,0,148,1652
DURANGO,VICTORIA DE DURANGO,5,134,0,139,1822
DURANGO,VICTORIA DE DURANGO,2,157,1,160,1822
DURANGO,VICTORIA DE DURANGO,10,151,1,162,1954
DURANGO,VICTORIA DE DURANGO,9,175,1,185,1954
DURANGO,VICTORIA DE DURANGO,11,114,1,126,1743
DURANGO,VICTORIA DE DURANGO,9,138,2,149,1742
DURANGO,VICTORIA DE DURANGO,10,133,1,144,1742
DURANGO,VICTORIA DE DURANGO,5,80,1,86,1847
DURANGO,VICTORIA DE DURANGO,16,184,1,201,1676
DURANGO,VICTORIA DE DURANGO,8,156,3,167,1675
DURANGO,VICTORIA DE DURANGO,25,201,2,228,1675
DURANGO,VICTORIA DE DURANGO,2,93,1,96,2216
DURANGO,VICTORIA DE DURANGO,4,114,2,120,2215
DURANGO,VICTORIA DE DURANGO,5,18,3,26,1824
DURANGO,VICTORIA DE DURANGO,5,23,1,29,1823
DURANGO,VICTORIA DE DURANGO,10,34,1,45,1823
DURANGO,VICTORIA DE DURANGO,8,241,8,257,2124
DURANGO,VICTORIA DE DURANGO,7,246,3,256,2123
DURANGO,VICTORIA DE DURANGO,4,238,2,244,2123
DURANGO,VICTORIA DE DURANGO,7,155,5,167,2113
DURANGO,VICTORIA DE DURANGO,8,190,1,199,2112
DURANGO,VICTORIA DE DURANGO,5,173,1,179,2112
DURANGO,VICTORIA DE DURANGO,7,83,0,90,2154
DURANGO,VICTORIA DE DURANGO,4,68,1,73,2154
DURANGO,VICTORIA DE DURANGO,7,63,1,71,2154
DURANGO,VICTORIA DE DURANGO,8,97,4,109,2293
DURANGO,VICTORIA DE DURANGO,6,101,1,108,2293
DURANGO,VICTORIA DE DURANGO,12,146,1,159,1792
DURANGO,VICTORIA DE DURANGO,8,157,5,170,1792
DURANGO,VICTORIA DE DURANGO,12,150,4,166,1792
DURANGO,VICTORIA DE DURANGO,14,194,4,212,2362
DURANGO,VICTORIA DE DURANGO,15,198,3,216,2361
DURANGO,VICTORIA DE DURANGO,8,104,0,112,2318
DURANGO,VICTORIA DE DURANGO,9,125,3,137,2317
DURANGO,VICTORIA DE DURANGO,10,148,2,160,2317
DURANGO,VICTORIA DE DURANGO,8,134,1,143,1481
DURANGO,VICTORIA DE DURANGO,6,117,0,123,1481
DURANGO,VICTORIA DE DURANGO,10,137,3,150,1558
DURANGO,VICTORIA DE DURANGO,8,127,3,138,1558
DURANGO,VICTORIA DE DURANGO,11,120,3,134,1759
DURANGO,VICTORIA DE DURANGO,11,127,9,147,1758
DURANGO,VICTORIA DE DURANGO,3,145,2,150,1818
DURANGO,VICTORIA DE DURANGO,7,167,5,179,1817
DURANGO,VICTORIA DE DURANGO,8,130,2,140,1817
DURANGO,VICTORIA DE DURANGO,9,349,7,365,1851
DURANGO,VICTORIA DE DURANGO,5,270,13,288,1851
DURANGO,VICTORIA DE DURANGO,0,261,3,264,1851
DURANGO,VICTORIA DE DURANGO,5,300,6,311,1851
DURANGO,VICTORIA DE DURANGO,9,138,3,150,1706
DURANGO,VICTORIA DE DURANGO,7,151,6,164,1706
DURANGO,VICTORIA DE DURANGO,5,208,2,215,1706
DURANGO,VICTORIA DE DURANGO,7,214,4,225,2091
DURANGO,VICTORIA DE DURANGO,8,206,5,219,2090
DURANGO,VICTORIA DE DURANGO,5,124,1,130,2229
DURANGO,VICTORIA DE DURANGO,4,153,3,160,2228
DURANGO,VICTORIA DE DURANGO,4,99,0,103,1955
DURANGO,VICTORIA DE DURANGO,3,121,0,124,1955
DURANGO,VICTORIA DE DURANGO,3,116,0,119,1954
DURANGO,VICTORIA DE DURANGO,1,82,0,83,2250
DURANGO,VICTORIA DE DURANGO,1,88,2,91,2250
DURANGO,VICTORIA DE DURANGO,6,61,1,68,2249
DURANGO,VICTORIA DE DURANGO,9,238,0,247,1939
DURANGO,VICTORIA DE DURANGO,11,223,1,235,1938
DURANGO,VICTORIA DE DURANGO,7,154,6,167,1631
DURANGO,VICTORIA DE DURANGO,7,201,4,212,1631
DURANGO,VICTORIA DE DURANGO,10,224,3,237,1630
DURANGO,VICTORIA DE DURANGO,7,203,1,211,2022
DURANGO,VICTORIA DE DURANGO,13,218,2,233,2022
DURANGO,VICTORIA DE DURANGO,5,219,2,226,1794
DURANGO,VICTORIA DE DURANGO,6,191,3,200,1793
DURANGO,VICTORIA DE DURANGO,2,169,2,173,1793
DURANGO,GOMEZ PALACIO,27,253,3,283,1681
DURANGO,GOMEZ PALACIO,25,245,3,273,1680
DURANGO,GOMEZ PALACIO,9,159,2,170,1239
DURANGO,GOMEZ PALACIO,4,135,0,139,1238
DURANGO,GOMEZ PALACIO,12,218,2,232,1635
DURANGO,GOMEZ PALACIO,7,232,2,241,1635
DURANGO,GOMEZ PALACIO,15,218,0,233,1635
DURANGO,GOMEZ PALACIO,2,221,0,223,1634
DURANGO,GOMEZ PALACIO,11,234,1,246,1634
DURANGO,GOMEZ PALACIO,12,285,1,298,1892
DURANGO,GOMEZ PALACIO,16,271,2,289,1891
DURANGO,GOMEZ PALACIO,11,189,1,201,1626
DURANGO,GOMEZ PALACIO,8,177,2,187,1626
DURANGO,GOMEZ PALACIO,9,175,1,185,1626
DURANGO,GOMEZ PALACIO,5,152,0,157,1626
DURANGO,GOMEZ PALACIO,5,161,0,166,1626
DURANGO,GOMEZ PALACIO,5,134,0,139,1709
DURANGO,GOMEZ PALACIO,9,126,4,139,1709
DURANGO,GOMEZ PALACIO,8,127,0,135,1709
DURANGO,GOMEZ PALACIO,11,137,0,148,1709
DURANGO,GOMEZ PALACIO,2,126,1,129,1708
DURANGO,GOMEZ PALACIO,19,234,0,253,1813
DURANGO,GOMEZ PALACIO,24,239,1,264,1813
DURANGO,GOMEZ PALACIO,16,206,8,230,1813
DURANGO,GOMEZ PALACIO,15,215,0,230,1813
DURANGO,GOMEZ PALACIO,15,223,0,238,1813
DURANGO,GOMEZ PALACIO,41,291,1,333,1685
DURANGO,GOMEZ PALACIO,35,327,2,364,1685
DURANGO,GOMEZ PALACIO,17,320,4,341,1905
DURANGO,GOMEZ PALACIO,20,282,3,305,1905
DURANGO,GOMEZ PALACIO,10,296,6,312,1738
DURANGO,GOMEZ PALACIO,10,288,5,303,1737
DURANGO,GOMEZ PALACIO,17,316,4,337,1782
DURANGO,GOMEZ PALACIO,12,281,2,295,1782
DURANGO,GOMEZ PALACIO,16,328,0,344,1971
DURANGO,GOMEZ PALACIO,13,314,5,332,1970
DURANGO,GOMEZ PALACIO,19,236,2,257,1281
DURANGO,GOMEZ PALACIO,12,221,2,235,1281
DURANGO,GOMEZ PALACIO,17,269,1,287,1689
DURANGO,GOMEZ PALACIO,10,264,5,279,1688
DURANGO,GOMEZ PALACIO,4,300,1,305,1976
DURANGO,GOMEZ PALACIO,10,306,2,318,1975
DURANGO,GOMEZ PALACIO,10,328,2,340,1748
DURANGO,GOMEZ PALACIO,17,320,2,339,1748
DURANGO,GOMEZ PALACIO,12,323,2,337,1748
DURANGO,GOMEZ PALACIO,22,314,8,344,1894
DURANGO,GOMEZ PALACIO,19,346,4,369,1893
DURANGO,GOMEZ PALACIO,11,185,8,204,1699
DURANGO,GOMEZ PALACIO,12,194,2,208,1699
DURANGO,GOMEZ PALACIO,6,211,1,218,1723
DURANGO,GOMEZ PALACIO,3,246,2,251,1723
DURANGO,GOMEZ PALACIO,12,203,1,216,1823
DURANGO,GOMEZ PALACIO,8,184,0,192,1823
DURANGO,GOMEZ PALACIO,16,236,2,254,1822
DURANGO,GOMEZ PALACIO,7,214,4,225,1822
DURANGO,GOMEZ PALACIO,6,240,3,249,1822
DURANGO,GOMEZ PALACIO,11,230,1,242,1822
DURANGO,GOMEZ PALACIO,10,215,4,229,1822
DURANGO,GOMEZ PALACIO,7,188,1,196,1210
DURANGO,GOMEZ PALACIO,6,152,0,158,1210
DURANGO,GOMEZ PALACIO,5,190,3,198,1520
DURANGO,GOMEZ PALACIO,11,167,4,182,1519
DURANGO,GOMEZ PALACIO,19,219,0,238,1377
DURANGO,GOMEZ PALACIO,13,220,0,233,1377
DURANGO,GOMEZ PALACIO,15,228,1,244,1376
DURANGO,GOMEZ PALACIO,20,304,2,326,1814
DURANGO,GOMEZ PALACIO,17,325,2,344,1814
DURANGO,GOMEZ PALACIO,21,328,6,355,1819
DURANGO,GOMEZ PALACIO,33,327,5,365,1819
DURANGO,GOMEZ PALACIO,5,309,5,319,1796
DURANGO,GOMEZ PALACIO,11,278,10,299,1795
DURANGO,GOMEZ PALACIO,6,161,2,169,1431
DURANGO,GOMEZ PALACIO,5,140,0,145,1431
DURANGO,GOMEZ PALACIO,6,179,1,186,1431
DURANGO,GOMEZ PALACIO,20,227,2,249,1689
DURANGO,GOMEZ PALACIO,21,257,4,282,1689
DURANGO,GOMEZ PALACIO,18,254,2,274,1689
DURANGO,GOMEZ PALACIO,27,220,1,248,1588
DURANGO,GOMEZ PALACIO,27,206,3,236,1588
DURANGO,GOMEZ PALACIO,23,184,1,208,1241
DURANGO,GOMEZ PALACIO,8,170,3,181,1241
DURANGO,GOMEZ PALACIO,11,285,2,298,1718
DURANGO,GOMEZ PALACIO,13,286,1,300,1717
DURANGO,GOMEZ PALACIO,9,205,0,214,1454
DURANGO,GOMEZ PALACIO,7,222,4,233,1454
DURANGO,GOMEZ PALACIO,6,200,2,208,1454
DURANGO,GOMEZ PALACIO,24,194,1,219,1793
DURANGO,GOMEZ PALACIO,28,188,1,217,1793
DURANGO,GOMEZ PALACIO,23,184,4,211,1793
DURANGO,GOMEZ PALACIO,43,110,1,154,1240
DURANGO,GOMEZ PALACIO,33,86,1,120,1240
DURANGO,GOMEZ PALACIO,8,252,0,260,1994
DURANGO,GOMEZ PALACIO,15,183,6,204,1994
DURANGO,GOMEZ PALACIO,10,214,3,227,1994
DURANGO,GOMEZ PALACIO,10,214,2,226,1993
DURANGO,GOMEZ PALACIO,11,242,0,253,1993
DURANGO,GOMEZ PALACIO,39,811,5,855,0
DURANGO,GOMEZ PALACIO,14,276,0,290,1698
DURANGO,GOMEZ PALACIO,17,252,1,270,1697
DURANGO,GOMEZ PALACIO,9,193,2,204,1755
DURANGO,GOMEZ PALACIO,7,225,4,236,1755
DURANGO,GOMEZ PALACIO,3,215,2,220,1754
DURANGO,GOMEZ PALACIO,7,216,3,226,1554
DURANGO,GOMEZ PALACIO,4,244,1,249,1554
DURANGO,GOMEZ PALACIO,2,204,1,207,1626
DURANGO,GOMEZ PALACIO,2,252,2,256,1625
DURANGO,GOMEZ PALACIO,12,223,3,238,1662
DURANGO,GOMEZ PALACIO,11,234,1,246,1662
DURANGO,GOMEZ PALACIO,2,219,1,222,1662
DURANGO,GOMEZ PALACIO,1,172,2,175,1730
DURANGO,GOMEZ PALACIO,9,177,4,190,1729
DURANGO,GOMEZ PALACIO,5,184,0,189,1361
DURANGO,GOMEZ PALACIO,2,171,0,173,1361
DURANGO,GOMEZ PALACIO,6,189,3,198,1361
DURANGO,GOMEZ PALACIO,7,197,2,206,1963
DURANGO,GOMEZ PALACIO,0,213,8,221,1962
DURANGO,GOMEZ PALACIO,10,368,4,382,1649
DURANGO,GOMEZ PALACIO,9,403,4,416,1648
DURANGO,GOMEZ PALACIO,3,193,1,197,1693
DURANGO,GOMEZ PALACIO,5,200,2,207,1693
DURANGO,GOMEZ PALACIO,6,151,3,160,1693
DURANGO,GOMEZ PALACIO,13,167,0,180,1548
DURANGO,GOMEZ PALACIO,7,160,0,167,1548
DURANGO,GOMEZ PALACIO,3,280,2,285,1229
DURANGO,GOMEZ PALACIO,6,271,0,277,1228
DURANGO,GOMEZ PALACIO,8,177,2,187,1973
DURANGO,GOMEZ PALACIO,15,187,2,204,1973
DURANGO,GOMEZ PALACIO,3,203,6,212,1371
DURANGO,GOMEZ PALACIO,4,191,5,200,1370
DURANGO,GOMEZ PALACIO,3,200,0,203,1370
DURANGO,GOMEZ PALACIO,4,76,4,84,1896
DURANGO,GOMEZ PALACIO,4,101,1,106,1895
DURANGO,GOMEZ PALACIO,3,76,2,81,1895
DURANGO,GOMEZ PALACIO,6,205,4,215,1079
DURANGO,GOMEZ PALACIO,5,248,1,254,1079
DURANGO,GOMEZ PALACIO,6,147,26,179,1913
DURANGO,GOMEZ PALACIO,8,181,10,199,1913
DURANGO,GOMEZ PALACIO,7,167,1,175,1843
DURANGO,GOMEZ PALACIO,7,161,2,170,1843
DURANGO,GOMEZ PALACIO,9,150,2,161,1843
DURANGO,GOMEZ PALACIO,17,173,1,191,1843
DURANGO,GOMEZ PALACIO,6,131,1,138,1629
DURANGO,GOMEZ PALACIO,3,135,1,139,1629
DURANGO,GOMEZ PALACIO,6,137,2,145,1099
DURANGO,GOMEZ PALACIO,8,140,0,148,1099
DURANGO,GOMEZ PALACIO,10,206,5,221,1284
DURANGO,GOMEZ PALACIO,8,183,5,196,1283
DURANGO,GOMEZ PALACIO,13,304,5,322,1973
DURANGO,GOMEZ PALACIO,13,301,1,315,1973
DURANGO,GOMEZ PALACIO,5,45,1,51,1879
DURANGO,GOMEZ PALACIO,3,54,3,60,1879
DURANGO,GOMEZ PALACIO,2,71,1,74,1878
DURANGO,GOMEZ PALACIO,2,47,0,49,1878
DURANGO,GOMEZ PALACIO,8,92,4,104,1351
DURANGO,GOMEZ PALACIO,12,135,2,149,1351
DURANGO,GOMEZ PALACIO,7,70,0,77,1217
DURANGO,GOMEZ PALACIO,4,81,3,88,1217
DURANGO,GOMEZ PALACIO,11,245,2,258,1713
DURANGO,GOMEZ PALACIO,3,194,3,200,1712
DURANGO,GOMEZ PALACIO,8,226,5,239,1712
DURANGO,GOMEZ PALACIO,7,198,3,208,1802
DURANGO,GOMEZ PALACIO,15,182,4,201,1801
DURANGO,GOMEZ PALACIO,11,277,3,291,1867
DURANGO,GOMEZ PALACIO,3,278,3,284,1867
DURANGO,GOMEZ PALACIO,9,291,6,306,1867
DURANGO,GOMEZ PALACIO,3,149,1,153,1629
DURANGO,GOMEZ PALACIO,4,113,0,117,1628
DURANGO,GOMEZ PALACIO,10,170,5,185,1740
DURANGO,GOMEZ PALACIO,5,211,0,216,1740
DURANGO,GOMEZ PALACIO,5,181,3,189,1739
DURANGO,GOMEZ PALACIO,1,180,5,186,1739
DURANGO,GOMEZ PALACIO,7,96,2,105,1855
DURANGO,GOMEZ PALACIO,6,112,4,122,1854
DURANGO,GOMEZ PALACIO,5,89,1,95,1854
DURANGO,GOMEZ PALACIO,8,88,4,100,1854
DURANGO,GOMEZ PALACIO,1,128,4,133,1854
DURANGO,GOMEZ PALACIO,9,112,1,122,1349
DURANGO,GOMEZ PALACIO,4,106,2,112,1348
DURANGO,GOMEZ PALACIO,6,111,3,120,1542
DURANGO,GOMEZ PALACIO,3,103,5,111,1542
DURANGO,GOMEZ PALACIO,3,85,1,89,1541
DURANGO,GOMEZ PALACIO,5,170,1,176,1757
DURANGO,GOMEZ PALACIO,6,173,5,184,1757
DURANGO,GOMEZ PALACIO,6,192,2,200,1757
DURANGO,GOMEZ PALACIO,6,315,2,323,1508
DURANGO,GOMEZ PALACIO,13,305,2,320,1507
DURANGO,GOMEZ PALACIO,9,275,2,286,1507
DURANGO,GOMEZ PALACIO,8,306,3,317,1507
DURANGO,GOMEZ PALACIO,5,277,8,290,1133
DURANGO,GOMEZ PALACIO,8,250,1,259,1133
DURANGO,GOMEZ PALACIO,9,405,0,414,1832
DURANGO,GOMEZ PALACIO,5,406,3,414,1832
DURANGO,GOMEZ PALACIO,6,195,0,201,1969
DURANGO,GOMEZ PALACIO,14,207,0,221,1969
DURANGO,GOMEZ PALACIO,8,191,2,201,1969
DURANGO,GOMEZ PALACIO,8,246,0,254,1816
DURANGO,GOMEZ PALACIO,10,211,1,222,1815
DURANGO,GOMEZ PALACIO,11,168,0,179,1283
DURANGO,GOMEZ PALACIO,9,186,0,195,1283
DURANGO,GOMEZ PALACIO,15,207,15,237,1701
DURANGO,GOMEZ PALACIO,16,225,2,243,1701
DURANGO,GOMEZ PALACIO,9,172,1,182,1701
DURANGO,GOMEZ PALACIO,16,179,0,195,1701
DURANGO,GUADALUPE VICTORIA,6,138,1,145,1521
DURANGO,GUADALUPE VICTORIA,7,77,0,84,1521
DURANGO,GUADALUPE VICTORIA,9,107,1,117,1520
DURANGO,GUADALUPE VICTORIA,5,104,1,110,1520
DURANGO,GUADALUPE VICTORIA,5,147,3,155,1934
DURANGO,GUADALUPE VICTORIA,11,186,1,198,1934
DURANGO,GUADALUPE VICTORIA,13,156,4,173,1566
DURANGO,GUADALUPE VICTORIA,14,162,3,179,1565
DURANGO,GUADALUPE VICTORIA,10,57,2,69,1418
DURANGO,GUADALUPE VICTORIA,5,63,0,68,1417
DURANGO,GUADALUPE VICTORIA,7,79,0,86,1940
DURANGO,GUADALUPE VICTORIA,80,2,3,85,1939
DURANGO,GUADALUPE VICTORIA,14,141,4,159,1384
DURANGO,GUADALUPE VICTORIA,10,138,1,149,1384
DURANGO,GUADALUPE VICTORIA,6,83,3,92,1260
DURANGO,GUADALUPE VICTORIA,2,109,3,114,1260
DURANGO,GUADALUPE VICTORIA,6,204,0,210,1460
DURANGO,GUADALUPE VICTORIA,9,267,2,278,1459
DURANGO,GUADALUPE VICTORIA,10,136,1,147,1656
DURANGO,GUADALUPE VICTORIA,5,156,1,162,1655
DURANGO,GUADALUPE VICTORIA,4,188,1,193,1655
DURANGO,GUADALUPE VICTORIA,8,161,2,171,1655
DURANGO,GUADALUPE VICTORIA,6,181,5,192,1895
DURANGO,GUADALUPE VICTORIA,11,175,3,189,1894
DURANGO,GUADALUPE VICTORIA,13,182,0,195,1894
DURANGO,GUADALUPE VICTORIA,6,164,6,176,1562
DURANGO,GUADALUPE VICTORIA,3,146,5,154,1561
DURANGO,GUADALUPE VICTORIA,0,145,4,149,1561
DURANGO,GUADALUPE VICTORIA,3,105,0,108,1071
DURANGO,GUADALUPE VICTORIA,3,109,1,113,1071
DURANGO,GUADALUPE VICTORIA,6,164,1,171,1947
DURANGO,GUADALUPE VICTORIA,5,219,2,226,1947
DURANGO,GUADALUPE VICTORIA,4,78,1,83,1482
DURANGO,GUADALUPE VICTORIA,3,108,1,112,1481
DURANGO,GUADALUPE VICTORIA,2,222,4,228,1470
DURANGO,GUADALUPE VICTORIA,6,190,4,200,1470
DURANGO,GUADALUPE VICTORIA,8,220,4,232,1469
DURANGO,GUADALUPE VICTORIA,8,147,6,161,1333
DURANGO,GUADALUPE VICTORIA,9,140,0,149,1333
DURANGO,GUADALUPE VICTORIA,9,114,4,127,1332
DURANGO,GUADALUPE VICTORIA,9,159,1,169,1250
DURANGO,GUADALUPE VICTORIA,19,149,2,170,1250
DURANGO,GUADALUPE VICTORIA,12,133,1,146,1429
DURANGO,GUADALUPE VICTORIA,15,194,2,211,1429
DURANGO,GUADALUPE VICTORIA,9,155,2,166,1429
DURANGO,GUADALUPE VICTORIA,8,107,1,116,1571
DURANGO,GUADALUPE VICTORIA,8,140,1,149,1570
DURANGO,GUADALUPE VICTORIA,5,143,1,149,1570
DURANGO,GUADALUPE VICTORIA,7,128,2,137,1431
DURANGO,GUADALUPE VICTORIA,8,99,2,109,1431
DURANGO,GUADALUPE VICTORIA,5,100,0,105,1365
DURANGO,GUADALUPE VICTORIA,7,101,0,108,1365
DURANGO,GUADALUPE VICTORIA,1,112,0,113,1364
DURANGO,GUADALUPE VICTORIA,5,116,2,123,1751
DURANGO,GUADALUPE VICTORIA,8,138,1,147,1751
DURANGO,GUADALUPE VICTORIA,8,130,1,139,1810
DURANGO,GUADALUPE VICTORIA,11,150,8,169,1810
DURANGO,GUADALUPE VICTORIA,18,232,7,257,1705
DURANGO,GUADALUPE VICTORIA,13,225,1,239,1705
DURANGO,GUADALUPE VICTORIA,9,223,2,234,1705
DURANGO,GUADALUPE VICTORIA,11,227,2,240,1704
DURANGO,GUADALUPE VICTORIA,36,210,0,246,1308
DURANGO,GUADALUPE VICTORIA,28,195,6,229,1308
DURANGO,GUADALUPE VICTORIA,19,262,2,283,1746
DURANGO,GUADALUPE VICTORIA,17,244,0,261,1746
DURANGO,GUADALUPE VICTORIA,16,268,3,287,1745
DURANGO,GUADALUPE VICTORIA,20,233,5,258,1460
DURANGO,GUADALUPE VICTORIA,20,215,3,238,1460
DURANGO,GUADALUPE VICTORIA,22,319,2,343,1814
DURANGO,GUADALUPE VICTORIA,19,335,0,354,1814
DURANGO,GUADALUPE VICTORIA,24,161,3,188,1456
DURANGO,GUADALUPE VICTORIA,11,195,2,208,1456
DURANGO,GUADALUPE VICTORIA,11,188,3,202,1814
DURANGO,GUADALUPE VICTORIA,19,195,2,216,1814
DURANGO,GUADALUPE VICTORIA,13,183,0,196,1813
DURANGO,GUADALUPE VICTORIA,11,199,0,210,1813
DURANGO,GUADALUPE VICTORIA,11,208,1,220,1813
DURANGO,GUADALUPE VICTORIA,17,163,3,183,1030
DURANGO,GUADALUPE VICTORIA,19,179,1,199,1030
DURANGO,GUADALUPE VICTORIA,10,156,1,167,1469
DURANGO,GUADALUPE VICTORIA,5,158,1,164,1469
DURANGO,GUADALUPE VICTORIA,9,131,0,140,1468
DURANGO,GUADALUPE VICTORIA,29,224,1,254,1779
DURANGO,GUADALUPE VICTORIA,23,238,2,263,1778
DURANGO,GUADALUPE VICTORIA,18,177,0,195,1450
DURANGO,GUADALUPE VICTORIA,1,226,2,229,1450
DURANGO,GUADALUPE VICTORIA,7,234,2,243,1793
DURANGO,GUADALUPE VICTORIA,13,244,3,260,1792
DURANGO,GUADALUPE VICTORIA,12,233,3,248,1915
DURANGO,GUADALUPE VICTORIA,12,272,4,288,1914
DURANGO,GUADALUPE VICTORIA,17,187,5,209,1201
DURANGO,GUADALUPE VICTORIA,9,232,1,242,1200
DURANGO,GUADALUPE VICTORIA,22,236,1,259,0
DURANGO,GUADALUPE VICTORIA,5,207,1,213,1615
DURANGO,GUADALUPE VICTORIA,4,180,5,189,1615
DURANGO,GUADALUPE VICTORIA,12,212,6,230,1615
DURANGO,GUADALUPE VICTORIA,6,226,0,232,1619
DURANGO,GUADALUPE VICTORIA,9,209,3,221,1619
DURANGO,GUADALUPE VICTORIA,6,238,4,248,1619
DURANGO,GUADALUPE VICTORIA,3,103,1,107,1188
DURANGO,GUADALUPE VICTORIA,3,154,0,157,1187
DURANGO,GUADALUPE VICTORIA,11,191,1,203,1224
DURANGO,GUADALUPE VICTORIA,4,183,4,191,1224
DURANGO,GUADALUPE VICTORIA,3,230,4,237,1710
DURANGO,GUADALUPE VICTORIA,9,243,2,254,1709
DURANGO,GUADALUPE VICTORIA,1,203,0,204,1709
DURANGO,GUADALUPE VICTORIA,4,175,9,188,1922
DURANGO,GUADALUPE VICTORIA,10,182,8,200,1921
DURANGO,GUADALUPE VICTORIA,4,189,5,198,1921
DURANGO,GUADALUPE VICTORIA,8,228,2,238,1782
DURANGO,GUADALUPE VICTORIA,7,221,1,229,1781
DURANGO,GUADALUPE VICTORIA,8,202,3,213,1738
DURANGO,GUADALUPE VICTORIA,4,186,4,194,1738
DURANGO,GUADALUPE VICTORIA,9,179,1,189,1737
DURANGO,GUADALUPE VICTORIA,9,234,4,247,1773
DURANGO,GUADALUPE VICTORIA,2,148,42,192,1773
DURANGO,GUADALUPE VICTORIA,6,267,5,278,1773
DURANGO,GUADALUPE VICTORIA,12,176,28,216,1772
DURANGO,GUADALUPE VICTORIA,6,307,8,321,1625
DURANGO,GUADALUPE VICTORIA,4,357,4,365,1624
DURANGO,GUADALUPE VICTORIA,8,173,1,182,1894
DURANGO,GUADALUPE VICTORIA,5,201,4,210,1893
DURANGO,GUADALUPE VICTORIA,12,258,6,276,1620
DURANGO,GUADALUPE VICTORIA,15,272,4,291,1619
DURANGO,GUADALUPE VICTORIA,8,256,5,269,1619
DURANGO,GUADALUPE VICTORIA,2,167,5,174,1552
DURANGO,GUADALUPE VICTORIA,1,163,3,167,1552
DURANGO,GUADALUPE VICTORIA,4,143,4,151,1552
DURANGO,GUADALUPE VICTORIA,6,261,5,272,1479
DURANGO,GUADALUPE VICTORIA,10,303,9,322,1479
DURANGO,GUADALUPE VICTORIA,6,231,5,242,1478
DURANGO,GUADALUPE VICTORIA,18,358,3,379,1789
DURANGO,GUADALUPE VICTORIA,6,394,3,403,1789
DURANGO,GUADALUPE VICTORIA,4,347,5,356,1788
DURANGO,GUADALUPE VICTORIA,4,194,4,202,1839
DURANGO,GUADALUPE VICTORIA,10,173,2,185,1839
DURANGO,GUADALUPE VICTORIA,10,182,0,192,1839
DURANGO,GUADALUPE VICTORIA,6,183,2,191,1838
DURANGO,GUADALUPE VICTORIA,4,167,0,171,1403
DURANGO,GUADALUPE VICTORIA,3,136,1,140,1403
DURANGO,GUADALUPE VICTORIA,4,151,2,157,1403
DURANGO,GUADALUPE VICTORIA,10,139,1,150,1372
DURANGO,GUADALUPE VICTORIA,5,138,3,146,1372
DURANGO,GUADALUPE VICTORIA,1,151,1,153,1147
DURANGO,GUADALUPE VICTORIA,10,147,0,157,1146
DURANGO,GUADALUPE VICTORIA,8,219,3,230,1842
DURANGO,GUADALUPE VICTORIA,9,189,1,199,1841
DURANGO,GUADALUPE VICTORIA,5,78,3,86,1846
DURANGO,GUADALUPE VICTORIA,7,75,0,82,1845
DURANGO,GUADALUPE VICTORIA,6,129,2,137,1187
DURANGO,GUADALUPE VICTORIA,5,129,2,136,1187
DURANGO,GUADALUPE VICTORIA,2,34,0,36,1343
DURANGO,GUADALUPE VICTORIA,1,37,0,38,1343
DURANGO,GUADALUPE VICTORIA,2,40,2,44,1342
DURANGO,GUADALUPE VICTORIA,4,87,0,91,1851
DURANGO,GUADALUPE VICTORIA,1,67,0,68,1851
DURANGO,GUADALUPE VICTORIA,2,67,0,69,1851
DURANGO,GUADALUPE VICTORIA,0,53,0,53,1850
DURANGO,GUADALUPE VICTORIA,9,163,4,176,1881
DURANGO,GUADALUPE VICTORIA,8,168,2,178,1881
DURANGO,GUADALUPE VICTORIA,8,139,3,150,1957
DURANGO,GUADALUPE VICTORIA,2,121,0,123,1957
DURANGO,GUADALUPE VICTORIA,6,133,3,142,1177
DURANGO,GUADALUPE VICTORIA,6,100,5,111,1176
DURANGO,GUADALUPE VICTORIA,5,73,3,81,1174
DURANGO,GUADALUPE VICTORIA,2,71,2,75,1174
DURANGO,GUADALUPE VICTORIA,13,183,4,200,1593
DURANGO,GUADALUPE VICTORIA,0,196,3,199,1593
DURANGO,GUADALUPE VICTORIA,3,179,1,183,1593
DURANGO,GUADALUPE VICTORIA,10,169,2,181,1593
DURANGO,GUADALUPE VICTORIA,5,163,1,169,1543
DURANGO,GUADALUPE VICTORIA,7,167,2,176,1543
DURANGO,GUADALUPE VICTORIA,2,111,0,113,1827
DURANGO,GUADALUPE VICTORIA,8,139,5,152,1826
DURANGO,GUADALUPE VICTORIA,19,178,4,201,1717
DURANGO,GUADALUPE VICTORIA,11,163,2,176,1716
DURANGO,GUADALUPE VICTORIA,9,211,1,221,1613
DURANGO,GUADALUPE VICTORIA,6,152,3,161,1612
DURANGO,GUADALUPE VICTORIA,9,118,2,129,1241
DURANGO,GUADALUPE VICTORIA,0,139,2,141,1241
DURANGO,GUADALUPE VICTORIA,2,135,2,139,1789
DURANGO,GUADALUPE VICTORIA,9,136,2,147,1788
DURANGO,GUADALUPE VICTORIA,3,73,1,77,1060
DURANGO,GUADALUPE VICTORIA,3,69,2,74,1059
DURANGO,GUADALUPE VICTORIA,9,124,1,134,1330
DURANGO,GUADALUPE VICTORIA,3,118,2,123,1329
DURANGO,GUADALUPE VICTORIA,6,183,0,189,1797
DURANGO,GUADALUPE VICTORIA,4,129,1,134,1797
DURANGO,GUADALUPE VICTORIA,1,152,0,153,1797
DURANGO,GUADALUPE VICTORIA,5,119,0,124,1797
DURANGO,GUADALUPE VICTORIA,10,144,4,158,1465
DURANGO,GUADALUPE VICTORIA,10,109,2,121,1464
DURANGO,GUADALUPE VICTORIA,9,254,6,269,1682
DURANGO,GUADALUPE VICTORIA,7,264,6,277,1682
DURANGO,GUADALUPE VICTORIA,8,283,4,295,1682
DURANGO,GUADALUPE VICTORIA,7,338,6,351,1682
DURANGO,GUADALUPE VICTORIA,7,112,3,122,1748
DURANGO,GUADALUPE VICTORIA,3,122,3,128,1748
DURANGO,GUADALUPE VICTORIA,6,151,2,159,1748
DURANGO,GUADALUPE VICTORIA,4,119,1,124,1748
DURANGO,GUADALUPE VICTORIA,15,551,4,570,1889
DURANGO,GUADALUPE VICTORIA,15,260,11,286,1447
DURANGO,GUADALUPE VICTORIA,11,211,12,234,1446
DURANGO,GUADALUPE VICTORIA,11,236,9,256,1446
DURANGO,VICTORIA DE DURANGO,45,153,3,201,1852
DURANGO,VICTORIA DE DURANGO,31,158,1,190,1851
DURANGO,VICTORIA DE DURANGO,34,157,2,193,1851
DURANGO,VICTORIA DE DURANGO,23,151,2,176,1851
DURANGO,VICTORIA DE DURANGO,9,93,1,103,1516
DURANGO,VICTORIA DE DURANGO,12,132,2,146,1515
DURANGO,VICTORIA DE DURANGO,14,100,0,114,1515
DURANGO,VICTORIA DE DURANGO,8,135,1,144,1707
DURANGO,VICTORIA DE DURANGO,21,151,0,172,1706
DURANGO,VICTORIA DE DURANGO,10,168,0,178,1706
DURANGO,VICTORIA DE DURANGO,16,148,0,164,1706
DURANGO,VICTORIA DE DURANGO,15,139,1,155,1706
DURANGO,VICTORIA DE DURANGO,20,150,1,171,1745
DURANGO,VICTORIA DE DURANGO,13,130,4,147,1744
DURANGO,VICTORIA DE DURANGO,25,176,2,203,1626
DURANGO,VICTORIA DE DURANGO,16,163,0,179,1626
DURANGO,VICTORIA DE DURANGO,23,118,1,142,1835
DURANGO,VICTORIA DE DURANGO,16,111,3,130,1835
DURANGO,VICTORIA DE DURANGO,18,105,4,127,1835
DURANGO,VICTORIA DE DURANGO,16,114,2,132,1834
DURANGO,VICTORIA DE DURANGO,10,155,2,167,1834
DURANGO,VICTORIA DE DURANGO,15,105,2,122,1834
DURANGO,VICTORIA DE DURANGO,5,103,1,109,1865
DURANGO,VICTORIA DE DURANGO,5,125,2,132,1865
DURANGO,VICTORIA DE DURANGO,12,65,0,77,1499
DURANGO,VICTORIA DE DURANGO,11,86,3,100,1499
DURANGO,VICTORIA DE DURANGO,7,107,1,115,1499
DURANGO,VICTORIA DE DURANGO,12,141,6,159,2061
DURANGO,VICTORIA DE DURANGO,9,145,1,155,1317
DURANGO,VICTORIA DE DURANGO,12,146,3,161,1317
DURANGO,VICTORIA DE DURANGO,11,122,0,133,1822
DURANGO,VICTORIA DE DURANGO,18,109,1,128,1821
DURANGO,VICTORIA DE DURANGO,11,100,1,112,1486
DURANGO,VICTORIA DE DURANGO,0,91,1,92,1485
DURANGO,VICTORIA DE DURANGO,8,75,0,83,1485
DURANGO,VICTORIA DE DURANGO,10,125,2,137,2004
DURANGO,VICTORIA DE DURANGO,9,128,3,140,2004
DURANGO,VICTORIA DE DURANGO,9,101,1,111,1553
DURANGO,VICTORIA DE DURANGO,16,78,2,96,1553
DURANGO,VICTORIA DE DURANGO,12,77,1,90,1552
DURANGO,VICTORIA DE DURANGO,3,88,0,91,1186
DURANGO,VICTORIA DE DURANGO,11,85,0,96,1186
DURANGO,VICTORIA DE DURANGO,9,145,3,157,1709
DURANGO,VICTORIA DE DURANGO,12,102,1,115,1708
DURANGO,VICTORIA DE DURANGO,7,134,1,142,1923
DURANGO,VICTORIA DE DURANGO,14,130,3,147,1923
DURANGO,VICTORIA DE DURANGO,2,84,0,86,1119
DURANGO,VICTORIA DE DURANGO,10,112,0,122,1119
DURANGO,VICTORIA DE DURANGO,13,165,0,178,1779
DURANGO,VICTORIA DE DURANGO,13,187,1,201,1779
DURANGO,VICTORIA DE DURANGO,26,112,3,141,1345
DURANGO,VICTORIA DE DURANGO,21,151,1,173,1344
DURANGO,VICTORIA DE DURANGO,22,149,2,173,1731
DURANGO,VICTORIA DE DURANGO,15,136,5,156,1731
DURANGO,VICTORIA DE DURANGO,25,205,3,233,1678
DURANGO,VICTORIA DE DURANGO,37,199,1,237,1678
DURANGO,VICTORIA DE DURANGO,19,234,3,256,1956
DURANGO,VICTORIA DE DURANGO,25,183,3,211,1955
DURANGO,VICTORIA DE DURANGO,20,143,3,166,1349
DURANGO,VICTORIA DE DURANGO,22,140,0,162,1349
DURANGO,VICTORIA DE DURANGO,31,167,2,200,1822
DURANGO,VICTORIA DE DURANGO,20,166,0,186,1821
DURANGO,VICTORIA DE DURANGO,164,19,0,183,2043
DURANGO,VICTORIA DE DURANGO,27,138,2,167,2043
DURANGO,VICTORIA DE DURANGO,22,154,1,177,2043
DURANGO,VICTORIA DE DURANGO,16,139,0,155,2042
DURANGO,VICTORIA DE DURANGO,19,131,1,151,2042
DURANGO,VICTORIA DE DURANGO,24,179,2,205,2042
DURANGO,VICTORIA DE DURANGO,16,150,3,169,1880
DURANGO,VICTORIA DE DURANGO,28,129,3,160,1879
DURANGO,VICTORIA DE DURANGO,33,145,1,179,1749
DURANGO,VICTORIA DE DURANGO,37,167,3,207,1749
DURANGO,VICTORIA DE DURANGO,14,174,1,189,1545
DURANGO,VICTORIA DE DURANGO,13,132,5,150,1545
DURANGO,VICTORIA DE DURANGO,11,126,1,138,1545
DURANGO,VICTORIA DE DURANGO,16,112,0,128,1498
DURANGO,VICTORIA DE DURANGO,9,127,0,136,1498
DURANGO,VICTORIA DE DURANGO,9,123,2,134,1498
DURANGO,VICTORIA DE DURANGO,10,119,2,131,1553
DURANGO,VICTORIA DE DURANGO,17,108,2,127,1553
DURANGO,VICTORIA DE DURANGO,5,67,2,74,1495
DURANGO,VICTORIA DE DURANGO,10,55,0,65,1494
DURANGO,VICTORIA DE DURANGO,4,101,3,108,1862
DURANGO,VICTORIA DE DURANGO,6,86,0,92,1862
DURANGO,VICTORIA DE DURANGO,9,134,2,145,1504
DURANGO,VICTORIA DE DURANGO,9,79,0,88,1504
DURANGO,VICTORIA DE DURANGO,7,98,3,108,1504
DURANGO,VICTORIA DE DURANGO,17,159,1,177,1887
DURANGO,VICTORIA DE DURANGO,14,181,3,198,1886
DURANGO,VICTORIA DE DURANGO,17,108,2,127,1464
DURANGO,VICTORIA DE DURANGO,16,137,0,153,1463
DURANGO,VICTORIA DE DURANGO,14,137,0,151,1463
DURANGO,VICTORIA DE DURANGO,109,782,15,906,0
DURANGO,VICTORIA DE DURANGO,12,110,0,122,1279
DURANGO,VICTORIA DE DURANGO,16,127,1,144,1279
DURANGO,VICTORIA DE DURANGO,10,207,0,217,1954
DURANGO,VICTORIA DE DURANGO,18,179,3,200,1954
DURANGO,VICTORIA DE DURANGO,5,122,1,128,1147
DURANGO,VICTORIA DE DURANGO,5,127,5,137,1147
DURANGO,VICTORIA DE DURANGO,34,181,3,218,1740
DURANGO,VICTORIA DE DURANGO,20,146,3,169,1739
DURANGO,VICTORIA DE DURANGO,31,195,2,228,1906
DURANGO,VICTORIA DE DURANGO,31,156,1,188,1906
DURANGO,VICTORIA DE DURANGO,22,111,3,136,1206
DURANGO,VICTORIA DE DURANGO,14,132,2,148,1205
DURANGO,VICTORIA DE DURANGO,27,123,0,150,1400
DURANGO,VICTORIA DE DURANGO,15,111,2,128,1399
DURANGO,VICTORIA DE DURANGO,16,130,2,148,1399
DURANGO,VICTORIA DE DURANGO,34,161,1,196,1929
DURANGO,VICTORIA DE DURANGO,34,146,1,181,1928
DURANGO,VICTORIA DE DURANGO,42,141,1,184,2003
DURANGO,VICTORIA DE DURANGO,49,158,2,209,2003
DURANGO,VICTORIA DE DURANGO,24,166,1,191,1686
DURANGO,VICTORIA DE DURANGO,29,156,1,186,1685
DURANGO,VICTORIA DE DURANGO,16,118,1,135,1463
DURANGO,VICTORIA DE DURANGO,10,92,1,103,1462
DURANGO,VICTORIA DE DURANGO,20,167,2,189,1966
DURANGO,VICTORIA DE DURANGO,17,156,1,174,1965
DURANGO,VICTORIA DE DURANGO,32,191,2,225,1683
DURANGO,VICTORIA DE DURANGO,26,194,1,221,1683
DURANGO,VICTORIA DE DURANGO,33,134,2,169,1756
DURANGO,VICTORIA DE DURANGO,36,152,0,188,1756
DURANGO,VICTORIA DE DURANGO,24,154,3,181,1756
DURANGO,VICTORIA DE DURANGO,24,183,2,209,1821
DURANGO,VICTORIA DE DURANGO,13,156,4,173,1820
DURANGO,VICTORIA DE DURANGO,23,153,1,177,1598
DURANGO,VICTORIA DE DURANGO,25,157,2,184,1597
DURANGO,VICTORIA DE DURANGO,18,163,1,182,1423
DURANGO,VICTORIA DE DURANGO,16,136,2,154,1422
DURANGO,VICTORIA DE DURANGO,27,126,0,153,1957
DURANGO,VICTORIA DE DURANGO,14,123,0,137,1956
DURANGO,VICTORIA DE DURANGO,10,78,1,89,1883
DURANGO,VICTORIA DE DURANGO,9,94,1,104,1882
DURANGO,VICTORIA DE DURANGO,16,102,3,121,1882
DURANGO,VICTORIA DE DURANGO,7,114,1,122,1882
DURANGO,VICTORIA DE DURANGO,16,100,3,119,1559
DURANGO,VICTORIA DE DURANGO,13,102,4,119,1559
DURANGO,VICTORIA DE DURANGO,13,132,0,145,1483
DURANGO,VICTORIA DE DURANGO,13,149,0,162,1483
DURANGO,VICTORIA DE DURANGO,16,125,2,143,1483
DURANGO,VICTORIA DE DURANGO,20,196,2,218,1873
DURANGO,VICTORIA DE DURANGO,20,210,1,231,1872
DURANGO,VICTORIA DE DURANGO,43,158,2,203,1635
DURANGO,VICTORIA DE DURANGO,26,154,0,180,1635
DURANGO,VICTORIA DE DURANGO,27,191,1,219,1634
DURANGO,VICTORIA DE DURANGO,22,205,0,227,1865
DURANGO,VICTORIA DE DURANGO,18,195,4,217,1865
DURANGO,VICTORIA DE DURANGO,23,181,1,205,1936
DURANGO,VICTORIA DE DURANGO,30,214,0,244,1936
DURANGO,VICTORIA DE DURANGO,28,190,2,220,1936
DURANGO,VICTORIA DE DURANGO,21,196,2,219,1936
DURANGO,VICTORIA DE DURANGO,18,166,2,186,2085
DURANGO,VICTORIA DE DURANGO,16,76,3,95,1427
DURANGO,VICTORIA DE DURANGO,15,104,4,123,1427
DURANGO,VICTORIA DE DURANGO,20,200,1,221,2073
DURANGO,VICTORIA DE DURANGO,25,224,1,250,2150
DURANGO,VICTORIA DE DURANGO,40,304,4,348,2137
DURANGO,VICTORIA DE DURANGO,29,137,0,166,1789
DURANGO,VICTORIA DE DURANGO,18,147,0,165,1789
DURANGO,VICTORIA DE DURANGO,24,206,1,231,1697
DURANGO,VICTORIA DE DURANGO,0,191,1,192,1697
DURANGO,VICTORIA DE DURANGO,13,184,3,200,1740
DURANGO,VICTORIA DE DURANGO,15,175,1,191,1740
DURANGO,VICTORIA DE DURANGO,18,214,3,235,1740
DURANGO,VICTORIA DE DURANGO,19,155,1,175,1851
DURANGO,VICTORIA DE DURANGO,19,191,0,210,1851
DURANGO,VICTORIA DE DURANGO,4,58,1,63,1552
DURANGO,VICTORIA DE DURANGO,10,79,0,89,1552
DURANGO,VICTORIA DE DURANGO,22,204,0,226,1807
DURANGO,VICTORIA DE DURANGO,33,199,2,234,1807
DURANGO,VICTORIA DE DURANGO,5,62,1,68,1937
DURANGO,VICTORIA DE DURANGO,7,81,0,88,2159
DURANGO,VICTORIA DE DURANGO,1,74,2,77,2158
DURANGO,VICTORIA DE DURANGO,9,122,0,131,2105
DURANGO,VICTORIA DE DURANGO,8,113,1,122,2104
DURANGO,VICTORIA DE DURANGO,8,69,2,79,1902
DURANGO,VICTORIA DE DURANGO,6,56,3,65,1902
DURANGO,VICTORIA DE DURANGO,5,66,2,73,1449
DURANGO,VICTORIA DE DURANGO,6,54,3,63,1449
DURANGO,VICTORIA DE DURANGO,4,73,1,78,2057
DURANGO,VICTORIA DE DURANGO,15,78,1,94,2057
DURANGO,VICTORIA DE DURANGO,9,97,2,108,2057
DURANGO,VICTORIA DE DURANGO,7,100,2,109,2057
DURANGO,VICTORIA DE DURANGO,12,93,1,106,2057
DURANGO,VICTORIA DE DURANGO,11,87,0,98,2057
DURANGO,VICTORIA DE DURANGO,4,58,3,65,1925
DURANGO,VICTORIA DE DURANGO,6,77,2,85,1924
DURANGO,VICTORIA DE DURANGO,13,112,1,126,1865
DURANGO,VICTORIA DE DURANGO,6,125,0,131,1864
DURANGO,VICTORIA DE DURANGO,14,117,1,132,1676
DURANGO,VICTORIA DE DURANGO,13,104,0,117,1676
DURANGO,VICTORIA DE DURANGO,13,154,1,168,1617
DURANGO,VICTORIA DE DURANGO,27,132,0,159,1617
DURANGO,VICTORIA DE DURANGO,15,148,1,164,1790
DURANGO,VICTORIA DE DURANGO,10,128,1,139,1790
DURANGO,VICTORIA DE DURANGO,6,133,0,139,1789
DURANGO,VICTORIA DE DURANGO,18,171,0,189,1992
DURANGO,VICTORIA DE DURANGO,24,179,2,205,1991
DURANGO,VICTORIA DE DURANGO,7,145,1,153,1422
DURANGO,VICTORIA DE DURANGO,8,130,3,141,1422
DURANGO,VICTORIA DE DURANGO,5,128,0,133,1422
GUANAJUATO,SAN LUIS DE LA PAZ,3,202,15,220,1682
GUANAJUATO,SAN LUIS DE LA PAZ,4,198,3,205,1681
GUANAJUATO,SAN LUIS DE LA PAZ,7,186,7,200,1093
GUANAJUATO,SAN LUIS DE LA PAZ,6,175,5,186,1093
GUANAJUATO,SAN LUIS DE LA PAZ,14,248,4,266,1655
GUANAJUATO,SAN LUIS DE LA PAZ,11,260,15,286,1654
GUANAJUATO,SAN LUIS DE LA PAZ,11,226,8,245,1757
GUANAJUATO,SAN LUIS DE LA PAZ,8,202,10,220,1756
GUANAJUATO,SAN LUIS DE LA PAZ,9,193,6,208,1382
GUANAJUATO,SAN LUIS DE LA PAZ,14,189,7,210,1382
GUANAJUATO,SAN LUIS DE LA PAZ,14,217,4,235,1511
GUANAJUATO,SAN LUIS DE LA PAZ,10,211,6,227,1511
GUANAJUATO,SAN LUIS DE LA PAZ,7,103,1,111,1813
GUANAJUATO,SAN LUIS DE LA PAZ,6,112,8,126,1813
GUANAJUATO,SAN LUIS DE LA PAZ,8,264,4,276,1663
GUANAJUATO,SAN LUIS DE LA PAZ,24,194,8,226,1662
GUANAJUATO,SAN LUIS DE LA PAZ,8,231,2,241,1662
GUANAJUATO,SAN LUIS DE LA PAZ,13,75,3,91,1396
GUANAJUATO,SAN LUIS DE LA PAZ,12,79,3,94,1395
GUANAJUATO,SAN LUIS DE LA PAZ,17,142,1,160,1725
GUANAJUATO,SAN LUIS DE LA PAZ,8,105,3,116,1725
GUANAJUATO,SAN LUIS DE LA PAZ,12,143,0,155,1775
GUANAJUATO,SAN LUIS DE LA PAZ,3,133,7,143,1774
GUANAJUATO,SAN LUIS DE LA PAZ,77,472,8,557,0
GUANAJUATO,SAN LUIS DE LA PAZ,11,93,1,105,1490
GUANAJUATO,SAN LUIS DE LA PAZ,15,97,2,114,1489
GUANAJUATO,SAN LUIS DE LA PAZ,8,135,2,145,1782
GUANAJUATO,SAN LUIS DE LA PAZ,14,151,2,167,1782
GUANAJUATO,SAN LUIS DE LA PAZ,13,120,0,133,1739
GUANAJUATO,SAN LUIS DE LA PAZ,17,112,0,129,1738
GUANAJUATO,SAN LUIS DE LA PAZ,13,137,2,152,1748
GUANAJUATO,SAN LUIS DE LA PAZ,9,141,2,152,1747
GUANAJUATO,SAN LUIS DE LA PAZ,13,138,5,156,1747
GUANAJUATO,SAN LUIS DE LA PAZ,12,103,2,117,1080
GUANAJUATO,SAN LUIS DE LA PAZ,9,109,0,118,1079
GUANAJUATO,SAN LUIS DE LA PAZ,16,70,6,92,1880
GUANAJUATO,SAN LUIS DE LA PAZ,16,72,3,91,1879
GUANAJUATO,SAN LUIS DE LA PAZ,13,120,2,135,1885
GUANAJUATO,SAN LUIS DE LA PAZ,18,112,3,133,1885
GUANAJUATO,SAN LUIS DE LA PAZ,14,92,1,107,1501
GUANAJUATO,SAN LUIS DE LA PAZ,13,84,3,100,1501
GUANAJUATO,SAN LUIS DE LA PAZ,5,56,31,92,1501
GUANAJUATO,SAN LUIS DE LA PAZ,19,159,3,181,1837
GUANAJUATO,SAN LUIS DE LA PAZ,19,129,0,148,1837
GUANAJUATO,SAN LUIS DE LA PAZ,6,69,0,75,1681
GUANAJUATO,SAN LUIS DE LA PAZ,8,68,0,76,1681
GUANAJUATO,SAN LUIS DE LA PAZ,7,77,2,86,1450
GUANAJUATO,SAN LUIS DE LA PAZ,11,97,3,111,1450
GUANAJUATO,SAN LUIS DE LA PAZ,17,102,1,120,1504
GUANAJUATO,SAN LUIS DE LA PAZ,14,77,1,92,1504
GUANAJUATO,SAN LUIS DE LA PAZ,16,87,3,106,1504
GUANAJUATO,SAN LUIS DE LA PAZ,45,106,3,154,1882
GUANAJUATO,SAN LUIS DE LA PAZ,24,115,2,141,1881
GUANAJUATO,SAN LUIS DE LA PAZ,52,103,1,156,1881
GUANAJUATO,SAN LUIS DE LA PAZ,20,91,10,121,1962
GUANAJUATO,SAN LUIS DE LA PAZ,13,108,4,125,1962
GUANAJUATO,SAN LUIS DE LA PAZ,13,96,5,114,1678
GUANAJUATO,SAN LUIS DE LA PAZ,21,91,4,116,1678
GUANAJUATO,SAN LUIS DE LA PAZ,11,69,3,83,1157
GUANAJUATO,SAN LUIS DE LA PAZ,12,77,6,95,1157
GUANAJUATO,SAN LUIS DE LA PAZ,15,85,6,106,1468
GUANAJUATO,SAN LUIS DE LA PAZ,17,73,4,94,1467
GUANAJUATO,SAN LUIS DE LA PAZ,13,87,4,104,1828
GUANAJUATO,SAN LUIS DE LA PAZ,15,74,9,98,1827
GUANAJUATO,SAN LUIS DE LA PAZ,6,97,3,106,1635
GUANAJUATO,SAN LUIS DE LA PAZ,5,82,2,89,1634
GUANAJUATO,SAN LUIS DE LA PAZ,5,30,1,36,1797
GUANAJUATO,SAN LUIS DE LA PAZ,10,30,0,40,1796
GUANAJUATO,SAN LUIS DE LA PAZ,19,37,4,60,1354
GUANAJUATO,SAN LUIS DE LA PAZ,7,64,1,72,1354
GUANAJUATO,SAN LUIS DE LA PAZ,5,53,2,60,1354
GUANAJUATO,SAN LUIS DE LA PAZ,22,70,6,98,1248
GUANAJUATO,SAN LUIS DE LA PAZ,16,78,11,105,1248
GUANAJUATO,SAN LUIS DE LA PAZ,18,51,8,77,1898
GUANAJUATO,SAN LUIS DE LA PAZ,17,46,2,65,1897
GUANAJUATO,SAN LUIS DE LA PAZ,12,82,6,100,1851
GUANAJUATO,SAN LUIS DE LA PAZ,9,84,11,104,1851
GUANAJUATO,SAN LUIS DE LA PAZ,6,112,4,122,1851
GUANAJUATO,SAN LUIS DE LA PAZ,16,58,4,78,1070
GUANAJUATO,SAN LUIS DE LA PAZ,8,54,2,64,1069
GUANAJUATO,SAN LUIS DE LA PAZ,8,59,5,72,1453
GUANAJUATO,SAN LUIS DE LA PAZ,6,48,3,57,1453
GUANAJUATO,SAN LUIS DE LA PAZ,18,111,4,133,1675
GUANAJUATO,SAN LUIS DE LA PAZ,18,131,9,158,1675
GUANAJUATO,SAN LUIS DE LA PAZ,19,87,20,126,1674
GUANAJUATO,SAN LUIS DE LA PAZ,18,91,9,118,1661
GUANAJUATO,SAN LUIS DE LA PAZ,23,56,10,89,1661
GUANAJUATO,SAN LUIS DE LA PAZ,17,52,14,83,1403
GUANAJUATO,SAN LUIS DE LA PAZ,15,55,10,80,1403
GUANAJUATO,SAN LUIS DE LA PAZ,7,48,10,65,1402
GUANAJUATO,SAN LUIS DE LA PAZ,13,94,0,107,1315
GUANAJUATO,SAN LUIS DE LA PAZ,11,83,2,96,1314
GUANAJUATO,SAN LUIS DE LA PAZ,6,89,1,96,1475
GUANAJUATO,SAN LUIS DE LA PAZ,6,79,6,91,1475
GUANAJUATO,SAN LUIS DE LA PAZ,13,106,1,120,1511
GUANAJUATO,SAN LUIS DE LA PAZ,10,119,7,136,1510
GUANAJUATO,SAN LUIS DE LA PAZ,19,136,5,160,1604
GUANAJUATO,SAN LUIS DE LA PAZ,13,142,3,158,1603
GUANAJUATO,SAN LUIS DE LA PAZ,7,143,5,155,1991
GUANAJUATO,SAN LUIS DE LA PAZ,10,146,1,157,1757
GUANAJUATO,SAN LUIS DE LA PAZ,11,152,2,165,1757
GUANAJUATO,SAN LUIS DE LA PAZ,16,112,1,129,1711
GUANAJUATO,SAN LUIS DE LA PAZ,11,120,0,131,1710
GUANAJUATO,SAN LUIS DE LA PAZ,13,115,11,139,1710
GUANAJUATO,SAN LUIS DE LA PAZ,11,130,0,141,1433
GUANAJUATO,SAN LUIS DE LA PAZ,17,119,3,139,1432
GUANAJUATO,SAN LUIS DE LA PAZ,16,109,3,128,1556
GUANAJUATO,SAN LUIS DE LA PAZ,20,121,0,141,1556
GUANAJUATO,SAN LUIS DE LA PAZ,16,93,0,109,1214
GUANAJUATO,SAN LUIS DE LA PAZ,8,85,3,96,1213
GUANAJUATO,SAN LUIS DE LA PAZ,11,95,4,110,1210
GUANAJUATO,SAN LUIS DE LA PAZ,11,93,1,105,1209
GUANAJUATO,SAN LUIS DE LA PAZ,14,118,3,135,1402
GUANAJUATO,SAN LUIS DE LA PAZ,9,140,7,156,1402
GUANAJUATO,SAN LUIS DE LA PAZ,13,117,2,132,1588
GUANAJUATO,SAN LUIS DE LA PAZ,8,89,3,100,1587
GUANAJUATO,SAN LUIS DE LA PAZ,37,91,4,132,1934
GUANAJUATO,SAN LUIS DE LA PAZ,23,37,2,62,1455
GUANAJUATO,SAN LUIS DE LA PAZ,17,38,0,55,1454
GUANAJUATO,SAN LUIS DE LA PAZ,16,71,1,88,1825
GUANAJUATO,SAN LUIS DE LA PAZ,10,57,0,67,1825
GUANAJUATO,SAN LUIS DE LA PAZ,7,18,1,26,1495
GUANAJUATO,SAN LUIS DE LA PAZ,15,34,1,50,1495
GUANAJUATO,SAN LUIS DE LA PAZ,1,26,3,30,1495
GUANAJUATO,SAN LUIS DE LA PAZ,9,21,2,32,1493
GUANAJUATO,SAN LUIS DE LA PAZ,5,30,2,37,1493
GUANAJUATO,SAN LUIS DE LA PAZ,23,73,3,99,1557
GUANAJUATO,SAN LUIS DE LA PAZ,22,66,0,88,1557
GUANAJUATO,SAN LUIS DE LA PAZ,20,73,3,96,1932
GUANAJUATO,SAN LUIS DE LA PAZ,4,52,0,56,1931
GUANAJUATO,SAN LUIS DE LA PAZ,9,79,4,92,1935
GUANAJUATO,SAN LUIS DE LA PAZ,14,74,3,91,1935
GUANAJUATO,SAN LUIS DE LA PAZ,13,76,1,90,1935
GUANAJUATO,SAN LUIS DE LA PAZ,7,76,1,84,1436
GUANAJUATO,SAN LUIS DE LA PAZ,2,56,0,58,1435
GUANAJUATO,SAN LUIS DE LA PAZ,9,53,2,64,1660
GUANAJUATO,SAN LUIS DE LA PAZ,14,54,2,70,1660
GUANAJUATO,SAN LUIS DE LA PAZ,5,83,5,93,1624
GUANAJUATO,SAN LUIS DE LA PAZ,6,72,1,79,1624
GUANAJUATO,SAN LUIS DE LA PAZ,9,96,1,106,1623
GUANAJUATO,SAN LUIS DE LA PAZ,6,33,1,40,1844
GUANAJUATO,SAN LUIS DE LA PAZ,3,39,1,43,1843
GUANAJUATO,SAN LUIS DE LA PAZ,18,46,4,68,1246
GUANAJUATO,SAN LUIS DE LA PAZ,9,40,2,51,1245
GUANAJUATO,SAN LUIS DE LA PAZ,12,111,3,126,1662
GUANAJUATO,SAN LUIS DE LA PAZ,9,96,6,111,1662
GUANAJUATO,SAN LUIS DE LA PAZ,9,101,1,111,1843
GUANAJUATO,SAN LUIS DE LA PAZ,10,78,5,93,1842
GUANAJUATO,SAN LUIS DE LA PAZ,10,121,5,136,1241
GUANAJUATO,SAN LUIS DE LA PAZ,10,93,4,107,1241
GUANAJUATO,SAN LUIS DE LA PAZ,11,150,0,161,1537
GUANAJUATO,SAN LUIS DE LA PAZ,10,150,6,166,1537
GUANAJUATO,SAN LUIS DE LA PAZ,6,124,4,134,1537
GUANAJUATO,SAN LUIS DE LA PAZ,5,159,7,171,1280
GUANAJUATO,SAN LUIS DE LA PAZ,5,127,5,137,1280
GUANAJUATO,SAN LUIS DE LA PAZ,11,227,3,241,1934
GUANAJUATO,SAN LUIS DE LA PAZ,6,187,13,206,1934
GUANAJUATO,SAN LUIS DE LA PAZ,14,241,16,271,1710
GUANAJUATO,SAN LUIS DE LA PAZ,9,258,14,281,1710
GUANAJUATO,SAN LUIS DE LA PAZ,3,186,9,198,1118
GUANAJUATO,SAN LUIS DE LA PAZ,4,159,1,164,1118
GUANAJUATO,SAN LUIS DE LA PAZ,12,177,6,195,1515
GUANAJUATO,SAN LUIS DE LA PAZ,6,164,6,176,1515
GUANAJUATO,SAN LUIS DE LA PAZ,14,249,7,270,1879
GUANAJUATO,SAN LUIS DE LA PAZ,18,241,7,266,1879
GUANAJUATO,SAN LUIS DE LA PAZ,7,54,5,66,1045
GUANAJUATO,SAN LUIS DE LA PAZ,15,90,2,107,1044
GUANAJUATO,SAN LUIS DE LA PAZ,11,174,11,196,1678
GUANAJUATO,SAN LUIS DE LA PAZ,11,157,8,176,1677
GUANAJUATO,SAN LUIS DE LA PAZ,10,169,7,186,1850
GUANAJUATO,SAN LUIS DE LA PAZ,8,173,6,187,1849
GUANAJUATO,SAN LUIS DE LA PAZ,16,215,11,242,1583
GUANAJUATO,SAN LUIS DE LA PAZ,19,221,10,250,1583
GUANAJUATO,SAN LUIS DE LA PAZ,15,222,6,243,1582
GUANAJUATO,SAN LUIS DE LA PAZ,16,171,10,197,1428
GUANAJUATO,SAN LUIS DE LA PAZ,5,126,9,140,1428
GUANAJUATO,SAN MIGUEL DE ALLENDE,18,115,0,133,1900
GUANAJUATO,SAN MIGUEL DE ALLENDE,18,120,1,139,1900
GUANAJUATO,SAN MIGUEL DE ALLENDE,8,124,0,132,1899
GUANAJUATO,SAN MIGUEL DE ALLENDE,14,171,1,186,1890
GUANAJUATO,SAN MIGUEL DE ALLENDE,18,156,2,176,1890
GUANAJUATO,SAN MIGUEL DE ALLENDE,12,104,2,118,1279
GUANAJUATO,SAN MIGUEL DE ALLENDE,18,137,1,156,1278
GUANAJUATO,SAN MIGUEL DE ALLENDE,4,97,0,101,1630
GUANAJUATO,SAN MIGUEL DE ALLENDE,5,94,2,101,1630
GUANAJUATO,SAN MIGUEL DE ALLENDE,8,79,2,89,1630
GUANAJUATO,SAN MIGUEL DE ALLENDE,8,104,0,112,1630
GUANAJUATO,SAN MIGUEL DE ALLENDE,9,166,0,175,1556
GUANAJUATO,SAN MIGUEL DE ALLENDE,18,127,5,150,1556
GUANAJUATO,SAN MIGUEL DE ALLENDE,11,108,3,122,1158
GUANAJUATO,SAN MIGUEL DE ALLENDE,8,88,0,96,1158
GUANAJUATO,SAN MIGUEL DE ALLENDE,8,120,7,135,2001
GUANAJUATO,SAN MIGUEL DE ALLENDE,15,129,2,146,2000
GUANAJUATO,SAN MIGUEL DE ALLENDE,14,114,2,130,1647
GUANAJUATO,SAN MIGUEL DE ALLENDE,18,125,3,146,1647
GUANAJUATO,SAN MIGUEL DE ALLENDE,17,142,1,160,1646
GUANAJUATO,SAN MIGUEL DE ALLENDE,7,110,2,119,1218
GUANAJUATO,SAN MIGUEL DE ALLENDE,6,97,0,103,1218
GUANAJUATO,SAN MIGUEL DE ALLENDE,19,114,2,135,1539
GUANAJUATO,SAN MIGUEL DE ALLENDE,11,108,0,119,1539
GUANAJUATO,SAN MIGUEL DE ALLENDE,8,88,0,96,1480
GUANAJUATO,SAN MIGUEL DE ALLENDE,9,85,1,95,1479
GUANAJUATO,SAN MIGUEL DE ALLENDE,8,93,2,103,1479
GUANAJUATO,SAN MIGUEL DE ALLENDE,8,126,0,134,1669
GUANAJUATO,SAN MIGUEL DE ALLENDE,16,158,2,176,1669
GUANAJUATO,SAN MIGUEL DE ALLENDE,10,126,0,136,1578
GUANAJUATO,SAN MIGUEL DE ALLENDE,8,113,1,122,1578
GUANAJUATO,SAN MIGUEL DE ALLENDE,14,99,0,113,1823
GUANAJUATO,SAN MIGUEL DE ALLENDE,11,97,1,109,1822
GUANAJUATO,SAN MIGUEL DE ALLENDE,25,156,0,181,1632
GUANAJUATO,SAN MIGUEL DE ALLENDE,20,145,3,168,1632
GUANAJUATO,SAN MIGUEL DE ALLENDE,21,152,0,173,1797
GUANAJUATO,SAN MIGUEL DE ALLENDE,20,132,0,152,1797
GUANAJUATO,SAN MIGUEL DE ALLENDE,14,75,2,91,1332
GUANAJUATO,SAN MIGUEL DE ALLENDE,17,96,1,114,1332
GUANAJUATO,SAN MIGUEL DE ALLENDE,11,67,1,79,1391
GUANAJUATO,SAN MIGUEL DE ALLENDE,14,58,1,73,1391
GUANAJUATO,SAN MIGUEL DE ALLENDE,118,590,5,713,0
GUANAJUATO,SAN MIGUEL DE ALLENDE,12,95,4,111,1941
GUANAJUATO,SAN MIGUEL DE ALLENDE,19,92,2,113,1941
GUANAJUATO,SAN MIGUEL DE ALLENDE,21,97,8,126,1885
GUANAJUATO,SAN MIGUEL DE ALLENDE,17,87,2,106,1885
GUANAJUATO,SAN MIGUEL DE ALLENDE,8,74,2,84,1621
GUANAJUATO,SAN MIGUEL DE ALLENDE,6,72,3,81,1621
GUANAJUATO,SAN MIGUEL DE ALLENDE,7,52,2,61,1620
GUANAJUATO,SAN MIGUEL DE ALLENDE,15,103,5,123,1802
GUANAJUATO,SAN MIGUEL DE ALLENDE,14,86,3,103,1802
GUANAJUATO,SAN MIGUEL DE ALLENDE,12,70,4,86,1801
GUANAJUATO,SAN MIGUEL DE ALLENDE,10,169,3,182,2013
GUANAJUATO,SAN MIGUEL DE ALLENDE,17,60,10,87,1885
GUANAJUATO,SAN MIGUEL DE ALLENDE,13,59,6,78,1884
GUANAJUATO,SAN MIGUEL DE ALLENDE,6,40,0,46,1944
GUANAJUATO,SAN MIGUEL DE ALLENDE,4,47,1,52,1944
GUANAJUATO,SAN MIGUEL DE ALLENDE,10,52,3,65,1952
GUANAJUATO,SAN MIGUEL DE ALLENDE,54,15,1,70,1952
GUANAJUATO,SAN MIGUEL DE ALLENDE,5,36,1,42,1646
GUANAJUATO,SAN MIGUEL DE ALLENDE,3,46,1,50,1646
GUANAJUATO,SAN MIGUEL DE ALLENDE,7,67,4,78,1529
GUANAJUATO,SAN MIGUEL DE ALLENDE,8,89,4,101,1528
GUANAJUATO,SAN MIGUEL DE ALLENDE,6,16,1,23,1952
GUANAJUATO,SAN MIGUEL DE ALLENDE,4,16,0,20,1952
GUANAJUATO,SAN MIGUEL DE ALLENDE,4,76,1,81,1433
GUANAJUATO,SAN MIGUEL DE ALLENDE,8,63,4,75,1433
GUANAJUATO,SAN MIGUEL DE ALLENDE,8,82,2,92,2041
GUANAJUATO,SAN MIGUEL DE ALLENDE,3,71,0,74,1647
GUANAJUATO,SAN MIGUEL DE ALLENDE,9,83,4,96,1646
GUANAJUATO,SAN MIGUEL DE ALLENDE,2,39,4,45,1441
GUANAJUATO,SAN MIGUEL DE ALLENDE,3,46,1,50,1441
GUANAJUATO,SAN MIGUEL DE ALLENDE,10,75,2,87,1515
GUANAJUATO,SAN MIGUEL DE ALLENDE,8,100,4,112,1515
GUANAJUATO,SAN MIGUEL DE ALLENDE,5,34,0,39,1618
GUANAJUATO,SAN MIGUEL DE ALLENDE,3,41,1,45,1617
GUANAJUATO,SAN MIGUEL DE ALLENDE,1,30,0,31,1617
GUANAJUATO,SAN MIGUEL DE ALLENDE,6,66,9,81,1387
GUANAJUATO,SAN MIGUEL DE ALLENDE,5,103,3,111,1387
GUANAJUATO,SAN MIGUEL DE ALLENDE,6,84,1,91,1386
GUANAJUATO,SAN MIGUEL DE ALLENDE,6,10,2,18,1927
GUANAJUATO,SAN MIGUEL DE ALLENDE,14,209,12,235,1651
GUANAJUATO,SAN MIGUEL DE ALLENDE,12,180,11,203,1651
GUANAJUATO,SAN MIGUEL DE ALLENDE,24,237,8,269,1755
GUANAJUATO,SAN MIGUEL DE ALLENDE,21,197,6,224,1754
GUANAJUATO,SAN MIGUEL DE ALLENDE,13,200,7,220,1754
GUANAJUATO,SAN MIGUEL DE ALLENDE,11,165,1,177,1388
GUANAJUATO,SAN MIGUEL DE ALLENDE,17,195,6,218,1387
GUANAJUATO,SAN MIGUEL DE ALLENDE,17,250,1,268,1723
GUANAJUATO,SAN MIGUEL DE ALLENDE,13,233,1,247,1723
GUANAJUATO,SAN MIGUEL DE ALLENDE,18,149,7,174,1274
GUANAJUATO,SAN MIGUEL DE ALLENDE,15,128,2,145,1274
GUANAJUATO,SAN MIGUEL DE ALLENDE,13,228,2,243,1925
GUANAJUATO,SAN MIGUEL DE ALLENDE,8,191,4,203,1925
GUANAJUATO,SAN MIGUEL DE ALLENDE,23,187,6,216,1771
GUANAJUATO,SAN MIGUEL DE ALLENDE,27,189,5,221,1770
GUANAJUATO,SAN MIGUEL DE ALLENDE,24,105,4,133,1342
GUANAJUATO,SAN MIGUEL DE ALLENDE,26,123,0,149,1342
GUANAJUATO,SAN MIGUEL DE ALLENDE,19,190,2,211,1996
GUANAJUATO,SAN MIGUEL DE ALLENDE,19,178,4,201,1995
GUANAJUATO,SAN MIGUEL DE ALLENDE,14,194,4,212,1577
GUANAJUATO,SAN MIGUEL DE ALLENDE,23,185,6,214,1576
GUANAJUATO,SAN MIGUEL DE ALLENDE,18,241,1,260,1920
GUANAJUATO,SAN MIGUEL DE ALLENDE,17,240,6,263,1920
GUANAJUATO,SAN MIGUEL DE ALLENDE,0,152,2,154,1892
GUANAJUATO,SAN MIGUEL DE ALLENDE,18,142,1,161,1892
GUANAJUATO,SAN MIGUEL DE ALLENDE,7,330,1,338,2028
GUANAJUATO,SAN MIGUEL DE ALLENDE,5,339,5,349,2027
GUANAJUATO,SAN MIGUEL DE ALLENDE,10,184,3,197,1936
GUANAJUATO,SAN MIGUEL DE ALLENDE,12,255,3,270,1935
GUANAJUATO,SAN MIGUEL DE ALLENDE,11,200,7,218,1520
GUANAJUATO,SAN MIGUEL DE ALLENDE,7,236,3,246,1520
GUANAJUATO,SAN MIGUEL DE ALLENDE,27,179,3,209,1948
GUANAJUATO,SAN MIGUEL DE ALLENDE,22,140,0,162,1948
GUANAJUATO,SAN MIGUEL DE ALLENDE,10,138,0,148,1031
GUANAJUATO,SAN MIGUEL DE ALLENDE,8,93,2,103,1031
GUANAJUATO,SAN MIGUEL DE ALLENDE,6,161,1,168,1496
GUANAJUATO,SAN MIGUEL DE ALLENDE,13,113,4,130,1496
GUANAJUATO,SAN MIGUEL DE ALLENDE,15,126,4,145,1486
GUANAJUATO,SAN MIGUEL DE ALLENDE,9,126,2,137,1485
GUANAJUATO,SAN MIGUEL DE ALLENDE,0,92,3,95,1573
GUANAJUATO,SAN MIGUEL DE ALLENDE,10,96,4,110,1573
GUANAJUATO,SAN MIGUEL DE ALLENDE,9,187,3,199,1952
GUANAJUATO,SAN MIGUEL DE ALLENDE,14,175,4,193,1952
GUANAJUATO,SAN MIGUEL DE ALLENDE,7,135,2,144,1464
GUANAJUATO,SAN MIGUEL DE ALLENDE,3,114,4,121,1463
GUANAJUATO,SAN MIGUEL DE ALLENDE,10,182,1,193,1384
GUANAJUATO,SAN MIGUEL DE ALLENDE,2,124,3,129,1383
GUANAJUATO,SAN MIGUEL DE ALLENDE,14,118,4,136,1770
GUANAJUATO,SAN MIGUEL DE ALLENDE,15,140,2,157,1770
GUANAJUATO,SAN MIGUEL DE ALLENDE,9,38,4,51,1425
GUANAJUATO,SAN MIGUEL DE ALLENDE,6,31,0,37,1425
GUANAJUATO,SAN MIGUEL DE ALLENDE,5,81,0,86,1924
GUANAJUATO,SAN MIGUEL DE ALLENDE,5,58,1,64,1924
GUANAJUATO,SAN MIGUEL DE ALLENDE,3,62,0,65,1658
GUANAJUATO,SAN MIGUEL DE ALLENDE,8,85,4,97,1658
GUANAJUATO,SAN MIGUEL DE ALLENDE,6,40,2,48,1678
GUANAJUATO,SAN MIGUEL DE ALLENDE,9,30,2,41,1677
GUANAJUATO,SAN MIGUEL DE ALLENDE,11,45,1,57,1677
GUANAJUATO,SAN MIGUEL DE ALLENDE,12,37,9,58,1203
GUANAJUATO,SAN MIGUEL DE ALLENDE,18,50,4,72,1202
GUANAJUATO,SAN MIGUEL DE ALLENDE,4,96,2,102,1565
GUANAJUATO,SAN MIGUEL DE ALLENDE,2,108,1,111,1564
GUANAJUATO,SAN MIGUEL DE ALLENDE,7,102,4,113,1564
GUANAJUATO,SAN MIGUEL DE ALLENDE,11,40,2,53,1774
GUANAJUATO,SAN MIGUEL DE ALLENDE,14,30,1,45,1773
GUANAJUATO,SAN MIGUEL DE ALLENDE,8,20,1,29,1773
GUANAJUATO,SAN MIGUEL DE ALLENDE,2,122,5,129,1715
GUANAJUATO,SAN MIGUEL DE ALLENDE,6,169,5,180,1714
GUANAJUATO,SAN MIGUEL DE ALLENDE,12,150,5,167,1714
GUANAJUATO,SAN MIGUEL DE ALLENDE,16,299,7,322,1857
GUANAJUATO,SAN MIGUEL DE ALLENDE,18,240,5,263,1857
GUANAJUATO,SAN MIGUEL DE ALLENDE,22,271,5,298,1991
GUANAJUATO,SAN MIGUEL DE ALLENDE,5,153,3,161,1446
GUANAJUATO,SAN MIGUEL DE ALLENDE,11,161,5,177,1445
GUANAJUATO,SAN MIGUEL DE ALLENDE,11,200,2,213,1964
GUANAJUATO,SAN MIGUEL DE ALLENDE,19,236,3,258,1964
GUANAJUATO,SAN MIGUEL DE ALLENDE,18,194,3,215,1856
GUANAJUATO,SAN MIGUEL DE ALLENDE,11,186,5,202,1856
GUANAJUATO,SAN MIGUEL DE ALLENDE,8,170,4,182,1855
GUANAJUATO,SAN MIGUEL DE ALLENDE,15,140,0,155,1423
GUANAJUATO,SAN MIGUEL DE ALLENDE,5,137,0,142,1422
GUANAJUATO,SAN MIGUEL DE ALLENDE,20,212,5,237,1804
GUANAJUATO,SAN MIGUEL DE ALLENDE,6,192,2,200,1803
GUANAJUATO,SAN MIGUEL DE ALLENDE,12,189,1,202,1802
GUANAJUATO,SAN MIGUEL DE ALLENDE,13,181,1,195,1801
GUANAJUATO,SAN MIGUEL DE ALLENDE,20,220,0,240,1943
GUANAJUATO,SAN MIGUEL DE ALLENDE,19,184,2,205,1942
GUANAJUATO,SAN MIGUEL DE ALLENDE,15,145,4,164,1375
GUANAJUATO,SAN MIGUEL DE ALLENDE,11,146,4,161,1375
GUANAJUATO,SAN MIGUEL DE ALLENDE,8,91,0,99,1828
GUANAJUATO,SAN MIGUEL DE ALLENDE,13,84,0,97,1828
GUANAJUATO,SAN MIGUEL DE ALLENDE,5,94,0,99,1514
GUANAJUATO,SAN MIGUEL DE ALLENDE,10,81,1,92,1514
GUANAJUATO,SAN MIGUEL DE ALLENDE,14,100,0,114,1513
GUANAJUATO,SAN MIGUEL DE ALLENDE,13,86,2,101,1550
GUANAJUATO,SAN MIGUEL DE ALLENDE,6,100,1,107,1550
GUANAJUATO,SAN MIGUEL DE ALLENDE,8,70,0,78,1549
GUANAJUATO,SAN MIGUEL DE ALLENDE,4,113,1,118,1757
GUANAJUATO,SAN MIGUEL DE ALLENDE,10,130,5,145,1757
GUANAJUATO,SAN MIGUEL DE ALLENDE,17,130,3,150,1651
GUANAJUATO,SAN MIGUEL DE ALLENDE,11,129,1,141,1650
GUANAJUATO,SAN MIGUEL DE ALLENDE,7,165,3,175,1650
GUANAJUATO,SAN MIGUEL DE ALLENDE,6,116,1,123,1993
GUANAJUATO,SAN MIGUEL DE ALLENDE,8,105,0,113,1993
GUANAJUATO,SAN MIGUEL DE ALLENDE,7,114,1,122,1680
GUANAJUATO,SAN MIGUEL DE ALLENDE,9,127,2,138,1679
GUANAJUATO,SAN MIGUEL DE ALLENDE,5,137,1,143,1511
GUANAJUATO,SAN MIGUEL DE ALLENDE,10,110,2,122,1511
GUANAJUATO,SAN MIGUEL DE ALLENDE,2,52,0,54,1558
GUANAJUATO,SAN MIGUEL DE ALLENDE,6,51,2,59,1558
GUANAJUATO,SAN MIGUEL DE ALLENDE,6,79,2,87,1557
GUANAJUATO,LEON,21,82,7,110,1545
GUANAJUATO,LEON,18,89,11,118,1544
GUANAJUATO,LEON,14,62,10,86,1544
GUANAJUATO,LEON,10,69,0,79,1909
GUANAJUATO,LEON,10,75,2,87,1908
GUANAJUATO,LEON,21,105,4,130,1894
GUANAJUATO,LEON,18,93,5,116,1893
GUANAJUATO,LEON,18,108,4,130,1683
GUANAJUATO,LEON,17,100,9,126,1682
GUANAJUATO,LEON,14,103,0,117,1626
GUANAJUATO,LEON,28,99,0,127,1625
GUANAJUATO,LEON,17,92,1,110,1625
GUANAJUATO,LEON,13,105,2,120,2109
GUANAJUATO,LEON,9,106,0,115,2109
GUANAJUATO,LEON,18,108,2,128,1905
GUANAJUATO,LEON,17,85,2,104,1904
GUANAJUATO,LEON,14,84,3,101,1904
GUANAJUATO,LEON,11,123,2,136,1700
GUANAJUATO,LEON,18,127,3,148,1699
GUANAJUATO,LEON,15,91,2,108,1386
GUANAJUATO,LEON,18,86,2,106,1386
GUANAJUATO,LEON,17,108,4,129,1385
GUANAJUATO,LEON,14,41,1,56,1065
GUANAJUATO,LEON,20,33,2,55,1064
GUANAJUATO,LEON,14,60,3,77,1667
GUANAJUATO,LEON,29,59,3,91,1667
GUANAJUATO,LEON,7,62,1,70,1666
GUANAJUATO,LEON,17,52,1,70,1666
GUANAJUATO,LEON,12,105,2,119,1459
GUANAJUATO,LEON,17,62,3,82,1459
GUANAJUATO,LEON,16,79,4,99,1459
GUANAJUATO,LEON,30,92,3,125,1626
GUANAJUATO,LEON,19,88,0,107,1626
GUANAJUATO,LEON,24,89,2,115,1626
GUANAJUATO,LEON,25,100,2,127,1626
GUANAJUATO,LEON,20,84,1,105,1626
GUANAJUATO,LEON,35,130,0,165,1626
GUANAJUATO,LEON,24,131,1,156,1626
GUANAJUATO,LEON,32,73,6,111,2003
GUANAJUATO,LEON,29,55,1,85,1811
GUANAJUATO,LEON,39,63,1,103,1811
GUANAJUATO,LEON,31,44,1,76,1810
GUANAJUATO,LEON,27,50,1,78,1810
GUANAJUATO,LEON,23,60,0,83,1810
GUANAJUATO,LEON,94,350,6,450,0
GUANAJUATO,LEON,29,85,0,114,1482
GUANAJUATO,LEON,31,84,1,116,1482
GUANAJUATO,LEON,45,96,1,142,1482
GUANAJUATO,LEON,20,110,4,134,1615
GUANAJUATO,LEON,221,115,1,337,1615
GUANAJUATO,LEON,15,118,3,136,1615
GUANAJUATO,LEON,25,81,0,106,1615
GUANAJUATO,LEON,22,105,2,129,1615
GUANAJUATO,LEON,13,93,1,107,1591
GUANAJUATO,LEON,25,102,3,130,1591
GUANAJUATO,LEON,32,122,2,156,1591
GUANAJUATO,LEON,31,103,3,137,1590
GUANAJUATO,LEON,26,104,1,131,1590
GUANAJUATO,LEON,16,83,0,99,1021
GUANAJUATO,LEON,13,92,1,106,1020
GUANAJUATO,LEON,20,135,2,157,1736
GUANAJUATO,LEON,26,128,3,157,1736
GUANAJUATO,LEON,19,151,6,176,1793
GUANAJUATO,LEON,21,152,3,176,1792
GUANAJUATO,LEON,30,137,2,169,1856
GUANAJUATO,LEON,19,131,2,152,1856
GUANAJUATO,LEON,29,88,1,118,1157
GUANAJUATO,LEON,18,111,3,132,1157
GUANAJUATO,LEON,18,136,9,163,1470
GUANAJUATO,LEON,10,121,3,134,1470
GUANAJUATO,LEON,15,121,1,137,1470
GUANAJUATO,LEON,35,116,0,151,1853
GUANAJUATO,LEON,40,96,1,137,1853
GUANAJUATO,LEON,44,98,0,142,1853
GUANAJUATO,LEON,48,103,0,151,1853
GUANAJUATO,LEON,23,165,3,191,1645
GUANAJUATO,LEON,15,149,6,170,1645
GUANAJUATO,LEON,39,112,0,151,1807
GUANAJUATO,LEON,41,109,2,152,1807
GUANAJUATO,LEON,14,167,4,185,1904
GUANAJUATO,LEON,16,192,4,212,1903
GUANAJUATO,LEON,15,148,4,167,1682
GUANAJUATO,LEON,19,157,3,179,1682
GUANAJUATO,LEON,12,145,4,161,1682
GUANAJUATO,LEON,26,145,2,173,1729
GUANAJUATO,LEON,13,153,4,170,1728
GUANAJUATO,LEON,10,109,1,120,1212
GUANAJUATO,LEON,11,118,2,131,1211
GUANAJUATO,LEON,28,130,1,159,1535
GUANAJUATO,LEON,25,116,4,145,1534
GUANAJUATO,LEON,13,123,4,140,1449
GUANAJUATO,LEON,20,99,3,122,1448
GUANAJUATO,LEON,26,122,3,151,1448
GUANAJUATO,LEON,22,85,0,107,1692
GUANAJUATO,LEON,31,79,3,113,1692
GUANAJUATO,LEON,27,166,3,196,1707
GUANAJUATO,LEON,20,147,7,174,1706
GUANAJUATO,LEON,16,118,4,138,1161
GUANAJUATO,LEON,17,83,2,102,1160
GUANAJUATO,LEON,15,142,2,159,1625
GUANAJUATO,LEON,15,133,4,152,1624
GUANAJUATO,LEON,27,181,11,219,1991
GUANAJUATO,LEON,24,133,2,159,1706
GUANAJUATO,LEON,27,130,7,164,1706
GUANAJUATO,LEON,33,142,3,178,1705
GUANAJUATO,LEON,15,112,4,131,1050
GUANAJUATO,LEON,11,100,3,114,1050
GUANAJUATO,LEON,18,112,7,137,1782
GUANAJUATO,LEON,20,141,3,164,1781
GUANAJUATO,LEON,24,26,0,50,1733
GUANAJUATO,LEON,29,31,2,62,1732
GUANAJUATO,LEON,11,31,2,44,1281
GUANAJUATO,LEON,6,27,2,35,1281
GUANAJUATO,LEON,19,100,2,121,1974
GUANAJUATO,LEON,18,77,1,96,1974
GUANAJUATO,LEON,30,91,3,124,1515
GUANAJUATO,LEON,19,90,1,110,1514
GUANAJUATO,LEON,20,96,1,117,1514
GUANAJUATO,LEON,21,102,4,127,1477
GUANAJUATO,LEON,29,93,2,124,1477
GUANAJUATO,LEON,21,97,1,119,1477
GUANAJUATO,LEON,35,127,0,162,1907
GUANAJUATO,LEON,31,151,1,183,1907
GUANAJUATO,LEON,9,83,1,93,1422
GUANAJUATO,LEON,11,73,3,87,1422
GUANAJUATO,LEON,11,79,5,95,1422
GUANAJUATO,LEON,43,141,2,186,1908
GUANAJUATO,LEON,26,137,3,166,1907
GUANAJUATO,LEON,10,95,4,109,1838
GUANAJUATO,LEON,25,76,1,102,1837
GUANAJUATO,LEON,15,70,4,89,1837
GUANAJUATO,LEON,26,80,1,107,1837
GUANAJUATO,LEON,22,100,3,125,1837
GUANAJUATO,LEON,23,102,1,126,1582
GUANAJUATO,LEON,21,90,1,112,1581
GUANAJUATO,LEON,34,20,0,54,1853
GUANAJUATO,LEON,22,24,0,46,1853
GUANAJUATO,LEON,21,177,2,200,1807
GUANAJUATO,LEON,20,195,8,223,1807
GUANAJUATO,LEON,22,148,0,170,1420
GUANAJUATO,LEON,14,132,1,147,1420
GUANAJUATO,LEON,138,15,2,155,1479
GUANAJUATO,LEON,27,132,2,161,1478
GUANAJUATO,LEON,37,54,2,93,2023
GUANAJUATO,LEON,34,51,1,86,2023
GUANAJUATO,LEON,39,154,5,198,2135
GUANAJUATO,LEON,41,183,5,229,2134
GUANAJUATO,LEON,31,79,2,112,1825
GUANAJUATO,LEON,27,89,1,117,1825
GUANAJUATO,LEON,16,33,0,49,1499
GUANAJUATO,LEON,27,43,0,70,1499
GUANAJUATO,LEON,23,42,1,66,1499
GUANAJUATO,LEON,30,56,1,87,1631
GUANAJUATO,LEON,37,34,1,72,1631
GUANAJUATO,LEON,29,60,0,89,1630
GUANAJUATO,LEON,33,82,2,117,1482
GUANAJUATO,LEON,30,84,4,118,1481
GUANAJUATO,LEON,25,26,0,51,1755
GUANAJUATO,LEON,14,37,0,51,1754
GUANAJUATO,LEON,18,40,1,59,1754
GUANAJUATO,LEON,21,130,2,153,1918
GUANAJUATO,LEON,21,113,2,136,1918
GUANAJUATO,LEON,20,118,3,141,1572
GUANAJUATO,LEON,9,113,1,123,1571
GUANAJUATO,LEON,25,103,2,130,1571
GUANAJUATO,LEON,18,63,0,81,2154
GUANAJUATO,LEON,9,49,0,58,2153
GUANAJUATO,LEON,6,39,1,46,1369
GUANAJUATO,LEON,7,37,0,44,1369
GUANAJUATO,LEON,7,45,2,54,1368
GUANAJUATO,LEON,10,70,4,84,1551
GUANAJUATO,LEON,10,70,2,82,1550
GUANAJUATO,LEON,18,74,1,93,1234
GUANAJUATO,LEON,11,62,0,73,1233
GUANAJUATO,LEON,23,10,2,35,2108
GUANAJUATO,LEON,30,76,3,109,2108
GUANAJUATO,LEON,10,34,1,45,1290
GUANAJUATO,LEON,8,45,3,56,1290
GUANAJUATO,LEON,16,94,2,112,1891
GUANAJUATO,LEON,19,103,1,123,1890
GUANAJUATO,LEON,22,82,2,106,1651
GUANAJUATO,LEON,17,90,1,108,1650
GUANAJUATO,LEON,14,88,1,103,1650
GUANAJUATO,GUANAJUATO,16,122,3,141,1504
GUANAJUATO,GUANAJUATO,14,136,1,151,1503
GUANAJUATO,GUANAJUATO,12,145,5,162,1503
GUANAJUATO,GUANAJUATO,9,111,7,127,1675
GUANAJUATO,GUANAJUATO,9,105,2,116,1674
GUANAJUATO,GUANAJUATO,19,170,5,194,1674
GUANAJUATO,GUANAJUATO,19,143,3,165,1674
GUANAJUATO,GUANAJUATO,9,141,1,151,1796
GUANAJUATO,GUANAJUATO,14,142,1,157,1795
GUANAJUATO,GUANAJUATO,19,159,3,181,1679
GUANAJUATO,GUANAJUATO,21,180,0,201,1679
GUANAJUATO,GUANAJUATO,6,99,10,115,1601
GUANAJUATO,GUANAJUATO,11,125,3,139,1601
GUANAJUATO,GUANAJUATO,16,133,0,149,1601
GUANAJUATO,GUANAJUATO,21,158,1,180,1859
GUANAJUATO,GUANAJUATO,20,168,2,190,1858
GUANAJUATO,GUANAJUATO,8,100,0,108,1644
GUANAJUATO,GUANAJUATO,9,107,1,117,1643
GUANAJUATO,GUANAJUATO,9,106,0,115,1643
GUANAJUATO,GUANAJUATO,8,108,2,118,1071
GUANAJUATO,GUANAJUATO,9,113,2,124,1071
GUANAJUATO,GUANAJUATO,22,125,0,147,1699
GUANAJUATO,GUANAJUATO,28,169,2,199,1699
GUANAJUATO,GUANAJUATO,11,110,2,123,1522
GUANAJUATO,GUANAJUATO,15,101,2,118,1521
GUANAJUATO,GUANAJUATO,22,135,1,158,1521
GUANAJUATO,GUANAJUATO,30,145,1,176,1786
GUANAJUATO,GUANAJUATO,20,175,0,195,1785
GUANAJUATO,GUANAJUATO,19,83,1,103,1253
GUANAJUATO,GUANAJUATO,22,112,5,139,1252
GUANAJUATO,GUANAJUATO,16,124,3,143,1848
GUANAJUATO,GUANAJUATO,16,135,5,156,1848
GUANAJUATO,GUANAJUATO,25,136,3,164,1810
GUANAJUATO,GUANAJUATO,24,134,2,160,1809
GUANAJUATO,GUANAJUATO,14,118,2,134,1465
GUANAJUATO,GUANAJUATO,11,109,1,121,1464
GUANAJUATO,GUANAJUATO,9,91,4,104,1401
GUANAJUATO,GUANAJUATO,15,113,0,128,1401
GUANAJUATO,GUANAJUATO,17,105,0,122,1682
GUANAJUATO,GUANAJUATO,12,134,5,151,1682
GUANAJUATO,GUANAJUATO,23,107,0,130,1063
GUANAJUATO,GUANAJUATO,23,90,1,114,1063
GUANAJUATO,GUANAJUATO,18,82,6,106,1589
GUANAJUATO,GUANAJUATO,0,72,2,74,1589
GUANAJUATO,GUANAJUATO,16,82,0,98,1367
GUANAJUATO,GUANAJUATO,7,45,0,52,1366
GUANAJUATO,GUANAJUATO,19,58,0,77,1911
GUANAJUATO,GUANAJUATO,9,55,1,65,1911
GUANAJUATO,GUANAJUATO,9,95,0,104,1841
GUANAJUATO,GUANAJUATO,21,81,2,104,1840
GUANAJUATO,GUANAJUATO,15,128,2,145,1806
GUANAJUATO,GUANAJUATO,9,122,6,137,1805
GUANAJUATO,GUANAJUATO,11,134,4,149,1691
GUANAJUATO,GUANAJUATO,12,148,2,162,1690
GUANAJUATO,GUANAJUATO,11,155,3,169,1690
GUANAJUATO,GUANAJUATO,21,96,2,119,1831
GUANAJUATO,GUANAJUATO,27,106,3,136,1831
GUANAJUATO,GUANAJUATO,15,146,4,165,1947
GUANAJUATO,GUANAJUATO,23,132,7,162,1947
GUANAJUATO,GUANAJUATO,15,74,3,92,1295
GUANAJUATO,GUANAJUATO,5,78,4,87,1295
GUANAJUATO,GUANAJUATO,2,14,0,16,1517
GUANAJUATO,GUANAJUATO,2,16,1,19,1517
GUANAJUATO,GUANAJUATO,10,44,1,55,1516
GUANAJUATO,GUANAJUATO,13,67,1,81,1206
GUANAJUATO,GUANAJUATO,7,62,1,70,1206
GUANAJUATO,GUANAJUATO,15,42,8,65,1352
GUANAJUATO,GUANAJUATO,22,53,4,79,1352
GUANAJUATO,GUANAJUATO,18,116,2,136,1912
GUANAJUATO,GUANAJUATO,15,108,8,131,1911
GUANAJUATO,GUANAJUATO,5,69,0,74,1506
GUANAJUATO,GUANAJUATO,9,43,0,52,1506
GUANAJUATO,GUANAJUATO,10,70,1,81,1249
GUANAJUATO,GUANAJUATO,4,52,1,57,1249
GUANAJUATO,GUANAJUATO,8,35,0,43,1919
GUANAJUATO,GUANAJUATO,12,68,3,83,1919
GUANAJUATO,GUANAJUATO,13,107,0,120,1428
GUANAJUATO,GUANAJUATO,19,161,2,182,1427
GUANAJUATO,GUANAJUATO,11,124,2,137,1555
GUANAJUATO,GUANAJUATO,12,90,5,107,1554
GUANAJUATO,GUANAJUATO,4,91,1,96,1450
GUANAJUATO,GUANAJUATO,6,119,4,129,1449
GUANAJUATO,GUANAJUATO,14,146,6,166,1696
GUANAJUATO,GUANAJUATO,21,151,20,192,1696
GUANAJUATO,GUANAJUATO,7,48,3,58,1777
GUANAJUATO,GUANAJUATO,5,29,5,39,1776
GUANAJUATO,GUANAJUATO,14,91,5,110,1288
GUANAJUATO,GUANAJUATO,20,79,7,106,1287
GUANAJUATO,GUANAJUATO,9,77,3,89,1441
GUANAJUATO,GUANAJUATO,18,111,6,135,1440
GUANAJUATO,GUANAJUATO,13,81,4,98,1417
GUANAJUATO,GUANAJUATO,31,71,1,103,1416
GUANAJUATO,GUANAJUATO,13,94,1,108,1461
GUANAJUATO,GUANAJUATO,10,98,5,113,1460
GUANAJUATO,GUANAJUATO,12,81,2,95,1460
GUANAJUATO,GUANAJUATO,13,176,17,206,1913
GUANAJUATO,GUANAJUATO,23,136,11,170,1913
GUANAJUATO,GUANAJUATO,17,90,6,113,1852
GUANAJUATO,GUANAJUATO,24,81,8,113,1851
GUANAJUATO,GUANAJUATO,15,79,1,95,1860
GUANAJUATO,GUANAJUATO,0,75,5,80,1859
GUANAJUATO,GUANAJUATO,9,66,6,81,1818
GUANAJUATO,GUANAJUATO,10,83,6,99,1817
GUANAJUATO,GUANAJUATO,10,76,4,90,1969
GUANAJUATO,GUANAJUATO,17,68,0,85,1969
GUANAJUATO,GUANAJUATO,5,61,3,69,1069
GUANAJUATO,GUANAJUATO,4,51,0,55,1068
GUANAJUATO,GUANAJUATO,7,74,11,92,1209
GUANAJUATO,GUANAJUATO,7,95,0,102,1209
GUANAJUATO,GUANAJUATO,11,113,1,125,1564
GUANAJUATO,GUANAJUATO,9,89,1,99,1563
GUANAJUATO,GUANAJUATO,9,92,0,101,1859
GUANAJUATO,GUANAJUATO,5,62,0,67,1858
GUANAJUATO,GUANAJUATO,10,108,4,122,1547
GUANAJUATO,GUANAJUATO,16,101,2,119,1546
GUANAJUATO,GUANAJUATO,22,115,2,139,1692
GUANAJUATO,GUANAJUATO,8,98,1,107,1692
GUANAJUATO,GUANAJUATO,23,149,7,179,1848
GUANAJUATO,GUANAJUATO,13,112,4,129,1848
GUANAJUATO,GUANAJUATO,10,120,3,133,1677
GUANAJUATO,GUANAJUATO,13,86,3,102,1677
GUANAJUATO,GUANAJUATO,9,120,2,131,1960
GUANAJUATO,GUANAJUATO,9,113,2,124,1960
GUANAJUATO,GUANAJUATO,30,142,5,177,1367
GUANAJUATO,GUANAJUATO,45,158,8,211,1367
GUANAJUATO,GUANAJUATO,8,128,5,141,1938
GUANAJUATO,GUANAJUATO,11,137,4,152,1937
GUANAJUATO,GUANAJUATO,24,71,3,98,1737
GUANAJUATO,GUANAJUATO,77,18,7,102,1737
GUANAJUATO,GUANAJUATO,13,152,10,175,1330
GUANAJUATO,GUANAJUATO,9,130,13,152,1330
GUANAJUATO,GUANAJUATO,15,201,11,227,1720
GUANAJUATO,GUANAJUATO,22,188,6,216,1719
GUANAJUATO,GUANAJUATO,14,161,6,181,1697
GUANAJUATO,GUANAJUATO,12,103,4,119,1697
GUANAJUATO,GUANAJUATO,22,114,3,139,1594
GUANAJUATO,GUANAJUATO,26,125,5,156,1594
GUANAJUATO,GUANAJUATO,18,111,5,134,1045
GUANAJUATO,GUANAJUATO,27,109,7,143,1044
GUANAJUATO,GUANAJUATO,25,203,13,241,1756
GUANAJUATO,GUANAJUATO,25,185,11,221,1755
GUANAJUATO,GUANAJUATO,28,197,1,226,1588
GUANAJUATO,GUANAJUATO,18,160,6,184,1588
GUANAJUATO,GUANAJUATO,8,81,5,94,1894
GUANAJUATO,GUANAJUATO,4,68,4,76,1894
GUANAJUATO,GUANAJUATO,3,138,5,146,1778
GUANAJUATO,GUANAJUATO,14,112,2,128,1778
GUANAJUATO,GUANAJUATO,12,101,4,117,1625
GUANAJUATO,GUANAJUATO,13,90,3,106,1625
GUANAJUATO,GUANAJUATO,31,67,10,108,1491
GUANAJUATO,GUANAJUATO,33,74,7,114,1490
GUANAJUATO,GUANAJUATO,15,67,2,84,1041
GUANAJUATO,GUANAJUATO,16,67,2,85,1040
GUANAJUATO,GUANAJUATO,34,154,21,209,1402
GUANAJUATO,GUANAJUATO,24,129,11,164,1402
GUANAJUATO,GUANAJUATO,45,81,7,133,1809
GUANAJUATO,GUANAJUATO,29,106,2,137,1808
GUANAJUATO,GUANAJUATO,33,106,19,158,1086
GUANAJUATO,GUANAJUATO,36,92,7,135,1085
GUANAJUATO,GUANAJUATO,26,130,8,164,1223
GUANAJUATO,GUANAJUATO,39,111,5,155,1223
GUANAJUATO,GUANAJUATO,20,131,2,153,1980
GUANAJUATO,GUANAJUATO,18,144,0,162,1980
GUANAJUATO,GUANAJUATO,23,104,4,131,1549
GUANAJUATO,GUANAJUATO,10,90,1,101,1549
GUANAJUATO,GUANAJUATO,21,88,0,109,1548
GUANAJUATO,GUANAJUATO,101,484,4,589,0
GUANAJUATO,GUANAJUATO,10,97,1,108,1309
GUANAJUATO,GUANAJUATO,14,100,0,114,1309
GUANAJUATO,GUANAJUATO,15,99,0,114,1613
GUANAJUATO,GUANAJUATO,18,115,3,136,1612
GUANAJUATO,GUANAJUATO,13,119,2,134,1612
GUANAJUATO,GUANAJUATO,15,126,0,141,1915
GUANAJUATO,GUANAJUATO,21,107,2,130,1915
GUANAJUATO,LEON,18,115,2,135,1866
GUANAJUATO,LEON,22,138,3,163,1866
GUANAJUATO,LEON,12,101,2,115,1752
GUANAJUATO,LEON,5,92,2,99,1752
GUANAJUATO,LEON,11,100,30,141,1751
GUANAJUATO,LEON,8,111,4,123,1560
GUANAJUATO,LEON,17,78,3,98,1559
GUANAJUATO,LEON,15,79,3,97,1559
GUANAJUATO,LEON,18,110,2,130,2060
GUANAJUATO,LEON,19,100,3,122,2060
GUANAJUATO,LEON,21,77,4,102,2059
GUANAJUATO,LEON,21,76,0,97,1897
GUANAJUATO,LEON,13,62,2,77,1896
GUANAJUATO,LEON,20,73,0,93,1896
GUANAJUATO,LEON,10,44,1,55,1896
GUANAJUATO,LEON,6,78,3,87,2156
GUANAJUATO,LEON,11,72,2,85,2156
GUANAJUATO,LEON,11,86,0,97,2156
GUANAJUATO,LEON,8,89,2,99,2156
GUANAJUATO,LEON,8,89,1,98,2156
GUANAJUATO,LEON,12,71,2,85,2155
GUANAJUATO,LEON,14,109,1,124,2155
GUANAJUATO,LEON,9,65,0,74,2155
GUANAJUATO,LEON,17,63,1,81,1531
GUANAJUATO,LEON,14,92,1,107,1531
GUANAJUATO,LEON,14,73,1,88,1531
GUANAJUATO,LEON,16,105,1,122,1935
GUANAJUATO,LEON,19,109,7,135,1934
GUANAJUATO,LEON,24,104,1,129,1934
GUANAJUATO,LEON,15,75,0,90,1660
GUANAJUATO,LEON,12,77,0,89,1660
GUANAJUATO,LEON,9,60,3,72,1660
GUANAJUATO,LEON,10,73,1,84,1659
GUANAJUATO,LEON,13,94,3,110,1760
GUANAJUATO,LEON,11,78,1,90,1759
GUANAJUATO,LEON,7,94,2,103,1759
GUANAJUATO,LEON,13,74,3,90,1759
GUANAJUATO,LEON,17,92,2,111,1759
GUANAJUATO,LEON,9,96,2,107,1813
GUANAJUATO,LEON,6,90,0,96,1812
GUANAJUATO,LEON,3,87,3,93,2090
GUANAJUATO,LEON,11,87,0,98,2089
GUANAJUATO,LEON,8,87,3,98,2089
GUANAJUATO,LEON,20,97,0,117,1905
GUANAJUATO,LEON,20,109,1,130,1904
GUANAJUATO,LEON,23,111,3,137,1904
GUANAJUATO,LEON,20,152,2,174,1826
GUANAJUATO,LEON,24,159,5,188,1825
GUANAJUATO,LEON,8,99,0,107,1758
GUANAJUATO,LEON,7,59,1,67,1757
GUANAJUATO,LEON,12,161,2,175,1790
GUANAJUATO,LEON,18,161,1,180,1789
GUANAJUATO,LEON,18,108,1,127,1228
GUANAJUATO,LEON,16,85,5,106,1227
GUANAJUATO,LEON,16,89,2,107,1520
GUANAJUATO,LEON,15,88,2,105,1520
GUANAJUATO,LEON,10,80,1,91,1520
GUANAJUATO,LEON,73,286,2,361,0
GUANAJUATO,LEON,15,116,0,131,1569
GUANAJUATO,LEON,14,92,4,110,1568
GUANAJUATO,LEON,20,137,2,159,1550
GUANAJUATO,LEON,17,154,0,171,1550
GUANAJUATO,LEON,19,90,2,111,1496
GUANAJUATO,LEON,28,118,2,148,1496
GUANAJUATO,LEON,21,128,2,151,1787
GUANAJUATO,LEON,24,163,8,195,1787
GUANAJUATO,LEON,24,131,2,157,1766
GUANAJUATO,LEON,15,139,3,157,1766
GUANAJUATO,LEON,30,116,5,151,1619
GUANAJUATO,LEON,14,132,4,150,1618
GUANAJUATO,LEON,20,184,5,209,1904
GUANAJUATO,LEON,22,172,5,199,1904
GUANAJUATO,LEON,23,128,1,152,1276
GUANAJUATO,LEON,17,116,2,135,1275
GUANAJUATO,LEON,20,96,3,119,1303
GUANAJUATO,LEON,24,114,2,140,1303
GUANAJUATO,LEON,35,171,3,209,1913
GUANAJUATO,LEON,41,163,3,207,1913
GUANAJUATO,LEON,24,135,4,163,1780
GUANAJUATO,LEON,19,135,2,156,1779
GUANAJUATO,LEON,46,165,5,216,1843
GUANAJUATO,LEON,28,128,4,160,1843
GUANAJUATO,LEON,18,156,1,175,1810
GUANAJUATO,LEON,26,148,3,177,1809
GUANAJUATO,LEON,22,101,3,126,1368
GUANAJUATO,LEON,25,104,1,130,1368
GUANAJUATO,LEON,22,129,3,154,1812
GUANAJUATO,LEON,25,123,4,152,1811
GUANAJUATO,LEON,18,133,4,155,1723
GUANAJUATO,LEON,8,121,2,131,1723
GUANAJUATO,LEON,18,117,0,135,1672
GUANAJUATO,LEON,29,111,3,143,1671
GUANAJUATO,LEON,15,127,5,147,1284
GUANAJUATO,LEON,18,102,2,122,1283
GUANAJUATO,LEON,16,122,2,140,1520
GUANAJUATO,LEON,19,162,8,189,1519
GUANAJUATO,LEON,22,150,4,176,1519
GUANAJUATO,LEON,25,106,6,137,1691
GUANAJUATO,LEON,26,97,4,127,1691
GUANAJUATO,LEON,16,175,6,197,1707
GUANAJUATO,LEON,22,186,4,212,1707
GUANAJUATO,LEON,23,121,0,144,1713
GUANAJUATO,LEON,14,84,2,100,1713
GUANAJUATO,LEON,15,90,0,105,1712
GUANAJUATO,LEON,24,90,0,114,1712
GUANAJUATO,LEON,29,113,2,144,1921
GUANAJUATO,LEON,19,107,3,129,1921
GUANAJUATO,LEON,38,166,0,204,2133
GUANAJUATO,LEON,33,163,10,206,2133
GUANAJUATO,LEON,18,142,4,164,1799
GUANAJUATO,LEON,21,154,6,181,1798
GUANAJUATO,LEON,21,94,2,117,1821
GUANAJUATO,LEON,14,99,0,113,1821
GUANAJUATO,LEON,21,104,1,126,1821
GUANAJUATO,LEON,34,63,0,97,1854
GUANAJUATO,LEON,45,71,0,116,1854
GUANAJUATO,LEON,27,118,1,146,1746
GUANAJUATO,LEON,31,91,1,123,1745
GUANAJUATO,LEON,20,97,1,118,1745
GUANAJUATO,LEON,16,139,3,158,1877
GUANAJUATO,LEON,19,157,5,181,1877
GUANAJUATO,LEON,15,121,0,136,1907
GUANAJUATO,LEON,29,125,2,156,1907
GUANAJUATO,LEON,21,134,0,155,1842
GUANAJUATO,LEON,18,122,3,143,1842
GUANAJUATO,LEON,40,135,2,177,1876
GUANAJUATO,LEON,20,127,6,153,1876
GUANAJUATO,LEON,20,77,7,104,1384
GUANAJUATO,LEON,14,106,0,120,1383
GUANAJUATO,LEON,24,130,9,163,1534
GUANAJUATO,LEON,22,134,8,164,1534
GUANAJUATO,LEON,22,153,4,179,2152
GUANAJUATO,LEON,25,169,7,201,2152
GUANAJUATO,LEON,20,156,6,182,1852
GUANAJUATO,LEON,21,160,6,187,1851
GUANAJUATO,LEON,17,165,4,186,1460
GUANAJUATO,LEON,27,110,2,139,1459
GUANAJUATO,LEON,22,80,0,102,1550
GUANAJUATO,LEON,23,109,0,132,1550
GUANAJUATO,LEON,22,116,3,141,1792
GUANAJUATO,LEON,29,136,2,167,1791
GUANAJUATO,LEON,8,131,2,141,1645
GUANAJUATO,LEON,19,132,2,153,1644
GUANAJUATO,LEON,15,117,4,136,1644
GUANAJUATO,LEON,16,132,0,148,1737
GUANAJUATO,LEON,20,140,3,163,1737
GUANAJUATO,LEON,32,168,13,213,1983
GUANAJUATO,LEON,7,100,4,111,1164
GUANAJUATO,LEON,11,102,1,114,1164
GUANAJUATO,LEON,16,155,4,175,1638
GUANAJUATO,LEON,14,148,6,168,1638
GUANAJUATO,LEON,21,122,0,143,1899
GUANAJUATO,LEON,20,136,2,158,1899
GUANAJUATO,LEON,26,102,2,130,1935
GUANAJUATO,LEON,42,109,0,151,1934
GUANAJUATO,LEON,15,121,1,137,1793
GUANAJUATO,LEON,19,123,1,143,1793
GUANAJUATO,LEON,20,74,3,97,1773
GUANAJUATO,LEON,20,84,0,104,1773
GUANAJUATO,LEON,18,92,4,114,1773
GUANAJUATO,LEON,11,76,1,88,1773
GUANAJUATO,LEON,14,91,5,110,1646
GUANAJUATO,LEON,20,66,2,88,1646
GUANAJUATO,LEON,19,102,0,121,1552
GUANAJUATO,LEON,15,111,0,126,1552
GUANAJUATO,LEON,19,88,1,108,1510
GUANAJUATO,LEON,5,114,0,119,1510
GUANAJUATO,LEON,20,99,0,119,1258
GUANAJUATO,LEON,17,122,0,139,1257
GUANAJUATO,LEON,25,126,0,151,1908
GUANAJUATO,LEON,28,107,3,138,1907
GUANAJUATO,LEON,19,107,1,127,1521
GUANAJUATO,LEON,21,88,0,109,1521
GUANAJUATO,LEON,30,121,3,154,1521
GUANAJUATO,LEON,19,104,1,124,1520
GUANAJUATO,LEON,24,163,1,188,1706
GUANAJUATO,LEON,25,156,1,182,1705
GUANAJUATO,LEON,13,108,3,124,1401
GUANAJUATO,LEON,9,96,0,105,1401
GUANAJUATO,LEON,14,102,3,119,1400
GUANAJUATO,LEON,15,181,3,199,1604
GUANAJUATO,LEON,19,156,0,175,1604
GUANAJUATO,LEON,18,152,5,175,1799
GUANAJUATO,LEON,12,132,2,146,1798
GUANAJUATO,LEON,16,146,3,165,1798
GUANAJUATO,LEON,12,91,3,106,1324
GUANAJUATO,LEON,16,92,3,111,1324
GUANAJUATO,LEON,15,138,4,157,1789
GUANAJUATO,LEON,15,131,1,147,1788
GUANAJUATO,LEON,16,125,4,145,1523
GUANAJUATO,LEON,15,129,5,149,1522
GUANAJUATO,LEON,14,116,2,132,1199
GUANAJUATO,LEON,18,117,8,143,1199
GUANAJUATO,LEON,4,70,3,77,1245
GUANAJUATO,LEON,32,105,1,138,1244
GUANAJUATO,LEON,29,199,6,234,2068
GUANAJUATO,LEON,13,109,4,126,1435
GUANAJUATO,LEON,26,135,1,162,1435
GUANAJUATO,LEON,22,122,7,151,1435
GUANAJUATO,LEON,22,123,6,151,1659
GUANAJUATO,LEON,18,128,4,150,1659
GUANAJUATO,LEON,17,88,1,106,1569
GUANAJUATO,LEON,31,84,1,116,1569
GUANAJUATO,LEON,17,81,1,99,1568
GUANAJUATO,LEON,31,76,1,108,1568
GUANAJUATO,LEON,13,126,1,140,1525
GUANAJUATO,LEON,11,124,4,139,1524
GUANAJUATO,LEON,19,163,6,188,1639
GUANAJUATO,LEON,19,174,4,197,1639
GUANAJUATO,LEON,23,175,0,198,1638
GUANAJUATO,LEON,11,178,3,192,1689
GUANAJUATO,LEON,13,167,6,186,1688
GUANAJUATO,LEON,33,189,1,223,1907
GUANAJUATO,LEON,29,163,2,194,1907
GUANAJUATO,LEON,22,152,4,178,1917
GUANAJUATO,LEON,16,159,0,175,1917
GUANAJUATO,LEON,17,168,0,185,1583
GUANAJUATO,LEON,15,138,2,155,1582
GUANAJUATO,LEON,29,67,1,97,1511
GUANAJUATO,LEON,28,80,2,110,1511
GUANAJUATO,LEON,26,70,0,96,1510
GUANAJUATO,LEON,37,159,1,197,1922
GUANAJUATO,LEON,31,135,2,168,1922
GUANAJUATO,LEON,25,148,0,173,1913
GUANAJUATO,LEON,25,148,5,178,1913
GUANAJUATO,LEON,12,169,7,188,1912
GUANAJUATO,LEON,27,127,2,156,1922
GUANAJUATO,LEON,24,143,4,171,1922
GUANAJUATO,LEON,27,136,5,168,1922
GUANAJUATO,LEON,24,150,5,179,1917
GUANAJUATO,LEON,15,123,3,141,1917
GUANAJUATO,LEON,11,152,7,170,1917
GUANAJUATO,LEON,23,129,1,153,1987
GUANAJUATO,LEON,21,131,0,152,1986
GUANAJUATO,LEON,27,70,3,100,1193
GUANAJUATO,LEON,27,67,1,95,1193
GUANAJUATO,LEON,24,183,6,213,1826
GUANAJUATO,LEON,29,202,4,235,1825
GUANAJUATO,LEON,19,74,1,94,1418
GUANAJUATO,LEON,13,97,2,112,1417
GUANAJUATO,LEON,31,116,5,152,1613
GUANAJUATO,LEON,16,116,2,134,1613
GUANAJUATO,LEON,25,141,2,168,1775
GUANAJUATO,LEON,27,148,0,175,1775
GUANAJUATO,LEON,27,124,1,152,1775
GUANAJUATO,LEON,27,91,3,121,1606
GUANAJUATO,LEON,26,112,2,140,1605
GUANAJUATO,LEON,33,161,3,197,1426
GUANAJUATO,LEON,24,143,4,171,1425
GUANAJUATO,LEON,28,157,3,188,1425
GUANAJUATO,LEON,27,68,5,100,1561
GUANAJUATO,LEON,16,44,1,61,1561
GUANAJUATO,LEON,7,65,1,73,1790
GUANAJUATO,LEON,16,67,1,84,1789
GUANAJUATO,LEON,13,52,3,68,1789
GUANAJUATO,LEON,18,87,2,107,1580
GUANAJUATO,LEON,20,85,6,111,1580
GUANAJUATO,LEON,15,98,7,120,1580
GUANAJUATO,LEON,8,77,1,86,1634
GUANAJUATO,LEON,17,92,5,114,1634
GUANAJUATO,LEON,11,67,1,79,1634
GUANAJUATO,LEON,10,71,3,84,1633
GUANAJUATO,LEON,11,71,2,84,1717
GUANAJUATO,LEON,18,87,0,105,1717
GUANAJUATO,LEON,10,69,1,80,1717
GUANAJUATO,LEON,26,71,1,98,1717
GUANAJUATO,LEON,23,110,0,133,1716
GUANAJUATO,LEON,19,77,2,98,1716
GUANAJUATO,LEON,11,68,0,79,1716
GUANAJUATO,LEON,13,105,1,119,1797
GUANAJUATO,LEON,11,79,1,91,1797
GUANAJUATO,LEON,11,81,12,104,1629
GUANAJUATO,LEON,21,111,9,141,1628
GUANAJUATO,LEON,16,101,5,122,1418
GUANAJUATO,LEON,6,82,7,95,1417
GUANAJUATO,LEON,18,100,5,123,1417
GUANAJUATO,LEON,18,97,1,116,1830
GUANAJUATO,LEON,16,93,2,111,1830
GUANAJUATO,LEON,11,77,1,89,1830
GUANAJUATO,LEON,18,118,1,137,1830
GUANAJUATO,LEON,27,107,5,139,1856
GUANAJUATO,LEON,12,74,6,92,1855
GUANAJUATO,LEON,10,68,3,81,1855
GUANAJUATO,LEON,10,92,2,104,1684
GUANAJUATO,LEON,13,78,0,91,1684
GUANAJUATO,LEON,9,81,2,92,1684
GUANAJUATO,LEON,8,101,2,111,1683
GUANAJUATO,LEON,98,580,5,683,0
GUANAJUATO,LEON,46,69,1,116,1598
GUANAJUATO,LEON,28,84,1,113,1598
GUANAJUATO,LEON,52,78,0,130,1597
GUANAJUATO,LEON,34,85,0,119,1597
GUANAJUATO,LEON,37,113,0,150,1593
GUANAJUATO,LEON,27,108,1,136,1592
GUANAJUATO,LEON,34,146,2,182,1691
GUANAJUATO,LEON,36,161,2,199,1690
GUANAJUATO,LEON,25,126,2,153,1749
GUANAJUATO,LEON,29,139,1,169,1749
GUANAJUATO,LEON,20,164,7,191,1749
GUANAJUATO,LEON,36,141,4,181,1749
GUANAJUATO,LEON,19,82,2,103,1556
GUANAJUATO,LEON,16,86,5,107,1556
GUANAJUATO,LEON,20,61,5,86,1555
GUANAJUATO,LEON,9,175,4,188,1774
GUANAJUATO,LEON,17,128,7,152,1773
GUANAJUATO,LEON,28,94,1,123,1754
GUANAJUATO,LEON,24,95,0,119,1754
GUANAJUATO,LEON,14,85,2,101,1754
GUANAJUATO,LEON,20,100,1,121,1229
GUANAJUATO,LEON,28,92,0,120,1229
GUANAJUATO,LEON,26,155,1,182,2138
GUANAJUATO,LEON,28,116,2,146,1702
GUANAJUATO,LEON,24,144,0,168,1701
GUANAJUATO,LEON,21,98,0,119,1930
GUANAJUATO,LEON,17,129,0,146,1929
GUANAJUATO,LEON,26,109,1,136,1675
GUANAJUATO,LEON,24,108,3,135,1675
GUANAJUATO,LEON,24,114,1,139,1675
GUANAJUATO,LEON,5,58,2,65,1582
GUANAJUATO,LEON,6,52,1,59,1582
GUANAJUATO,LEON,12,60,1,73,1582
GUANAJUATO,LEON,15,69,2,86,1871
GUANAJUATO,LEON,13,63,1,77,1871
GUANAJUATO,LEON,7,98,2,107,1973
GUANAJUATO,LEON,17,83,2,102,1972
GUANAJUATO,LEON,3,57,0,60,1508
GUANAJUATO,LEON,8,70,0,78,1508
GUANAJUATO,LEON,2,69,1,72,1282
GUANAJUATO,LEON,9,59,1,69,1281
GUANAJUATO,LEON,8,125,0,133,1928
GUANAJUATO,LEON,14,98,0,112,1928
GUANAJUATO,LEON,7,75,0,82,1644
GUANAJUATO,LEON,8,74,2,84,1644
GUANAJUATO,LEON,10,74,0,84,1643
GUANAJUATO,LEON,22,91,0,113,1248
GUANAJUATO,LEON,20,84,0,104,1247
GUANAJUATO,LEON,12,99,4,115,1361
GUANAJUATO,LEON,29,96,3,128,1360
GUANAJUATO,LEON,14,93,0,107,1360
GUANAJUATO,LEON,6,82,3,91,1598
GUANAJUATO,LEON,8,76,0,84,1597
GUANAJUATO,LEON,16,81,1,98,1597
GUANAJUATO,LEON,9,88,0,97,1550
GUANAJUATO,LEON,5,68,1,74,1549
GUANAJUATO,LEON,9,109,1,119,1745
GUANAJUATO,LEON,10,103,0,113,1744
GUANAJUATO,LEON,13,104,6,123,1733
GUANAJUATO,LEON,17,93,1,111,1732
GUANAJUATO,LEON,12,90,2,104,1820
GUANAJUATO,LEON,14,76,2,92,1819
GUANAJUATO,LEON,41,76,0,117,1714
GUANAJUATO,LEON,35,68,1,104,1713
GUANAJUATO,LEON,11,66,1,78,1459
GUANAJUATO,LEON,12,71,0,83,1459
GUANAJUATO,LEON,8,70,1,79,1502
GUANAJUATO,LEON,9,58,0,67,1502
GUANAJUATO,LEON,22,87,1,110,2065
GUANAJUATO,LEON,9,83,0,92,2065
GUANAJUATO,SAN FRANCISCO DEL RINCON,11,148,1,160,1597
GUANAJUATO,SAN FRANCISCO DEL RINCON,18,130,2,150,1597
GUANAJUATO,SAN FRANCISCO DEL RINCON,3,75,3,81,1206
GUANAJUATO,SAN FRANCISCO DEL RINCON,2,99,1,102,1206
GUANAJUATO,SAN FRANCISCO DEL RINCON,3,133,6,142,1614
GUANAJUATO,SAN FRANCISCO DEL RINCON,16,117,0,133,1613
GUANAJUATO,SAN FRANCISCO DEL RINCON,7,112,5,124,1613
GUANAJUATO,SAN FRANCISCO DEL RINCON,6,83,2,91,1869
GUANAJUATO,SAN FRANCISCO DEL RINCON,8,77,0,85,1868
GUANAJUATO,SAN FRANCISCO DEL RINCON,7,92,0,99,1868
GUANAJUATO,SAN FRANCISCO DEL RINCON,12,129,4,145,1685
GUANAJUATO,SAN FRANCISCO DEL RINCON,10,133,2,145,1685
GUANAJUATO,SAN FRANCISCO DEL RINCON,7,130,1,138,1685
GUANAJUATO,SAN FRANCISCO DEL RINCON,6,72,5,83,1447
GUANAJUATO,SAN FRANCISCO DEL RINCON,1,78,1,80,1447
GUANAJUATO,SAN FRANCISCO DEL RINCON,2,57,2,61,1446
GUANAJUATO,SAN FRANCISCO DEL RINCON,11,95,2,108,1775
GUANAJUATO,SAN FRANCISCO DEL RINCON,6,85,1,92,1774
GUANAJUATO,SAN FRANCISCO DEL RINCON,5,110,6,121,1774
GUANAJUATO,SAN FRANCISCO DEL RINCON,9,173,8,190,1970
GUANAJUATO,SAN FRANCISCO DEL RINCON,9,144,4,157,1970
GUANAJUATO,SAN FRANCISCO DEL RINCON,10,135,5,150,1629
GUANAJUATO,SAN FRANCISCO DEL RINCON,6,152,1,159,1629
GUANAJUATO,SAN FRANCISCO DEL RINCON,2,117,3,122,1052
GUANAJUATO,SAN FRANCISCO DEL RINCON,3,109,3,115,1051
GUANAJUATO,SAN FRANCISCO DEL RINCON,11,153,9,173,1839
GUANAJUATO,SAN FRANCISCO DEL RINCON,8,175,3,186,1838
GUANAJUATO,SAN FRANCISCO DEL RINCON,12,171,1,184,1658
GUANAJUATO,SAN FRANCISCO DEL RINCON,11,172,5,188,1658
GUANAJUATO,SAN FRANCISCO DEL RINCON,2,142,4,148,1920
GUANAJUATO,SAN FRANCISCO DEL RINCON,3,153,1,157,1920
GUANAJUATO,SAN FRANCISCO DEL RINCON,3,195,5,203,1467
GUANAJUATO,SAN FRANCISCO DEL RINCON,6,201,2,209,1467
GUANAJUATO,SAN FRANCISCO DEL RINCON,11,114,2,127,1830
GUANAJUATO,SAN FRANCISCO DEL RINCON,13,137,1,151,1830
GUANAJUATO,SAN FRANCISCO DEL RINCON,10,213,4,227,1864
GUANAJUATO,SAN FRANCISCO DEL RINCON,5,215,4,224,1863
GUANAJUATO,SAN FRANCISCO DEL RINCON,13,138,1,152,1508
GUANAJUATO,SAN FRANCISCO DEL RINCON,6,108,0,114,1507
GUANAJUATO,SAN FRANCISCO DEL RINCON,18,128,5,151,1507
GUANAJUATO,SAN FRANCISCO DEL RINCON,8,29,6,43,1361
GUANAJUATO,SAN FRANCISCO DEL RINCON,7,41,0,48,1361
GUANAJUATO,SAN FRANCISCO DEL RINCON,4,39,5,48,1361
GUANAJUATO,SAN FRANCISCO DEL RINCON,14,135,5,154,1954
GUANAJUATO,SAN FRANCISCO DEL RINCON,6,128,4,138,1954
GUANAJUATO,SAN FRANCISCO DEL RINCON,9,129,1,139,1572
GUANAJUATO,SAN FRANCISCO DEL RINCON,6,158,2,166,1572
GUANAJUATO,SAN FRANCISCO DEL RINCON,8,140,1,149,1572
GUANAJUATO,SAN FRANCISCO DEL RINCON,4,152,4,160,1886
GUANAJUATO,SAN FRANCISCO DEL RINCON,3,137,2,142,1885
GUANAJUATO,SAN FRANCISCO DEL RINCON,26,180,5,211,1878
GUANAJUATO,SAN FRANCISCO DEL RINCON,20,158,4,182,1878
GUANAJUATO,SAN FRANCISCO DEL RINCON,2,58,3,63,1611
GUANAJUATO,SAN FRANCISCO DEL RINCON,4,74,2,80,1611
GUANAJUATO,SAN FRANCISCO DEL RINCON,3,138,6,147,1676
GUANAJUATO,SAN FRANCISCO DEL RINCON,9,103,4,116,1676
GUANAJUATO,SAN FRANCISCO DEL RINCON,7,150,1,158,1901
GUANAJUATO,SAN FRANCISCO DEL RINCON,9,133,2,144,1901
GUANAJUATO,SAN FRANCISCO DEL RINCON,10,218,5,233,1602
GUANAJUATO,SAN FRANCISCO DEL RINCON,12,199,6,217,1602
GUANAJUATO,SAN FRANCISCO DEL RINCON,4,239,5,248,1602
GUANAJUATO,SAN FRANCISCO DEL RINCON,12,107,2,121,1147
GUANAJUATO,SAN FRANCISCO DEL RINCON,5,99,0,104,1147
GUANAJUATO,SAN FRANCISCO DEL RINCON,18,255,5,278,1913
GUANAJUATO,SAN FRANCISCO DEL RINCON,17,233,3,253,1913
GUANAJUATO,SAN FRANCISCO DEL RINCON,7,162,5,174,1840
GUANAJUATO,SAN FRANCISCO DEL RINCON,8,165,7,180,1839
GUANAJUATO,SAN FRANCISCO DEL RINCON,2,89,2,93,1031
GUANAJUATO,SAN FRANCISCO DEL RINCON,1,131,4,136,1030
GUANAJUATO,SAN FRANCISCO DEL RINCON,13,185,2,200,1334
GUANAJUATO,SAN FRANCISCO DEL RINCON,5,153,3,161,1334
GUANAJUATO,SAN FRANCISCO DEL RINCON,15,117,4,136,1838
GUANAJUATO,SAN FRANCISCO DEL RINCON,10,93,7,110,1837
GUANAJUATO,SAN FRANCISCO DEL RINCON,7,79,2,88,1739
GUANAJUATO,SAN FRANCISCO DEL RINCON,3,118,9,130,1739
GUANAJUATO,SAN FRANCISCO DEL RINCON,6,95,0,101,1351
GUANAJUATO,SAN FRANCISCO DEL RINCON,9,134,5,148,1350
GUANAJUATO,SAN FRANCISCO DEL RINCON,10,166,3,179,1659
GUANAJUATO,SAN FRANCISCO DEL RINCON,8,132,0,140,1659
GUANAJUATO,SAN FRANCISCO DEL RINCON,5,167,2,174,1705
GUANAJUATO,SAN FRANCISCO DEL RINCON,8,119,5,132,1704
GUANAJUATO,SAN FRANCISCO DEL RINCON,13,136,0,149,1534
GUANAJUATO,SAN FRANCISCO DEL RINCON,8,126,1,135,1534
GUANAJUATO,SAN FRANCISCO DEL RINCON,5,60,1,66,1682
GUANAJUATO,SAN FRANCISCO DEL RINCON,4,72,2,78,1681
GUANAJUATO,SAN FRANCISCO DEL RINCON,11,93,5,109,1155
GUANAJUATO,SAN FRANCISCO DEL RINCON,6,121,10,137,1155
GUANAJUATO,SAN FRANCISCO DEL RINCON,9,192,6,207,1644
GUANAJUATO,SAN FRANCISCO DEL RINCON,11,207,1,219,1643
GUANAJUATO,SAN FRANCISCO DEL RINCON,8,119,0,127,1860
GUANAJUATO,SAN FRANCISCO DEL RINCON,12,115,1,128,1860
GUANAJUATO,SAN FRANCISCO DEL RINCON,12,263,1,276,1908
GUANAJUATO,SAN FRANCISCO DEL RINCON,21,197,7,225,1908
GUANAJUATO,SAN FRANCISCO DEL RINCON,4,108,2,114,1522
GUANAJUATO,SAN FRANCISCO DEL RINCON,5,106,7,118,1522
GUANAJUATO,SAN FRANCISCO DEL RINCON,3,111,1,115,1522
GUANAJUATO,SAN FRANCISCO DEL RINCON,6,90,3,99,1042
GUANAJUATO,SAN FRANCISCO DEL RINCON,6,77,3,86,1042
GUANAJUATO,SAN FRANCISCO DEL RINCON,12,62,3,77,1485
GUANAJUATO,SAN FRANCISCO DEL RINCON,13,51,1,65,1484
GUANAJUATO,SAN FRANCISCO DEL RINCON,10,47,0,57,1403
GUANAJUATO,SAN FRANCISCO DEL RINCON,13,40,1,54,1403
GUANAJUATO,SAN FRANCISCO DEL RINCON,8,41,2,51,1402
GUANAJUATO,SAN FRANCISCO DEL RINCON,10,63,0,73,1942
GUANAJUATO,SAN FRANCISCO DEL RINCON,10,53,1,64,1941
GUANAJUATO,SAN FRANCISCO DEL RINCON,9,52,0,61,1941
GUANAJUATO,SAN FRANCISCO DEL RINCON,13,65,2,80,1941
GUANAJUATO,SAN FRANCISCO DEL RINCON,12,76,1,89,1861
GUANAJUATO,SAN FRANCISCO DEL RINCON,11,74,1,86,1860
GUANAJUATO,SAN FRANCISCO DEL RINCON,12,95,1,108,1873
GUANAJUATO,SAN FRANCISCO DEL RINCON,20,81,0,101,1873
GUANAJUATO,SAN FRANCISCO DEL RINCON,10,80,1,91,1902
GUANAJUATO,SAN FRANCISCO DEL RINCON,13,59,0,72,1901
GUANAJUATO,SAN FRANCISCO DEL RINCON,13,77,2,92,1901
GUANAJUATO,SAN FRANCISCO DEL RINCON,17,74,1,92,1901
GUANAJUATO,SAN FRANCISCO DEL RINCON,8,31,0,39,1380
GUANAJUATO,SAN FRANCISCO DEL RINCON,3,33,0,36,1380
GUANAJUATO,SAN FRANCISCO DEL RINCON,10,28,1,39,1380
GUANAJUATO,SAN FRANCISCO DEL RINCON,12,49,1,62,1537
GUANAJUATO,SAN FRANCISCO DEL RINCON,13,41,2,56,1537
GUANAJUATO,SAN FRANCISCO DEL RINCON,14,81,2,97,1537
GUANAJUATO,SAN FRANCISCO DEL RINCON,6,54,2,62,1843
GUANAJUATO,SAN FRANCISCO DEL RINCON,16,49,4,69,1843
GUANAJUATO,SAN FRANCISCO DEL RINCON,16,37,3,56,1581
GUANAJUATO,SAN FRANCISCO DEL RINCON,10,30,0,40,1580
GUANAJUATO,SAN FRANCISCO DEL RINCON,8,34,1,43,1580
GUANAJUATO,SAN FRANCISCO DEL RINCON,5,56,2,63,1963
GUANAJUATO,SAN FRANCISCO DEL RINCON,2,47,0,49,1963
GUANAJUATO,SAN FRANCISCO DEL RINCON,10,40,3,53,1856
GUANAJUATO,SAN FRANCISCO DEL RINCON,9,42,0,51,1856
GUANAJUATO,SAN FRANCISCO DEL RINCON,13,37,5,55,1761
GUANAJUATO,SAN FRANCISCO DEL RINCON,9,49,1,59,1760
GUANAJUATO,SAN FRANCISCO DEL RINCON,10,31,2,43,1760
GUANAJUATO,SAN FRANCISCO DEL RINCON,15,71,2,88,1947
GUANAJUATO,SAN FRANCISCO DEL RINCON,17,109,2,128,1947
GUANAJUATO,SAN FRANCISCO DEL RINCON,25,59,3,87,1595
GUANAJUATO,SAN FRANCISCO DEL RINCON,32,76,6,114,1595
GUANAJUATO,SAN FRANCISCO DEL RINCON,24,99,1,124,1715
GUANAJUATO,SAN FRANCISCO DEL RINCON,16,92,1,109,1714
GUANAJUATO,SAN FRANCISCO DEL RINCON,24,147,5,176,0
GUANAJUATO,SAN FRANCISCO DEL RINCON,14,77,1,92,1274
GUANAJUATO,SAN FRANCISCO DEL RINCON,15,75,1,91,1274
GUANAJUATO,SAN FRANCISCO DEL RINCON,27,99,3,129,1881
GUANAJUATO,SAN FRANCISCO DEL RINCON,24,119,2,145,1881
GUANAJUATO,SAN FRANCISCO DEL RINCON,21,114,1,136,1807
GUANAJUATO,SAN FRANCISCO DEL RINCON,29,92,0,121,1807
GUANAJUATO,SAN FRANCISCO DEL RINCON,14,50,0,64,1330
GUANAJUATO,SAN FRANCISCO DEL RINCON,17,42,0,59,1330
GUANAJUATO,SAN FRANCISCO DEL RINCON,11,43,1,55,1329
GUANAJUATO,SAN FRANCISCO DEL RINCON,9,65,1,75,1500
GUANAJUATO,SAN FRANCISCO DEL RINCON,6,53,1,60,1499
GUANAJUATO,SAN FRANCISCO DEL RINCON,9,53,1,63,1499
GUANAJUATO,SAN FRANCISCO DEL RINCON,16,66,1,83,1494
GUANAJUATO,SAN FRANCISCO DEL RINCON,19,85,2,106,1493
GUANAJUATO,SAN FRANCISCO DEL RINCON,10,61,1,72,1870
GUANAJUATO,SAN FRANCISCO DEL RINCON,11,60,2,73,1870
GUANAJUATO,SAN FRANCISCO DEL RINCON,22,55,0,77,1683
GUANAJUATO,SAN FRANCISCO DEL RINCON,8,49,0,57,1682
GUANAJUATO,SAN FRANCISCO DEL RINCON,19,83,3,105,1329
GUANAJUATO,SAN FRANCISCO DEL RINCON,22,103,2,127,1328
GUANAJUATO,SAN FRANCISCO DEL RINCON,21,91,2,114,1914
GUANAJUATO,SAN FRANCISCO DEL RINCON,12,105,0,117,1913
GUANAJUATO,SAN FRANCISCO DEL RINCON,25,97,0,122,1913
GUANAJUATO,SAN FRANCISCO DEL RINCON,18,79,0,97,1620
GUANAJUATO,SAN FRANCISCO DEL RINCON,16,79,3,98,1620
GUANAJUATO,SAN FRANCISCO DEL RINCON,16,69,4,89,1620
GUANAJUATO,SAN FRANCISCO DEL RINCON,19,74,0,93,1620
GUANAJUATO,SAN FRANCISCO DEL RINCON,15,68,0,83,1620
GUANAJUATO,SAN FRANCISCO DEL RINCON,14,71,0,85,1908
GUANAJUATO,SAN FRANCISCO DEL RINCON,26,71,2,99,1907
GUANAJUATO,SAN FRANCISCO DEL RINCON,14,67,0,81,1907
GUANAJUATO,SAN FRANCISCO DEL RINCON,19,74,0,93,1663
GUANAJUATO,SAN FRANCISCO DEL RINCON,12,66,1,79,1662
GUANAJUATO,SAN FRANCISCO DEL RINCON,11,50,0,61,1676
GUANAJUATO,SAN FRANCISCO DEL RINCON,12,36,5,53,1676
GUANAJUATO,SAN FRANCISCO DEL RINCON,14,45,1,60,1676
GUANAJUATO,SAN FRANCISCO DEL RINCON,10,59,0,69,1360
GUANAJUATO,SAN FRANCISCO DEL RINCON,12,38,0,50,1360
GUANAJUATO,SAN FRANCISCO DEL RINCON,18,44,0,62,1937
GUANAJUATO,SAN FRANCISCO DEL RINCON,6,20,2,28,1937
GUANAJUATO,SAN FRANCISCO DEL RINCON,20,40,4,64,1847
GUANAJUATO,SAN FRANCISCO DEL RINCON,8,51,2,61,1847
GUANAJUATO,SAN FRANCISCO DEL RINCON,11,37,0,48,1673
GUANAJUATO,SAN FRANCISCO DEL RINCON,5,31,0,36,1673
GUANAJUATO,SAN FRANCISCO DEL RINCON,9,20,0,29,1673
GUANAJUATO,SAN FRANCISCO DEL RINCON,17,67,6,90,1507
GUANAJUATO,SAN FRANCISCO DEL RINCON,15,60,2,77,1506
GUANAJUATO,SAN FRANCISCO DEL RINCON,15,59,6,80,1892
GUANAJUATO,SAN FRANCISCO DEL RINCON,14,62,1,77,1892
GUANAJUATO,SAN FRANCISCO DEL RINCON,12,36,3,51,1930
GUANAJUATO,SAN FRANCISCO DEL RINCON,10,27,0,37,1929
GUANAJUATO,SALAMANCA,20,215,2,237,1626
GUANAJUATO,SALAMANCA,18,240,4,262,1626
GUANAJUATO,SALAMANCA,24,236,2,262,1626
GUANAJUATO,SALAMANCA,13,194,2,209,1458
GUANAJUATO,SALAMANCA,22,190,1,213,1458
GUANAJUATO,SALAMANCA,21,181,2,204,1458
GUANAJUATO,SALAMANCA,20,211,1,232,1459
GUANAJUATO,SALAMANCA,25,221,1,247,1458
GUANAJUATO,SALAMANCA,26,289,4,319,1832
GUANAJUATO,SALAMANCA,31,315,0,346,1832
GUANAJUATO,SALAMANCA,12,202,2,216,1043
GUANAJUATO,SALAMANCA,14,208,2,224,1043
GUANAJUATO,SALAMANCA,11,195,0,206,1370
GUANAJUATO,SALAMANCA,9,221,4,234,1369
GUANAJUATO,SALAMANCA,9,202,2,213,1369
GUANAJUATO,SALAMANCA,10,218,2,230,1444
GUANAJUATO,SALAMANCA,5,213,3,221,1444
GUANAJUATO,SALAMANCA,12,222,2,236,1443
GUANAJUATO,SALAMANCA,23,265,2,290,1799
GUANAJUATO,SALAMANCA,22,251,5,278,1798
GUANAJUATO,SALAMANCA,20,177,2,199,1369
GUANAJUATO,SALAMANCA,31,248,4,283,1369
GUANAJUATO,SALAMANCA,18,214,5,237,1369
GUANAJUATO,SALAMANCA,23,238,2,263,1957
GUANAJUATO,SALAMANCA,28,292,1,321,1956
GUANAJUATO,SALAMANCA,15,340,1,356,1761
GUANAJUATO,SALAMANCA,14,354,9,377,1760
GUANAJUATO,SALAMANCA,13,339,8,360,1760
GUANAJUATO,SALAMANCA,20,267,5,292,1764
GUANAJUATO,SALAMANCA,16,307,6,329,1763
GUANAJUATO,SALAMANCA,10,288,0,298,1671
GUANAJUATO,SALAMANCA,18,294,6,318,1671
GUANAJUATO,SALAMANCA,18,241,3,262,1427
GUANAJUATO,SALAMANCA,10,306,5,321,1427
GUANAJUATO,SALAMANCA,9,223,2,234,1826
GUANAJUATO,SALAMANCA,19,205,3,227,1825
GUANAJUATO,SALAMANCA,7,232,2,241,1825
GUANAJUATO,SALAMANCA,19,266,1,286,1474
GUANAJUATO,SALAMANCA,9,211,1,221,1474
GUANAJUATO,SALAMANCA,8,250,6,264,1548
GUANAJUATO,SALAMANCA,14,294,4,312,1548
GUANAJUATO,SALAMANCA,13,269,4,286,1716
GUANAJUATO,SALAMANCA,16,280,2,298,1716
GUANAJUATO,SALAMANCA,12,235,5,252,1584
GUANAJUATO,SALAMANCA,10,230,0,240,1583
GUANAJUATO,SALAMANCA,18,331,4,353,1930
GUANAJUATO,SALAMANCA,18,301,6,325,1929
GUANAJUATO,SALAMANCA,12,300,4,316,1978
GUANAJUATO,SALAMANCA,9,293,5,307,1977
GUANAJUATO,SALAMANCA,16,233,1,250,1353
GUANAJUATO,SALAMANCA,17,199,1,217,1352
GUANAJUATO,SALAMANCA,21,214,5,240,1352
GUANAJUATO,SALAMANCA,11,353,4,368,1868
GUANAJUATO,SALAMANCA,13,313,4,330,1867
GUANAJUATO,SALAMANCA,4,216,1,221,1444
GUANAJUATO,SALAMANCA,8,206,2,216,1444
GUANAJUATO,SALAMANCA,6,222,3,231,1443
GUANAJUATO,SALAMANCA,11,239,1,251,1366
GUANAJUATO,SALAMANCA,12,244,4,260,1366
GUANAJUATO,SALAMANCA,16,237,3,256,1366
GUANAJUATO,SALAMANCA,11,283,3,297,1677
GUANAJUATO,SALAMANCA,6,253,2,261,1677
GUANAJUATO,SALAMANCA,6,304,1,311,1677
GUANAJUATO,SALAMANCA,9,340,2,351,1993
GUANAJUATO,SALAMANCA,11,292,0,303,1993
GUANAJUATO,SALAMANCA,20,247,1,268,1747
GUANAJUATO,SALAMANCA,8,305,3,316,1746
GUANAJUATO,SALAMANCA,13,241,6,260,1746
GUANAJUATO,SALAMANCA,10,250,2,262,1746
GUANAJUATO,SALAMANCA,14,302,2,318,1746
GUANAJUATO,SALAMANCA,49,527,14,590,0
GUANAJUATO,SALAMANCA,19,338,1,358,1843
GUANAJUATO,SALAMANCA,15,299,4,318,1843
GUANAJUATO,SALAMANCA,17,293,1,311,1342
GUANAJUATO,SALAMANCA,12,270,3,285,1342
GUANAJUATO,SALAMANCA,14,271,4,289,1341
GUANAJUATO,SALAMANCA,14,264,0,278,1608
GUANAJUATO,SALAMANCA,9,259,4,272,1608
GUANAJUATO,SALAMANCA,6,260,5,271,1607
GUANAJUATO,SALAMANCA,23,392,3,418,2002
GUANAJUATO,SALAMANCA,21,331,8,360,2002
GUANAJUATO,SALAMANCA,6,119,1,126,1320
GUANAJUATO,SALAMANCA,3,82,4,89,1319
GUANAJUATO,SALAMANCA,4,93,2,99,1319
GUANAJUATO,SALAMANCA,9,135,2,146,1563
GUANAJUATO,SALAMANCA,4,109,4,117,1563
GUANAJUATO,SALAMANCA,12,128,3,143,1562
GUANAJUATO,SALAMANCA,15,87,8,110,1865
GUANAJUATO,SALAMANCA,21,150,4,175,1865
GUANAJUATO,SALAMANCA,11,60,4,75,1864
GUANAJUATO,SALAMANCA,27,141,7,175,1569
GUANAJUATO,SALAMANCA,16,116,0,132,1568
GUANAJUATO,SALAMANCA,27,130,3,160,1568
GUANAJUATO,SALAMANCA,11,126,2,139,1072
GUANAJUATO,SALAMANCA,5,147,2,154,1072
GUANAJUATO,SALAMANCA,5,227,9,241,1522
GUANAJUATO,SALAMANCA,14,231,6,251,1522
GUANAJUATO,SALAMANCA,9,253,1,263,1734
GUANAJUATO,SALAMANCA,8,297,5,310,1734
GUANAJUATO,SALAMANCA,10,230,1,241,1733
GUANAJUATO,SALAMANCA,5,173,3,181,1501
GUANAJUATO,SALAMANCA,7,130,9,146,1500
GUANAJUATO,SALAMANCA,0,176,5,181,1500
GUANAJUATO,SALAMANCA,3,241,4,248,1758
GUANAJUATO,SALAMANCA,11,168,5,184,1758
GUANAJUATO,SALAMANCA,12,219,3,234,1758
GUANAJUATO,SALAMANCA,16,300,8,324,1640
GUANAJUATO,SALAMANCA,8,278,2,288,1639
GUANAJUATO,SALAMANCA,7,152,4,163,1608
GUANAJUATO,SALAMANCA,21,214,5,240,1608
GUANAJUATO,SALAMANCA,15,210,6,231,1608
GUANAJUATO,SALAMANCA,6,112,4,122,1535
GUANAJUATO,SALAMANCA,11,100,8,119,1535
GUANAJUATO,SALAMANCA,20,103,3,126,1534
GUANAJUATO,SALAMANCA,14,108,12,134,1534
GUANAJUATO,SALAMANCA,10,215,5,230,1771
GUANAJUATO,SALAMANCA,12,206,2,220,1770
GUANAJUATO,SALAMANCA,7,312,1,320,1882
GUANAJUATO,SALAMANCA,18,255,4,277,1882
GUANAJUATO,SALAMANCA,11,283,6,300,1881
GUANAJUATO,SALAMANCA,18,221,2,241,1947
GUANAJUATO,SALAMANCA,12,240,3,255,1947
GUANAJUATO,SALAMANCA,8,13,2,23,1173
GUANAJUATO,SALAMANCA,9,196,1,206,1172
GUANAJUATO,SALAMANCA,9,135,0,144,997
GUANAJUATO,SALAMANCA,6,127,1,134,997
GUANAJUATO,SALAMANCA,9,249,5,263,1836
GUANAJUATO,SALAMANCA,10,280,5,295,1836
GUANAJUATO,SALAMANCA,6,203,12,221,1460
GUANAJUATO,SALAMANCA,9,201,9,219,1459
GUANAJUATO,SALAMANCA,15,243,14,272,1459
GUANAJUATO,SALAMANCA,10,284,10,304,1976
GUANAJUATO,SALAMANCA,15,220,0,235,1976
GUANAJUATO,SALAMANCA,10,175,7,192,1807
GUANAJUATO,SALAMANCA,11,151,0,162,1807
GUANAJUATO,SALAMANCA,12,193,4,209,1585
GUANAJUATO,SALAMANCA,6,193,0,199,1585
GUANAJUATO,SALAMANCA,6,202,1,209,1915
GUANAJUATO,SALAMANCA,8,190,9,207,1915
GUANAJUATO,SALAMANCA,8,177,5,190,1708
GUANAJUATO,SALAMANCA,10,173,0,183,1708
GUANAJUATO,SALAMANCA,15,152,2,169,1810
GUANAJUATO,SALAMANCA,14,178,4,196,1810
GUANAJUATO,SALAMANCA,15,193,6,214,1898
GUANAJUATO,SALAMANCA,13,160,3,176,1897
GUANAJUATO,SALAMANCA,10,168,3,181,1321
GUANAJUATO,SALAMANCA,7,174,1,182,1321
GUANAJUATO,SALAMANCA,14,267,2,283,1687
GUANAJUATO,SALAMANCA,13,227,4,244,1687
GUANAJUATO,SALAMANCA,17,235,5,257,1775
GUANAJUATO,SALAMANCA,12,246,6,264,1774
GUANAJUATO,SALAMANCA,19,243,1,263,1671
GUANAJUATO,SALAMANCA,10,191,1,202,1671
GUANAJUATO,SALAMANCA,12,261,3,276,1891
GUANAJUATO,SALAMANCA,9,254,2,265,1891
GUANAJUATO,SALAMANCA,7,235,5,247,1891
GUANAJUATO,SALAMANCA,12,54,0,66,1277
GUANAJUATO,SALAMANCA,19,38,3,60,1276
GUANAJUATO,SALAMANCA,8,116,2,126,1274
GUANAJUATO,SALAMANCA,11,86,3,100,1274
GUANAJUATO,SALAMANCA,14,117,5,136,2040
GUANAJUATO,SALAMANCA,7,93,1,101,1482
GUANAJUATO,SALAMANCA,4,57,0,61,1482
GUANAJUATO,SALAMANCA,10,136,3,149,1995
GUANAJUATO,SALAMANCA,0,133,3,136,1994
GUANAJUATO,SALAMANCA,8,109,3,120,1030
GUANAJUATO,SALAMANCA,4,91,3,98,1030
GUANAJUATO,SALAMANCA,19,197,7,223,1816
GUANAJUATO,SALAMANCA,7,196,2,205,1816
GUANAJUATO,SALAMANCA,16,104,5,125,1985
GUANAJUATO,SALAMANCA,15,91,1,107,1985
GUANAJUATO,SALAMANCA,14,82,6,102,1514
GUANAJUATO,SALAMANCA,22,124,2,148,1513
GUANAJUATO,SALAMANCA,14,188,1,203,1411
GUANAJUATO,SALAMANCA,5,196,4,205,1410
GUANAJUATO,SALAMANCA,15,151,1,167,1565
GUANAJUATO,SALAMANCA,7,178,0,185,1565
GUANAJUATO,SALAMANCA,8,168,1,177,1802
GUANAJUATO,SALAMANCA,9,192,2,203,1802
GUANAJUATO,SALAMANCA,7,160,3,170,1801
GUANAJUATO,SALAMANCA,8,252,5,265,1553
GUANAJUATO,SALAMANCA,4,235,1,240,1553
GUANAJUATO,SALAMANCA,14,234,6,254,1552
GUANAJUATO,SALAMANCA,10,212,2,224,1506
GUANAJUATO,SALAMANCA,6,210,2,218,1506
GUANAJUATO,SALAMANCA,10,239,0,249,1816
GUANAJUATO,SALAMANCA,15,249,1,265,1815
GUANAJUATO,SALAMANCA,12,158,0,170,1298
GUANAJUATO,SALAMANCA,2,184,4,190,1298
GUANAJUATO,SALAMANCA,8,112,3,123,1731
GUANAJUATO,SALAMANCA,5,116,3,124,1731
GUANAJUATO,SALAMANCA,10,185,6,201,1862
GUANAJUATO,SALAMANCA,9,226,3,238,1861
GUANAJUATO,SALAMANCA,3,100,3,106,1935
GUANAJUATO,SALAMANCA,4,112,2,118,1935
GUANAJUATO,SALAMANCA,4,180,3,187,1327
GUANAJUATO,SALAMANCA,5,211,5,221,1326
GUANAJUATO,SALAMANCA,11,151,2,164,1326
GUANAJUATO,SALAMANCA,7,199,5,211,1466
GUANAJUATO,SALAMANCA,6,208,4,218,1466
GUANAJUATO,SALAMANCA,9,142,3,154,1049
GUANAJUATO,SALAMANCA,7,123,0,130,1048
GUANAJUATO,SALAMANCA,6,164,2,172,1457
GUANAJUATO,SALAMANCA,9,149,4,162,1457
GUANAJUATO,SALAMANCA,11,135,1,147,1457
GUANAJUATO,IRAPUATO,22,65,1,88,1550
GUANAJUATO,IRAPUATO,11,86,2,99,1550
GUANAJUATO,IRAPUATO,14,101,2,117,1549
GUANAJUATO,IRAPUATO,11,136,3,150,1703
GUANAJUATO,IRAPUATO,7,120,4,131,1702
GUANAJUATO,IRAPUATO,13,114,2,129,1702
GUANAJUATO,IRAPUATO,7,126,0,133,1702
GUANAJUATO,IRAPUATO,24,106,1,131,1728
GUANAJUATO,IRAPUATO,24,131,1,156,1727
GUANAJUATO,IRAPUATO,25,168,0,193,1727
GUANAJUATO,IRAPUATO,29,116,0,145,1745
GUANAJUATO,IRAPUATO,15,131,1,147,1744
GUANAJUATO,IRAPUATO,28,127,1,156,1744
GUANAJUATO,IRAPUATO,22,146,1,169,1731
GUANAJUATO,IRAPUATO,27,143,4,174,1731
GUANAJUATO,IRAPUATO,22,184,5,211,1532
GUANAJUATO,IRAPUATO,14,165,4,183,1532
GUANAJUATO,IRAPUATO,19,141,4,164,1791
GUANAJUATO,IRAPUATO,34,138,1,173,1791
GUANAJUATO,IRAPUATO,57,153,1,211,1963
GUANAJUATO,IRAPUATO,33,189,2,224,1963
GUANAJUATO,IRAPUATO,34,106,1,141,1707
GUANAJUATO,IRAPUATO,26,127,0,153,1707
GUANAJUATO,IRAPUATO,21,186,1,208,1490
GUANAJUATO,IRAPUATO,21,155,6,182,1489
GUANAJUATO,IRAPUATO,17,164,1,182,1516
GUANAJUATO,IRAPUATO,28,139,2,169,1515
GUANAJUATO,IRAPUATO,15,122,2,139,1515
GUANAJUATO,IRAPUATO,22,159,2,183,1515
GUANAJUATO,IRAPUATO,9,127,2,138,1883
GUANAJUATO,IRAPUATO,12,106,2,120,1883
GUANAJUATO,IRAPUATO,9,115,2,126,1883
GUANAJUATO,IRAPUATO,9,121,1,131,1882
GUANAJUATO,IRAPUATO,5,109,7,121,1882
GUANAJUATO,IRAPUATO,10,165,3,178,1788
GUANAJUATO,IRAPUATO,11,163,1,175,1787
GUANAJUATO,IRAPUATO,16,153,2,171,1787
GUANAJUATO,IRAPUATO,3,114,2,119,1658
GUANAJUATO,IRAPUATO,9,105,1,115,1658
GUANAJUATO,IRAPUATO,6,122,2,130,1658
GUANAJUATO,IRAPUATO,10,114,3,127,1657
GUANAJUATO,IRAPUATO,6,127,2,135,1657
GUANAJUATO,IRAPUATO,8,90,1,99,1347
GUANAJUATO,IRAPUATO,15,79,4,98,1347
GUANAJUATO,IRAPUATO,9,77,0,86,1347
GUANAJUATO,IRAPUATO,13,89,8,110,1617
GUANAJUATO,IRAPUATO,10,108,1,119,1616
GUANAJUATO,IRAPUATO,22,102,7,131,1616
GUANAJUATO,IRAPUATO,20,159,8,187,1955
GUANAJUATO,IRAPUATO,7,158,3,168,1954
GUANAJUATO,IRAPUATO,16,117,4,137,1114
GUANAJUATO,IRAPUATO,19,103,5,127,1114
GUANAJUATO,IRAPUATO,11,94,4,109,1747
GUANAJUATO,IRAPUATO,11,118,4,133,1747
GUANAJUATO,IRAPUATO,22,147,9,178,1932
GUANAJUATO,IRAPUATO,17,156,4,177,1932
GUANAJUATO,IRAPUATO,6,83,1,90,1543
GUANAJUATO,IRAPUATO,10,70,2,82,1542
GUANAJUATO,IRAPUATO,8,72,4,84,1542
GUANAJUATO,IRAPUATO,28,166,1,195,1670
GUANAJUATO,IRAPUATO,18,155,4,177,1669
GUANAJUATO,IRAPUATO,6,87,6,99,1471
GUANAJUATO,IRAPUATO,9,126,3,138,1471
GUANAJUATO,IRAPUATO,12,148,1,161,1470
GUANAJUATO,IRAPUATO,18,101,6,125,1392
GUANAJUATO,IRAPUATO,15,96,2,113,1391
GUANAJUATO,IRAPUATO,9,99,6,114,1379
GUANAJUATO,IRAPUATO,10,118,2,130,1379
GUANAJUATO,IRAPUATO,20,126,2,148,1481
GUANAJUATO,IRAPUATO,20,123,3,146,1480
GUANAJUATO,IRAPUATO,15,121,2,138,1480
GUANAJUATO,IRAPUATO,10,99,7,116,1061
GUANAJUATO,IRAPUATO,5,73,2,80,1061
GUANAJUATO,IRAPUATO,13,93,1,107,1402
GUANAJUATO,IRAPUATO,8,89,1,98,1401
GUANAJUATO,IRAPUATO,10,96,2,108,1401
GUANAJUATO,IRAPUATO,5,77,5,87,1321
GUANAJUATO,IRAPUATO,7,80,2,89,1320
GUANAJUATO,IRAPUATO,5,176,9,190,1715
GUANAJUATO,IRAPUATO,9,100,6,115,1715
GUANAJUATO,IRAPUATO,16,61,3,80,1503
GUANAJUATO,IRAPUATO,17,76,7,100,1502
GUANAJUATO,IRAPUATO,6,94,3,103,1340
GUANAJUATO,IRAPUATO,4,81,3,88,1339
GUANAJUATO,IRAPUATO,8,140,4,152,1804
GUANAJUATO,IRAPUATO,8,130,9,147,1804
GUANAJUATO,IRAPUATO,5,115,2,122,1359
GUANAJUATO,IRAPUATO,14,130,0,144,1358
GUANAJUATO,IRAPUATO,13,96,3,112,1358
GUANAJUATO,IRAPUATO,35,60,1,96,1647
GUANAJUATO,IRAPUATO,37,66,3,106,1647
GUANAJUATO,IRAPUATO,15,40,3,58,1115
GUANAJUATO,IRAPUATO,16,35,0,51,1114
GUANAJUATO,IRAPUATO,12,83,6,101,1807
GUANAJUATO,IRAPUATO,16,103,5,124,1807
GUANAJUATO,IRAPUATO,19,89,6,114,1807
GUANAJUATO,IRAPUATO,19,92,3,114,2008
GUANAJUATO,IRAPUATO,19,129,9,157,2008
GUANAJUATO,IRAPUATO,6,107,2,115,1909
GUANAJUATO,IRAPUATO,8,61,0,69,1909
GUANAJUATO,IRAPUATO,15,182,3,200,1491
GUANAJUATO,IRAPUATO,13,187,5,205,1490
GUANAJUATO,IRAPUATO,6,128,4,138,1490
GUANAJUATO,IRAPUATO,7,177,3,187,1762
GUANAJUATO,IRAPUATO,9,168,2,179,1761
GUANAJUATO,IRAPUATO,13,195,2,210,1971
GUANAJUATO,IRAPUATO,17,149,3,169,1970
GUANAJUATO,IRAPUATO,12,213,3,228,1708
GUANAJUATO,IRAPUATO,16,176,4,196,1708
GUANAJUATO,IRAPUATO,42,437,7,486,0
GUANAJUATO,IRAPUATO,12,191,2,205,1700
GUANAJUATO,IRAPUATO,13,188,4,205,1700
GUANAJUATO,IRAPUATO,13,136,1,150,1165
GUANAJUATO,IRAPUATO,11,137,2,150,1165
GUANAJUATO,IRAPUATO,16,175,2,193,1615
GUANAJUATO,IRAPUATO,14,147,1,162,1615
GUANAJUATO,IRAPUATO,18,171,2,191,1614
GUANAJUATO,IRAPUATO,14,156,2,172,1378
GUANAJUATO,IRAPUATO,162,12,4,178,1377
GUANAJUATO,IRAPUATO,16,200,1,217,1787
GUANAJUATO,IRAPUATO,17,197,2,216,1787
GUANAJUATO,IRAPUATO,15,215,3,233,1841
GUANAJUATO,IRAPUATO,21,230,1,252,1840
GUANAJUATO,IRAPUATO,16,155,2,173,1547
GUANAJUATO,IRAPUATO,19,166,2,187,1547
GUANAJUATO,IRAPUATO,12,162,3,177,1627
GUANAJUATO,IRAPUATO,14,189,2,205,1627
GUANAJUATO,IRAPUATO,15,179,10,204,1573
GUANAJUATO,IRAPUATO,8,159,3,170,1572
GUANAJUATO,IRAPUATO,4,191,4,199,1648
GUANAJUATO,IRAPUATO,6,177,3,186,1647
GUANAJUATO,IRAPUATO,10,197,0,207,1487
GUANAJUATO,IRAPUATO,8,192,1,201,1487
GUANAJUATO,IRAPUATO,11,193,3,207,1707
GUANAJUATO,IRAPUATO,11,201,2,214,1707
GUANAJUATO,IRAPUATO,10,210,4,224,1707
GUANAJUATO,IRAPUATO,3,152,1,156,1264
GUANAJUATO,IRAPUATO,10,152,3,165,1263
GUANAJUATO,IRAPUATO,10,71,1,82,1224
GUANAJUATO,IRAPUATO,10,120,0,130,1223
GUANAJUATO,IRAPUATO,9,87,0,96,1512
GUANAJUATO,IRAPUATO,7,95,4,106,1512
GUANAJUATO,IRAPUATO,5,105,1,111,1511
GUANAJUATO,IRAPUATO,17,104,0,121,1778
GUANAJUATO,IRAPUATO,17,123,4,144,1777
GUANAJUATO,IRAPUATO,12,100,0,112,1099
GUANAJUATO,IRAPUATO,12,96,0,108,1099
GUANAJUATO,IRAPUATO,14,155,1,170,1513
GUANAJUATO,IRAPUATO,15,131,5,151,1513
GUANAJUATO,IRAPUATO,20,166,6,192,1863
GUANAJUATO,IRAPUATO,12,143,7,162,1862
GUANAJUATO,IRAPUATO,13,127,3,143,1784
GUANAJUATO,IRAPUATO,14,100,4,118,1783
GUANAJUATO,IRAPUATO,14,144,5,163,1809
GUANAJUATO,IRAPUATO,14,184,2,200,1808
GUANAJUATO,IRAPUATO,8,182,4,194,1309
GUANAJUATO,IRAPUATO,7,176,3,186,1309
GUANAJUATO,IRAPUATO,20,143,6,169,1912
GUANAJUATO,IRAPUATO,16,168,0,184,1912
GUANAJUATO,IRAPUATO,27,277,9,313,1925
GUANAJUATO,IRAPUATO,15,265,5,285,1924
GUANAJUATO,IRAPUATO,11,146,5,162,1284
GUANAJUATO,IRAPUATO,2,117,3,122,1283
GUANAJUATO,IRAPUATO,19,129,8,156,1936
GUANAJUATO,IRAPUATO,9,101,6,116,1935
GUANAJUATO,IRAPUATO,9,119,3,131,1536
GUANAJUATO,IRAPUATO,10,113,0,123,1536
GUANAJUATO,IRAPUATO,4,102,2,108,1535
GUANAJUATO,IRAPUATO,7,111,1,119,1535
GUANAJUATO,IRAPUATO,13,95,10,118,1777
GUANAJUATO,IRAPUATO,11,173,6,190,1776
GUANAJUATO,IRAPUATO,11,164,6,181,2039
GUANAJUATO,IRAPUATO,9,179,3,191,2038
GUANAJUATO,IRAPUATO,19,166,2,187,1625
GUANAJUATO,IRAPUATO,17,170,3,190,1625
GUANAJUATO,IRAPUATO,14,149,8,171,1604
GUANAJUATO,IRAPUATO,12,138,4,154,1604
GUANAJUATO,IRAPUATO,13,150,2,165,1604
GUANAJUATO,IRAPUATO,21,198,4,223,1867
GUANAJUATO,IRAPUATO,21,218,8,247,1866
GUANAJUATO,IRAPUATO,17,105,1,123,1642
GUANAJUATO,IRAPUATO,12,100,6,118,1641
GUANAJUATO,IRAPUATO,12,293,9,314,1908
GUANAJUATO,IRAPUATO,18,327,4,349,1908
GUANAJUATO,IRAPUATO,8,129,5,142,1695
GUANAJUATO,IRAPUATO,12,106,2,120,1694
GUANAJUATO,URIANGATO,22,257,5,284,1878
GUANAJUATO,URIANGATO,13,220,2,235,1878
GUANAJUATO,URIANGATO,19,204,15,238,1877
GUANAJUATO,URIANGATO,20,206,4,230,1666
GUANAJUATO,URIANGATO,18,236,10,264,1665
GUANAJUATO,URIANGATO,13,289,6,308,1767
GUANAJUATO,URIANGATO,22,299,3,324,1766
GUANAJUATO,URIANGATO,12,177,1,190,1179
GUANAJUATO,URIANGATO,10,183,2,195,1179
GUANAJUATO,URIANGATO,21,256,1,278,1676
GUANAJUATO,URIANGATO,14,247,2,263,1675
GUANAJUATO,URIANGATO,5,200,4,209,1540
GUANAJUATO,URIANGATO,19,206,2,227,1540
GUANAJUATO,URIANGATO,15,188,1,204,1540
GUANAJUATO,URIANGATO,14,227,2,243,1501
GUANAJUATO,URIANGATO,17,226,5,248,1501
GUANAJUATO,URIANGATO,25,229,2,256,1620
GUANAJUATO,URIANGATO,10,218,3,231,1619
GUANAJUATO,URIANGATO,14,202,1,217,1124
GUANAJUATO,URIANGATO,11,213,12,236,1123
GUANAJUATO,URIANGATO,14,241,2,257,1897
GUANAJUATO,URIANGATO,9,260,2,271,1896
GUANAJUATO,URIANGATO,25,160,3,188,1280
GUANAJUATO,URIANGATO,20,138,1,159,1279
GUANAJUATO,URIANGATO,14,162,6,182,1490
GUANAJUATO,URIANGATO,3,146,7,156,1490
GUANAJUATO,URIANGATO,12,174,0,186,1489
GUANAJUATO,URIANGATO,8,209,2,219,1582
GUANAJUATO,URIANGATO,13,232,3,248,1582
GUANAJUATO,URIANGATO,12,151,4,167,1438
GUANAJUATO,URIANGATO,6,178,3,187,1438
GUANAJUATO,URIANGATO,0,177,5,182,1346
GUANAJUATO,URIANGATO,5,149,0,154,1345
GUANAJUATO,URIANGATO,12,159,0,171,1379
GUANAJUATO,URIANGATO,12,163,2,177,1379
GUANAJUATO,URIANGATO,16,104,6,126,1249
GUANAJUATO,URIANGATO,10,59,1,70,1248
GUANAJUATO,URIANGATO,5,195,1,201,1659
GUANAJUATO,URIANGATO,21,137,4,162,1659
GUANAJUATO,URIANGATO,13,218,4,235,1658
GUANAJUATO,URIANGATO,7,187,1,195,1752
GUANAJUATO,URIANGATO,8,232,3,243,1751
GUANAJUATO,URIANGATO,12,112,8,132,1934
GUANAJUATO,URIANGATO,16,130,3,149,1933
GUANAJUATO,URIANGATO,10,71,6,87,992
GUANAJUATO,URIANGATO,6,63,2,71,992
GUANAJUATO,URIANGATO,6,43,3,52,1608
GUANAJUATO,URIANGATO,6,37,5,48,1608
GUANAJUATO,URIANGATO,14,113,7,134,1977
GUANAJUATO,URIANGATO,10,112,3,125,1976
GUANAJUATO,URIANGATO,18,219,3,240,1553
GUANAJUATO,URIANGATO,11,242,3,256,1553
GUANAJUATO,URIANGATO,15,219,5,239,1782
GUANAJUATO,URIANGATO,23,216,6,245,1782
GUANAJUATO,URIANGATO,19,194,2,215,1701
GUANAJUATO,URIANGATO,24,180,4,208,1700
GUANAJUATO,URIANGATO,33,364,6,403,0
GUANAJUATO,URIANGATO,22,209,2,233,1708
GUANAJUATO,URIANGATO,14,222,2,238,1707
GUANAJUATO,URIANGATO,8,230,3,241,1263
GUANAJUATO,URIANGATO,8,197,5,210,1263
GUANAJUATO,URIANGATO,10,197,3,210,1739
GUANAJUATO,URIANGATO,7,220,4,231,1738
GUANAJUATO,URIANGATO,19,272,4,295,1728
GUANAJUATO,URIANGATO,20,250,3,273,1728
GUANAJUATO,URIANGATO,12,197,2,211,1662
GUANAJUATO,URIANGATO,11,165,3,179,1661
GUANAJUATO,URIANGATO,3,133,1,137,1248
GUANAJUATO,URIANGATO,6,153,1,160,1247
GUANAJUATO,URIANGATO,17,244,2,263,1910
GUANAJUATO,URIANGATO,21,259,5,285,1910
GUANAJUATO,URIANGATO,19,171,4,194,1603
GUANAJUATO,URIANGATO,19,168,2,189,1603
GUANAJUATO,URIANGATO,14,181,2,197,1603
GUANAJUATO,URIANGATO,9,130,3,142,1592
GUANAJUATO,URIANGATO,11,156,4,171,1592
GUANAJUATO,URIANGATO,7,146,4,157,1592
GUANAJUATO,URIANGATO,12,173,3,188,1817
GUANAJUATO,URIANGATO,8,171,2,181,1816
GUANAJUATO,URIANGATO,11,155,2,168,1867
GUANAJUATO,URIANGATO,4,215,4,223,1867
GUANAJUATO,URIANGATO,7,238,0,245,1700
GUANAJUATO,URIANGATO,9,214,1,224,1699
GUANAJUATO,URIANGATO,10,208,1,219,1814
GUANAJUATO,URIANGATO,9,222,3,234,1813
GUANAJUATO,URIANGATO,11,199,0,210,1913
GUANAJUATO,URIANGATO,9,225,2,236,1913
GUANAJUATO,URIANGATO,12,216,3,231,1495
GUANAJUATO,URIANGATO,18,202,2,222,1495
GUANAJUATO,URIANGATO,14,207,9,230,1667
GUANAJUATO,URIANGATO,22,228,3,253,1667
GUANAJUATO,URIANGATO,11,250,6,267,1857
GUANAJUATO,URIANGATO,8,241,2,251,1856
GUANAJUATO,URIANGATO,10,215,5,230,1507
GUANAJUATO,URIANGATO,11,203,4,218,1507
GUANAJUATO,URIANGATO,20,214,0,234,1503
GUANAJUATO,URIANGATO,11,219,2,232,1502
GUANAJUATO,URIANGATO,5,129,3,137,1375
GUANAJUATO,URIANGATO,4,142,3,149,1375
GUANAJUATO,URIANGATO,7,147,1,155,1375
GUANAJUATO,URIANGATO,6,224,9,239,1834
GUANAJUATO,URIANGATO,11,256,13,280,1834
GUANAJUATO,URIANGATO,3,158,3,164,1429
GUANAJUATO,URIANGATO,7,124,1,132,1429
GUANAJUATO,URIANGATO,7,150,5,162,1428
GUANAJUATO,URIANGATO,11,200,7,218,1828
GUANAJUATO,URIANGATO,10,199,11,220,1828
GUANAJUATO,URIANGATO,14,156,8,178,1412
GUANAJUATO,URIANGATO,7,222,9,238,1412
GUANAJUATO,URIANGATO,8,152,4,164,1412
GUANAJUATO,URIANGATO,4,184,5,193,1457
GUANAJUATO,URIANGATO,4,161,5,170,1457
GUANAJUATO,URIANGATO,8,147,6,161,1457
GUANAJUATO,URIANGATO,14,240,4,258,1688
GUANAJUATO,URIANGATO,9,187,4,200,1688
GUANAJUATO,URIANGATO,6,197,5,208,1687
GUANAJUATO,URIANGATO,18,258,14,290,1949
GUANAJUATO,URIANGATO,23,254,3,280,1948
GUANAJUATO,URIANGATO,1,131,3,135,1439
GUANAJUATO,URIANGATO,3,149,1,153,1438
GUANAJUATO,URIANGATO,3,136,3,142,1438
GUANAJUATO,URIANGATO,13,129,3,145,1363
GUANAJUATO,URIANGATO,8,142,0,150,1362
GUANAJUATO,URIANGATO,6,95,2,103,1071
GUANAJUATO,URIANGATO,4,76,2,82,1070
GUANAJUATO,URIANGATO,5,146,3,154,1857
GUANAJUATO,URIANGATO,9,165,6,180,1856
GUANAJUATO,URIANGATO,5,149,3,157,1508
GUANAJUATO,URIANGATO,3,143,6,152,1508
GUANAJUATO,URIANGATO,7,162,1,170,1508
GUANAJUATO,URIANGATO,5,204,3,212,1033
GUANAJUATO,URIANGATO,4,202,0,206,1033
GUANAJUATO,URIANGATO,5,110,2,117,1558
GUANAJUATO,URIANGATO,8,116,3,127,1558
GUANAJUATO,URIANGATO,3,64,5,72,1557
GUANAJUATO,URIANGATO,4,257,6,267,1573
GUANAJUATO,URIANGATO,10,207,4,221,1573
GUANAJUATO,URIANGATO,6,205,2,213,1442
GUANAJUATO,URIANGATO,4,176,4,184,1442
GUANAJUATO,URIANGATO,9,201,5,215,1441
GUANAJUATO,URIANGATO,11,332,3,346,1974
GUANAJUATO,URIANGATO,15,311,5,331,1974
GUANAJUATO,URIANGATO,13,254,3,270,1864
GUANAJUATO,URIANGATO,14,205,6,225,1863
GUANAJUATO,URIANGATO,10,240,5,255,1863
GUANAJUATO,URIANGATO,10,206,2,218,1415
GUANAJUATO,URIANGATO,10,164,1,175,1415
GUANAJUATO,URIANGATO,9,186,2,197,1414
GUANAJUATO,URIANGATO,9,275,3,287,1871
GUANAJUATO,URIANGATO,4,249,2,255,1871
GUANAJUATO,URIANGATO,9,231,4,244,1871
GUANAJUATO,URIANGATO,9,199,3,211,1441
GUANAJUATO,URIANGATO,7,214,3,224,1441
GUANAJUATO,URIANGATO,15,169,1,185,1319
GUANAJUATO,URIANGATO,14,193,3,210,1319
GUANAJUATO,URIANGATO,6,191,3,200,1319
GUANAJUATO,URIANGATO,16,199,3,218,1332
GUANAJUATO,URIANGATO,10,194,1,205,1331
GUANAJUATO,URIANGATO,14,224,2,240,1648
GUANAJUATO,URIANGATO,10,224,4,238,1648
GUANAJUATO,URIANGATO,9,204,6,219,1660
GUANAJUATO,URIANGATO,14,194,3,211,1660
GUANAJUATO,URIANGATO,10,247,1,258,1688
GUANAJUATO,URIANGATO,13,237,4,254,1688
GUANAJUATO,URIANGATO,13,196,9,218,1688
GUANAJUATO,URIANGATO,2,111,2,115,1314
GUANAJUATO,URIANGATO,4,105,5,114,1314
GUANAJUATO,URIANGATO,2,127,2,131,1314
GUANAJUATO,URIANGATO,5,76,1,82,1896
GUANAJUATO,URIANGATO,6,79,2,87,1896
GUANAJUATO,URIANGATO,9,232,2,243,1811
GUANAJUATO,URIANGATO,3,170,1,174,1810
GUANAJUATO,URIANGATO,6,243,3,252,1353
GUANAJUATO,URIANGATO,0,213,6,219,1353
GUANAJUATO,URIANGATO,13,211,5,229,1352
GUANAJUATO,URIANGATO,7,262,4,273,1491
GUANAJUATO,URIANGATO,9,276,5,290,1491
GUANAJUATO,URIANGATO,9,263,4,276,1436
GUANAJUATO,URIANGATO,5,200,3,208,1436
GUANAJUATO,URIANGATO,5,211,4,220,1435
GUANAJUATO,URIANGATO,9,233,1,243,1650
GUANAJUATO,URIANGATO,7,236,2,245,1650
GUANAJUATO,URIANGATO,7,256,2,265,1649
GUANAJUATO,URIANGATO,17,274,1,292,1576
GUANAJUATO,URIANGATO,7,283,2,292,1575
GUANAJUATO,URIANGATO,10,237,2,249,1872
GUANAJUATO,URIANGATO,7,212,5,224,1872
GUANAJUATO,URIANGATO,8,190,4,202,1498
GUANAJUATO,URIANGATO,4,224,3,231,1497
GUANAJUATO,URIANGATO,7,207,7,221,1497
GUANAJUATO,URIANGATO,11,118,4,133,1037
GUANAJUATO,URIANGATO,7,173,0,180,1037
GUANAJUATO,URIANGATO,12,210,17,239,1385
GUANAJUATO,URIANGATO,10,235,4,249,1385
GUANAJUATO,URIANGATO,3,106,6,115,1112
GUANAJUATO,URIANGATO,2,124,0,126,1111
GUANAJUATO,URIANGATO,11,116,3,130,1272
GUANAJUATO,URIANGATO,8,146,7,161,1271
GUANAJUATO,URIANGATO,22,104,10,136,1286
GUANAJUATO,URIANGATO,14,101,4,119,1286
GUANAJUATO,URIANGATO,11,92,10,113,1165
GUANAJUATO,URIANGATO,6,94,13,113,1164
GUANAJUATO,URIANGATO,7,94,3,104,1751
GUANAJUATO,URIANGATO,1,138,3,142,1751
GUANAJUATO,URIANGATO,21,209,3,233,1396
GUANAJUATO,URIANGATO,25,140,9,174,1395
GUANAJUATO,URIANGATO,19,157,12,188,1603
GUANAJUATO,URIANGATO,22,148,1,171,1602
GUANAJUATO,URIANGATO,5,68,1,74,1214
GUANAJUATO,URIANGATO,10,83,0,93,1214
GUANAJUATO,LEON,19,130,6,155,1429
GUANAJUATO,LEON,9,122,1,132,1429
GUANAJUATO,LEON,7,182,6,195,1539
GUANAJUATO,LEON,21,163,3,187,1538
GUANAJUATO,LEON,22,146,1,169,1858
GUANAJUATO,LEON,21,168,3,192,1857
GUANAJUATO,LEON,20,169,3,192,1926
GUANAJUATO,LEON,19,156,1,176,1926
GUANAJUATO,LEON,18,88,1,107,1326
GUANAJUATO,LEON,24,72,0,96,1326
GUANAJUATO,LEON,20,102,1,123,1325
GUANAJUATO,LEON,35,107,2,144,1919
GUANAJUATO,LEON,45,101,0,146,1918
GUANAJUATO,LEON,28,181,4,213,1827
GUANAJUATO,LEON,33,152,2,187,1826
GUANAJUATO,LEON,20,102,4,126,1851
GUANAJUATO,LEON,16,104,1,121,1850
GUANAJUATO,LEON,43,365,7,415,0
GUANAJUATO,LEON,9,91,0,100,1171
GUANAJUATO,LEON,22,87,2,111,1170
GUANAJUATO,LEON,24,126,3,153,1796
GUANAJUATO,LEON,29,106,0,135,1796
GUANAJUATO,LEON,33,97,1,131,1538
GUANAJUATO,LEON,18,117,0,135,1538
GUANAJUATO,LEON,32,76,3,111,1538
GUANAJUATO,LEON,12,96,1,109,1538
GUANAJUATO,LEON,17,138,1,156,1703
GUANAJUATO,LEON,11,144,2,157,1702
GUANAJUATO,LEON,23,85,1,109,1291
GUANAJUATO,LEON,9,100,2,111,1291
GUANAJUATO,LEON,26,133,1,160,1563
GUANAJUATO,LEON,27,111,2,140,1563
GUANAJUATO,LEON,15,120,5,140,1715
GUANAJUATO,LEON,8,120,1,129,1715
GUANAJUATO,LEON,22,126,2,150,1387
GUANAJUATO,LEON,2,112,2,116,1386
GUANAJUATO,LEON,23,144,5,172,1386
GUANAJUATO,LEON,18,144,11,173,1913
GUANAJUATO,LEON,19,155,1,175,1913
GUANAJUATO,LEON,15,103,0,118,1552
GUANAJUATO,LEON,22,115,0,137,1552
GUANAJUATO,LEON,15,159,7,181,1775
GUANAJUATO,LEON,23,132,2,157,1774
GUANAJUATO,LEON,22,134,0,156,1851
GUANAJUATO,LEON,20,134,2,156,1851
GUANAJUATO,LEON,22,121,1,144,1629
GUANAJUATO,LEON,19,103,3,125,1629
GUANAJUATO,LEON,21,128,2,151,1628
GUANAJUATO,LEON,27,122,0,149,1628
GUANAJUATO,LEON,33,82,4,119,1843
GUANAJUATO,LEON,24,110,0,134,1843
GUANAJUATO,LEON,14,110,1,125,1843
GUANAJUATO,LEON,22,103,2,127,1843
GUANAJUATO,LEON,24,89,0,113,1843
GUANAJUATO,LEON,17,96,2,115,1843
GUANAJUATO,LEON,18,90,0,108,1843
GUANAJUATO,LEON,16,105,3,124,1842
GUANAJUATO,LEON,16,110,0,126,1430
GUANAJUATO,LEON,9,103,0,112,1429
GUANAJUATO,LEON,11,121,0,132,1545
GUANAJUATO,LEON,12,117,0,129,1545
GUANAJUATO,LEON,21,118,1,140,1545
GUANAJUATO,LEON,18,113,1,132,1544
GUANAJUATO,LEON,15,139,5,159,1502
GUANAJUATO,LEON,16,138,1,155,1501
GUANAJUATO,LEON,8,148,0,156,1501
GUANAJUATO,LEON,15,143,0,158,1831
GUANAJUATO,LEON,18,132,6,156,1830
GUANAJUATO,LEON,20,113,4,137,1359
GUANAJUATO,LEON,22,122,2,146,1359
GUANAJUATO,LEON,17,140,2,159,1359
GUANAJUATO,LEON,9,127,5,141,1742
GUANAJUATO,LEON,12,145,3,160,1742
GUANAJUATO,LEON,9,85,0,94,1376
GUANAJUATO,LEON,2,104,2,108,1375
GUANAJUATO,LEON,4,102,0,106,1375
GUANAJUATO,LEON,22,103,1,126,1816
GUANAJUATO,LEON,9,86,1,96,1816
GUANAJUATO,LEON,22,75,1,98,1816
GUANAJUATO,LEON,21,93,3,117,1815
GUANAJUATO,LEON,24,107,2,133,1952
GUANAJUATO,LEON,38,101,0,139,1952
GUANAJUATO,LEON,29,110,1,140,1952
GUANAJUATO,LEON,30,131,0,161,1952
GUANAJUATO,LEON,20,122,2,144,1952
GUANAJUATO,LEON,24,134,0,158,1951
GUANAJUATO,LEON,30,106,0,136,1951
GUANAJUATO,LEON,22,131,0,153,1623
GUANAJUATO,LEON,30,115,1,146,1623
GUANAJUATO,LEON,14,120,2,136,1357
GUANAJUATO,LEON,12,108,2,122,1356
GUANAJUATO,LEON,11,123,0,134,1797
GUANAJUATO,LEON,18,142,2,162,1797
GUANAJUATO,LEON,21,120,5,146,1796
GUANAJUATO,LEON,19,111,1,131,1781
GUANAJUATO,LEON,15,121,0,136,1781
GUANAJUATO,LEON,14,134,4,152,1781
GUANAJUATO,LEON,18,88,2,108,1781
GUANAJUATO,LEON,14,101,1,116,1781
GUANAJUATO,LEON,16,106,3,125,1781
GUANAJUATO,LEON,18,106,4,128,1781
GUANAJUATO,LEON,7,115,5,127,1780
GUANAJUATO,LEON,16,98,2,116,1780
GUANAJUATO,LEON,12,111,4,127,1663
GUANAJUATO,LEON,9,109,2,120,1663
GUANAJUATO,LEON,5,80,3,88,1663
GUANAJUATO,LEON,8,96,0,104,1663
GUANAJUATO,LEON,7,92,4,103,1663
GUANAJUATO,LEON,17,110,0,127,1754
GUANAJUATO,LEON,22,102,3,127,1753
GUANAJUATO,LEON,16,89,1,106,1753
GUANAJUATO,LEON,9,102,2,113,1753
GUANAJUATO,LEON,13,99,3,115,1775
GUANAJUATO,LEON,12,111,4,127,1774
GUANAJUATO,LEON,22,122,3,147,1861
GUANAJUATO,LEON,12,117,4,133,1861
GUANAJUATO,LEON,14,100,0,114,1959
GUANAJUATO,LEON,17,88,0,105,1959
GUANAJUATO,LEON,11,87,2,100,1959
GUANAJUATO,LEON,10,94,1,105,1959
GUANAJUATO,LEON,16,79,2,97,1958
GUANAJUATO,LEON,12,102,0,114,1958
GUANAJUATO,LEON,13,108,1,122,1958
GUANAJUATO,LEON,20,136,4,160,1773
GUANAJUATO,LEON,16,123,1,140,1773
GUANAJUATO,LEON,16,117,0,133,1773
GUANAJUATO,LEON,8,74,1,83,1955
GUANAJUATO,LEON,10,86,3,99,1955
GUANAJUATO,LEON,18,62,8,88,1793
GUANAJUATO,LEON,22,78,3,103,1792
GUANAJUATO,LEON,16,65,3,84,1792
GUANAJUATO,LEON,15,75,1,91,1841
GUANAJUATO,LEON,17,82,2,101,1841
GUANAJUATO,LEON,17,74,1,92,1840
GUANAJUATO,LEON,12,106,2,120,1059
GUANAJUATO,LEON,5,70,1,76,1059
GUANAJUATO,LEON,14,114,5,133,1855
GUANAJUATO,LEON,16,74,3,93,1855
GUANAJUATO,LEON,18,97,2,117,1854
GUANAJUATO,LEON,16,38,3,57,1300
GUANAJUATO,LEON,24,42,0,66,1300
GUANAJUATO,LEON,22,89,10,121,1884
GUANAJUATO,LEON,26,89,2,117,1883
GUANAJUATO,LEON,17,87,4,108,1710
GUANAJUATO,LEON,14,125,4,143,1710
GUANAJUATO,LEON,19,98,1,118,1710
GUANAJUATO,LEON,9,42,0,51,1568
GUANAJUATO,LEON,6,80,4,90,1567
GUANAJUATO,LEON,11,148,5,164,1421
GUANAJUATO,LEON,14,119,4,137,1421
GUANAJUATO,LEON,26,190,9,225,1952
GUANAJUATO,LEON,34,208,16,258,1951
GUANAJUATO,LEON,14,121,9,144,1312
GUANAJUATO,LEON,26,152,4,182,1312
GUANAJUATO,LEON,9,99,1,109,1630
GUANAJUATO,LEON,6,92,1,99,1629
GUANAJUATO,LEON,13,80,0,93,1402
GUANAJUATO,LEON,26,99,0,125,1401
GUANAJUATO,LEON,21,114,0,135,1625
GUANAJUATO,LEON,15,109,1,125,1625
GUANAJUATO,LEON,22,105,0,127,1440
GUANAJUATO,LEON,10,70,2,82,1439
GUANAJUATO,LEON,8,87,0,95,1323
GUANAJUATO,LEON,13,91,0,104,1323
GUANAJUATO,LEON,6,69,0,75,1322
GUANAJUATO,LEON,16,73,1,90,1248
GUANAJUATO,LEON,22,82,0,104,1248
GUANAJUATO,LEON,23,104,0,127,1307
GUANAJUATO,LEON,16,107,0,123,1306
GUANAJUATO,CELAYA,16,171,3,190,1855
GUANAJUATO,CELAYA,20,166,1,187,1854
GUANAJUATO,CELAYA,17,152,1,170,1854
GUANAJUATO,CELAYA,14,141,1,156,1854
GUANAJUATO,CELAYA,19,151,3,173,1854
GUANAJUATO,CELAYA,15,153,1,169,1854
GUANAJUATO,CELAYA,14,152,0,166,1854
GUANAJUATO,CELAYA,10,177,0,187,1854
GUANAJUATO,CELAYA,17,182,3,202,1854
GUANAJUATO,CELAYA,19,189,1,209,1486
GUANAJUATO,CELAYA,13,163,2,178,1485
GUANAJUATO,CELAYA,30,168,0,198,1485
GUANAJUATO,CELAYA,24,134,1,159,1329
GUANAJUATO,CELAYA,15,120,0,135,1328
GUANAJUATO,CELAYA,8,121,2,131,1328
GUANAJUATO,CELAYA,18,168,7,193,1331
GUANAJUATO,CELAYA,15,160,5,180,1330
GUANAJUATO,CELAYA,6,113,23,142,1709
GUANAJUATO,CELAYA,11,154,3,168,1708
GUANAJUATO,CELAYA,10,154,3,167,1708
GUANAJUATO,CELAYA,8,124,0,132,1792
GUANAJUATO,CELAYA,13,115,1,129,1791
GUANAJUATO,CELAYA,17,163,1,181,1768
GUANAJUATO,CELAYA,13,157,0,170,1768
GUANAJUATO,CELAYA,19,132,1,152,1768
GUANAJUATO,CELAYA,16,145,1,162,1768
GUANAJUATO,CELAYA,12,151,1,164,1768
GUANAJUATO,CELAYA,21,129,2,152,1768
GUANAJUATO,CELAYA,18,142,0,160,1767
GUANAJUATO,CELAYA,15,130,0,145,1767
GUANAJUATO,CELAYA,6,110,0,116,1252
GUANAJUATO,CELAYA,5,98,0,103,1251
GUANAJUATO,CELAYA,11,147,2,160,1427
GUANAJUATO,CELAYA,7,145,2,154,1427
GUANAJUATO,CELAYA,9,164,3,176,1426
GUANAJUATO,CELAYA,23,204,4,231,1735
GUANAJUATO,CELAYA,13,204,1,218,1735
GUANAJUATO,CELAYA,9,210,1,220,1952
GUANAJUATO,CELAYA,6,191,3,200,1951
GUANAJUATO,CELAYA,22,123,0,145,1902
GUANAJUATO,CELAYA,8,103,2,113,1902
GUANAJUATO,CELAYA,25,192,1,218,1764
GUANAJUATO,CELAYA,25,175,0,200,1764
GUANAJUATO,CELAYA,26,266,5,297,1842
GUANAJUATO,CELAYA,25,249,6,280,1842
GUANAJUATO,CELAYA,8,163,0,171,1667
GUANAJUATO,CELAYA,14,138,0,152,1666
GUANAJUATO,CELAYA,14,166,2,182,1891
GUANAJUATO,CELAYA,29,193,2,224,1891
GUANAJUATO,CELAYA,30,179,4,213,1782
GUANAJUATO,CELAYA,30,198,2,230,1781
GUANAJUATO,CELAYA,9,159,2,170,1606
GUANAJUATO,CELAYA,13,172,0,185,1606
GUANAJUATO,CELAYA,9,147,3,159,1525
GUANAJUATO,CELAYA,29,116,6,151,1524
GUANAJUATO,CELAYA,32,169,3,204,1752
GUANAJUATO,CELAYA,21,164,4,189,1751
GUANAJUATO,CELAYA,10,186,1,197,1432
GUANAJUATO,CELAYA,21,187,2,210,1431
GUANAJUATO,CELAYA,12,132,1,145,1397
GUANAJUATO,CELAYA,20,104,0,124,1396
GUANAJUATO,CELAYA,12,92,1,105,1112
GUANAJUATO,CELAYA,16,83,0,99,1111
GUANAJUATO,CELAYA,32,195,2,229,1920
GUANAJUATO,CELAYA,29,173,2,204,1920
GUANAJUATO,CELAYA,30,145,3,178,1710
GUANAJUATO,CELAYA,29,153,2,184,1709
GUANAJUATO,CELAYA,22,146,5,173,1709
GUANAJUATO,CELAYA,26,145,0,171,1601
GUANAJUATO,CELAYA,28,139,1,168,1600
GUANAJUATO,CELAYA,31,122,0,153,1600
GUANAJUATO,CELAYA,19,173,5,197,1886
GUANAJUATO,CELAYA,13,168,1,182,1885
GUANAJUATO,CELAYA,15,151,4,170,1510
GUANAJUATO,CELAYA,7,170,3,180,1510
GUANAJUATO,CELAYA,13,89,2,104,1479
GUANAJUATO,CELAYA,16,107,1,124,1479
GUANAJUATO,CELAYA,13,102,1,116,1478
GUANAJUATO,CELAYA,39,119,1,159,1533
GUANAJUATO,CELAYA,32,128,3,163,1532
GUANAJUATO,CELAYA,15,158,1,174,1478
GUANAJUATO,CELAYA,17,142,2,161,1477
GUANAJUATO,CELAYA,36,206,3,245,1736
GUANAJUATO,CELAYA,19,207,4,230,1736
GUANAJUATO,CELAYA,29,187,1,217,1860
GUANAJUATO,CELAYA,24,187,6,217,1860
GUANAJUATO,CELAYA,35,184,3,222,1860
GUANAJUATO,CELAYA,23,185,2,210,1859
GUANAJUATO,CELAYA,15,198,1,214,1859
GUANAJUATO,CELAYA,25,185,2,212,1452
GUANAJUATO,CELAYA,11,195,1,207,1451
GUANAJUATO,CELAYA,32,184,3,219,1451
GUANAJUATO,CELAYA,41,117,2,160,1756
GUANAJUATO,CELAYA,27,179,2,208,1756
GUANAJUATO,CELAYA,14,76,1,91,1516
GUANAJUATO,CELAYA,11,78,1,90,1516
GUANAJUATO,CELAYA,9,85,3,97,1515
GUANAJUATO,CELAYA,22,126,0,148,1396
GUANAJUATO,CELAYA,22,99,2,123,1396
GUANAJUATO,CELAYA,17,148,1,166,1822
GUANAJUATO,CELAYA,10,142,2,154,1822
GUANAJUATO,CELAYA,13,156,0,169,1822
GUANAJUATO,CELAYA,87,769,11,867,0
GUANAJUATO,CELAYA,18,122,3,143,1380
GUANAJUATO,CELAYA,18,124,2,144,1379
GUANAJUATO,CELAYA,8,121,3,132,1379
GUANAJUATO,CELAYA,20,71,1,92,1092
GUANAJUATO,CELAYA,12,78,0,90,1092
GUANAJUATO,CELAYA,17,172,2,191,1772
GUANAJUATO,CELAYA,16,146,0,162,1771
GUANAJUATO,CELAYA,22,158,3,183,1771
GUANAJUATO,CELAYA,38,174,1,213,1709
GUANAJUATO,CELAYA,17,176,3,196,1709
GUANAJUATO,CELAYA,26,179,4,209,1708
GUANAJUATO,CELAYA,21,162,0,183,1562
GUANAJUATO,CELAYA,26,138,1,165,1561
GUANAJUATO,CELAYA,16,144,1,161,1561
GUANAJUATO,CELAYA,14,113,3,130,1320
GUANAJUATO,CELAYA,23,142,3,168,1320
GUANAJUATO,CELAYA,16,139,4,159,1320
GUANAJUATO,CELAYA,11,190,1,202,1605
GUANAJUATO,CELAYA,13,164,2,179,1605
GUANAJUATO,CELAYA,15,170,3,188,1604
GUANAJUATO,CELAYA,8,136,0,144,1548
GUANAJUATO,CELAYA,11,142,1,154,1547
GUANAJUATO,CELAYA,15,140,3,158,1547
GUANAJUATO,CELAYA,12,180,4,196,1843
GUANAJUATO,CELAYA,10,212,1,223,1842
GUANAJUATO,CELAYA,24,135,1,160,1791
GUANAJUATO,CELAYA,26,151,1,178,1791
GUANAJUATO,CELAYA,9,157,1,167,1421
GUANAJUATO,CELAYA,11,152,1,164,1421
GUANAJUATO,CELAYA,12,148,2,162,1421
GUANAJUATO,CELAYA,13,129,3,145,1156
GUANAJUATO,CELAYA,11,95,0,106,1156
GUANAJUATO,CELAYA,22,181,2,205,1523
GUANAJUATO,CELAYA,10,150,5,165,1522
GUANAJUATO,CELAYA,12,140,5,157,1294
GUANAJUATO,CELAYA,8,158,3,169,1293
GUANAJUATO,CELAYA,11,121,5,137,1631
GUANAJUATO,CELAYA,10,114,2,126,1631
GUANAJUATO,CELAYA,11,124,1,136,1408
GUANAJUATO,CELAYA,6,124,0,130,1407
GUANAJUATO,CELAYA,11,110,1,122,1596
GUANAJUATO,CELAYA,5,92,0,97,1596
GUANAJUATO,CELAYA,13,105,0,118,1595
GUANAJUATO,CELAYA,20,174,2,196,1597
GUANAJUATO,CELAYA,14,194,2,210,1596
GUANAJUATO,CELAYA,25,149,2,176,1925
GUANAJUATO,CELAYA,17,164,4,185,1924
GUANAJUATO,CELAYA,8,121,2,131,1805
GUANAJUATO,CELAYA,13,121,2,136,1805
GUANAJUATO,CELAYA,7,130,3,140,1896
GUANAJUATO,CELAYA,12,97,0,109,1895
GUANAJUATO,CELAYA,16,118,1,135,1895
GUANAJUATO,CELAYA,15,149,2,166,1895
GUANAJUATO,CELAYA,6,109,0,115,1589
GUANAJUATO,CELAYA,9,92,0,101,1589
GUANAJUATO,CELAYA,16,115,1,132,1589
GUANAJUATO,CELAYA,11,87,0,98,1211
GUANAJUATO,CELAYA,10,95,1,106,1210
GUANAJUATO,CELAYA,13,141,2,156,1783
GUANAJUATO,CELAYA,14,140,8,162,1783
GUANAJUATO,CELAYA,19,140,2,161,1782
GUANAJUATO,CELAYA,16,144,0,160,1782
GUANAJUATO,CELAYA,14,136,1,151,1604
GUANAJUATO,CELAYA,9,136,5,150,1603
GUANAJUATO,CELAYA,6,213,5,224,1751
GUANAJUATO,CELAYA,25,180,0,205,1751
GUANAJUATO,CELAYA,17,110,1,128,1935
GUANAJUATO,CELAYA,10,123,0,133,1935
GUANAJUATO,CELAYA,15,132,5,152,1958
GUANAJUATO,CELAYA,10,136,7,153,1957
GUANAJUATO,CELAYA,9,83,3,95,1802
GUANAJUATO,CELAYA,14,99,2,115,1801
GUANAJUATO,CELAYA,16,114,1,131,1452
GUANAJUATO,CELAYA,34,127,4,165,1452
GUANAJUATO,CELAYA,19,130,3,152,1452
GUANAJUATO,CELAYA,24,146,4,174,1617
GUANAJUATO,CELAYA,31,205,2,238,1616
GUANAJUATO,CELAYA,14,219,5,238,1925
GUANAJUATO,CELAYA,21,196,2,219,1925
GUANAJUATO,CELAYA,24,155,5,184,1544
GUANAJUATO,CELAYA,26,145,8,179,1543
GUANAJUATO,CELAYA,17,170,1,188,1577
GUANAJUATO,CELAYA,10,140,9,159,1577
GUANAJUATO,CELAYA,30,176,6,212,1920
GUANAJUATO,CELAYA,18,152,12,182,1919
GUANAJUATO,CELAYA,8,109,1,118,1572
GUANAJUATO,CELAYA,6,112,0,118,1571
GUANAJUATO,CELAYA,8,152,14,174,1785
GUANAJUATO,CELAYA,13,140,5,158,1785
GUANAJUATO,CELAYA,19,162,2,183,1597
GUANAJUATO,CELAYA,16,198,1,215,1596
GUANAJUATO,CELAYA,15,135,1,151,1524
GUANAJUATO,CELAYA,24,146,0,170,1524
GUANAJUATO,CELAYA,22,193,2,217,1874
GUANAJUATO,CELAYA,19,178,3,200,1873
GUANAJUATO,CELAYA,21,131,2,154,1431
GUANAJUATO,CELAYA,23,139,2,164,1431
GUANAJUATO,CELAYA,28,115,2,145,1430
GUANAJUATO,VALLE DE SANTIAGO,14,113,0,127,1770
GUANAJUATO,VALLE DE SANTIAGO,4,164,2,170,1769
GUANAJUATO,VALLE DE SANTIAGO,4,129,1,134,1731
GUANAJUATO,VALLE DE SANTIAGO,4,147,1,152,1731
GUANAJUATO,VALLE DE SANTIAGO,5,92,1,98,1455
GUANAJUATO,VALLE DE SANTIAGO,3,68,2,73,1455
GUANAJUATO,VALLE DE SANTIAGO,11,132,0,143,1319
GUANAJUATO,VALLE DE SANTIAGO,7,100,3,110,1318
GUANAJUATO,VALLE DE SANTIAGO,6,120,3,129,1366
GUANAJUATO,VALLE DE SANTIAGO,9,103,2,114,1365
GUANAJUATO,VALLE DE SANTIAGO,2,106,0,108,1365
GUANAJUATO,VALLE DE SANTIAGO,6,153,1,160,1785
GUANAJUATO,VALLE DE SANTIAGO,6,149,4,159,1784
GUANAJUATO,VALLE DE SANTIAGO,10,63,3,76,1760
GUANAJUATO,VALLE DE SANTIAGO,2,63,4,69,1760
GUANAJUATO,VALLE DE SANTIAGO,8,69,1,78,1759
GUANAJUATO,VALLE DE SANTIAGO,13,119,7,139,1877
GUANAJUATO,VALLE DE SANTIAGO,10,170,4,184,1877
GUANAJUATO,VALLE DE SANTIAGO,12,206,3,221,1879
GUANAJUATO,VALLE DE SANTIAGO,5,150,5,160,1878
GUANAJUATO,VALLE DE SANTIAGO,7,177,0,184,1967
GUANAJUATO,VALLE DE SANTIAGO,6,174,3,183,1966
GUANAJUATO,VALLE DE SANTIAGO,6,119,3,128,1770
GUANAJUATO,VALLE DE SANTIAGO,3,102,3,108,1770
GUANAJUATO,VALLE DE SANTIAGO,7,73,3,83,1432
GUANAJUATO,VALLE DE SANTIAGO,5,77,3,85,1431
GUANAJUATO,VALLE DE SANTIAGO,6,112,8,126,1431
GUANAJUATO,VALLE DE SANTIAGO,7,157,6,170,1829
GUANAJUATO,VALLE DE SANTIAGO,14,177,2,193,1828
GUANAJUATO,VALLE DE SANTIAGO,4,114,5,123,1633
GUANAJUATO,VALLE DE SANTIAGO,7,101,3,111,1633
GUANAJUATO,VALLE DE SANTIAGO,10,115,0,125,1633
GUANAJUATO,VALLE DE SANTIAGO,11,152,2,165,2002
GUANAJUATO,VALLE DE SANTIAGO,4,168,5,177,2001
GUANAJUATO,VALLE DE SANTIAGO,6,234,6,246,1837
GUANAJUATO,VALLE DE SANTIAGO,3,156,2,161,1836
GUANAJUATO,VALLE DE SANTIAGO,5,228,2,235,1761
GUANAJUATO,VALLE DE SANTIAGO,14,259,14,287,1761
GUANAJUATO,VALLE DE SANTIAGO,5,219,4,228,1761
GUANAJUATO,VALLE DE SANTIAGO,11,163,7,181,1761
GUANAJUATO,VALLE DE SANTIAGO,2,126,3,131,1365
GUANAJUATO,VALLE DE SANTIAGO,3,96,0,99,1364
GUANAJUATO,VALLE DE SANTIAGO,1,93,2,96,1364
GUANAJUATO,VALLE DE SANTIAGO,12,149,6,167,1953
GUANAJUATO,VALLE DE SANTIAGO,10,188,3,201,1952
GUANAJUATO,VALLE DE SANTIAGO,14,107,2,123,1258
GUANAJUATO,VALLE DE SANTIAGO,5,129,3,137,1257
GUANAJUATO,VALLE DE SANTIAGO,4,236,4,244,1705
GUANAJUATO,VALLE DE SANTIAGO,0,190,3,193,1704
GUANAJUATO,VALLE DE SANTIAGO,9,134,5,148,1889
GUANAJUATO,VALLE DE SANTIAGO,8,186,0,194,1889
GUANAJUATO,VALLE DE SANTIAGO,6,233,6,245,1889
GUANAJUATO,VALLE DE SANTIAGO,9,100,3,112,1082
GUANAJUATO,VALLE DE SANTIAGO,3,135,3,141,1082
GUANAJUATO,VALLE DE SANTIAGO,7,215,6,228,1729
GUANAJUATO,VALLE DE SANTIAGO,14,211,6,231,1728
GUANAJUATO,VALLE DE SANTIAGO,13,143,2,158,1609
GUANAJUATO,VALLE DE SANTIAGO,5,129,1,135,1608
GUANAJUATO,VALLE DE SANTIAGO,3,189,7,199,1636
GUANAJUATO,VALLE DE SANTIAGO,6,169,7,182,1635
GUANAJUATO,VALLE DE SANTIAGO,7,142,5,154,1813
GUANAJUATO,VALLE DE SANTIAGO,4,113,2,119,1813
GUANAJUATO,VALLE DE SANTIAGO,2,154,2,158,1813
GUANAJUATO,VALLE DE SANTIAGO,5,177,1,183,1388
GUANAJUATO,VALLE DE SANTIAGO,5,231,3,239,1388
GUANAJUATO,VALLE DE SANTIAGO,3,131,4,138,1381
GUANAJUATO,VALLE DE SANTIAGO,0,122,5,127,1381
GUANAJUATO,VALLE DE SANTIAGO,10,271,4,285,1736
GUANAJUATO,VALLE DE SANTIAGO,8,302,9,319,1735
GUANAJUATO,VALLE DE SANTIAGO,7,188,0,195,1638
GUANAJUATO,VALLE DE SANTIAGO,10,193,3,206,1638
GUANAJUATO,VALLE DE SANTIAGO,5,251,0,256,1704
GUANAJUATO,VALLE DE SANTIAGO,9,274,4,287,1703
GUANAJUATO,VALLE DE SANTIAGO,15,203,4,222,1317
GUANAJUATO,VALLE DE SANTIAGO,12,233,6,251,1316
GUANAJUATO,VALLE DE SANTIAGO,9,273,6,288,2027
GUANAJUATO,VALLE DE SANTIAGO,6,137,3,146,1593
GUANAJUATO,VALLE DE SANTIAGO,8,144,4,156,1592
GUANAJUATO,VALLE DE SANTIAGO,5,269,2,276,1924
GUANAJUATO,VALLE DE SANTIAGO,7,246,1,254,1923
GUANAJUATO,VALLE DE SANTIAGO,3,325,4,332,1573
GUANAJUATO,VALLE DE SANTIAGO,4,265,3,272,1573
GUANAJUATO,VALLE DE SANTIAGO,4,305,2,311,1573
GUANAJUATO,VALLE DE SANTIAGO,4,248,8,260,1870
GUANAJUATO,VALLE DE SANTIAGO,4,222,4,230,1870
GUANAJUATO,VALLE DE SANTIAGO,4,213,10,227,1870
GUANAJUATO,VALLE DE SANTIAGO,4,206,9,219,1869
GUANAJUATO,VALLE DE SANTIAGO,10,169,6,185,1906
GUANAJUATO,VALLE DE SANTIAGO,19,164,8,191,1905
GUANAJUATO,VALLE DE SANTIAGO,6,107,3,116,1758
GUANAJUATO,VALLE DE SANTIAGO,7,105,4,116,1757
GUANAJUATO,VALLE DE SANTIAGO,6,173,6,185,1371
GUANAJUATO,VALLE DE SANTIAGO,11,146,0,157,1370
GUANAJUATO,VALLE DE SANTIAGO,4,35,0,39,1429
GUANAJUATO,VALLE DE SANTIAGO,7,54,2,63,1429
GUANAJUATO,VALLE DE SANTIAGO,5,40,2,47,1428
GUANAJUATO,VALLE DE SANTIAGO,13,227,3,243,1897
GUANAJUATO,VALLE DE SANTIAGO,8,197,13,218,1896
GUANAJUATO,VALLE DE SANTIAGO,6,202,2,210,1579
GUANAJUATO,VALLE DE SANTIAGO,14,175,3,192,1579
GUANAJUATO,VALLE DE SANTIAGO,8,188,1,197,1579
GUANAJUATO,VALLE DE SANTIAGO,6,161,10,177,1570
GUANAJUATO,VALLE DE SANTIAGO,4,155,0,159,1570
GUANAJUATO,VALLE DE SANTIAGO,5,184,2,191,1569
GUANAJUATO,VALLE DE SANTIAGO,7,261,5,273,1773
GUANAJUATO,VALLE DE SANTIAGO,14,243,4,261,1773
GUANAJUATO,VALLE DE SANTIAGO,18,158,1,177,1275
GUANAJUATO,VALLE DE SANTIAGO,9,138,3,150,1275
GUANAJUATO,VALLE DE SANTIAGO,10,102,6,118,1773
GUANAJUATO,VALLE DE SANTIAGO,12,95,0,107,1773
GUANAJUATO,VALLE DE SANTIAGO,5,115,2,122,1902
GUANAJUATO,VALLE DE SANTIAGO,2,106,1,109,1901
GUANAJUATO,VALLE DE SANTIAGO,14,159,8,181,1645
GUANAJUATO,VALLE DE SANTIAGO,9,204,9,222,1645
GUANAJUATO,VALLE DE SANTIAGO,2,197,2,201,1645
GUANAJUATO,VALLE DE SANTIAGO,14,97,0,111,1733
GUANAJUATO,VALLE DE SANTIAGO,3,152,3,158,1733
GUANAJUATO,VALLE DE SANTIAGO,4,127,2,133,1500
GUANAJUATO,VALLE DE SANTIAGO,7,114,3,124,1499
GUANAJUATO,VALLE DE SANTIAGO,3,142,3,148,1499
GUANAJUATO,VALLE DE SANTIAGO,10,96,1,107,1206
GUANAJUATO,VALLE DE SANTIAGO,5,113,3,121,1206
GUANAJUATO,VALLE DE SANTIAGO,15,219,2,236,1850
GUANAJUATO,VALLE DE SANTIAGO,3,208,1,212,1850
GUANAJUATO,VALLE DE SANTIAGO,8,226,2,236,1850
GUANAJUATO,VALLE DE SANTIAGO,7,236,1,244,1735
GUANAJUATO,VALLE DE SANTIAGO,8,240,0,248,1735
GUANAJUATO,VALLE DE SANTIAGO,16,284,4,304,1824
GUANAJUATO,VALLE DE SANTIAGO,10,248,5,263,1823
GUANAJUATO,VALLE DE SANTIAGO,9,218,0,227,1372
GUANAJUATO,VALLE DE SANTIAGO,7,179,2,188,1372
GUANAJUATO,VALLE DE SANTIAGO,9,158,1,168,1371
GUANAJUATO,VALLE DE SANTIAGO,3,193,4,200,1502
GUANAJUATO,VALLE DE SANTIAGO,6,167,1,174,1501
GUANAJUATO,VALLE DE SANTIAGO,3,189,2,194,1543
GUANAJUATO,VALLE DE SANTIAGO,8,223,2,233,1542
GUANAJUATO,VALLE DE SANTIAGO,44,446,8,498,0
GUANAJUATO,VALLE DE SANTIAGO,17,187,5,209,1354
GUANAJUATO,VALLE DE SANTIAGO,17,164,5,186,1354
GUANAJUATO,VALLE DE SANTIAGO,10,244,2,256,1541
GUANAJUATO,VALLE DE SANTIAGO,16,234,4,254,1540
GUANAJUATO,VALLE DE SANTIAGO,2,170,3,175,1880
GUANAJUATO,VALLE DE SANTIAGO,9,178,3,190,1879
GUANAJUATO,VALLE DE SANTIAGO,11,254,1,266,1837
GUANAJUATO,VALLE DE SANTIAGO,16,256,3,275,1837
GUANAJUATO,VALLE DE SANTIAGO,6,215,3,224,1665
GUANAJUATO,VALLE DE SANTIAGO,8,178,9,195,1665
GUANAJUATO,VALLE DE SANTIAGO,6,220,0,226,1948
GUANAJUATO,VALLE DE SANTIAGO,9,222,2,233,1947
GUANAJUATO,VALLE DE SANTIAGO,8,173,7,188,1698
GUANAJUATO,VALLE DE SANTIAGO,7,183,6,196,1697
GUANAJUATO,VALLE DE SANTIAGO,4,135,3,142,1047
GUANAJUATO,VALLE DE SANTIAGO,1,151,0,152,1046
GUANAJUATO,VALLE DE SANTIAGO,12,207,5,224,1372
GUANAJUATO,VALLE DE SANTIAGO,7,182,2,191,1372
GUANAJUATO,VALLE DE SANTIAGO,5,190,3,198,1561
GUANAJUATO,VALLE DE SANTIAGO,8,189,3,200,1560
GUANAJUATO,VALLE DE SANTIAGO,9,160,9,178,1396
GUANAJUATO,VALLE DE SANTIAGO,8,147,5,160,1396
GUANAJUATO,VALLE DE SANTIAGO,6,154,4,164,1396
GUANAJUATO,VALLE DE SANTIAGO,7,170,1,178,1646
GUANAJUATO,VALLE DE SANTIAGO,4,152,0,156,1646
GUANAJUATO,VALLE DE SANTIAGO,6,193,4,203,1645
GUANAJUATO,VALLE DE SANTIAGO,2,141,2,145,1537
GUANAJUATO,VALLE DE SANTIAGO,5,144,3,152,1536
GUANAJUATO,VALLE DE SANTIAGO,3,149,3,155,1620
GUANAJUATO,VALLE DE SANTIAGO,6,168,6,180,1619
GUANAJUATO,VALLE DE SANTIAGO,12,260,4,276,1902
GUANAJUATO,VALLE DE SANTIAGO,7,229,7,243,1902
GUANAJUATO,VALLE DE SANTIAGO,6,94,1,101,1403
GUANAJUATO,VALLE DE SANTIAGO,3,76,2,81,1403
GUANAJUATO,VALLE DE SANTIAGO,8,268,9,285,1731
GUANAJUATO,VALLE DE SANTIAGO,5,254,2,261,1731
GUANAJUATO,VALLE DE SANTIAGO,10,279,4,293,1605
GUANAJUATO,VALLE DE SANTIAGO,11,267,9,287,1605
GUANAJUATO,VALLE DE SANTIAGO,12,216,3,231,1604
GUANAJUATO,VALLE DE SANTIAGO,4,206,0,210,1764
GUANAJUATO,VALLE DE SANTIAGO,4,236,3,243,1764
GUANAJUATO,VALLE DE SANTIAGO,14,170,5,189,1771
GUANAJUATO,VALLE DE SANTIAGO,12,206,5,223,1771
GUANAJUATO,VALLE DE SANTIAGO,7,118,5,130,1710
GUANAJUATO,VALLE DE SANTIAGO,5,133,4,142,1710
GUANAJUATO,VALLE DE SANTIAGO,14,249,4,267,1902
GUANAJUATO,VALLE DE SANTIAGO,14,219,4,237,1901
GUANAJUATO,VALLE DE SANTIAGO,6,55,4,65,1423
GUANAJUATO,VALLE DE SANTIAGO,3,74,8,85,1423
GUANAJUATO,VALLE DE SANTIAGO,5,51,1,57,1423
GUANAJUATO,VALLE DE SANTIAGO,1,101,3,105,1391
GUANAJUATO,VALLE DE SANTIAGO,3,99,3,105,1390
GUANAJUATO,VALLE DE SANTIAGO,3,88,1,92,1390
GUANAJUATO,VALLE DE SANTIAGO,0,103,1,104,1713
GUANAJUATO,VALLE DE SANTIAGO,8,109,5,122,1712
GUANAJUATO,ACAMBARO,23,205,4,232,1754
GUANAJUATO,ACAMBARO,27,184,5,216,1753
GUANAJUATO,ACAMBARO,10,204,8,222,1911
GUANAJUATO,ACAMBARO,14,194,4,212,1911
GUANAJUATO,ACAMBARO,10,143,9,162,1957
GUANAJUATO,ACAMBARO,6,157,3,166,1957
GUANAJUATO,ACAMBARO,14,144,0,158,1543
GUANAJUATO,ACAMBARO,13,153,2,168,1542
GUANAJUATO,ACAMBARO,5,176,8,189,1542
GUANAJUATO,ACAMBARO,10,138,3,151,1327
GUANAJUATO,ACAMBARO,11,132,1,144,1326
GUANAJUATO,ACAMBARO,8,204,2,214,1692
GUANAJUATO,ACAMBARO,16,187,5,208,1692
GUANAJUATO,ACAMBARO,21,190,1,212,1742
GUANAJUATO,ACAMBARO,23,176,4,203,1741
GUANAJUATO,ACAMBARO,9,136,6,151,1174
GUANAJUATO,ACAMBARO,6,142,2,150,1173
GUANAJUATO,ACAMBARO,13,153,1,167,1596
GUANAJUATO,ACAMBARO,9,177,7,193,1596
GUANAJUATO,ACAMBARO,7,133,4,144,1364
GUANAJUATO,ACAMBARO,7,166,3,176,1364
GUANAJUATO,ACAMBARO,24,220,6,250,1790
GUANAJUATO,ACAMBARO,22,230,1,253,1790
GUANAJUATO,ACAMBARO,44,371,7,422,0
GUANAJUATO,ACAMBARO,4,140,1,145,1433
GUANAJUATO,ACAMBARO,12,144,1,157,1432
GUANAJUATO,ACAMBARO,5,98,4,107,1267
GUANAJUATO,ACAMBARO,7,123,2,132,1266
GUANAJUATO,ACAMBARO,6,133,8,147,1373
GUANAJUATO,ACAMBARO,6,153,7,166,1373
GUANAJUATO,ACAMBARO,9,119,4,132,1373
GUANAJUATO,ACAMBARO,14,148,6,168,1945
GUANAJUATO,ACAMBARO,19,94,10,123,1945
GUANAJUATO,ACAMBARO,8,129,1,138,1361
GUANAJUATO,ACAMBARO,5,92,3,100,1361
GUANAJUATO,ACAMBARO,1,132,4,137,1649
GUANAJUATO,ACAMBARO,9,129,13,151,1648
GUANAJUATO,ACAMBARO,16,120,7,143,1648
GUANAJUATO,ACAMBARO,7,144,11,162,1846
GUANAJUATO,ACAMBARO,16,171,2,189,1846
GUANAJUATO,ACAMBARO,16,117,4,137,1817
GUANAJUATO,ACAMBARO,15,134,3,152,1816
GUANAJUATO,ACAMBARO,7,109,2,118,1346
GUANAJUATO,ACAMBARO,7,94,5,106,1346
GUANAJUATO,ACAMBARO,6,113,1,120,1345
GUANAJUATO,ACAMBARO,5,152,7,164,1672
GUANAJUATO,ACAMBARO,4,154,2,160,1672
GUANAJUATO,ACAMBARO,15,84,10,109,1640
GUANAJUATO,ACAMBARO,9,97,6,112,1640
GUANAJUATO,ACAMBARO,7,88,0,95,1639
GUANAJUATO,ACAMBARO,9,131,2,142,1639
GUANAJUATO,ACAMBARO,21,128,4,153,1782
GUANAJUATO,ACAMBARO,21,123,13,157,1781
GUANAJUATO,ACAMBARO,17,148,4,169,1827
GUANAJUATO,ACAMBARO,21,159,5,185,1827
GUANAJUATO,ACAMBARO,14,164,13,191,1826
GUANAJUATO,ACAMBARO,15,107,2,124,1689
GUANAJUATO,ACAMBARO,14,108,7,129,1689
GUANAJUATO,ACAMBARO,7,97,3,107,1688
GUANAJUATO,ACAMBARO,8,67,4,79,1432
GUANAJUATO,ACAMBARO,6,64,3,73,1431
GUANAJUATO,ACAMBARO,12,84,4,100,1431
GUANAJUATO,ACAMBARO,17,156,5,178,1960
GUANAJUATO,ACAMBARO,10,206,2,218,1960
GUANAJUATO,ACAMBARO,15,147,6,168,1441
GUANAJUATO,ACAMBARO,23,116,1,140,1441
GUANAJUATO,ACAMBARO,9,114,2,125,1440
GUANAJUATO,ACAMBARO,10,126,6,142,1909
GUANAJUATO,ACAMBARO,13,126,3,142,1909
GUANAJUATO,ACAMBARO,5,145,1,151,1764
GUANAJUATO,ACAMBARO,5,101,4,110,1763
GUANAJUATO,ACAMBARO,13,125,2,140,1802
GUANAJUATO,ACAMBARO,8,118,4,130,1802
GUANAJUATO,ACAMBARO,5,117,3,125,1801
GUANAJUATO,ACAMBARO,9,126,1,136,1527
GUANAJUATO,ACAMBARO,2,102,1,105,1527
GUANAJUATO,ACAMBARO,3,101,1,105,1526
GUANAJUATO,ACAMBARO,3,89,3,95,1570
GUANAJUATO,ACAMBARO,6,61,0,67,1569
GUANAJUATO,ACAMBARO,1,46,2,49,1569
GUANAJUATO,ACAMBARO,10,108,0,118,1954
GUANAJUATO,ACAMBARO,8,125,0,133,1953
GUANAJUATO,ACAMBARO,12,270,4,286,1789
GUANAJUATO,ACAMBARO,6,221,6,233,1788
GUANAJUATO,ACAMBARO,17,118,3,138,1878
GUANAJUATO,ACAMBARO,12,125,0,137,1877
GUANAJUATO,ACAMBARO,9,72,3,84,1707
GUANAJUATO,ACAMBARO,16,70,4,90,1706
GUANAJUATO,ACAMBARO,7,61,1,69,1706
GUANAJUATO,ACAMBARO,13,90,6,109,1541
GUANAJUATO,ACAMBARO,10,83,4,97,1541
GUANAJUATO,ACAMBARO,13,92,5,110,1541
GUANAJUATO,ACAMBARO,10,145,7,162,1106
GUANAJUATO,ACAMBARO,9,147,2,158,1105
GUANAJUATO,ACAMBARO,8,131,4,143,1762
GUANAJUATO,ACAMBARO,10,140,3,153,1762
GUANAJUATO,ACAMBARO,11,166,1,178,1762
GUANAJUATO,ACAMBARO,12,216,3,231,1879
GUANAJUATO,ACAMBARO,9,202,1,212,1879
GUANAJUATO,ACAMBARO,18,241,5,264,1819
GUANAJUATO,ACAMBARO,13,230,0,243,1819
GUANAJUATO,ACAMBARO,11,153,4,168,1614
GUANAJUATO,ACAMBARO,11,158,0,169,1614
GUANAJUATO,ACAMBARO,2,164,3,169,1580
GUANAJUATO,ACAMBARO,7,140,5,152,1580
GUANAJUATO,ACAMBARO,3,112,4,119,1580
GUANAJUATO,ACAMBARO,13,58,10,81,1503
GUANAJUATO,ACAMBARO,14,51,6,71,1503
GUANAJUATO,ACAMBARO,12,117,3,132,1913
GUANAJUATO,ACAMBARO,8,106,5,119,1913
GUANAJUATO,ACAMBARO,3,118,4,125,1912
GUANAJUATO,ACAMBARO,6,157,3,166,1777
GUANAJUATO,ACAMBARO,6,131,0,137,1777
GUANAJUATO,ACAMBARO,5,124,1,130,1808
GUANAJUATO,ACAMBARO,3,97,4,104,1807
GUANAJUATO,ACAMBARO,3,133,5,141,1225
GUANAJUATO,ACAMBARO,6,122,8,136,1225
GUANAJUATO,ACAMBARO,3,165,11,179,1721
GUANAJUATO,ACAMBARO,0,147,7,154,1720
GUANAJUATO,ACAMBARO,7,63,0,70,1832
GUANAJUATO,ACAMBARO,6,69,1,76,1832
GUANAJUATO,ACAMBARO,4,55,1,60,1831
GUANAJUATO,ACAMBARO,15,136,5,156,1743
GUANAJUATO,ACAMBARO,7,181,3,191,1743
GUANAJUATO,ACAMBARO,2,139,3,144,1743
GUANAJUATO,ACAMBARO,8,197,6,211,1882
GUANAJUATO,ACAMBARO,15,209,1,225,1882
GUANAJUATO,ACAMBARO,13,184,3,200,1881
GUANAJUATO,ACAMBARO,3,109,2,114,1346
GUANAJUATO,ACAMBARO,2,119,3,124,1346
GUANAJUATO,ACAMBARO,9,171,2,182,1645
GUANAJUATO,ACAMBARO,11,155,6,172,1645
GUANAJUATO,ACAMBARO,10,154,6,170,1663
GUANAJUATO,ACAMBARO,5,119,1,125,1663
GUANAJUATO,ACAMBARO,19,98,1,118,1415
GUANAJUATO,ACAMBARO,11,94,1,106,1415
GUANAJUATO,ACAMBARO,20,81,2,103,1414
GUANAJUATO,ACAMBARO,9,89,2,100,1848
GUANAJUATO,ACAMBARO,4,66,8,78,1848
GUANAJUATO,ACAMBARO,7,95,2,104,1773
GUANAJUATO,ACAMBARO,7,109,2,118,1772
GUANAJUATO,ACAMBARO,10,93,5,108,1772
GUANAJUATO,ACAMBARO,18,180,5,203,1748
GUANAJUATO,ACAMBARO,2,203,3,208,1747
GUANAJUATO,ACAMBARO,12,179,4,195,1261
GUANAJUATO,ACAMBARO,12,136,3,151,1260
GUANAJUATO,ACAMBARO,8,96,1,105,1742
GUANAJUATO,ACAMBARO,8,73,2,83,1742
GUANAJUATO,ACAMBARO,18,86,16,120,1737
GUANAJUATO,ACAMBARO,10,73,11,94,1737
GUANAJUATO,ACAMBARO,17,108,3,128,1737
GUANAJUATO,ACAMBARO,13,77,9,99,1482
GUANAJUATO,ACAMBARO,4,153,7,164,1482
GUANAJUATO,ACAMBARO,11,158,2,171,1481
GUANAJUATO,ACAMBARO,13,81,3,97,1598
GUANAJUATO,ACAMBARO,18,132,8,158,1598
GUANAJUATO,ACAMBARO,12,70,3,85,1716
GUANAJUATO,ACAMBARO,15,85,8,108,1715
GUANAJUATO,ACAMBARO,7,104,8,119,1392
GUANAJUATO,ACAMBARO,4,86,5,95,1392
GUANAJUATO,ACAMBARO,6,77,7,90,1392
GUANAJUATO,ACAMBARO,13,131,3,147,1501
GUANAJUATO,ACAMBARO,11,130,11,152,1500
GUANAJUATO,ACAMBARO,15,111,7,133,1923
GUANAJUATO,ACAMBARO,10,112,3,125,1923
GUANAJUATO,ACAMBARO,16,158,6,180,1662
GUANAJUATO,ACAMBARO,16,152,10,178,1662
GUANAJUATO,ACAMBARO,15,197,7,219,1413
GUANAJUATO,ACAMBARO,15,176,0,191,1413
GUANAJUATO,ACAMBARO,11,167,15,193,1413
GUANAJUATO,ACAMBARO,9,194,9,212,1576
GUANAJUATO,ACAMBARO,11,201,2,214,1576
GUANAJUATO,ACAMBARO,8,191,2,201,1576
GUANAJUATO,ACAMBARO,7,91,4,102,1547
GUANAJUATO,ACAMBARO,9,80,1,90,1547
GUANAJUATO,ACAMBARO,2,214,3,219,1508
GUANAJUATO,ACAMBARO,5,213,10,228,1507
GUANAJUATO,ACAMBARO,10,158,4,172,1595
GUANAJUATO,ACAMBARO,15,185,0,200,1595
GUANAJUATO,ACAMBARO,7,172,4,183,1595
GUANAJUATO,ACAMBARO,19,281,6,306,1538
GUANAJUATO,ACAMBARO,11,248,11,270,1538
GUANAJUATO,ACAMBARO,16,178,2,196,1559
GUANAJUATO,ACAMBARO,12,211,2,225,1559
GUANAJUATO,ACAMBARO,17,216,6,239,1558
GUANAJUATO,ACAMBARO,4,238,2,244,1214
GUANAJUATO,ACAMBARO,10,203,5,218,1213
GUANAJUATO,ACAMBARO,8,112,6,126,1908
GUANAJUATO,ACAMBARO,10,136,3,149,1908
GUANAJUATO,IRAPUATO,23,157,0,180,1381
GUANAJUATO,IRAPUATO,14,143,2,159,1380
GUANAJUATO,IRAPUATO,29,60,5,94,1039
GUANAJUATO,IRAPUATO,18,62,1,81,1039
GUANAJUATO,IRAPUATO,13,160,1,174,1355
GUANAJUATO,IRAPUATO,12,148,0,160,1354
GUANAJUATO,IRAPUATO,13,154,6,173,1712
GUANAJUATO,IRAPUATO,14,148,2,164,1711
GUANAJUATO,IRAPUATO,7,128,4,139,1711
GUANAJUATO,IRAPUATO,31,175,1,207,1671
GUANAJUATO,IRAPUATO,16,165,3,184,1671
GUANAJUATO,IRAPUATO,20,174,5,199,1670
GUANAJUATO,IRAPUATO,12,169,2,183,1663
GUANAJUATO,IRAPUATO,8,164,2,174,1662
GUANAJUATO,IRAPUATO,32,126,5,163,1902
GUANAJUATO,IRAPUATO,29,153,3,185,1902
GUANAJUATO,IRAPUATO,12,104,0,116,1524
GUANAJUATO,IRAPUATO,21,113,1,135,1524
GUANAJUATO,IRAPUATO,13,109,1,123,1524
GUANAJUATO,IRAPUATO,10,146,1,157,1282
GUANAJUATO,IRAPUATO,7,138,1,146,1282
GUANAJUATO,IRAPUATO,12,133,1,146,1560
GUANAJUATO,IRAPUATO,9,116,3,128,1560
GUANAJUATO,IRAPUATO,12,148,4,164,1559
GUANAJUATO,IRAPUATO,79,688,9,776,0
GUANAJUATO,IRAPUATO,17,179,4,200,1943
GUANAJUATO,IRAPUATO,19,167,0,186,1942
GUANAJUATO,IRAPUATO,27,161,1,189,1942
GUANAJUATO,IRAPUATO,16,114,1,131,1641
GUANAJUATO,IRAPUATO,20,124,1,145,1641
GUANAJUATO,IRAPUATO,12,121,0,133,1641
GUANAJUATO,IRAPUATO,19,130,1,150,1448
GUANAJUATO,IRAPUATO,8,144,1,153,1448
GUANAJUATO,IRAPUATO,16,125,0,141,1448
GUANAJUATO,IRAPUATO,12,161,1,174,1618
GUANAJUATO,IRAPUATO,13,186,2,201,1617
GUANAJUATO,IRAPUATO,13,188,0,201,1617
GUANAJUATO,IRAPUATO,15,202,1,218,1894
GUANAJUATO,IRAPUATO,17,227,7,251,1893
GUANAJUATO,IRAPUATO,16,134,1,151,1344
GUANAJUATO,IRAPUATO,13,142,7,162,1344
GUANAJUATO,IRAPUATO,19,132,4,155,1344
GUANAJUATO,IRAPUATO,14,208,2,224,1819
GUANAJUATO,IRAPUATO,16,202,2,220,1819
GUANAJUATO,IRAPUATO,9,130,4,143,1334
GUANAJUATO,IRAPUATO,8,150,4,162,1333
GUANAJUATO,IRAPUATO,6,134,1,141,1333
GUANAJUATO,IRAPUATO,6,126,3,135,1602
GUANAJUATO,IRAPUATO,9,127,4,140,1602
GUANAJUATO,IRAPUATO,6,111,5,122,1601
GUANAJUATO,IRAPUATO,13,102,2,117,1345
GUANAJUATO,IRAPUATO,9,100,1,110,1344
GUANAJUATO,IRAPUATO,15,149,3,167,1674
GUANAJUATO,IRAPUATO,21,185,1,207,1673
GUANAJUATO,IRAPUATO,14,124,2,140,1682
GUANAJUATO,IRAPUATO,12,154,2,168,1682
GUANAJUATO,IRAPUATO,15,144,1,160,1456
GUANAJUATO,IRAPUATO,5,129,2,136,1456
GUANAJUATO,IRAPUATO,14,130,2,146,1095
GUANAJUATO,IRAPUATO,11,144,2,157,1094
GUANAJUATO,IRAPUATO,13,175,1,189,1914
GUANAJUATO,IRAPUATO,14,172,3,189,1914
GUANAJUATO,IRAPUATO,11,161,3,175,1636
GUANAJUATO,IRAPUATO,29,179,3,211,1636
GUANAJUATO,IRAPUATO,16,170,2,188,1635
GUANAJUATO,IRAPUATO,15,212,3,230,1867
GUANAJUATO,IRAPUATO,16,225,4,245,1866
GUANAJUATO,IRAPUATO,12,177,2,191,1870
GUANAJUATO,IRAPUATO,20,209,6,235,1869
GUANAJUATO,IRAPUATO,12,221,3,236,1757
GUANAJUATO,IRAPUATO,16,241,4,261,1757
GUANAJUATO,IRAPUATO,17,206,4,227,1756
GUANAJUATO,IRAPUATO,22,183,1,206,1874
GUANAJUATO,IRAPUATO,10,174,4,188,1874
GUANAJUATO,IRAPUATO,9,152,1,162,1874
GUANAJUATO,IRAPUATO,11,143,3,157,1874
GUANAJUATO,IRAPUATO,13,174,2,189,1874
GUANAJUATO,IRAPUATO,9,193,0,202,1873
GUANAJUATO,IRAPUATO,20,164,3,187,1458
GUANAJUATO,IRAPUATO,21,150,2,173,1457
GUANAJUATO,IRAPUATO,17,167,1,185,1457
GUANAJUATO,IRAPUATO,15,176,3,194,1567
GUANAJUATO,IRAPUATO,14,131,1,146,1567
GUANAJUATO,IRAPUATO,20,165,5,190,1567
GUANAJUATO,IRAPUATO,13,162,4,179,1575
GUANAJUATO,IRAPUATO,12,213,6,231,1575
GUANAJUATO,IRAPUATO,12,171,2,185,1574
GUANAJUATO,IRAPUATO,10,223,2,235,1858
GUANAJUATO,IRAPUATO,12,219,2,233,1858
GUANAJUATO,IRAPUATO,10,160,3,173,1676
GUANAJUATO,IRAPUATO,7,154,5,166,1676
GUANAJUATO,IRAPUATO,11,161,1,173,1676
GUANAJUATO,IRAPUATO,16,173,3,192,1676
GUANAJUATO,IRAPUATO,15,157,3,175,1675
GUANAJUATO,IRAPUATO,5,143,1,149,1551
GUANAJUATO,IRAPUATO,11,152,1,164,1550
GUANAJUATO,IRAPUATO,4,170,2,176,1550
GUANAJUATO,IRAPUATO,12,237,5,254,1769
GUANAJUATO,IRAPUATO,13,251,10,274,1769
GUANAJUATO,IRAPUATO,20,258,9,287,1779
GUANAJUATO,IRAPUATO,20,243,6,269,1778
GUANAJUATO,IRAPUATO,11,213,6,230,1935
GUANAJUATO,IRAPUATO,20,214,2,236,1935
GUANAJUATO,IRAPUATO,7,185,7,199,1585
GUANAJUATO,IRAPUATO,6,145,3,154,1584
GUANAJUATO,IRAPUATO,12,186,2,200,1632
GUANAJUATO,IRAPUATO,6,190,3,199,1632
GUANAJUATO,IRAPUATO,12,159,2,173,1631
GUANAJUATO,IRAPUATO,3,182,2,187,1874
GUANAJUATO,IRAPUATO,5,166,2,173,1874
GUANAJUATO,IRAPUATO,6,151,1,158,1750
GUANAJUATO,IRAPUATO,10,146,2,158,1750
GUANAJUATO,IRAPUATO,10,121,3,134,1825
GUANAJUATO,IRAPUATO,14,141,0,155,1825
GUANAJUATO,IRAPUATO,8,115,1,124,1825
GUANAJUATO,IRAPUATO,14,130,3,147,1825
GUANAJUATO,IRAPUATO,17,150,3,170,1824
GUANAJUATO,IRAPUATO,12,140,1,153,1824
GUANAJUATO,IRAPUATO,14,119,5,138,1824
GUANAJUATO,IRAPUATO,11,114,3,128,1286
GUANAJUATO,IRAPUATO,6,126,4,136,1285
GUANAJUATO,IRAPUATO,6,145,4,155,1647
GUANAJUATO,IRAPUATO,10,148,1,159,1646
GUANAJUATO,IRAPUATO,15,154,8,177,1646
GUANAJUATO,IRAPUATO,18,222,2,242,1742
GUANAJUATO,IRAPUATO,15,190,1,206,1742
GUANAJUATO,IRAPUATO,3,154,4,161,1876
GUANAJUATO,IRAPUATO,5,136,4,145,1875
GUANAJUATO,IRAPUATO,8,121,4,133,1462
GUANAJUATO,IRAPUATO,9,134,2,145,1462
GUANAJUATO,IRAPUATO,16,106,7,129,1462
GUANAJUATO,IRAPUATO,23,161,0,184,1837
GUANAJUATO,IRAPUATO,16,154,0,170,1836
GUANAJUATO,IRAPUATO,12,167,1,180,1836
GUANAJUATO,IRAPUATO,25,163,0,188,1836
GUANAJUATO,IRAPUATO,13,175,1,189,1836
GUANAJUATO,IRAPUATO,19,167,3,189,1836
GUANAJUATO,IRAPUATO,29,145,0,174,1397
GUANAJUATO,IRAPUATO,22,146,2,170,1396
GUANAJUATO,IRAPUATO,8,99,0,107,1527
GUANAJUATO,IRAPUATO,12,115,2,129,1527
GUANAJUATO,IRAPUATO,11,91,1,103,1526
GUANAJUATO,IRAPUATO,16,106,9,131,1401
GUANAJUATO,IRAPUATO,13,102,3,118,1400
GUANAJUATO,IRAPUATO,11,100,0,111,1400
GUANAJUATO,IRAPUATO,7,117,4,128,1570
GUANAJUATO,IRAPUATO,12,124,4,140,1569
GUANAJUATO,IRAPUATO,10,97,5,112,1447
GUANAJUATO,IRAPUATO,5,123,6,134,1446
GUANAJUATO,IRAPUATO,5,107,7,119,1139
GUANAJUATO,IRAPUATO,12,110,4,126,1139
GUANAJUATO,IRAPUATO,12,194,2,208,1844
GUANAJUATO,IRAPUATO,14,232,6,252,1843
GUANAJUATO,IRAPUATO,17,182,5,204,1459
GUANAJUATO,IRAPUATO,21,185,2,208,1458
GUANAJUATO,IRAPUATO,12,114,2,128,1394
GUANAJUATO,IRAPUATO,7,112,2,121,1393
GUANAJUATO,IRAPUATO,8,142,1,151,1127
GUANAJUATO,IRAPUATO,7,114,5,126,1127
GUANAJUATO,IRAPUATO,8,119,6,133,1468
GUANAJUATO,IRAPUATO,10,131,5,146,1467
GUANAJUATO,IRAPUATO,5,81,2,88,1583
GUANAJUATO,IRAPUATO,7,90,4,101,1583
GUANAJUATO,IRAPUATO,5,69,3,77,1583
GUANAJUATO,IRAPUATO,3,60,5,68,1025
GUANAJUATO,IRAPUATO,4,62,3,69,1024
GUANAJUATO,IRAPUATO,10,93,4,107,1608
GUANAJUATO,IRAPUATO,13,86,0,99,1607
GUANAJUATO,IRAPUATO,6,116,1,123,1551
GUANAJUATO,IRAPUATO,10,165,2,177,1551
GUANAJUATO,IRAPUATO,4,103,2,109,1550
GUANAJUATO,IRAPUATO,4,147,5,156,1620
GUANAJUATO,IRAPUATO,9,135,2,146,1620
GUANAJUATO,IRAPUATO,11,132,1,144,1620
GUANAJUATO,IRAPUATO,9,140,0,149,1153
GUANAJUATO,IRAPUATO,11,136,0,147,1152
GUERRERO,CD. ALTAMIRANO,9,424,5,438,2070
GUERRERO,CD. ALTAMIRANO,7,372,0,379,2069
GUERRERO,CD. ALTAMIRANO,1,393,1,395,1718
GUERRERO,CD. ALTAMIRANO,8,343,6,357,1717
GUERRERO,CD. ALTAMIRANO,3,340,2,345,1717
GUERRERO,CD. ALTAMIRANO,4,317,7,328,1711
GUERRERO,CD. ALTAMIRANO,8,343,8,359,1711
GUERRERO,CD. ALTAMIRANO,2,343,3,348,1710
GUERRERO,CD. ALTAMIRANO,1,408,4,413,1971
GUERRERO,CD. ALTAMIRANO,1,402,2,405,1971
GUERRERO,CD. ALTAMIRANO,4,456,2,462,2084
GUERRERO,CD. ALTAMIRANO,2,463,2,467,2083
GUERRERO,CD. ALTAMIRANO,6,206,1,213,1250
GUERRERO,CD. ALTAMIRANO,7,227,4,238,1249
GUERRERO,CD. ALTAMIRANO,12,490,1,503,1777
GUERRERO,CD. ALTAMIRANO,10,524,5,539,1776
GUERRERO,CD. ALTAMIRANO,11,480,1,492,1883
GUERRERO,CD. ALTAMIRANO,14,470,4,488,1883
GUERRERO,CD. ALTAMIRANO,6,1782,2,1790,1882
GUERRERO,CD. ALTAMIRANO,14,1802,4,1820,1881
GUERRERO,CD. ALTAMIRANO,9,1774,2,1785,1881
GUERRERO,CD. ALTAMIRANO,5,1484,9,1498,1681
GUERRERO,CD. ALTAMIRANO,2,1438,1,1441,1681
GUERRERO,CD. ALTAMIRANO,11,1511,0,1522,1680
GUERRERO,CD. ALTAMIRANO,4,1469,6,1479,1563
GUERRERO,CD. ALTAMIRANO,1,1510,3,1514,1563
GUERRERO,CD. ALTAMIRANO,11,1506,3,1520,1562
GUERRERO,CD. ALTAMIRANO,2,1594,2,1598,1713
GUERRERO,CD. ALTAMIRANO,5,1556,22,1583,1712
GUERRERO,CD. ALTAMIRANO,14,1584,2,1600,1712
GUERRERO,CD. ALTAMIRANO,16,688,8,712,2091
GUERRERO,CD. ALTAMIRANO,14,663,3,680,2090
GUERRERO,CD. ALTAMIRANO,13,458,5,476,1510
GUERRERO,CD. ALTAMIRANO,17,412,4,433,1509
GUERRERO,CD. ALTAMIRANO,15,511,6,532,1509
GUERRERO,CD. ALTAMIRANO,17,411,10,438,1842
GUERRERO,CD. ALTAMIRANO,19,505,12,536,1841
GUERRERO,CD. ALTAMIRANO,8,206,8,222,1752
GUERRERO,CD. ALTAMIRANO,10,191,5,206,1751
GUERRERO,CD. ALTAMIRANO,13,392,8,413,1807
GUERRERO,CD. ALTAMIRANO,9,352,3,364,1806
GUERRERO,CD. ALTAMIRANO,17,531,7,555,1924
GUERRERO,CD. ALTAMIRANO,8,441,1,450,1924
GUERRERO,CD. ALTAMIRANO,22,408,4,434,1911
GUERRERO,CD. ALTAMIRANO,16,439,5,460,1910
GUERRERO,CD. ALTAMIRANO,4,416,21,441,1717
GUERRERO,CD. ALTAMIRANO,8,385,18,411,1717
GUERRERO,CD. ALTAMIRANO,13,428,3,444,2138
GUERRERO,CD. ALTAMIRANO,10,400,1,411,2138
GUERRERO,CD. ALTAMIRANO,1,508,2,511,1903
GUERRERO,CD. ALTAMIRANO,4,533,5,542,1903
GUERRERO,CD. ALTAMIRANO,16,396,2,414,2038
GUERRERO,CD. ALTAMIRANO,16,366,11,393,2037
GUERRERO,CD. ALTAMIRANO,0,132,3,135,1683
GUERRERO,CD. ALTAMIRANO,12,156,3,171,1682
GUERRERO,CD. ALTAMIRANO,18,259,7,284,1122
GUERRERO,CD. ALTAMIRANO,15,298,7,320,1122
GUERRERO,CD. ALTAMIRANO,23,569,16,608,1749
GUERRERO,CD. ALTAMIRANO,33,587,19,639,1749
GUERRERO,CD. ALTAMIRANO,4,586,1,591,2071
GUERRERO,CD. ALTAMIRANO,3,545,9,557,2071
GUERRERO,CD. ALTAMIRANO,4,394,1,399,1336
GUERRERO,CD. ALTAMIRANO,3,435,3,441,1335
GUERRERO,CD. ALTAMIRANO,12,533,1,546,1730
GUERRERO,CD. ALTAMIRANO,10,514,14,538,1729
GUERRERO,CD. ALTAMIRANO,7,509,7,523,1729
GUERRERO,CD. ALTAMIRANO,5,376,0,381,1507
GUERRERO,CD. ALTAMIRANO,4,313,5,322,1507
GUERRERO,CD. ALTAMIRANO,3,318,8,329,1506
GUERRERO,CD. ALTAMIRANO,18,616,7,641,2117
GUERRERO,CD. ALTAMIRANO,27,698,16,741,2117
GUERRERO,CD. ALTAMIRANO,11,309,2,322,1542
GUERRERO,CD. ALTAMIRANO,13,256,4,273,1541
GUERRERO,CD. ALTAMIRANO,6,285,1,292,1541
GUERRERO,CD. ALTAMIRANO,10,215,4,229,1206
GUERRERO,CD. ALTAMIRANO,8,242,2,252,1206
GUERRERO,CD. ALTAMIRANO,12,189,9,210,1275
GUERRERO,CD. ALTAMIRANO,11,207,4,222,1275
GUERRERO,CD. ALTAMIRANO,6,323,1,330,2031
GUERRERO,CD. ALTAMIRANO,11,308,5,324,2031
GUERRERO,CD. ALTAMIRANO,8,256,8,272,1589
GUERRERO,CD. ALTAMIRANO,11,301,3,315,1589
GUERRERO,CD. ALTAMIRANO,8,305,3,316,1588
GUERRERO,CD. ALTAMIRANO,10,321,5,336,1787
GUERRERO,CD. ALTAMIRANO,11,351,3,365,1786
GUERRERO,CD. ALTAMIRANO,15,433,5,453,1869
GUERRERO,CD. ALTAMIRANO,16,395,4,415,1869
GUERRERO,CD. ALTAMIRANO,24,978,3,1005,0
GUERRERO,CD. ALTAMIRANO,6,310,4,320,1956
GUERRERO,CD. ALTAMIRANO,4,311,4,319,1955
GUERRERO,CD. ALTAMIRANO,12,451,8,471,1919
GUERRERO,CD. ALTAMIRANO,12,398,7,417,1919
GUERRERO,CD. ALTAMIRANO,7,527,4,538,1948
GUERRERO,CD. ALTAMIRANO,12,500,6,518,1948
GUERRERO,CD. ALTAMIRANO,8,1570,15,1593,1738
GUERRERO,CD. ALTAMIRANO,11,1620,6,1637,1738
GUERRERO,CD. ALTAMIRANO,16,1465,8,1489,1737
GUERRERO,CD. ALTAMIRANO,5,1593,24,1622,1608
GUERRERO,CD. ALTAMIRANO,1,1427,19,1447,1608
GUERRERO,CD. ALTAMIRANO,2,1390,29,1421,1608
GUERRERO,CD. ALTAMIRANO,6,722,3,731,2067
GUERRERO,CD. ALTAMIRANO,4,613,3,620,2067
GUERRERO,CD. ALTAMIRANO,6,511,5,522,2154
GUERRERO,CD. ALTAMIRANO,5,487,5,497,2154
GUERRERO,CD. ALTAMIRANO,6,386,4,396,1746
GUERRERO,CD. ALTAMIRANO,7,403,6,416,1746
GUERRERO,CD. ALTAMIRANO,0,368,0,368,1999
GUERRERO,CD. ALTAMIRANO,2,328,0,330,1998
GUERRERO,CD. ALTAMIRANO,8,487,13,508,2081
GUERRERO,CD. ALTAMIRANO,12,460,6,478,2081
GUERRERO,CD. ALTAMIRANO,11,330,4,345,2126
GUERRERO,CD. ALTAMIRANO,2,316,5,323,2126
GUERRERO,CD. ALTAMIRANO,4,334,1,339,2039
GUERRERO,CD. ALTAMIRANO,5,334,3,342,2039
GUERRERO,CD. ALTAMIRANO,6,353,3,362,2039
GUERRERO,CD. ALTAMIRANO,0,553,12,565,2055
GUERRERO,CD. ALTAMIRANO,1,632,13,646,2055
GUERRERO,CD. ALTAMIRANO,3,291,2,296,1482
GUERRERO,CD. ALTAMIRANO,6,304,3,313,1482
GUERRERO,CD. ALTAMIRANO,3,245,5,253,1481
GUERRERO,CD. ALTAMIRANO,2,403,4,409,1974
GUERRERO,CD. ALTAMIRANO,5,474,1,480,1974
GUERRERO,CD. ALTAMIRANO,14,1497,3,1514,1887
GUERRERO,CD. ALTAMIRANO,16,751,3,770,1886
GUERRERO,CD. ALTAMIRANO,9,1253,4,1266,1546
GUERRERO,CD. ALTAMIRANO,10,1326,2,1338,1545
GUERRERO,CD. ALTAMIRANO,6,1267,15,1288,1545
GUERRERO,CD. ALTAMIRANO,5,576,1,582,1848
GUERRERO,CD. ALTAMIRANO,1,549,2,552,1848
GUERRERO,CD. ALTAMIRANO,5,605,1,611,1848
GUERRERO,CD. ALTAMIRANO,1,448,1,450,1639
GUERRERO,CD. ALTAMIRANO,6,440,6,452,1638
GUERRERO,CD. ALTAMIRANO,4,463,0,467,1638
GUERRERO,CD. ALTAMIRANO,3,693,2,698,1910
GUERRERO,CD. ALTAMIRANO,6,655,4,665,1909
GUERRERO,CD. ALTAMIRANO,1,486,0,487,1600
GUERRERO,CD. ALTAMIRANO,2,446,0,448,1600
GUERRERO,CD. ALTAMIRANO,3,433,0,436,1600
GUERRERO,CD. ALTAMIRANO,2,410,0,412,1533
GUERRERO,CD. ALTAMIRANO,3,333,0,336,1533
GUERRERO,CD. ALTAMIRANO,5,326,1,332,1533
GUERRERO,CD. ALTAMIRANO,14,453,5,472,1491
GUERRERO,CD. ALTAMIRANO,14,516,3,533,1491
GUERRERO,CD. ALTAMIRANO,9,506,4,519,1940
GUERRERO,CD. ALTAMIRANO,30,477,6,513,1940
GUERRERO,CD. ALTAMIRANO,16,578,10,604,1940
GUERRERO,IGUALA,9,376,6,391,1245
GUERRERO,IGUALA,11,436,4,451,1245
GUERRERO,IGUALA,8,506,5,519,1833
GUERRERO,IGUALA,8,506,17,531,1832
GUERRERO,IGUALA,10,223,8,241,1822
GUERRERO,IGUALA,6,249,6,261,1821
GUERRERO,IGUALA,12,235,1,248,1821
GUERRERO,IGUALA,13,243,3,259,1608
GUERRERO,IGUALA,11,249,4,264,1608
GUERRERO,IGUALA,16,252,4,272,1607
GUERRERO,IGUALA,3,420,8,431,1741
GUERRERO,IGUALA,8,427,3,438,1741
GUERRERO,IGUALA,8,373,7,388,1807
GUERRERO,IGUALA,2,377,1,380,1806
GUERRERO,IGUALA,4,366,4,374,1806
GUERRERO,IGUALA,14,424,19,457,1426
GUERRERO,IGUALA,9,429,14,452,1426
GUERRERO,IGUALA,22,311,6,339,1531
GUERRERO,IGUALA,9,318,3,330,1530
GUERRERO,IGUALA,7,252,3,262,1202
GUERRERO,IGUALA,14,240,6,260,1201
GUERRERO,IGUALA,11,311,4,326,1427
GUERRERO,IGUALA,16,304,1,321,1426
GUERRERO,IGUALA,15,250,2,267,1665
GUERRERO,IGUALA,4,249,6,259,1664
GUERRERO,IGUALA,8,272,3,283,1664
GUERRERO,IGUALA,18,408,8,434,1976
GUERRERO,IGUALA,11,383,10,404,1976
GUERRERO,IGUALA,10,243,7,260,1459
GUERRERO,IGUALA,7,269,2,278,1458
GUERRERO,IGUALA,2,171,1,174,1037
GUERRERO,IGUALA,1,183,4,188,1036
GUERRERO,IGUALA,16,282,3,301,1501
GUERRERO,IGUALA,16,318,6,340,1501
GUERRERO,IGUALA,4,218,4,226,1192
GUERRERO,IGUALA,7,221,2,230,1191
GUERRERO,IGUALA,19,394,5,418,1608
GUERRERO,IGUALA,19,330,8,357,1607
GUERRERO,IGUALA,10,229,5,244,1826
GUERRERO,IGUALA,9,217,5,231,1825
GUERRERO,IGUALA,10,223,5,238,1825
GUERRERO,IGUALA,9,301,3,313,1456
GUERRERO,IGUALA,8,315,3,326,1455
GUERRERO,IGUALA,7,266,6,279,1524
GUERRERO,IGUALA,15,281,5,301,1524
GUERRERO,IGUALA,3,265,0,268,1651
GUERRERO,IGUALA,4,248,3,255,1651
GUERRERO,IGUALA,9,239,2,250,1650
GUERRERO,IGUALA,8,376,3,387,1680
GUERRERO,IGUALA,5,347,3,355,1680
GUERRERO,IGUALA,8,353,1,362,1680
GUERRERO,IGUALA,14,372,1,387,1954
GUERRERO,IGUALA,15,338,1,354,1954
GUERRERO,IGUALA,80,1592,13,1685,0
GUERRERO,IGUALA,13,421,0,434,1684
GUERRERO,IGUALA,14,399,4,417,1683
GUERRERO,IGUALA,17,409,3,429,1856
GUERRERO,IGUALA,9,387,2,398,1856
GUERRERO,IGUALA,12,429,2,443,1855
GUERRERO,IGUALA,14,274,5,293,1487
GUERRERO,IGUALA,12,282,1,295,1486
GUERRERO,IGUALA,5,260,9,274,1486
GUERRERO,IGUALA,8,410,4,422,1872
GUERRERO,IGUALA,4,406,3,413,1871
GUERRERO,IGUALA,5,263,0,268,1038
GUERRERO,IGUALA,12,263,1,276,1037
GUERRERO,IGUALA,18,413,3,434,2057
GUERRERO,IGUALA,7,380,5,392,1929
GUERRERO,IGUALA,13,395,1,409,1928
GUERRERO,IGUALA,9,298,3,310,1423
GUERRERO,IGUALA,9,266,2,277,1423
GUERRERO,IGUALA,7,359,1,367,1854
GUERRERO,IGUALA,19,359,4,382,1854
GUERRERO,IGUALA,10,346,1,357,1673
GUERRERO,IGUALA,11,320,1,332,1673
GUERRERO,IGUALA,13,353,2,368,1950
GUERRERO,IGUALA,15,311,2,328,1949
GUERRERO,IGUALA,12,264,2,278,1669
GUERRERO,IGUALA,13,299,7,319,1669
GUERRERO,IGUALA,9,247,3,259,1196
GUERRERO,IGUALA,3,247,3,253,1196
GUERRERO,IGUALA,13,298,3,314,1736
GUERRERO,IGUALA,10,358,1,369,1735
GUERRERO,IGUALA,9,317,1,327,1552
GUERRERO,IGUALA,8,298,0,306,1552
GUERRERO,IGUALA,7,327,1,335,1552
GUERRERO,IGUALA,6,373,2,381,1865
GUERRERO,IGUALA,11,359,5,375,1865
GUERRERO,IGUALA,6,357,1,364,1673
GUERRERO,IGUALA,7,332,4,343,1673
GUERRERO,IGUALA,8,331,2,341,1673
GUERRERO,IGUALA,16,273,7,296,1720
GUERRERO,IGUALA,10,266,3,279,1720
GUERRERO,IGUALA,5,285,10,300,1720
GUERRERO,IGUALA,6,243,7,256,1300
GUERRERO,IGUALA,5,199,3,207,1299
GUERRERO,IGUALA,6,287,1,294,1470
GUERRERO,IGUALA,8,288,2,298,1469
GUERRERO,IGUALA,7,166,6,179,1256
GUERRERO,IGUALA,3,190,2,195,1255
GUERRERO,IGUALA,4,188,3,195,1047
GUERRERO,IGUALA,7,168,1,176,1047
GUERRERO,IGUALA,1,177,0,178,1278
GUERRERO,IGUALA,6,180,2,188,1277
GUERRERO,IGUALA,4,276,6,286,1737
GUERRERO,IGUALA,8,260,5,273,1736
GUERRERO,IGUALA,10,121,0,131,1133
GUERRERO,IGUALA,5,158,1,164,1132
GUERRERO,IGUALA,3,213,3,219,1162
GUERRERO,IGUALA,2,217,1,220,1162
GUERRERO,IGUALA,18,203,4,225,1393
GUERRERO,IGUALA,17,210,2,229,1392
GUERRERO,IGUALA,25,186,1,212,1392
GUERRERO,IGUALA,25,175,8,208,1427
GUERRERO,IGUALA,27,201,2,230,1426
GUERRERO,IGUALA,0,158,8,166,1149
GUERRERO,IGUALA,8,143,3,154,1149
GUERRERO,IGUALA,6,155,0,161,1581
GUERRERO,IGUALA,3,163,1,167,1580
GUERRERO,IGUALA,5,183,3,191,1580
GUERRERO,IGUALA,9,318,2,329,2019
GUERRERO,IGUALA,8,311,3,322,2019
GUERRERO,IGUALA,20,326,2,348,1883
GUERRERO,IGUALA,19,300,2,321,1883
GUERRERO,IGUALA,12,193,0,205,1466
GUERRERO,IGUALA,14,249,0,263,1465
GUERRERO,IGUALA,12,234,4,250,1465
GUERRERO,IGUALA,12,144,1,157,1275
GUERRERO,IGUALA,11,129,1,141,1274
GUERRERO,IGUALA,9,173,5,187,1891
GUERRERO,IGUALA,13,186,2,201,1890
GUERRERO,IGUALA,14,185,2,201,1415
GUERRERO,IGUALA,14,198,0,212,1415
GUERRERO,IGUALA,10,201,2,213,1414
GUERRERO,IGUALA,8,233,1,242,1524
GUERRERO,IGUALA,4,205,2,211,1524
GUERRERO,IGUALA,5,190,1,196,1334
GUERRERO,IGUALA,14,164,0,178,1333
GUERRERO,IGUALA,13,182,4,199,1692
GUERRERO,IGUALA,7,165,3,175,1692
GUERRERO,IGUALA,8,114,2,124,1882
GUERRERO,IGUALA,6,107,0,113,1881
GUERRERO,IGUALA,8,89,1,98,1769
GUERRERO,IGUALA,7,86,5,98,1769
GUERRERO,IGUALA,15,140,1,156,1710
GUERRERO,IGUALA,13,141,5,159,1709
GUERRERO,IGUALA,14,140,5,159,1549
GUERRERO,IGUALA,3,128,3,134,1549
GUERRERO,IGUALA,5,154,2,161,1549
GUERRERO,IGUALA,18,235,3,256,1889
GUERRERO,IGUALA,15,290,2,307,1888
GUERRERO,IGUALA,9,159,5,173,1971
GUERRERO,IGUALA,5,197,2,204,1971
GUERRERO,IGUALA,5,159,3,167,1971
GUERRERO,IGUALA,13,40,6,59,1969
GUERRERO,IGUALA,12,35,1,48,1969
GUERRERO,IGUALA,3,109,0,112,1513
GUERRERO,IGUALA,5,98,1,104,1513
GUERRERO,IGUALA,7,158,0,165,1803
GUERRERO,IGUALA,11,128,2,141,1802
GUERRERO,IGUALA,9,131,1,141,1802
GUERRERO,IGUALA,6,294,0,300,1793
GUERRERO,IGUALA,9,261,3,273,1793
GUERRERO,IGUALA,9,291,5,305,2051
GUERRERO,IGUALA,3,304,5,312,2051
GUERRERO,IGUALA,7,391,6,404,2045
GUERRERO,IGUALA,1,370,5,376,2044
GUERRERO,IGUALA,7,270,2,279,1484
GUERRERO,IGUALA,13,268,5,286,1483
GUERRERO,IGUALA,10,230,2,242,1796
GUERRERO,IGUALA,0,209,5,214,1795
GUERRERO,IGUALA,3,225,1,229,1795
GUERRERO,IGUALA,10,133,5,148,1507
GUERRERO,IGUALA,9,111,2,122,1507
GUERRERO,IGUALA,2,115,6,123,1507
GUERRERO,IGUALA,25,192,7,224,2038
GUERRERO,IGUALA,35,142,3,180,2037
GUERRERO,IGUALA,16,74,0,90,1799
GUERRERO,IGUALA,14,57,0,71,1799
GUERRERO,IGUALA,19,73,1,93,1799
GUERRERO,IGUALA,10,186,3,199,2002
GUERRERO,IGUALA,8,232,0,240,2002
GUERRERO,ZIHUATANEJO,17,323,5,345,1380
GUERRERO,ZIHUATANEJO,8,345,8,361,1379
GUERRERO,ZIHUATANEJO,7,470,6,483,1923
GUERRERO,ZIHUATANEJO,3,502,1,506,1922
GUERRERO,ZIHUATANEJO,12,416,3,431,1570
GUERRERO,ZIHUATANEJO,6,451,3,460,1569
GUERRERO,ZIHUATANEJO,4,455,5,464,1569
GUERRERO,ZIHUATANEJO,9,388,1,398,1659
GUERRERO,ZIHUATANEJO,6,379,10,395,1658
GUERRERO,ZIHUATANEJO,11,436,1,448,1356
GUERRERO,ZIHUATANEJO,6,348,7,361,1356
GUERRERO,ZIHUATANEJO,10,411,7,428,1567
GUERRERO,ZIHUATANEJO,16,437,2,455,1567
GUERRERO,ZIHUATANEJO,8,453,9,470,1566
GUERRERO,ZIHUATANEJO,7,462,7,476,1460
GUERRERO,ZIHUATANEJO,10,501,3,514,1460
GUERRERO,ZIHUATANEJO,12,466,9,487,1460
GUERRERO,ZIHUATANEJO,11,915,3,929,1135
GUERRERO,ZIHUATANEJO,6,975,8,989,1135
GUERRERO,ZIHUATANEJO,10,928,8,946,1835
GUERRERO,ZIHUATANEJO,4,438,9,451,1982
GUERRERO,ZIHUATANEJO,5,474,10,489,1982
GUERRERO,ZIHUATANEJO,6,486,6,498,1982
GUERRERO,ZIHUATANEJO,2,351,12,365,1602
GUERRERO,ZIHUATANEJO,0,391,0,391,1602
GUERRERO,ZIHUATANEJO,2,381,1,384,1602
GUERRERO,ZIHUATANEJO,8,377,12,397,1601
GUERRERO,ZIHUATANEJO,10,270,8,288,1142
GUERRERO,ZIHUATANEJO,10,237,10,257,1142
GUERRERO,ZIHUATANEJO,12,402,3,417,1771
GUERRERO,ZIHUATANEJO,5,425,1,431,1771
GUERRERO,ZIHUATANEJO,6,371,3,380,1770
GUERRERO,ZIHUATANEJO,11,396,2,409,1770
GUERRERO,ZIHUATANEJO,6,356,3,365,1570
GUERRERO,ZIHUATANEJO,4,367,4,375,1569
GUERRERO,ZIHUATANEJO,3,322,1,326,1569
GUERRERO,ZIHUATANEJO,21,655,0,676,1709
GUERRERO,ZIHUATANEJO,4,915,0,919,1709
GUERRERO,ZIHUATANEJO,0,387,0,387,1709
GUERRERO,ZIHUATANEJO,10,843,1,854,1708
GUERRERO,ZIHUATANEJO,0,441,1,442,1708
GUERRERO,ZIHUATANEJO,8,408,3,419,1994
GUERRERO,ZIHUATANEJO,9,436,7,452,1993
GUERRERO,ZIHUATANEJO,3,454,2,459,1993
GUERRERO,ZIHUATANEJO,12,296,9,317,1701
GUERRERO,ZIHUATANEJO,3,303,3,309,1701
GUERRERO,ZIHUATANEJO,7,338,3,348,1701
GUERRERO,ZIHUATANEJO,6,342,5,353,1369
GUERRERO,ZIHUATANEJO,5,308,3,316,1369
GUERRERO,ZIHUATANEJO,7,362,7,376,2057
GUERRERO,ZIHUATANEJO,7,339,5,351,2057
GUERRERO,ZIHUATANEJO,8,438,5,451,2056
GUERRERO,ZIHUATANEJO,13,276,2,291,1819
GUERRERO,ZIHUATANEJO,12,282,20,314,1697
GUERRERO,ZIHUATANEJO,13,254,16,283,1697
GUERRERO,ZIHUATANEJO,13,287,10,310,1914
GUERRERO,ZIHUATANEJO,17,329,1,347,1913
GUERRERO,ZIHUATANEJO,20,320,29,369,1913
GUERRERO,ZIHUATANEJO,15,320,12,347,1913
GUERRERO,ZIHUATANEJO,5,400,10,415,1761
GUERRERO,ZIHUATANEJO,11,338,6,355,1760
GUERRERO,ZIHUATANEJO,11,389,6,406,1760
GUERRERO,ZIHUATANEJO,19,449,13,481,2065
GUERRERO,ZIHUATANEJO,5,430,2,437,1481
GUERRERO,ZIHUATANEJO,10,270,10,290,1416
GUERRERO,ZIHUATANEJO,7,255,3,265,1415
GUERRERO,ZIHUATANEJO,10,257,7,274,1415
GUERRERO,ZIHUATANEJO,2,272,0,274,725
GUERRERO,ZIHUATANEJO,8,252,2,262,1554
GUERRERO,ZIHUATANEJO,6,287,5,298,1554
GUERRERO,ZIHUATANEJO,3,279,7,289,1554
GUERRERO,ZIHUATANEJO,3,266,5,274,1553
GUERRERO,ZIHUATANEJO,4,268,4,276,1485
GUERRERO,ZIHUATANEJO,7,264,2,273,1485
GUERRERO,ZIHUATANEJO,10,411,2,423,1832
GUERRERO,ZIHUATANEJO,7,397,3,407,1831
GUERRERO,ZIHUATANEJO,13,405,1,419,1831
GUERRERO,ZIHUATANEJO,9,236,1,246,1582
GUERRERO,ZIHUATANEJO,5,241,3,249,1581
GUERRERO,ZIHUATANEJO,6,268,2,276,1147
GUERRERO,ZIHUATANEJO,3,241,3,247,1146
GUERRERO,ZIHUATANEJO,6,316,0,322,1429
GUERRERO,ZIHUATANEJO,7,302,3,312,1428
GUERRERO,ZIHUATANEJO,5,272,2,279,1597
GUERRERO,ZIHUATANEJO,5,284,0,289,1596
GUERRERO,ZIHUATANEJO,8,277,3,288,1713
GUERRERO,ZIHUATANEJO,5,244,4,253,1712
GUERRERO,ZIHUATANEJO,7,280,5,292,1714
GUERRERO,ZIHUATANEJO,5,325,1,331,1714
GUERRERO,ZIHUATANEJO,56,1406,17,1479,0
GUERRERO,ZIHUATANEJO,12,283,1,296,1426
GUERRERO,ZIHUATANEJO,6,297,4,307,1426
GUERRERO,ZIHUATANEJO,15,346,3,364,1548
GUERRERO,ZIHUATANEJO,8,315,0,323,1548
GUERRERO,ZIHUATANEJO,7,302,1,310,1626
GUERRERO,ZIHUATANEJO,6,294,2,302,1625
GUERRERO,ZIHUATANEJO,17,431,4,452,2035
GUERRERO,ZIHUATANEJO,2,248,4,254,1430
GUERRERO,ZIHUATANEJO,6,261,3,270,1429
GUERRERO,ZIHUATANEJO,7,294,8,309,1429
GUERRERO,ZIHUATANEJO,9,335,3,347,1773
GUERRERO,ZIHUATANEJO,1,350,3,354,1773
GUERRERO,ZIHUATANEJO,6,396,2,404,1892
GUERRERO,ZIHUATANEJO,10,247,5,262,1432
GUERRERO,ZIHUATANEJO,4,278,5,287,1432
GUERRERO,ZIHUATANEJO,5,250,3,258,1432
GUERRERO,ZIHUATANEJO,5,351,2,358,1646
GUERRERO,ZIHUATANEJO,7,290,7,304,1645
GUERRERO,ZIHUATANEJO,7,242,6,255,1950
GUERRERO,ZIHUATANEJO,6,345,3,354,1949
GUERRERO,ZIHUATANEJO,7,279,9,295,1949
GUERRERO,ZIHUATANEJO,2,242,2,246,1914
GUERRERO,ZIHUATANEJO,8,212,1,221,1914
GUERRERO,ZIHUATANEJO,10,277,4,291,1458
GUERRERO,ZIHUATANEJO,4,296,3,303,1457
GUERRERO,ZIHUATANEJO,2,304,3,309,1820
GUERRERO,ZIHUATANEJO,5,262,4,271,1819
GUERRERO,ZIHUATANEJO,8,308,6,322,1835
GUERRERO,ZIHUATANEJO,6,274,1,281,1834
GUERRERO,ZIHUATANEJO,6,291,4,301,1834
GUERRERO,ZIHUATANEJO,5,295,2,302,1834
GUERRERO,ZIHUATANEJO,10,265,4,279,1834
GUERRERO,ZIHUATANEJO,6,215,4,225,1146
GUERRERO,ZIHUATANEJO,4,218,2,224,1146
GUERRERO,ZIHUATANEJO,6,316,2,324,1620
GUERRERO,ZIHUATANEJO,12,306,3,321,1620
GUERRERO,ZIHUATANEJO,6,301,2,309,1619
GUERRERO,ZIHUATANEJO,4,252,3,259,1619
GUERRERO,ZIHUATANEJO,1,248,5,254,1231
GUERRERO,ZIHUATANEJO,4,223,3,230,1230
GUERRERO,ZIHUATANEJO,11,390,5,406,2042
GUERRERO,ZIHUATANEJO,6,411,6,423,2041
GUERRERO,ZIHUATANEJO,1,379,4,384,1931
GUERRERO,ZIHUATANEJO,3,367,4,374,1931
GUERRERO,ZIHUATANEJO,5,372,1,378,1931
GUERRERO,ZIHUATANEJO,9,272,1,282,1594
GUERRERO,ZIHUATANEJO,6,277,3,286,1594
GUERRERO,ZIHUATANEJO,4,298,7,309,1594
GUERRERO,ZIHUATANEJO,9,441,2,452,2050
GUERRERO,ZIHUATANEJO,4,387,5,396,2049
GUERRERO,ZIHUATANEJO,3,320,6,329,1552
GUERRERO,ZIHUATANEJO,3,331,4,338,1552
GUERRERO,ZIHUATANEJO,3,321,5,329,1551
GUERRERO,ZIHUATANEJO,7,285,0,292,1551
GUERRERO,ZIHUATANEJO,7,382,4,393,1815
GUERRERO,ZIHUATANEJO,5,395,3,403,1814
GUERRERO,ZIHUATANEJO,3,327,0,330,1814
GUERRERO,ZIHUATANEJO,5,384,7,396,1814
GUERRERO,ZIHUATANEJO,4,247,6,257,1639
GUERRERO,ZIHUATANEJO,4,237,2,243,1638
GUERRERO,ZIHUATANEJO,5,300,1,306,1638
GUERRERO,ZIHUATANEJO,5,351,4,360,2083
GUERRERO,ZIHUATANEJO,4,379,4,387,2083
GUERRERO,ZIHUATANEJO,7,277,3,287,1420
GUERRERO,ZIHUATANEJO,3,309,1,313,1419
GUERRERO,ZIHUATANEJO,3,317,6,326,1419
GUERRERO,ZIHUATANEJO,3,316,3,322,1813
GUERRERO,ZIHUATANEJO,4,313,2,319,1813
GUERRERO,ZIHUATANEJO,6,335,4,345,1812
GUERRERO,ZIHUATANEJO,4,258,3,265,1473
GUERRERO,ZIHUATANEJO,10,257,1,268,1472
GUERRERO,ZIHUATANEJO,8,353,0,361,1657
GUERRERO,ZIHUATANEJO,4,312,4,320,1657
GUERRERO,ZIHUATANEJO,2,295,3,300,1657
GUERRERO,ZIHUATANEJO,2,277,3,282,1274
GUERRERO,ZIHUATANEJO,5,284,2,291,1274
GUERRERO,ZIHUATANEJO,3,623,2,628,1824
GUERRERO,ZIHUATANEJO,4,464,0,468,1824
GUERRERO,ZIHUATANEJO,0,554,3,557,2020
GUERRERO,ZIHUATANEJO,1,354,0,355,2020
GUERRERO,ZIHUATANEJO,4,478,1,483,2020
GUERRERO,ZIHUATANEJO,4,243,1,248,1623
GUERRERO,ZIHUATANEJO,4,297,3,304,1623
GUERRERO,ZIHUATANEJO,4,300,2,306,1623
GUERRERO,ZIHUATANEJO,5,277,3,285,1623
GUERRERO,ZIHUATANEJO,6,761,46,813,2153
GUERRERO,ZIHUATANEJO,5,352,1,358,1400
GUERRERO,ZIHUATANEJO,3,354,4,361,1400
GUERRERO,ZIHUATANEJO,1,375,0,376,1399
GUERRERO,ZIHUATANEJO,2,522,0,524,1806
GUERRERO,ZIHUATANEJO,6,327,0,333,1971
GUERRERO,ZIHUATANEJO,15,317,10,342,1971
GUERRERO,ZIHUATANEJO,9,898,0,907,1792
GUERRERO,ZIHUATANEJO,5,423,3,431,1791
GUERRERO,ZIHUATANEJO,3,404,2,409,1440
GUERRERO,ZIHUATANEJO,1,574,1,576,1878
GUERRERO,ZIHUATANEJO,1,561,2,564,1877
GUERRERO,ZIHUATANEJO,5,421,1,427,1724
GUERRERO,ZIHUATANEJO,0,469,1,470,1723
GUERRERO,ZIHUATANEJO,6,313,4,323,1485
GUERRERO,ZIHUATANEJO,6,320,4,330,1484
GUERRERO,ZIHUATANEJO,7,281,0,288,1577
GUERRERO,ZIHUATANEJO,9,258,1,268,1577
GUERRERO,ACAPULCO,12,401,7,420,1574
GUERRERO,ACAPULCO,9,405,5,419,1573
GUERRERO,ACAPULCO,4,464,6,474,1686
GUERRERO,ACAPULCO,5,463,7,475,1685
GUERRERO,ACAPULCO,6,420,1,427,1699
GUERRERO,ACAPULCO,13,453,2,468,1699
GUERRERO,ACAPULCO,9,421,4,434,1481
GUERRERO,ACAPULCO,5,410,2,417,1481
GUERRERO,ACAPULCO,15,396,6,417,1583
GUERRERO,ACAPULCO,10,411,10,431,1582
GUERRERO,ACAPULCO,5,367,3,375,1603
GUERRERO,ACAPULCO,7,363,8,378,1603
GUERRERO,ACAPULCO,17,302,1,320,1206
GUERRERO,ACAPULCO,7,375,4,386,1205
GUERRERO,ACAPULCO,5,530,5,540,1846
GUERRERO,ACAPULCO,2,449,5,456,1846
GUERRERO,ACAPULCO,9,377,4,390,1420
GUERRERO,ACAPULCO,6,368,5,379,1420
GUERRERO,ACAPULCO,12,339,5,356,1479
GUERRERO,ACAPULCO,10,311,5,326,1478
GUERRERO,ACAPULCO,14,430,10,454,1871
GUERRERO,ACAPULCO,13,412,1,426,1871
GUERRERO,ACAPULCO,8,399,2,409,1428
GUERRERO,ACAPULCO,9,381,4,394,1428
GUERRERO,ACAPULCO,10,379,0,389,1428
GUERRERO,ACAPULCO,7,377,4,388,1642
GUERRERO,ACAPULCO,10,398,4,412,1641
GUERRERO,ACAPULCO,7,372,4,383,1466
GUERRERO,ACAPULCO,10,394,3,407,1465
GUERRERO,ACAPULCO,12,331,7,350,1733
GUERRERO,ACAPULCO,12,367,3,382,1733
GUERRERO,ACAPULCO,18,360,8,386,1733
GUERRERO,ACAPULCO,17,501,2,520,1896
GUERRERO,ACAPULCO,14,460,2,476,1896
GUERRERO,ACAPULCO,14,495,4,513,1870
GUERRERO,ACAPULCO,4,490,4,498,1870
GUERRERO,ACAPULCO,14,444,4,462,1984
GUERRERO,ACAPULCO,19,457,4,480,1983
GUERRERO,ACAPULCO,8,326,5,339,1422
GUERRERO,ACAPULCO,11,332,7,350,1422
GUERRERO,ACAPULCO,11,304,5,320,1422
GUERRERO,ACAPULCO,6,406,5,417,1615
GUERRERO,ACAPULCO,13,398,1,412,1615
GUERRERO,ACAPULCO,9,449,6,464,1811
GUERRERO,ACAPULCO,13,432,3,448,1811
GUERRERO,ACAPULCO,11,438,2,451,1810
GUERRERO,ACAPULCO,21,354,0,375,1549
GUERRERO,ACAPULCO,17,399,2,418,1548
GUERRERO,ACAPULCO,14,354,2,370,1598
GUERRERO,ACAPULCO,13,379,3,395,1597
GUERRERO,ACAPULCO,13,359,2,374,1597
GUERRERO,ACAPULCO,9,319,4,332,1624
GUERRERO,ACAPULCO,18,315,1,334,1623
GUERRERO,ACAPULCO,8,316,1,325,1623
GUERRERO,ACAPULCO,7,378,3,388,1684
GUERRERO,ACAPULCO,11,369,5,385,1684
GUERRERO,ACAPULCO,10,394,5,409,1684
GUERRERO,ACAPULCO,13,380,1,394,1768
GUERRERO,ACAPULCO,15,387,5,407,1768
GUERRERO,ACAPULCO,6,350,2,358,1835
GUERRERO,ACAPULCO,10,355,5,370,1834
GUERRERO,ACAPULCO,87,1887,25,1999,0
GUERRERO,ACAPULCO,18,321,4,343,1733
GUERRERO,ACAPULCO,15,351,2,368,1732
GUERRERO,ACAPULCO,19,327,6,352,1578
GUERRERO,ACAPULCO,16,363,8,387,1578
GUERRERO,ACAPULCO,14,400,5,419,1930
GUERRERO,ACAPULCO,15,366,5,386,1929
GUERRERO,ACAPULCO,17,445,6,468,2037
GUERRERO,ACAPULCO,12,439,5,456,2037
GUERRERO,ACAPULCO,8,275,6,289,1445
GUERRERO,ACAPULCO,3,322,6,331,1445
GUERRERO,ACAPULCO,4,360,2,366,1721
GUERRERO,ACAPULCO,4,378,6,388,1721
GUERRERO,ACAPULCO,9,357,6,372,1811
GUERRERO,ACAPULCO,6,292,9,307,1810
GUERRERO,ACAPULCO,10,314,4,328,1396
GUERRERO,ACAPULCO,6,327,3,336,1396
GUERRERO,ACAPULCO,9,308,8,325,1395
GUERRERO,ACAPULCO,7,331,5,343,1854
GUERRERO,ACAPULCO,8,359,3,370,1853
GUERRERO,ACAPULCO,6,428,5,439,1797
GUERRERO,ACAPULCO,10,407,5,422,1796
GUERRERO,ACAPULCO,4,389,10,403,1742
GUERRERO,ACAPULCO,8,383,1,392,1742
GUERRERO,ACAPULCO,11,305,7,323,1399
GUERRERO,ACAPULCO,7,307,4,318,1398
GUERRERO,ACAPULCO,6,395,10,411,1547
GUERRERO,ACAPULCO,7,415,6,428,1547
GUERRERO,ACAPULCO,12,342,8,362,1669
GUERRERO,ACAPULCO,9,358,6,373,1668
GUERRERO,ACAPULCO,8,287,1,296,1272
GUERRERO,ACAPULCO,14,312,11,337,1272
GUERRERO,ACAPULCO,9,385,9,403,1504
GUERRERO,ACAPULCO,1,330,5,336,1504
GUERRERO,ACAPULCO,7,471,4,482,1807
GUERRERO,ACAPULCO,3,458,7,468,1807
GUERRERO,ACAPULCO,10,376,10,396,2063
GUERRERO,ACAPULCO,8,349,4,361,2062
GUERRERO,ACAPULCO,6,249,7,262,1263
GUERRERO,ACAPULCO,5,232,5,242,1262
GUERRERO,ACAPULCO,9,187,2,198,1017
GUERRERO,ACAPULCO,10,221,3,234,1017
GUERRERO,ACAPULCO,16,542,7,565,1830
GUERRERO,ACAPULCO,16,530,11,557,1830
GUERRERO,ACAPULCO,9,324,6,339,1463
GUERRERO,ACAPULCO,7,338,7,352,1463
GUERRERO,ACAPULCO,4,432,4,440,1961
GUERRERO,ACAPULCO,8,458,4,470,1961
GUERRERO,ACAPULCO,6,364,6,376,1533
GUERRERO,ACAPULCO,7,372,3,382,1532
GUERRERO,ACAPULCO,5,383,0,388,1532
GUERRERO,ACAPULCO,1,317,4,322,1456
GUERRERO,ACAPULCO,8,329,4,341,1455
GUERRERO,ACAPULCO,9,345,11,365,1637
GUERRERO,ACAPULCO,9,346,5,360,1637
GUERRERO,ACAPULCO,11,369,3,383,1454
GUERRERO,ACAPULCO,0,357,5,362,1454
GUERRERO,ACAPULCO,1,380,4,385,1472
GUERRERO,ACAPULCO,19,355,0,374,1472
GUERRERO,ACAPULCO,15,372,4,391,1349
GUERRERO,ACAPULCO,9,353,7,369,1349
GUERRERO,ACAPULCO,15,494,6,515,1827
GUERRERO,ACAPULCO,11,485,2,498,1826
GUERRERO,ACAPULCO,3,384,6,393,1462
GUERRERO,ACAPULCO,10,342,3,355,1461
GUERRERO,ACAPULCO,12,354,4,370,1671
GUERRERO,ACAPULCO,15,363,7,385,1670
GUERRERO,ACAPULCO,12,382,3,397,1502
GUERRERO,ACAPULCO,5,391,5,401,1502
GUERRERO,ACAPULCO,9,391,2,402,1502
GUERRERO,ACAPULCO,15,414,3,432,1727
GUERRERO,ACAPULCO,17,429,4,450,1727
GUERRERO,ACAPULCO,16,461,5,482,1824
GUERRERO,ACAPULCO,8,423,4,435,1824
GUERRERO,ACAPULCO,4,441,2,447,1694
GUERRERO,ACAPULCO,5,398,8,411,1693
GUERRERO,ACAPULCO,10,446,2,458,1808
GUERRERO,ACAPULCO,17,429,2,448,1808
GUERRERO,ACAPULCO,4,467,2,473,1807
GUERRERO,ACAPULCO,9,444,7,460,1865
GUERRERO,ACAPULCO,23,433,6,462,1865
GUERRERO,ACAPULCO,5,374,2,381,1545
GUERRERO,ACAPULCO,9,352,2,363,1545
GUERRERO,ACAPULCO,11,372,1,384,1544
GUERRERO,ACAPULCO,10,353,0,363,1563
GUERRERO,ACAPULCO,14,383,8,405,1562
GUERRERO,ACAPULCO,7,270,3,280,1119
GUERRERO,ACAPULCO,12,281,3,296,1119
GUERRERO,ACAPULCO,13,331,5,349,1294
GUERRERO,ACAPULCO,7,299,6,312,1294
GUERRERO,ACAPULCO,11,380,0,391,1589
GUERRERO,ACAPULCO,15,369,4,388,1588
GUERRERO,ACAPULCO,6,327,0,333,1389
GUERRERO,ACAPULCO,13,316,2,331,1388
GUERRERO,ACAPULCO,15,418,2,435,1693
GUERRERO,ACAPULCO,15,452,6,473,1693
GUERRERO,ACAPULCO,14,215,1,230,1423
GUERRERO,ACAPULCO,11,236,3,250,1422
GUERRERO,ACAPULCO,25,394,1,420,1946
GUERRERO,ACAPULCO,11,445,1,457,1945
GUERRERO,ACAPULCO,10,280,4,294,1545
GUERRERO,ACAPULCO,6,241,3,250,1545
GUERRERO,ACAPULCO,8,458,11,477,2003
GUERRERO,ACAPULCO,17,460,3,480,2002
GUERRERO,ACAPULCO,18,275,3,296,1801
GUERRERO,ACAPULCO,21,252,2,275,1800
GUERRERO,ACAPULCO,19,311,3,333,1800
GUERRERO,ACAPULCO,19,237,1,257,1650
GUERRERO,ACAPULCO,12,270,7,289,1649
GUERRERO,ACAPULCO,10,473,16,499,1954
GUERRERO,ACAPULCO,20,489,28,537,1953
GUERRERO,ACAPULCO,13,426,7,446,1258
GUERRERO,ACAPULCO,9,430,5,444,1257
GUERRERO,ACAPULCO,7,274,6,287,1019
GUERRERO,ACAPULCO,4,296,3,303,1018
GUERRERO,ACAPULCO,16,355,7,378,1411
GUERRERO,ACAPULCO,8,361,5,374,1411
GUERRERO,ACAPULCO,11,359,4,374,1816
GUERRERO,ACAPULCO,10,333,5,348,1816
GUERRERO,ACAPULCO,4,331,7,342,1816
GUERRERO,ACAPULCO,8,345,5,358,1816
GUERRERO,ACAPULCO,7,299,11,317,1815
GUERRERO,TLAPA,10,429,32,471,1722
GUERRERO,TLAPA,5,449,17,471,1721
GUERRERO,TLAPA,3,491,33,527,1721
GUERRERO,TLAPA,14,343,7,364,1574
GUERRERO,TLAPA,13,442,4,459,1574
GUERRERO,TLAPA,2,575,6,583,1574
GUERRERO,TLAPA,16,247,5,268,1314
GUERRERO,TLAPA,13,281,14,308,1314
GUERRERO,TLAPA,19,310,21,350,1314
GUERRERO,TLAPA,18,399,18,435,1283
GUERRERO,TLAPA,0,491,11,502,1283
GUERRERO,TLAPA,0,344,27,371,1283
GUERRERO,TLAPA,14,386,22,422,1336
GUERRERO,TLAPA,6,358,9,373,1336
GUERRERO,TLAPA,6,378,9,393,1336
GUERRERO,TLAPA,11,366,6,383,1665
GUERRERO,TLAPA,8,374,10,392,1665
GUERRERO,TLAPA,28,411,49,488,1568
GUERRERO,TLAPA,19,433,31,483,1568
GUERRERO,TLAPA,11,594,14,619,1824
GUERRERO,TLAPA,7,589,14,610,1824
GUERRERO,TLAPA,14,624,11,649,1823
GUERRERO,TLAPA,3,272,2,277,1267
GUERRERO,TLAPA,9,268,5,282,1266
GUERRERO,TLAPA,5,300,2,307,1266
GUERRERO,TLAPA,16,430,6,452,1654
GUERRERO,TLAPA,12,431,2,445,1653
GUERRERO,TLAPA,2,313,8,323,824
GUERRERO,TLAPA,4,274,6,284,824
GUERRERO,TLAPA,3,300,5,308,823
GUERRERO,TLAPA,13,300,6,319,1176
GUERRERO,TLAPA,5,297,7,309,1175
GUERRERO,TLAPA,5,486,11,502,1709
GUERRERO,TLAPA,3,508,8,519,1708
GUERRERO,TLAPA,7,462,5,474,1708
GUERRERO,TLAPA,1,1049,0,1050,1549
GUERRERO,TLAPA,7,953,2,962,1548
GUERRERO,TLAPA,12,485,14,511,1877
GUERRERO,TLAPA,14,468,8,490,1877
GUERRERO,TLAPA,5,213,6,224,1081
GUERRERO,TLAPA,5,247,1,253,1081
GUERRERO,TLAPA,23,407,43,473,1272
GUERRERO,TLAPA,13,360,28,401,1272
GUERRERO,TLAPA,22,381,24,427,1271
GUERRERO,TLAPA,20,260,14,294,1082
GUERRERO,TLAPA,24,271,18,313,1081
GUERRERO,TLAPA,14,488,7,509,1530
GUERRERO,TLAPA,25,462,20,507,1529
GUERRERO,TLAPA,19,461,16,496,1722
GUERRERO,TLAPA,27,448,16,491,1721
GUERRERO,TLAPA,32,554,27,613,1802
GUERRERO,TLAPA,30,549,19,598,1801
GUERRERO,TLAPA,22,538,24,584,1801
GUERRERO,TLAPA,20,176,9,205,1406
GUERRERO,TLAPA,14,169,3,186,1406
GUERRERO,TLAPA,7,177,15,199,1405
GUERRERO,TLAPA,16,520,9,545,1927
GUERRERO,TLAPA,4,570,10,584,1927
GUERRERO,TLAPA,1,1238,6,1245,1322
GUERRERO,TLAPA,4,1147,5,1156,1322
GUERRERO,TLAPA,10,1173,16,1199,1321
GUERRERO,TLAPA,8,866,14,888,1268
GUERRERO,TLAPA,7,860,14,881,1267
GUERRERO,TLAPA,9,686,2,697,1267
GUERRERO,TLAPA,13,568,20,601,1553
GUERRERO,TLAPA,21,747,12,780,1553
GUERRERO,TLAPA,27,991,5,1023,1821
GUERRERO,TLAPA,19,691,9,719,1821
GUERRERO,TLAPA,20,242,16,278,1657
GUERRERO,TLAPA,11,246,14,271,1656
GUERRERO,TLAPA,34,904,1,939,1143
GUERRERO,TLAPA,7,698,10,715,1143
GUERRERO,TLAPA,5,579,12,596,880
GUERRERO,TLAPA,6,594,27,627,879
GUERRERO,TLAPA,8,739,8,755,879
GUERRERO,TLAPA,6,434,3,443,1871
GUERRERO,TLAPA,11,433,9,453,1871
GUERRERO,TLAPA,9,345,2,356,1450
GUERRERO,TLAPA,6,360,6,372,1450
GUERRERO,TLAPA,12,330,23,365,1449
GUERRERO,TLAPA,8,362,8,378,1110
GUERRERO,TLAPA,11,315,3,329,1109
GUERRERO,TLAPA,15,287,4,306,1109
GUERRERO,TLAPA,8,324,7,339,1402
GUERRERO,TLAPA,10,328,7,345,1402
GUERRERO,TLAPA,5,355,10,370,1401
GUERRERO,TLAPA,6,347,6,359,1401
GUERRERO,TLAPA,1,219,1,221,1173
GUERRERO,TLAPA,2,246,4,252,1173
GUERRERO,TLAPA,25,338,6,369,1466
GUERRERO,TLAPA,10,331,10,351,1466
GUERRERO,TLAPA,12,339,8,359,1304
GUERRERO,TLAPA,25,336,6,367,1304
GUERRERO,TLAPA,5,335,7,347,1304
GUERRERO,TLAPA,12,441,26,479,1331
GUERRERO,TLAPA,23,374,20,417,1331
GUERRERO,TLAPA,12,357,17,386,1330
GUERRERO,TLAPA,11,225,7,243,1619
GUERRERO,TLAPA,3,194,9,206,1619
GUERRERO,TLAPA,8,232,22,262,1618
GUERRERO,TLAPA,8,253,4,265,1563
GUERRERO,TLAPA,13,236,16,265,1562
GUERRERO,TLAPA,11,238,6,255,1673
GUERRERO,TLAPA,10,198,5,213,1673
GUERRERO,TLAPA,6,203,7,216,1672
GUERRERO,TLAPA,3,354,8,365,1639
GUERRERO,TLAPA,1,377,17,395,1639
GUERRERO,TLAPA,3,391,6,400,1482
GUERRERO,TLAPA,4,352,2,358,1482
GUERRERO,TLAPA,5,754,4,763,1923
GUERRERO,TLAPA,10,574,0,584,1923
GUERRERO,TLAPA,15,510,14,539,1922
GUERRERO,TLAPA,13,295,16,324,1408
GUERRERO,TLAPA,9,702,0,711,1408
GUERRERO,TLAPA,11,761,15,787,1408
GUERRERO,TLAPA,13,655,10,678,1578
GUERRERO,TLAPA,7,411,8,426,1578
GUERRERO,TLAPA,10,386,8,404,1577
GUERRERO,TLAPA,8,500,1,509,1288
GUERRERO,TLAPA,0,423,10,433,1288
GUERRERO,TLAPA,0,485,11,496,1287
GUERRERO,TLAPA,11,404,2,417,1488
GUERRERO,TLAPA,6,396,2,404,1488
GUERRERO,TLAPA,5,398,5,408,1487
GUERRERO,TLAPA,8,311,5,324,1515
GUERRERO,TLAPA,8,297,4,309,1515
GUERRERO,TLAPA,7,403,5,415,1539
GUERRERO,TLAPA,5,379,8,392,1539
GUERRERO,TLAPA,5,335,9,349,1538
GUERRERO,TLAPA,7,365,8,380,1538
GUERRERO,TLAPA,36,1563,36,1635,0
GUERRERO,TLAPA,7,364,1,372,1499
GUERRERO,TLAPA,5,354,9,368,1499
GUERRERO,TLAPA,8,348,7,363,1499
GUERRERO,TLAPA,11,479,4,494,1619
GUERRERO,TLAPA,6,460,3,469,1619
GUERRERO,TLAPA,6,430,5,441,1603
GUERRERO,TLAPA,5,420,2,427,1603
GUERRERO,TLAPA,3,442,2,447,1602
GUERRERO,TLAPA,0,283,1,284,1072
GUERRERO,TLAPA,6,271,1,278,1072
GUERRERO,TLAPA,10,487,3,500,1888
GUERRERO,TLAPA,8,512,4,524,1888
GUERRERO,TLAPA,6,467,7,480,1887
GUERRERO,TLAPA,5,515,7,527,1585
GUERRERO,TLAPA,6,500,3,509,1584
GUERRERO,TLAPA,13,526,4,543,1785
GUERRERO,TLAPA,1,487,6,494,1785
GUERRERO,TLAPA,2,325,5,332,1372
GUERRERO,TLAPA,3,379,8,390,1372
GUERRERO,TLAPA,1,376,3,380,1372
GUERRERO,TLAPA,11,305,14,330,1345
GUERRERO,TLAPA,12,314,17,343,1345
GUERRERO,TLAPA,3,155,1,159,1356
GUERRERO,TLAPA,7,137,7,151,1356
GUERRERO,TLAPA,11,496,19,526,1690
GUERRERO,TLAPA,16,529,17,562,1689
GUERRERO,TLAPA,4,481,15,500,1689
GUERRERO,TLAPA,6,179,11,196,1264
GUERRERO,TLAPA,12,176,33,221,1263
GUERRERO,TLAPA,9,183,12,204,1263
GUERRERO,TLAPA,8,382,17,407,1923
GUERRERO,TLAPA,18,427,28,473,1923
GUERRERO,TLAPA,20,450,18,488,1923
GUERRERO,TLAPA,11,387,17,415,1332
GUERRERO,TLAPA,6,428,13,447,1332
GUERRERO,TLAPA,15,401,28,444,1331
GUERRERO,TLAPA,1,407,1,409,1295
GUERRERO,TLAPA,5,466,0,471,1295
GUERRERO,TLAPA,0,499,4,503,1295
GUERRERO,TLAPA,15,381,15,411,1576
GUERRERO,TLAPA,7,278,19,304,1575
GUERRERO,TLAPA,14,386,22,422,1575
GUERRERO,TLAPA,8,424,11,443,1881
GUERRERO,TLAPA,6,426,16,448,1880
GUERRERO,TLAPA,9,421,11,441,1880
GUERRERO,TLAPA,10,570,4,584,1638
GUERRERO,TLAPA,8,581,16,605,1638
GUERRERO,TLAPA,11,419,17,447,1595
GUERRERO,TLAPA,16,446,12,474,1595
GUERRERO,TLAPA,9,464,8,481,1594
GUERRERO,TLAPA,20,297,16,333,1275
GUERRERO,TLAPA,10,283,24,317,1274
GUERRERO,TLAPA,15,296,11,322,1274
GUERRERO,TLAPA,13,360,3,376,1792
GUERRERO,TLAPA,10,367,4,381,1792
GUERRERO,TLAPA,9,256,3,268,1196
GUERRERO,TLAPA,9,255,5,269,1195
GUERRERO,CHILAPA,11,324,12,347,1710
GUERRERO,CHILAPA,22,310,7,339,1710
GUERRERO,CHILAPA,12,397,12,421,1709
GUERRERO,CHILAPA,16,350,2,368,1561
GUERRERO,CHILAPA,20,357,8,385,1561
GUERRERO,CHILAPA,21,308,5,334,1464
GUERRERO,CHILAPA,9,319,17,345,1463
GUERRERO,CHILAPA,8,264,13,285,1491
GUERRERO,CHILAPA,11,235,5,251,1491
GUERRERO,CHILAPA,8,254,2,264,1491
GUERRERO,CHILAPA,12,354,20,386,1662
GUERRERO,CHILAPA,12,419,24,455,1662
GUERRERO,CHILAPA,24,384,29,437,1788
GUERRERO,CHILAPA,14,386,16,416,1788
GUERRERO,CHILAPA,18,456,21,495,1788
GUERRERO,CHILAPA,17,357,20,394,1337
GUERRERO,CHILAPA,12,343,8,363,1336
GUERRERO,CHILAPA,11,161,14,186,1926
GUERRERO,CHILAPA,22,137,15,174,1926
GUERRERO,CHILAPA,22,613,71,706,1488
GUERRERO,CHILAPA,33,596,65,694,1487
GUERRERO,CHILAPA,42,560,68,670,1929
GUERRERO,CHILAPA,57,517,67,641,1929
GUERRERO,CHILAPA,42,451,39,532,1228
GUERRERO,CHILAPA,35,446,28,509,1227
GUERRERO,CHILAPA,11,495,32,538,1611
GUERRERO,CHILAPA,17,536,19,572,1611
GUERRERO,CHILAPA,20,544,23,587,1610
GUERRERO,CHILAPA,12,382,16,410,1388
GUERRERO,CHILAPA,23,450,12,485,1387
GUERRERO,CHILAPA,17,299,30,346,1143
GUERRERO,CHILAPA,7,360,16,383,1142
GUERRERO,CHILAPA,12,493,19,524,1313
GUERRERO,CHILAPA,12,506,21,539,1313
GUERRERO,CHILAPA,14,505,22,541,1312
GUERRERO,CHILAPA,18,402,7,427,1763
GUERRERO,CHILAPA,7,371,3,381,1762
GUERRERO,CHILAPA,8,397,7,412,1762
GUERRERO,CHILAPA,16,412,2,430,1940
GUERRERO,CHILAPA,9,385,4,398,1939
GUERRERO,CHILAPA,5,474,10,489,1958
GUERRERO,CHILAPA,9,489,6,504,1957
GUERRERO,CHILAPA,38,925,20,983,0
GUERRERO,CHILAPA,14,492,5,511,1791
GUERRERO,CHILAPA,9,495,6,510,1790
GUERRERO,CHILAPA,5,230,1,236,1026
GUERRERO,CHILAPA,3,231,2,236,1025
GUERRERO,CHILAPA,13,387,1,401,1911
GUERRERO,CHILAPA,7,429,9,445,1911
GUERRERO,CHILAPA,17,411,2,430,1911
GUERRERO,CHILAPA,10,232,9,251,1796
GUERRERO,CHILAPA,9,248,11,268,1795
GUERRERO,CHILAPA,12,103,2,117,1023
GUERRERO,CHILAPA,11,66,4,81,1023
GUERRERO,CHILAPA,12,92,17,121,1066
GUERRERO,CHILAPA,16,82,14,112,1066
GUERRERO,CHILAPA,9,241,26,276,1945
GUERRERO,CHILAPA,18,236,22,276,1944
GUERRERO,CHILAPA,8,156,1,165,1641
GUERRERO,CHILAPA,8,158,7,173,1641
GUERRERO,CHILAPA,114,6,4,124,1413
GUERRERO,CHILAPA,13,69,11,93,1412
GUERRERO,CHILAPA,5,161,8,174,1556
GUERRERO,CHILAPA,6,157,7,170,1556
GUERRERO,CHILAPA,9,213,8,230,1556
GUERRERO,CHILAPA,8,99,13,120,1313
GUERRERO,CHILAPA,11,126,8,145,1313
GUERRERO,CHILAPA,33,171,25,229,1879
GUERRERO,CHILAPA,30,158,22,210,1879
GUERRERO,CHILAPA,19,176,24,219,1363
GUERRERO,CHILAPA,16,195,17,228,1362
GUERRERO,CHILAPA,16,190,18,224,1362
GUERRERO,CHILAPA,14,135,8,157,1132
GUERRERO,CHILAPA,10,155,11,176,1131
GUERRERO,CHILAPA,25,119,27,171,1751
GUERRERO,CHILAPA,9,109,18,136,1750
GUERRERO,CHILAPA,22,179,18,219,1746
GUERRERO,CHILAPA,16,164,17,197,1745
GUERRERO,CHILAPA,47,127,20,194,1585
GUERRERO,CHILAPA,33,175,18,226,1584
GUERRERO,CHILAPA,85,162,18,265,1178
GUERRERO,CHILAPA,73,159,11,243,1177
GUERRERO,CHILAPA,15,128,7,150,1505
GUERRERO,CHILAPA,20,110,16,146,1505
GUERRERO,CHILAPA,14,124,13,151,1505
GUERRERO,CHILAPA,32,111,23,166,1657
GUERRERO,CHILAPA,40,129,50,219,1657
GUERRERO,CHILAPA,12,230,25,267,1273
GUERRERO,CHILAPA,18,253,30,301,1272
GUERRERO,CHILAPA,17,420,18,455,1820
GUERRERO,CHILAPA,13,430,18,461,1819
GUERRERO,CHILAPA,14,216,19,249,1380
GUERRERO,CHILAPA,21,241,20,282,1380
GUERRERO,CHILAPA,52,139,83,274,1693
GUERRERO,CHILAPA,37,144,98,279,1692
GUERRERO,CHILAPA,48,167,86,301,1692
GUERRERO,CHILAPA,32,96,16,144,1258
GUERRERO,CHILAPA,44,82,16,142,1257
GUERRERO,CHILAPA,6,363,13,382,1839
GUERRERO,CHILAPA,10,292,10,312,1839
GUERRERO,CHILAPA,6,371,4,381,1839
GUERRERO,CHILAPA,12,331,8,351,1838
GUERRERO,CHILAPA,9,225,17,251,1643
GUERRERO,CHILAPA,8,207,13,228,1642
GUERRERO,CHILAPA,14,242,16,272,1642
GUERRERO,CHILAPA,11,273,13,297,1479
GUERRERO,CHILAPA,22,254,16,292,1479
GUERRERO,CHILAPA,25,281,10,316,1478
GUERRERO,CHILAPA,6,279,9,294,1626
GUERRERO,CHILAPA,7,270,6,283,1625
GUERRERO,CHILAPA,8,288,5,301,1625
GUERRERO,CHILAPA,14,251,9,274,1354
GUERRERO,CHILAPA,12,210,3,225,1353
GUERRERO,CHILAPA,8,247,10,265,1353
GUERRERO,CHILAPA,13,222,0,235,1909
GUERRERO,CHILAPA,4,167,8,179,1909
GUERRERO,CHILAPA,11,183,6,200,1908
GUERRERO,CHILAPA,4,74,3,81,1321
GUERRERO,CHILAPA,2,72,0,74,1321
GUERRERO,CHILAPA,4,101,1,106,1320
GUERRERO,CHILAPA,31,156,32,219,1131
GUERRERO,CHILAPA,36,117,30,183,1130
GUERRERO,CHILAPA,5,188,4,197,1832
GUERRERO,CHILAPA,6,140,2,148,1832
GUERRERO,CHILAPA,3,177,7,187,1831
GUERRERO,CHILAPA,4,145,1,150,1339
GUERRERO,CHILAPA,4,174,2,180,1338
GUERRERO,CHILAPA,5,163,1,169,1338
GUERRERO,CHILAPA,3,71,2,76,1694
GUERRERO,CHILAPA,10,91,1,102,1693
GUERRERO,CHILAPA,5,354,5,364,1756
GUERRERO,CHILAPA,5,360,4,369,1756
GUERRERO,CHILAPA,4,352,3,359,1755
GUERRERO,CHILAPA,10,506,4,520,1875
GUERRERO,CHILAPA,8,415,8,431,1875
GUERRERO,CHILAPA,4,299,4,307,1031
GUERRERO,CHILAPA,10,291,3,304,1030
GUERRERO,CHILAPA,8,305,10,323,1241
GUERRERO,CHILAPA,7,276,2,285,1241
GUERRERO,CHILAPA,8,441,6,455,1926
GUERRERO,CHILAPA,7,441,4,452,1926
GUERRERO,CHILAPA,10,397,5,412,1925
GUERRERO,CHILAPA,5,555,7,567,1847
GUERRERO,CHILAPA,8,481,0,489,1847
GUERRERO,CHILAPA,21,274,13,308,1901
GUERRERO,CHILAPA,18,271,7,296,1900
GUERRERO,CHILAPA,20,243,16,279,1900
GUERRERO,CHILAPA,22,174,30,226,1666
GUERRERO,CHILAPA,19,213,20,252,1666
GUERRERO,CHILAPA,17,205,25,247,1666
GUERRERO,CHILAPA,35,423,14,472,1915
GUERRERO,CHILAPA,20,392,15,427,1914
GUERRERO,CHILAPA,13,338,24,375,1491
GUERRERO,CHILAPA,11,375,21,407,1491
GUERRERO,CHILAPA,33,557,20,610,1738
GUERRERO,CHILAPA,29,594,19,642,1737
GUERRERO,CHILAPA,27,677,32,736,1737
GUERRERO,CHILAPA,27,636,16,679,1737
GUERRERO,CHILAPA,31,441,24,496,1459
GUERRERO,CHILAPA,46,410,28,484,1459
GUERRERO,CHILAPA,41,332,34,407,1615
GUERRERO,CHILAPA,35,290,27,352,1614
GUERRERO,CHILAPA,28,424,16,468,1373
GUERRERO,CHILAPA,18,389,18,425,1373
GUERRERO,CHILAPA,16,237,17,270,1236
GUERRERO,CHILAPA,22,275,11,308,1235
GUERRERO,CHILAPA,8,302,13,323,1378
GUERRERO,CHILAPA,4,261,12,277,1378
GUERRERO,CHILAPA,10,261,7,278,1377
GUERRERO,CHILAPA,11,182,1,194,1462
GUERRERO,CHILAPA,14,184,7,205,1462
GUERRERO,CHILAPA,13,213,8,234,1805
GUERRERO,CHILAPA,17,154,8,179,1805
GUERRERO,CHILAPA,41,438,34,513,1354
GUERRERO,CHILAPA,28,432,30,490,1354
GUERRERO,CHILAPA,35,420,28,483,1354
GUERRERO,CHILAPA,55,534,40,629,1506
GUERRERO,CHILAPA,49,532,44,625,1505
GUERRERO,CHILAPA,50,559,30,639,1505
GUERRERO,CHILAPA,20,296,8,324,1309
GUERRERO,CHILAPA,9,225,21,255,1309
GUERRERO,CHILAPA,12,272,24,308,1309
GUERRERO,CHILPANCINGO,19,299,7,325,1745
GUERRERO,CHILPANCINGO,7,331,7,345,1745
GUERRERO,CHILPANCINGO,20,327,3,350,1744
GUERRERO,CHILPANCINGO,9,326,4,339,1744
GUERRERO,CHILPANCINGO,9,302,1,312,1744
GUERRERO,CHILPANCINGO,14,370,5,389,2018
GUERRERO,CHILPANCINGO,11,299,4,314,2017
GUERRERO,CHILPANCINGO,9,280,7,296,1630
GUERRERO,CHILPANCINGO,10,292,3,305,1630
GUERRERO,CHILPANCINGO,5,281,0,286,1673
GUERRERO,CHILPANCINGO,5,264,12,281,1672
GUERRERO,CHILPANCINGO,11,274,6,291,1468
GUERRERO,CHILPANCINGO,8,272,1,281,1467
GUERRERO,CHILPANCINGO,12,367,2,381,1851
GUERRERO,CHILPANCINGO,8,410,3,421,1850
GUERRERO,CHILPANCINGO,9,224,2,235,1471
GUERRERO,CHILPANCINGO,3,286,2,291,1470
GUERRERO,CHILPANCINGO,13,324,4,341,1836
GUERRERO,CHILPANCINGO,12,373,1,386,1836
GUERRERO,CHILPANCINGO,6,332,3,341,1836
GUERRERO,CHILPANCINGO,0,362,2,364,1836
GUERRERO,CHILPANCINGO,8,328,8,344,1836
GUERRERO,CHILPANCINGO,6,348,2,356,1835
GUERRERO,CHILPANCINGO,6,350,2,358,1835
GUERRERO,CHILPANCINGO,11,322,1,334,1713
GUERRERO,CHILPANCINGO,12,331,2,345,1712
GUERRERO,CHILPANCINGO,8,301,1,310,1712
GUERRERO,CHILPANCINGO,36,1663,11,1710,0
GUERRERO,CHILPANCINGO,17,378,4,399,1840
GUERRERO,CHILPANCINGO,15,402,3,420,1840
GUERRERO,CHILPANCINGO,13,365,5,383,1696
GUERRERO,CHILPANCINGO,4,366,5,375,1695
GUERRERO,CHILPANCINGO,8,204,3,215,1188
GUERRERO,CHILPANCINGO,6,199,0,205,1188
GUERRERO,CHILPANCINGO,11,258,3,272,1774
GUERRERO,CHILPANCINGO,2,270,1,273,1774
GUERRERO,CHILPANCINGO,16,343,6,365,1966
GUERRERO,CHILPANCINGO,14,328,5,347,1966
GUERRERO,CHILPANCINGO,14,431,8,453,1776
GUERRERO,CHILPANCINGO,11,394,3,408,1776
GUERRERO,CHILPANCINGO,6,371,4,381,1936
GUERRERO,CHILPANCINGO,4,370,2,376,1935
GUERRERO,CHILPANCINGO,16,359,0,375,1582
GUERRERO,CHILPANCINGO,14,321,5,340,1582
GUERRERO,CHILPANCINGO,7,343,6,356,1915
GUERRERO,CHILPANCINGO,8,320,2,330,1914
GUERRERO,CHILPANCINGO,15,314,4,333,1455
GUERRERO,CHILPANCINGO,8,267,4,279,1454
GUERRERO,CHILPANCINGO,14,287,2,303,1695
GUERRERO,CHILPANCINGO,18,282,1,301,1694
GUERRERO,CHILPANCINGO,6,287,0,293,1344
GUERRERO,CHILPANCINGO,8,289,2,299,1344
GUERRERO,CHILPANCINGO,16,429,4,449,1949
GUERRERO,CHILPANCINGO,12,467,1,480,1948
GUERRERO,CHILPANCINGO,7,268,3,278,1360
GUERRERO,CHILPANCINGO,7,255,7,269,1360
GUERRERO,CHILPANCINGO,10,167,5,182,1056
GUERRERO,CHILPANCINGO,6,181,1,188,1055
GUERRERO,CHILPANCINGO,6,232,5,243,1266
GUERRERO,CHILPANCINGO,6,254,4,264,1266
GUERRERO,CHILPANCINGO,10,415,1,426,1966
GUERRERO,CHILPANCINGO,14,403,2,419,1965
GUERRERO,CHILPANCINGO,6,215,2,223,1202
GUERRERO,CHILPANCINGO,4,165,2,171,1202
GUERRERO,CHILPANCINGO,7,411,4,422,1893
GUERRERO,CHILPANCINGO,11,391,2,404,1892
GUERRERO,CHILPANCINGO,15,326,8,349,1394
GUERRERO,CHILPANCINGO,3,336,1,340,1393
GUERRERO,CHILPANCINGO,5,326,1,332,1393
GUERRERO,CHILPANCINGO,16,363,1,380,1419
GUERRERO,CHILPANCINGO,13,343,3,359,1418
GUERRERO,CHILPANCINGO,7,223,4,234,1677
GUERRERO,CHILPANCINGO,14,225,10,249,1677
GUERRERO,CHILPANCINGO,4,248,1,253,1676
GUERRERO,CHILPANCINGO,19,327,1,347,1664
GUERRERO,CHILPANCINGO,16,331,4,351,1664
GUERRERO,CHILPANCINGO,19,263,1,283,1405
GUERRERO,CHILPANCINGO,11,276,0,287,1405
GUERRERO,CHILPANCINGO,12,228,8,248,1330
GUERRERO,CHILPANCINGO,6,257,0,263,1330
GUERRERO,CHILPANCINGO,9,276,1,286,1330
GUERRERO,CHILPANCINGO,9,278,11,298,1549
GUERRERO,CHILPANCINGO,11,276,8,295,1548
GUERRERO,CHILPANCINGO,15,299,5,319,1548
GUERRERO,CHILPANCINGO,13,360,4,377,1545
GUERRERO,CHILPANCINGO,12,332,2,346,1545
GUERRERO,CHILPANCINGO,12,336,3,351,1829
GUERRERO,CHILPANCINGO,10,308,4,322,1829
GUERRERO,CHILPANCINGO,14,363,4,381,1829
GUERRERO,CHILPANCINGO,16,336,5,357,1829
GUERRERO,CHILPANCINGO,9,315,0,324,1828
GUERRERO,CHILPANCINGO,16,355,2,373,1828
GUERRERO,CHILPANCINGO,22,375,4,401,1897
GUERRERO,CHILPANCINGO,20,370,5,395,1897
GUERRERO,CHILPANCINGO,13,393,1,407,1896
GUERRERO,CHILPANCINGO,7,274,0,281,1450
GUERRERO,CHILPANCINGO,16,294,2,312,1450
GUERRERO,CHILPANCINGO,10,249,0,259,1449
GUERRERO,CHILPANCINGO,38,302,16,356,1861
GUERRERO,CHILPANCINGO,53,341,27,421,1860
GUERRERO,CHILPANCINGO,17,276,1,294,1455
GUERRERO,CHILPANCINGO,15,272,4,291,1454
GUERRERO,CHILPANCINGO,8,291,2,301,1454
GUERRERO,CHILPANCINGO,7,308,8,323,1709
GUERRERO,CHILPANCINGO,10,333,4,347,1709
GUERRERO,CHILPANCINGO,12,322,4,338,1708
GUERRERO,CHILPANCINGO,6,347,4,357,1565
GUERRERO,CHILPANCINGO,6,369,5,380,1565
GUERRERO,CHILPANCINGO,6,301,2,309,1522
GUERRERO,CHILPANCINGO,7,270,2,279,1521
GUERRERO,CHILPANCINGO,9,274,8,291,1920
GUERRERO,CHILPANCINGO,12,302,5,319,1920
GUERRERO,CHILPANCINGO,12,1065,8,1085,1939
GUERRERO,CHILPANCINGO,10,262,11,283,1859
GUERRERO,CHILPANCINGO,11,233,5,249,1858
GUERRERO,CHILPANCINGO,12,229,7,248,1253
GUERRERO,CHILPANCINGO,6,211,2,219,1252
GUERRERO,CHILPANCINGO,6,316,1,323,1785
GUERRERO,CHILPANCINGO,4,294,3,301,1785
GUERRERO,CHILPANCINGO,4,300,9,313,1708
GUERRERO,CHILPANCINGO,6,249,6,261,1708
GUERRERO,CHILPANCINGO,18,435,8,461,1878
GUERRERO,CHILPANCINGO,15,436,14,465,1878
GUERRERO,CHILPANCINGO,9,370,8,387,1315
GUERRERO,CHILPANCINGO,16,426,4,446,1315
GUERRERO,CHILPANCINGO,12,601,2,615,1895
GUERRERO,CHILPANCINGO,12,627,6,645,1894
GUERRERO,CHILPANCINGO,8,363,2,373,1211
GUERRERO,CHILPANCINGO,7,370,9,386,1211
GUERRERO,CHILPANCINGO,11,611,12,634,1543
GUERRERO,CHILPANCINGO,11,528,3,542,1543
GUERRERO,CHILPANCINGO,16,458,7,481,1615
GUERRERO,CHILPANCINGO,7,488,5,500,1615
GUERRERO,CHILPANCINGO,8,408,7,423,1421
GUERRERO,CHILPANCINGO,6,416,4,426,1420
GUERRERO,CHILPANCINGO,9,388,4,401,1390
GUERRERO,CHILPANCINGO,6,394,8,408,1389
GUERRERO,CHILPANCINGO,12,387,3,402,1763
GUERRERO,CHILPANCINGO,5,349,12,366,1763
GUERRERO,CHILPANCINGO,10,373,8,391,1763
GUERRERO,CHILPANCINGO,5,422,7,434,1763
GUERRERO,CHILPANCINGO,15,510,12,537,1737
GUERRERO,CHILPANCINGO,9,427,14,450,1737
GUERRERO,CHILPANCINGO,30,590,26,646,1839
GUERRERO,CHILPANCINGO,36,583,20,639,1839
GUERRERO,CHILPANCINGO,34,541,24,599,1839
GUERRERO,CHILPANCINGO,9,191,6,206,1644
GUERRERO,CHILPANCINGO,18,186,5,209,1644
GUERRERO,CHILPANCINGO,7,193,8,208,1644
GUERRERO,CHILPANCINGO,13,161,15,189,1644
GUERRERO,CHILPANCINGO,15,224,4,243,1482
GUERRERO,CHILPANCINGO,15,289,2,306,1482
GUERRERO,CHILPANCINGO,13,1178,9,1200,1589
GUERRERO,CHILPANCINGO,16,320,6,342,1588
GUERRERO,CHILPANCINGO,9,981,10,1000,1588
GUERRERO,CHILPANCINGO,20,344,10,374,1672
GUERRERO,CHILPANCINGO,7,368,15,390,1671
GUERRERO,CHILPANCINGO,13,1060,4,1077,1627
GUERRERO,CHILPANCINGO,3,1365,4,1372,1627
GUERRERO,CHILPANCINGO,5,363,6,374,1594
GUERRERO,CHILPANCINGO,4,333,0,337,1593
GUERRERO,CHILPANCINGO,10,283,1,294,1348
GUERRERO,CHILPANCINGO,6,310,4,320,1347
GUERRERO,CHILPANCINGO,3,267,4,274,1347
GUERRERO,CHILPANCINGO,15,349,13,377,1714
GUERRERO,CHILPANCINGO,9,338,5,352,1714
GUERRERO,CHILPANCINGO,12,341,5,358,1602
GUERRERO,CHILPANCINGO,3,344,5,352,1601
GUERRERO,CHILPANCINGO,5,277,0,282,1536
GUERRERO,CHILPANCINGO,4,316,11,331,1536
GUERRERO,CHILPANCINGO,4,348,5,357,1535
GUERRERO,AYUTLA DE LOS LIBRES,12,292,3,307,1600
GUERRERO,AYUTLA DE LOS LIBRES,16,281,12,309,1599
GUERRERO,AYUTLA DE LOS LIBRES,7,301,9,317,1599
GUERRERO,AYUTLA DE LOS LIBRES,5,249,2,256,1425
GUERRERO,AYUTLA DE LOS LIBRES,6,257,5,268,1424
GUERRERO,AYUTLA DE LOS LIBRES,2,259,1,262,1424
GUERRERO,AYUTLA DE LOS LIBRES,11,232,14,257,1433
GUERRERO,AYUTLA DE LOS LIBRES,8,235,11,254,1433
GUERRERO,AYUTLA DE LOS LIBRES,15,239,16,270,1433
GUERRERO,AYUTLA DE LOS LIBRES,13,245,13,271,1771
GUERRERO,AYUTLA DE LOS LIBRES,8,251,18,277,1771
GUERRERO,AYUTLA DE LOS LIBRES,37,446,52,535,1295
GUERRERO,AYUTLA DE LOS LIBRES,7,341,4,352,1581
GUERRERO,AYUTLA DE LOS LIBRES,8,377,4,389,1580
GUERRERO,AYUTLA DE LOS LIBRES,6,193,8,207,645
GUERRERO,AYUTLA DE LOS LIBRES,10,279,9,298,1555
GUERRERO,AYUTLA DE LOS LIBRES,5,261,4,270,1554
GUERRERO,AYUTLA DE LOS LIBRES,9,232,6,247,1876
GUERRERO,AYUTLA DE LOS LIBRES,7,195,9,211,1876
GUERRERO,AYUTLA DE LOS LIBRES,14,194,17,225,1428
GUERRERO,AYUTLA DE LOS LIBRES,5,148,32,185,1427
GUERRERO,AYUTLA DE LOS LIBRES,10,392,2,404,1712
GUERRERO,AYUTLA DE LOS LIBRES,13,309,7,329,1712
GUERRERO,AYUTLA DE LOS LIBRES,12,273,10,295,1505
GUERRERO,AYUTLA DE LOS LIBRES,8,240,12,260,1505
GUERRERO,AYUTLA DE LOS LIBRES,3,272,5,280,1505
GUERRERO,AYUTLA DE LOS LIBRES,7,254,8,269,1446
GUERRERO,AYUTLA DE LOS LIBRES,0,251,5,256,1446
GUERRERO,AYUTLA DE LOS LIBRES,3,243,4,250,1446
GUERRERO,AYUTLA DE LOS LIBRES,8,164,5,177,1547
GUERRERO,AYUTLA DE LOS LIBRES,5,174,3,182,1547
GUERRERO,AYUTLA DE LOS LIBRES,4,203,13,220,1547
GUERRERO,AYUTLA DE LOS LIBRES,3,435,3,441,1490
GUERRERO,AYUTLA DE LOS LIBRES,2,455,4,461,1490
GUERRERO,AYUTLA DE LOS LIBRES,4,405,4,413,1489
GUERRERO,AYUTLA DE LOS LIBRES,1,385,2,388,1602
GUERRERO,AYUTLA DE LOS LIBRES,10,391,4,405,1601
GUERRERO,AYUTLA DE LOS LIBRES,6,380,2,388,1601
GUERRERO,AYUTLA DE LOS LIBRES,7,453,7,467,1808
GUERRERO,AYUTLA DE LOS LIBRES,11,469,3,483,1808
GUERRERO,AYUTLA DE LOS LIBRES,5,473,14,492,1807
GUERRERO,AYUTLA DE LOS LIBRES,6,400,6,412,1502
GUERRERO,AYUTLA DE LOS LIBRES,6,383,5,394,1501
GUERRERO,AYUTLA DE LOS LIBRES,6,387,7,400,1501
GUERRERO,AYUTLA DE LOS LIBRES,5,433,6,444,1857
GUERRERO,AYUTLA DE LOS LIBRES,8,430,4,442,1857
GUERRERO,AYUTLA DE LOS LIBRES,3,428,0,431,1856
GUERRERO,AYUTLA DE LOS LIBRES,5,368,3,376,1353
GUERRERO,AYUTLA DE LOS LIBRES,2,342,5,349,1353
GUERRERO,AYUTLA DE LOS LIBRES,6,377,7,390,1353
GUERRERO,AYUTLA DE LOS LIBRES,2,473,4,479,2011
GUERRERO,AYUTLA DE LOS LIBRES,3,503,2,508,2011
GUERRERO,AYUTLA DE LOS LIBRES,6,428,7,441,1558
GUERRERO,AYUTLA DE LOS LIBRES,7,444,5,456,1557
GUERRERO,AYUTLA DE LOS LIBRES,2,340,0,342,1466
GUERRERO,AYUTLA DE LOS LIBRES,3,341,6,350,1466
GUERRERO,AYUTLA DE LOS LIBRES,6,324,6,336,1466
GUERRERO,AYUTLA DE LOS LIBRES,6,479,4,489,1820
GUERRERO,AYUTLA DE LOS LIBRES,1,444,12,457,1820
GUERRERO,AYUTLA DE LOS LIBRES,2,310,4,316,1024
GUERRERO,AYUTLA DE LOS LIBRES,2,360,2,364,1023
GUERRERO,AYUTLA DE LOS LIBRES,5,420,3,428,1569
GUERRERO,AYUTLA DE LOS LIBRES,9,386,3,398,1568
GUERRERO,AYUTLA DE LOS LIBRES,7,461,6,474,1622
GUERRERO,AYUTLA DE LOS LIBRES,2,470,2,474,1621
GUERRERO,AYUTLA DE LOS LIBRES,6,381,8,395,1283
GUERRERO,AYUTLA DE LOS LIBRES,11,402,4,417,1282
GUERRERO,AYUTLA DE LOS LIBRES,18,540,10,568,2052
GUERRERO,AYUTLA DE LOS LIBRES,9,480,6,495,2052
GUERRERO,AYUTLA DE LOS LIBRES,10,519,15,544,1942
GUERRERO,AYUTLA DE LOS LIBRES,8,497,15,520,1942
GUERRERO,AYUTLA DE LOS LIBRES,6,583,9,598,1860
GUERRERO,AYUTLA DE LOS LIBRES,13,510,11,534,1860
GUERRERO,AYUTLA DE LOS LIBRES,3,376,0,379,1549
GUERRERO,AYUTLA DE LOS LIBRES,2,365,1,368,1548
GUERRERO,AYUTLA DE LOS LIBRES,3,329,0,332,1429
GUERRERO,AYUTLA DE LOS LIBRES,0,302,2,304,1428
GUERRERO,AYUTLA DE LOS LIBRES,4,295,3,302,1428
GUERRERO,AYUTLA DE LOS LIBRES,10,271,14,295,1344
GUERRERO,AYUTLA DE LOS LIBRES,8,266,2,276,1343
GUERRERO,AYUTLA DE LOS LIBRES,4,262,5,271,1343
GUERRERO,AYUTLA DE LOS LIBRES,3,548,2,553,1851
GUERRERO,AYUTLA DE LOS LIBRES,2,283,3,288,1465
GUERRERO,AYUTLA DE LOS LIBRES,2,293,2,297,1464
GUERRERO,AYUTLA DE LOS LIBRES,7,311,3,321,1904
GUERRERO,AYUTLA DE LOS LIBRES,7,319,3,329,1904
GUERRERO,AYUTLA DE LOS LIBRES,3,390,2,395,1896
GUERRERO,AYUTLA DE LOS LIBRES,6,334,1,341,1895
GUERRERO,AYUTLA DE LOS LIBRES,6,294,4,304,1809
GUERRERO,AYUTLA DE LOS LIBRES,3,335,8,346,1809
GUERRERO,AYUTLA DE LOS LIBRES,7,267,9,283,1388
GUERRERO,AYUTLA DE LOS LIBRES,8,278,0,286,1388
GUERRERO,AYUTLA DE LOS LIBRES,5,424,6,435,2128
GUERRERO,AYUTLA DE LOS LIBRES,9,406,9,424,2128
GUERRERO,AYUTLA DE LOS LIBRES,6,455,5,466,1787
GUERRERO,AYUTLA DE LOS LIBRES,2,502,4,508,1786
GUERRERO,AYUTLA DE LOS LIBRES,12,460,8,480,1786
GUERRERO,AYUTLA DE LOS LIBRES,4,318,2,324,1349
GUERRERO,AYUTLA DE LOS LIBRES,7,297,2,306,1348
GUERRERO,AYUTLA DE LOS LIBRES,1,314,2,317,1348
GUERRERO,AYUTLA DE LOS LIBRES,8,684,2,694,1519
GUERRERO,AYUTLA DE LOS LIBRES,0,510,8,518,1518
GUERRERO,AYUTLA DE LOS LIBRES,3,442,3,448,1518
GUERRERO,AYUTLA DE LOS LIBRES,1,921,12,934,1520
GUERRERO,AYUTLA DE LOS LIBRES,1,641,2,644,1520
GUERRERO,AYUTLA DE LOS LIBRES,12,789,4,805,1519
GUERRERO,AYUTLA DE LOS LIBRES,4,358,2,364,1562
GUERRERO,AYUTLA DE LOS LIBRES,2,463,2,467,1562
GUERRERO,AYUTLA DE LOS LIBRES,2,519,20,541,1561
GUERRERO,AYUTLA DE LOS LIBRES,5,375,2,382,1561
GUERRERO,AYUTLA DE LOS LIBRES,1,591,2,594,2105
GUERRERO,AYUTLA DE LOS LIBRES,2,728,3,733,2105
GUERRERO,AYUTLA DE LOS LIBRES,6,1168,13,1187,1997
GUERRERO,AYUTLA DE LOS LIBRES,13,1734,2,1749,1997
GUERRERO,AYUTLA DE LOS LIBRES,28,634,20,682,1996
GUERRERO,AYUTLA DE LOS LIBRES,11,724,6,741,1849
GUERRERO,AYUTLA DE LOS LIBRES,11,658,16,685,1849
GUERRERO,AYUTLA DE LOS LIBRES,19,420,15,454,1925
GUERRERO,AYUTLA DE LOS LIBRES,7,441,9,457,1925
GUERRERO,AYUTLA DE LOS LIBRES,7,495,9,511,1714
GUERRERO,AYUTLA DE LOS LIBRES,5,493,11,509,1714
GUERRERO,AYUTLA DE LOS LIBRES,2,428,6,436,1826
GUERRERO,AYUTLA DE LOS LIBRES,4,353,3,360,1825
GUERRERO,AYUTLA DE LOS LIBRES,6,358,4,368,1343
GUERRERO,AYUTLA DE LOS LIBRES,6,307,7,320,1343
GUERRERO,AYUTLA DE LOS LIBRES,6,321,3,330,1343
GUERRERO,AYUTLA DE LOS LIBRES,9,498,2,509,0
GUERRERO,AYUTLA DE LOS LIBRES,11,340,13,364,1562
GUERRERO,AYUTLA DE LOS LIBRES,7,353,2,362,1562
GUERRERO,AYUTLA DE LOS LIBRES,6,313,4,323,1562
GUERRERO,AYUTLA DE LOS LIBRES,15,433,18,466,1922
GUERRERO,AYUTLA DE LOS LIBRES,14,375,10,399,1922
GUERRERO,AYUTLA DE LOS LIBRES,12,493,12,517,2192
GUERRERO,AYUTLA DE LOS LIBRES,8,450,10,468,2191
GUERRERO,AYUTLA DE LOS LIBRES,15,234,4,253,1519
GUERRERO,AYUTLA DE LOS LIBRES,17,250,5,272,1519
GUERRERO,AYUTLA DE LOS LIBRES,4,310,7,321,1829
GUERRERO,AYUTLA DE LOS LIBRES,9,278,1,288,1829
GUERRERO,AYUTLA DE LOS LIBRES,7,232,7,246,1828
GUERRERO,AYUTLA DE LOS LIBRES,8,624,13,645,2121
GUERRERO,AYUTLA DE LOS LIBRES,7,522,7,536,2121
GUERRERO,AYUTLA DE LOS LIBRES,4,246,1,251,1334
GUERRERO,AYUTLA DE LOS LIBRES,3,189,0,192,1333
GUERRERO,AYUTLA DE LOS LIBRES,9,353,7,369,1887
GUERRERO,AYUTLA DE LOS LIBRES,5,317,3,325,1887
GUERRERO,AYUTLA DE LOS LIBRES,7,323,6,336,1365
GUERRERO,AYUTLA DE LOS LIBRES,8,323,1,332,1365
GUERRERO,AYUTLA DE LOS LIBRES,6,344,6,356,1364
GUERRERO,AYUTLA DE LOS LIBRES,18,289,13,320,1957
GUERRERO,AYUTLA DE LOS LIBRES,19,297,14,330,1957
GUERRERO,AYUTLA DE LOS LIBRES,17,384,7,408,1844
GUERRERO,AYUTLA DE LOS LIBRES,7,355,2,364,1844
GUERRERO,AYUTLA DE LOS LIBRES,9,220,5,234,1365
GUERRERO,AYUTLA DE LOS LIBRES,9,251,2,262,1364
GUERRERO,AYUTLA DE LOS LIBRES,7,502,1,510,1983
GUERRERO,AYUTLA DE LOS LIBRES,7,471,0,478,1982
GUERRERO,AYUTLA DE LOS LIBRES,22,268,7,297,1114
GUERRERO,AYUTLA DE LOS LIBRES,15,207,0,222,1113
GUERRERO,AYUTLA DE LOS LIBRES,22,308,14,344,1932
GUERRERO,AYUTLA DE LOS LIBRES,22,315,10,347,1932
GUERRERO,ACAPULCO,7,244,3,254,1451
GUERRERO,ACAPULCO,3,278,5,286,1450
GUERRERO,ACAPULCO,8,277,2,287,1437
GUERRERO,ACAPULCO,13,260,9,282,1436
GUERRERO,ACAPULCO,5,268,4,277,1436
GUERRERO,ACAPULCO,10,269,8,287,1436
GUERRERO,ACAPULCO,6,255,7,268,1192
GUERRERO,ACAPULCO,5,191,7,203,1192
GUERRERO,ACAPULCO,5,249,8,262,1191
GUERRERO,ACAPULCO,8,389,12,409,1787
GUERRERO,ACAPULCO,11,363,4,378,1786
GUERRERO,ACAPULCO,252,2,1,255,1115
GUERRERO,ACAPULCO,10,217,3,230,1114
GUERRERO,ACAPULCO,4,229,1,234,1257
GUERRERO,ACAPULCO,5,200,2,207,1256
GUERRERO,ACAPULCO,3,230,2,235,1552
GUERRERO,ACAPULCO,4,227,6,237,1551
GUERRERO,ACAPULCO,13,367,6,386,1710
GUERRERO,ACAPULCO,5,357,6,368,1709
GUERRERO,ACAPULCO,2,260,4,266,1426
GUERRERO,ACAPULCO,3,265,2,270,1426
GUERRERO,ACAPULCO,5,236,6,247,1425
GUERRERO,ACAPULCO,11,246,5,262,1320
GUERRERO,ACAPULCO,4,264,4,272,1320
GUERRERO,ACAPULCO,5,266,2,273,1319
GUERRERO,ACAPULCO,12,400,7,419,1526
GUERRERO,ACAPULCO,7,351,2,360,1526
GUERRERO,ACAPULCO,6,374,2,382,1525
GUERRERO,ACAPULCO,15,386,0,401,1840
GUERRERO,ACAPULCO,7,378,1,386,1840
GUERRERO,ACAPULCO,4,412,7,423,1755
GUERRERO,ACAPULCO,11,429,3,443,1755
GUERRERO,ACAPULCO,15,451,3,469,1638
GUERRERO,ACAPULCO,8,455,3,466,1637
GUERRERO,ACAPULCO,11,369,2,382,1376
GUERRERO,ACAPULCO,2,336,3,341,1376
GUERRERO,ACAPULCO,7,349,4,360,1376
GUERRERO,ACAPULCO,6,286,6,298,1275
GUERRERO,ACAPULCO,9,278,3,290,1275
GUERRERO,ACAPULCO,5,314,4,323,1274
GUERRERO,ACAPULCO,6,337,0,343,1320
GUERRERO,ACAPULCO,5,328,2,335,1320
GUERRERO,ACAPULCO,7,342,5,354,1320
GUERRERO,ACAPULCO,11,320,7,338,1526
GUERRERO,ACAPULCO,8,363,6,377,1526
GUERRERO,ACAPULCO,10,344,5,359,1526
GUERRERO,ACAPULCO,2,352,10,364,1802
GUERRERO,ACAPULCO,10,366,5,381,1801
GUERRERO,ACAPULCO,11,407,2,420,1782
GUERRERO,ACAPULCO,5,436,5,446,1781
GUERRERO,ACAPULCO,17,335,1,353,1295
GUERRERO,ACAPULCO,6,315,6,327,1295
GUERRERO,ACAPULCO,11,338,4,353,1294
GUERRERO,ACAPULCO,4,393,3,400,1256
GUERRERO,ACAPULCO,8,334,4,346,1256
GUERRERO,ACAPULCO,4,321,2,327,1256
GUERRERO,ACAPULCO,5,343,1,349,1280
GUERRERO,ACAPULCO,7,330,7,344,1280
GUERRERO,ACAPULCO,3,323,2,328,1279
GUERRERO,ACAPULCO,63,1904,37,2004,0
GUERRERO,ACAPULCO,4,312,4,320,1394
GUERRERO,ACAPULCO,1,317,6,324,1394
GUERRERO,ACAPULCO,5,324,4,333,1394
GUERRERO,ACAPULCO,5,192,3,200,1043
GUERRERO,ACAPULCO,5,188,5,198,1042
GUERRERO,ACAPULCO,10,337,4,351,1437
GUERRERO,ACAPULCO,4,326,1,331,1436
GUERRERO,ACAPULCO,4,243,4,251,1413
GUERRERO,ACAPULCO,3,262,6,271,1413
GUERRERO,ACAPULCO,7,275,8,290,1413
GUERRERO,ACAPULCO,9,367,5,381,1808
GUERRERO,ACAPULCO,6,431,4,441,1808
GUERRERO,ACAPULCO,7,332,2,341,1560
GUERRERO,ACAPULCO,6,333,5,344,1559
GUERRERO,ACAPULCO,6,382,2,390,1280
GUERRERO,ACAPULCO,5,323,7,335,1280
GUERRERO,ACAPULCO,319,5,1,325,1279
GUERRERO,ACAPULCO,5,387,3,395,1759
GUERRERO,ACAPULCO,5,388,7,400,1758
GUERRERO,ACAPULCO,5,208,8,221,1328
GUERRERO,ACAPULCO,5,244,0,249,1328
GUERRERO,ACAPULCO,5,271,0,276,1307
GUERRERO,ACAPULCO,4,237,8,249,1307
GUERRERO,ACAPULCO,7,195,6,208,1243
GUERRERO,ACAPULCO,8,201,4,213,1242
GUERRERO,ACAPULCO,4,196,6,206,1242
GUERRERO,ACAPULCO,4,391,1,396,1745
GUERRERO,ACAPULCO,10,415,8,433,1745
GUERRERO,ACAPULCO,6,320,4,330,1516
GUERRERO,ACAPULCO,8,263,8,279,1516
GUERRERO,ACAPULCO,5,355,3,363,1835
GUERRERO,ACAPULCO,9,354,3,366,1834
GUERRERO,ACAPULCO,6,345,9,360,1834
GUERRERO,ACAPULCO,4,252,5,261,1284
GUERRERO,ACAPULCO,2,291,1,294,1283
GUERRERO,ACAPULCO,1,234,2,237,1283
GUERRERO,ACAPULCO,10,410,6,426,1795
GUERRERO,ACAPULCO,11,402,3,416,1794
GUERRERO,ACAPULCO,6,344,2,352,2005
GUERRERO,ACAPULCO,3,275,2,280,2005
GUERRERO,ACAPULCO,6,285,2,293,2005
GUERRERO,ACAPULCO,5,285,2,292,2005
GUERRERO,ACAPULCO,8,286,2,296,1252
GUERRERO,ACAPULCO,4,272,3,279,1251
GUERRERO,ACAPULCO,4,339,2,345,1251
GUERRERO,ACAPULCO,8,307,1,316,1540
GUERRERO,ACAPULCO,5,316,4,325,1540
GUERRERO,ACAPULCO,8,233,6,247,1403
GUERRERO,ACAPULCO,18,263,5,286,1403
GUERRERO,ACAPULCO,13,217,3,233,1770
GUERRERO,ACAPULCO,15,258,5,278,1770
GUERRERO,ACAPULCO,13,296,2,311,1452
GUERRERO,ACAPULCO,9,279,4,292,1451
GUERRERO,ACAPULCO,6,374,6,386,2095
GUERRERO,ACAPULCO,8,366,6,380,2095
GUERRERO,ACAPULCO,7,388,5,400,2095
GUERRERO,ACAPULCO,9,413,9,431,2095
GUERRERO,ACAPULCO,14,388,4,406,2095
GUERRERO,ACAPULCO,11,288,8,307,1544
GUERRERO,ACAPULCO,6,280,3,289,1543
GUERRERO,ACAPULCO,4,246,3,253,1455
GUERRERO,ACAPULCO,8,263,6,277,1455
GUERRERO,ACAPULCO,8,267,3,278,1719
GUERRERO,ACAPULCO,10,211,2,223,1718
GUERRERO,ACAPULCO,8,239,2,249,1718
GUERRERO,ACAPULCO,10,236,2,248,1718
GUERRERO,ACAPULCO,8,231,3,242,1718
GUERRERO,ACAPULCO,2,370,2,374,1718
GUERRERO,ACAPULCO,3,288,6,297,1813
GUERRERO,ACAPULCO,6,271,8,285,1813
GUERRERO,ACAPULCO,5,289,31,325,1813
GUERRERO,ACAPULCO,6,284,6,296,1813
GUERRERO,ACAPULCO,1,183,3,187,1014
GUERRERO,ACAPULCO,1,160,5,166,1013
GUERRERO,ACAPULCO,11,312,1,324,2179
GUERRERO,ACAPULCO,11,303,4,318,2179
GUERRERO,ACAPULCO,6,335,1,342,2179
GUERRERO,ACAPULCO,6,320,3,329,2178
GUERRERO,ACAPULCO,10,325,2,337,2178
GUERRERO,ACAPULCO,6,282,0,288,2178
GUERRERO,ACAPULCO,21,174,3,198,1441
GUERRERO,ACAPULCO,16,185,4,205,1440
GUERRERO,ACAPULCO,13,393,10,416,1319
GUERRERO,ACAPULCO,16,359,10,385,1319
GUERRERO,ACAPULCO,5,352,10,367,1319
GUERRERO,ACAPULCO,7,526,7,540,1698
GUERRERO,ACAPULCO,9,509,2,520,1698
GUERRERO,ACAPULCO,13,406,12,431,1697
GUERRERO,ACAPULCO,13,309,6,328,1159
GUERRERO,ACAPULCO,13,283,7,303,1159
GUERRERO,ACAPULCO,12,302,7,321,1158
GUERRERO,ACAPULCO,13,393,10,416,1106
GUERRERO,ACAPULCO,10,573,14,597,1983
GUERRERO,ACAPULCO,16,561,22,599,1982
GUERRERO,ACAPULCO,12,498,10,520,1982
GUERRERO,ACAPULCO,13,371,3,387,1381
GUERRERO,ACAPULCO,9,388,8,405,1380
GUERRERO,ACAPULCO,6,275,2,283,686
GUERRERO,ACAPULCO,32,372,14,418,1728
GUERRERO,ACAPULCO,12,384,12,408,1728
GUERRERO,ACAPULCO,12,408,12,432,1706
GUERRERO,ACAPULCO,14,365,6,385,1705
GUERRERO,ACAPULCO,7,207,3,217,1089
GUERRERO,ACAPULCO,5,204,8,217,1088
GUERRERO,ACAPULCO,6,209,1,216,1649
GUERRERO,ACAPULCO,6,226,4,236,1648
GUERRERO,ACAPULCO,6,321,11,338,1269
GUERRERO,ACAPULCO,13,354,9,376,1268
GUERRERO,ACAPULCO,17,318,11,346,1268
GUERRERO,ACAPULCO,15,314,11,340,1341
GUERRERO,ACAPULCO,16,303,14,333,1340
GUERRERO,ACAPULCO,18,300,14,332,1340
GUERRERO,ACAPULCO,8,202,12,222,1111
GUERRERO,ACAPULCO,10,198,4,212,1110
GUERRERO,ACAPULCO,4,359,5,368,1854
GUERRERO,ACAPULCO,8,317,8,333,1854
GUERRERO,ACAPULCO,2,127,0,129,801
GUERRERO,ACAPULCO,6,153,0,159,800
GUERRERO,ACAPULCO,6,187,5,198,800
GUERRERO,ACAPULCO,0,283,2,285,1166
GUERRERO,ACAPULCO,8,296,6,310,1166
GUERRERO,ACAPULCO,5,267,1,273,1797
GUERRERO,ACAPULCO,13,283,6,302,1797
GUERRERO,ACAPULCO,7,216,8,231,1446
GUERRERO,ACAPULCO,6,242,5,253,1446
GUERRERO,ACAPULCO,1,229,2,232,1445
GUERRERO,ACAPULCO,7,236,4,247,952
GUERRERO,ACAPULCO,3,223,8,234,951
GUERRERO,ACAPULCO,7,220,8,235,951
GUERRERO,ACAPULCO,0,776,3,779,1718
GUERRERO,ACAPULCO,0,519,3,522,1717
GUERRERO,ACAPULCO,21,444,18,483,1846
GUERRERO,ACAPULCO,18,423,18,459,1846
HIDALGO,HUEJUTLA DE REYES,16,479,19,514,1371
HIDALGO,HUEJUTLA DE REYES,22,483,17,522,1371
HIDALGO,HUEJUTLA DE REYES,15,513,21,549,1370
HIDALGO,HUEJUTLA DE REYES,34,666,31,731,1756
HIDALGO,HUEJUTLA DE REYES,32,675,20,727,1756
HIDALGO,HUEJUTLA DE REYES,25,693,53,771,1878
HIDALGO,HUEJUTLA DE REYES,29,677,41,747,1878
HIDALGO,HUEJUTLA DE REYES,16,342,11,369,1339
HIDALGO,HUEJUTLA DE REYES,7,168,11,186,1339
HIDALGO,HUEJUTLA DE REYES,27,314,11,352,1338
HIDALGO,HUEJUTLA DE REYES,29,556,29,614,1973
HIDALGO,HUEJUTLA DE REYES,31,542,39,612,1973
HIDALGO,HUEJUTLA DE REYES,22,349,26,397,1533
HIDALGO,HUEJUTLA DE REYES,38,314,57,409,1533
HIDALGO,HUEJUTLA DE REYES,17,299,21,337,1532
HIDALGO,HUEJUTLA DE REYES,25,724,14,763,1744
HIDALGO,HUEJUTLA DE REYES,19,699,18,736,1744
HIDALGO,HUEJUTLA DE REYES,20,473,16,509,1744
HIDALGO,HUEJUTLA DE REYES,16,372,20,408,1743
HIDALGO,HUEJUTLA DE REYES,21,547,25,593,1743
HIDALGO,HUEJUTLA DE REYES,10,607,21,638,1572
HIDALGO,HUEJUTLA DE REYES,11,647,18,676,1572
HIDALGO,HUEJUTLA DE REYES,7,634,11,652,1571
HIDALGO,HUEJUTLA DE REYES,32,427,39,498,1589
HIDALGO,HUEJUTLA DE REYES,16,430,26,472,1589
HIDALGO,HUEJUTLA DE REYES,42,452,43,537,1588
HIDALGO,HUEJUTLA DE REYES,7,354,8,369,1383
HIDALGO,HUEJUTLA DE REYES,17,332,20,369,1383
HIDALGO,HUEJUTLA DE REYES,12,324,16,352,1382
HIDALGO,HUEJUTLA DE REYES,14,192,16,222,1062
HIDALGO,HUEJUTLA DE REYES,12,229,10,251,1061
HIDALGO,HUEJUTLA DE REYES,12,353,11,376,1394
HIDALGO,HUEJUTLA DE REYES,10,311,13,334,1394
HIDALGO,HUEJUTLA DE REYES,9,422,11,442,1393
HIDALGO,HUEJUTLA DE REYES,11,594,10,615,1742
HIDALGO,HUEJUTLA DE REYES,20,543,5,568,1741
HIDALGO,HUEJUTLA DE REYES,15,602,3,620,1915
HIDALGO,HUEJUTLA DE REYES,13,633,6,652,1915
HIDALGO,HUEJUTLA DE REYES,11,598,7,616,1915
HIDALGO,HUEJUTLA DE REYES,12,563,3,578,1850
HIDALGO,HUEJUTLA DE REYES,15,484,4,503,1850
HIDALGO,HUEJUTLA DE REYES,49,1607,38,1694,0
HIDALGO,HUEJUTLA DE REYES,6,444,4,454,1472
HIDALGO,HUEJUTLA DE REYES,7,458,0,465,1471
HIDALGO,HUEJUTLA DE REYES,11,565,7,583,1471
HIDALGO,HUEJUTLA DE REYES,11,539,9,559,1470
HIDALGO,HUEJUTLA DE REYES,10,600,19,629,1836
HIDALGO,HUEJUTLA DE REYES,12,591,19,622,1836
HIDALGO,HUEJUTLA DE REYES,11,627,8,646,1835
HIDALGO,HUEJUTLA DE REYES,12,588,10,610,1922
HIDALGO,HUEJUTLA DE REYES,18,596,11,625,1921
HIDALGO,HUEJUTLA DE REYES,12,548,17,577,1624
HIDALGO,HUEJUTLA DE REYES,9,551,12,572,1624
HIDALGO,HUEJUTLA DE REYES,6,514,12,532,1623
HIDALGO,HUEJUTLA DE REYES,20,283,17,320,1674
HIDALGO,HUEJUTLA DE REYES,17,275,35,327,1674
HIDALGO,HUEJUTLA DE REYES,16,374,30,420,1673
HIDALGO,HUEJUTLA DE REYES,17,520,11,548,1649
HIDALGO,HUEJUTLA DE REYES,20,456,27,503,1648
HIDALGO,HUEJUTLA DE REYES,14,490,11,515,1648
HIDALGO,HUEJUTLA DE REYES,21,623,35,679,1861
HIDALGO,HUEJUTLA DE REYES,15,628,35,678,1860
HIDALGO,HUEJUTLA DE REYES,7,494,5,506,1839
HIDALGO,HUEJUTLA DE REYES,6,431,25,462,1839
HIDALGO,HUEJUTLA DE REYES,17,267,39,323,1706
HIDALGO,HUEJUTLA DE REYES,13,284,34,331,1706
HIDALGO,HUEJUTLA DE REYES,15,164,10,189,1401
HIDALGO,HUEJUTLA DE REYES,13,168,9,190,1401
HIDALGO,HUEJUTLA DE REYES,9,203,8,220,1401
HIDALGO,HUEJUTLA DE REYES,22,163,45,230,1965
HIDALGO,HUEJUTLA DE REYES,19,179,36,234,1964
HIDALGO,HUEJUTLA DE REYES,31,342,22,395,1282
HIDALGO,HUEJUTLA DE REYES,36,348,29,413,1281
HIDALGO,HUEJUTLA DE REYES,12,353,7,372,1409
HIDALGO,HUEJUTLA DE REYES,13,345,29,387,1409
HIDALGO,HUEJUTLA DE REYES,0,328,16,344,1409
HIDALGO,HUEJUTLA DE REYES,33,458,41,532,1990
HIDALGO,HUEJUTLA DE REYES,14,482,57,553,1990
HIDALGO,HUEJUTLA DE REYES,23,296,33,352,1691
HIDALGO,HUEJUTLA DE REYES,10,338,28,376,1690
HIDALGO,HUEJUTLA DE REYES,14,213,15,242,1398
HIDALGO,HUEJUTLA DE REYES,16,253,11,280,1397
HIDALGO,HUEJUTLA DE REYES,32,128,35,195,1817
HIDALGO,HUEJUTLA DE REYES,34,126,51,211,1816
HIDALGO,HUEJUTLA DE REYES,13,287,26,326,1773
HIDALGO,HUEJUTLA DE REYES,11,349,15,375,1773
HIDALGO,HUEJUTLA DE REYES,15,345,29,389,1595
HIDALGO,HUEJUTLA DE REYES,8,315,29,352,1594
HIDALGO,HUEJUTLA DE REYES,18,510,30,558,1874
HIDALGO,HUEJUTLA DE REYES,26,439,40,505,1873
HIDALGO,HUEJUTLA DE REYES,13,517,18,548,1873
HIDALGO,HUEJUTLA DE REYES,12,269,12,293,1558
HIDALGO,HUEJUTLA DE REYES,14,175,7,196,1557
HIDALGO,HUEJUTLA DE REYES,13,175,10,198,1557
HIDALGO,HUEJUTLA DE REYES,6,382,8,396,1586
HIDALGO,HUEJUTLA DE REYES,11,320,22,353,1586
HIDALGO,HUEJUTLA DE REYES,12,305,12,329,1585
HIDALGO,HUEJUTLA DE REYES,21,420,14,455,1476
HIDALGO,HUEJUTLA DE REYES,15,330,4,349,1475
HIDALGO,HUEJUTLA DE REYES,16,385,11,412,1475
HIDALGO,HUEJUTLA DE REYES,13,479,18,510,1584
HIDALGO,HUEJUTLA DE REYES,7,387,39,433,1584
HIDALGO,HUEJUTLA DE REYES,9,406,11,426,1298
HIDALGO,HUEJUTLA DE REYES,14,417,18,449,1298
HIDALGO,HUEJUTLA DE REYES,12,462,20,494,1771
HIDALGO,HUEJUTLA DE REYES,11,444,23,478,1770
HIDALGO,HUEJUTLA DE REYES,8,333,21,362,1004
HIDALGO,HUEJUTLA DE REYES,11,376,14,401,1004
HIDALGO,HUEJUTLA DE REYES,11,471,30,512,1936
HIDALGO,HUEJUTLA DE REYES,15,443,16,474,1936
HIDALGO,HUEJUTLA DE REYES,14,374,39,427,1814
HIDALGO,HUEJUTLA DE REYES,25,392,59,476,1814
HIDALGO,HUEJUTLA DE REYES,27,432,25,484,1474
HIDALGO,HUEJUTLA DE REYES,20,430,25,475,1474
HIDALGO,HUEJUTLA DE REYES,29,293,51,373,1944
HIDALGO,HUEJUTLA DE REYES,36,267,33,336,1944
HIDALGO,HUEJUTLA DE REYES,15,215,18,248,1062
HIDALGO,HUEJUTLA DE REYES,14,302,24,340,1062
HIDALGO,HUEJUTLA DE REYES,4,192,7,203,1700
HIDALGO,HUEJUTLA DE REYES,9,252,15,276,1700
HIDALGO,HUEJUTLA DE REYES,7,224,7,238,1699
HIDALGO,HUEJUTLA DE REYES,14,222,6,242,1699
HIDALGO,HUEJUTLA DE REYES,43,262,45,350,1911
HIDALGO,HUEJUTLA DE REYES,56,223,45,324,1910
HIDALGO,HUEJUTLA DE REYES,37,262,53,352,1910
HIDALGO,HUEJUTLA DE REYES,14,305,21,340,1890
HIDALGO,HUEJUTLA DE REYES,12,318,26,356,1889
HIDALGO,HUEJUTLA DE REYES,17,310,21,348,1889
HIDALGO,HUEJUTLA DE REYES,15,410,10,435,1666
HIDALGO,HUEJUTLA DE REYES,14,382,11,407,1665
HIDALGO,HUEJUTLA DE REYES,14,285,18,317,1486
HIDALGO,HUEJUTLA DE REYES,51,334,23,408,1485
HIDALGO,HUEJUTLA DE REYES,22,280,8,310,1485
HIDALGO,HUEJUTLA DE REYES,12,355,28,395,1467
HIDALGO,HUEJUTLA DE REYES,37,389,46,472,1466
HIDALGO,HUEJUTLA DE REYES,24,429,21,474,1466
HIDALGO,HUEJUTLA DE REYES,12,365,15,392,1852
HIDALGO,HUEJUTLA DE REYES,15,412,9,436,1852
HIDALGO,HUEJUTLA DE REYES,33,383,20,436,1750
HIDALGO,HUEJUTLA DE REYES,18,327,16,361,1750
HIDALGO,HUEJUTLA DE REYES,39,466,29,534,1841
HIDALGO,HUEJUTLA DE REYES,42,435,30,507,1840
HIDALGO,HUEJUTLA DE REYES,37,330,22,389,1712
HIDALGO,HUEJUTLA DE REYES,38,314,20,372,1712
HIDALGO,HUEJUTLA DE REYES,31,366,31,428,1748
HIDALGO,HUEJUTLA DE REYES,18,285,21,324,1748
HIDALGO,HUEJUTLA DE REYES,28,321,25,374,1748
HIDALGO,HUEJUTLA DE REYES,72,349,34,455,1890
HIDALGO,HUEJUTLA DE REYES,64,400,44,508,1889
HIDALGO,HUEJUTLA DE REYES,35,476,15,526,1922
HIDALGO,HUEJUTLA DE REYES,31,475,17,523,1921
HIDALGO,HUEJUTLA DE REYES,19,327,33,379,1882
HIDALGO,HUEJUTLA DE REYES,22,291,26,339,1882
HIDALGO,HUEJUTLA DE REYES,16,374,9,399,1881
HIDALGO,HUEJUTLA DE REYES,27,438,44,509,1887
HIDALGO,HUEJUTLA DE REYES,38,470,37,545,1886
HIDALGO,HUEJUTLA DE REYES,23,349,27,399,1933
HIDALGO,HUEJUTLA DE REYES,42,384,34,460,1932
HIDALGO,HUEJUTLA DE REYES,16,386,11,413,1961
HIDALGO,HUEJUTLA DE REYES,19,370,17,406,1960
HIDALGO,HUEJUTLA DE REYES,12,319,18,349,1610
HIDALGO,HUEJUTLA DE REYES,6,358,15,379,1610
HIDALGO,HUEJUTLA DE REYES,34,616,51,701,1950
HIDALGO,HUEJUTLA DE REYES,30,606,60,696,1949
HIDALGO,HUEJUTLA DE REYES,30,664,46,740,1958
HIDALGO,HUEJUTLA DE REYES,22,735,20,777,1957
HIDALGO,HUEJUTLA DE REYES,16,445,10,471,1332
HIDALGO,HUEJUTLA DE REYES,7,517,21,545,1332
HIDALGO,HUEJUTLA DE REYES,16,441,27,484,1907
HIDALGO,HUEJUTLA DE REYES,24,539,46,609,1906
HIDALGO,HUEJUTLA DE REYES,14,381,18,413,1353
HIDALGO,HUEJUTLA DE REYES,18,330,18,366,1353
HIDALGO,HUEJUTLA DE REYES,9,179,16,204,1596
HIDALGO,HUEJUTLA DE REYES,23,164,27,214,1596
HIDALGO,HUEJUTLA DE REYES,7,220,22,249,1596
HIDALGO,IXMIQUILPAN,20,405,19,444,1890
HIDALGO,IXMIQUILPAN,25,401,9,435,1889
HIDALGO,IXMIQUILPAN,16,309,13,338,1298
HIDALGO,IXMIQUILPAN,10,333,13,356,1297
HIDALGO,IXMIQUILPAN,10,303,8,321,1427
HIDALGO,IXMIQUILPAN,8,340,15,363,1427
HIDALGO,IXMIQUILPAN,26,308,17,351,1815
HIDALGO,IXMIQUILPAN,14,358,15,387,1815
HIDALGO,IXMIQUILPAN,10,400,4,414,1491
HIDALGO,IXMIQUILPAN,6,424,8,438,1491
HIDALGO,IXMIQUILPAN,6,379,8,393,1491
HIDALGO,IXMIQUILPAN,5,503,5,513,1741
HIDALGO,IXMIQUILPAN,19,529,17,565,1741
HIDALGO,IXMIQUILPAN,21,610,14,645,1855
HIDALGO,IXMIQUILPAN,15,536,11,562,1854
HIDALGO,IXMIQUILPAN,20,592,10,622,1854
HIDALGO,IXMIQUILPAN,8,473,13,494,1487
HIDALGO,IXMIQUILPAN,6,557,14,577,1487
HIDALGO,IXMIQUILPAN,15,259,16,290,1654
HIDALGO,IXMIQUILPAN,18,260,21,299,1653
HIDALGO,IXMIQUILPAN,21,271,16,308,1653
HIDALGO,IXMIQUILPAN,15,274,10,299,1592
HIDALGO,IXMIQUILPAN,15,280,7,302,1591
HIDALGO,IXMIQUILPAN,15,287,26,328,1591
HIDALGO,IXMIQUILPAN,30,327,22,379,1953
HIDALGO,IXMIQUILPAN,23,328,21,372,1952
HIDALGO,IXMIQUILPAN,26,242,30,298,1440
HIDALGO,IXMIQUILPAN,12,275,15,302,1440
HIDALGO,IXMIQUILPAN,11,281,10,302,1452
HIDALGO,IXMIQUILPAN,8,254,8,270,1452
HIDALGO,IXMIQUILPAN,13,504,13,530,1726
HIDALGO,IXMIQUILPAN,12,308,5,325,1376
HIDALGO,IXMIQUILPAN,6,319,2,327,1376
HIDALGO,IXMIQUILPAN,4,292,7,303,1375
HIDALGO,IXMIQUILPAN,14,404,11,429,1517
HIDALGO,IXMIQUILPAN,12,421,8,441,1517
HIDALGO,IXMIQUILPAN,15,335,13,363,1516
HIDALGO,IXMIQUILPAN,11,468,9,488,1606
HIDALGO,IXMIQUILPAN,23,484,15,522,1605
HIDALGO,IXMIQUILPAN,19,550,9,578,1890
HIDALGO,IXMIQUILPAN,7,457,15,479,1890
HIDALGO,IXMIQUILPAN,18,392,15,425,1610
HIDALGO,IXMIQUILPAN,24,379,6,409,1610
HIDALGO,IXMIQUILPAN,17,331,10,358,1611
HIDALGO,IXMIQUILPAN,14,364,6,384,1610
HIDALGO,IXMIQUILPAN,16,336,6,358,1773
HIDALGO,IXMIQUILPAN,14,322,3,339,1772
HIDALGO,IXMIQUILPAN,13,315,4,332,1772
HIDALGO,IXMIQUILPAN,15,323,3,341,1566
HIDALGO,IXMIQUILPAN,16,347,4,367,1566
HIDALGO,IXMIQUILPAN,24,333,3,360,1565
HIDALGO,IXMIQUILPAN,28,358,1,387,1821
HIDALGO,IXMIQUILPAN,21,393,4,418,1820
HIDALGO,IXMIQUILPAN,18,318,9,345,1504
HIDALGO,IXMIQUILPAN,15,323,2,340,1504
HIDALGO,IXMIQUILPAN,24,389,7,420,1516
HIDALGO,IXMIQUILPAN,21,416,3,440,1515
HIDALGO,IXMIQUILPAN,56,1067,11,1134,0
HIDALGO,IXMIQUILPAN,16,563,13,592,1749
HIDALGO,IXMIQUILPAN,12,465,11,488,1749
HIDALGO,IXMIQUILPAN,11,627,7,645,1933
HIDALGO,IXMIQUILPAN,23,557,7,587,1932
HIDALGO,IXMIQUILPAN,11,263,9,283,1133
HIDALGO,IXMIQUILPAN,5,320,7,332,1132
HIDALGO,IXMIQUILPAN,7,385,9,401,1444
HIDALGO,IXMIQUILPAN,6,400,7,413,1444
HIDALGO,IXMIQUILPAN,10,403,11,424,1443
HIDALGO,IXMIQUILPAN,16,373,15,404,1326
HIDALGO,IXMIQUILPAN,16,340,11,367,1326
HIDALGO,IXMIQUILPAN,10,434,7,451,1588
HIDALGO,IXMIQUILPAN,8,401,8,417,1588
HIDALGO,IXMIQUILPAN,12,267,10,289,1384
HIDALGO,IXMIQUILPAN,12,335,9,356,1384
HIDALGO,IXMIQUILPAN,12,314,7,333,1383
HIDALGO,IXMIQUILPAN,7,432,14,453,1616
HIDALGO,IXMIQUILPAN,12,469,11,492,1615
HIDALGO,IXMIQUILPAN,12,577,13,602,1922
HIDALGO,IXMIQUILPAN,26,711,21,758,1922
HIDALGO,IXMIQUILPAN,12,466,8,486,1525
HIDALGO,IXMIQUILPAN,6,428,6,440,1525
HIDALGO,IXMIQUILPAN,13,462,11,486,1524
HIDALGO,IXMIQUILPAN,14,380,7,401,1636
HIDALGO,IXMIQUILPAN,5,376,14,395,1636
HIDALGO,IXMIQUILPAN,15,373,20,408,1635
HIDALGO,IXMIQUILPAN,11,446,12,469,1669
HIDALGO,IXMIQUILPAN,22,484,12,518,1668
HIDALGO,IXMIQUILPAN,16,198,12,226,1427
HIDALGO,IXMIQUILPAN,8,199,13,220,1427
HIDALGO,IXMIQUILPAN,10,218,14,242,1426
HIDALGO,IXMIQUILPAN,20,245,15,280,1946
HIDALGO,IXMIQUILPAN,19,240,11,270,1946
HIDALGO,IXMIQUILPAN,14,188,20,222,1946
HIDALGO,IXMIQUILPAN,12,417,21,450,1761
HIDALGO,IXMIQUILPAN,12,380,13,405,1761
HIDALGO,IXMIQUILPAN,9,266,14,289,1165
HIDALGO,IXMIQUILPAN,8,334,16,358,1164
HIDALGO,IXMIQUILPAN,9,198,5,212,1337
HIDALGO,IXMIQUILPAN,6,167,4,177,1337
HIDALGO,IXMIQUILPAN,13,168,8,189,1336
HIDALGO,IXMIQUILPAN,20,220,12,252,1725
HIDALGO,IXMIQUILPAN,13,233,11,257,1725
HIDALGO,IXMIQUILPAN,12,219,16,247,1725
HIDALGO,IXMIQUILPAN,12,214,11,237,1724
HIDALGO,IXMIQUILPAN,18,187,8,213,1632
HIDALGO,IXMIQUILPAN,12,155,10,177,1632
HIDALGO,IXMIQUILPAN,13,149,12,174,1631
HIDALGO,IXMIQUILPAN,9,165,6,180,1631
HIDALGO,IXMIQUILPAN,26,354,7,387,1522
HIDALGO,IXMIQUILPAN,15,323,6,344,1521
HIDALGO,IXMIQUILPAN,17,315,6,338,1521
HIDALGO,IXMIQUILPAN,11,314,5,330,1516
HIDALGO,IXMIQUILPAN,11,325,3,339,1516
HIDALGO,IXMIQUILPAN,12,292,6,310,1515
HIDALGO,IXMIQUILPAN,12,270,3,285,1515
HIDALGO,IXMIQUILPAN,14,401,9,424,1878
HIDALGO,IXMIQUILPAN,19,350,1,370,1878
HIDALGO,IXMIQUILPAN,7,298,3,308,1337
HIDALGO,IXMIQUILPAN,16,334,4,354,1337
HIDALGO,IXMIQUILPAN,14,277,4,295,1337
HIDALGO,IXMIQUILPAN,15,412,5,432,1421
HIDALGO,IXMIQUILPAN,13,395,3,411,1420
HIDALGO,IXMIQUILPAN,19,406,8,433,1420
HIDALGO,IXMIQUILPAN,13,532,13,558,1811
HIDALGO,IXMIQUILPAN,16,519,13,548,1811
HIDALGO,IXMIQUILPAN,26,498,16,540,1978
HIDALGO,IXMIQUILPAN,23,558,9,590,1978
HIDALGO,IXMIQUILPAN,18,526,8,552,1977
HIDALGO,IXMIQUILPAN,21,508,7,536,1849
HIDALGO,IXMIQUILPAN,17,479,14,510,1849
HIDALGO,IXMIQUILPAN,18,466,10,494,1377
HIDALGO,IXMIQUILPAN,15,417,8,440,1376
HIDALGO,IXMIQUILPAN,11,424,4,439,1376
HIDALGO,IXMIQUILPAN,16,390,6,412,1703
HIDALGO,IXMIQUILPAN,9,424,4,437,1702
HIDALGO,IXMIQUILPAN,8,275,4,287,1308
HIDALGO,IXMIQUILPAN,11,295,7,313,1308
HIDALGO,IXMIQUILPAN,6,338,9,353,1515
HIDALGO,IXMIQUILPAN,11,337,9,357,1515
HIDALGO,IXMIQUILPAN,16,342,5,363,1514
HIDALGO,IXMIQUILPAN,8,407,12,427,1481
HIDALGO,IXMIQUILPAN,9,330,5,344,1050
HIDALGO,IXMIQUILPAN,4,343,9,356,1049
HIDALGO,IXMIQUILPAN,27,401,8,436,1895
HIDALGO,IXMIQUILPAN,15,462,14,491,1894
HIDALGO,IXMIQUILPAN,13,463,7,483,1502
HIDALGO,IXMIQUILPAN,15,436,8,459,1502
HIDALGO,IXMIQUILPAN,23,509,8,540,1772
HIDALGO,IXMIQUILPAN,18,486,11,515,1772
HIDALGO,IXMIQUILPAN,17,670,15,702,1840
HIDALGO,IXMIQUILPAN,16,717,12,745,1840
HIDALGO,IXMIQUILPAN,17,425,21,463,1731
HIDALGO,IXMIQUILPAN,9,391,22,422,1731
HIDALGO,IXMIQUILPAN,10,393,12,415,1730
HIDALGO,IXMIQUILPAN,19,386,11,416,1689
HIDALGO,IXMIQUILPAN,8,362,18,388,1688
HIDALGO,IXMIQUILPAN,16,316,5,337,1986
HIDALGO,IXMIQUILPAN,21,278,4,303,1985
HIDALGO,IXMIQUILPAN,16,190,7,213,1636
HIDALGO,IXMIQUILPAN,10,204,5,219,1635
HIDALGO,IXMIQUILPAN,6,189,3,198,1635
HIDALGO,IXMIQUILPAN,14,116,6,136,1535
HIDALGO,IXMIQUILPAN,5,103,3,111,1534
HIDALGO,IXMIQUILPAN,2,98,4,104,1151
HIDALGO,IXMIQUILPAN,11,105,8,124,1151
HIDALGO,IXMIQUILPAN,18,182,14,214,1377
HIDALGO,IXMIQUILPAN,9,155,7,171,1376
HIDALGO,IXMIQUILPAN,1,151,9,161,1376
HIDALGO,IXMIQUILPAN,9,183,4,196,1743
HIDALGO,IXMIQUILPAN,8,169,5,182,1742
HIDALGO,IXMIQUILPAN,11,150,6,167,1507
HIDALGO,IXMIQUILPAN,10,122,3,135,1544
HIDALGO,IXMIQUILPAN,11,110,1,122,1544
HIDALGO,IXMIQUILPAN,13,116,3,132,1544
HIDALGO,IXMIQUILPAN,9,280,3,292,1378
HIDALGO,IXMIQUILPAN,4,263,3,270,1378
HIDALGO,IXMIQUILPAN,12,227,1,240,1377
HIDALGO,IXMIQUILPAN,20,317,0,337,1521
HIDALGO,IXMIQUILPAN,10,323,6,339,1521
HIDALGO,IXMIQUILPAN,13,229,13,255,1492
HIDALGO,IXMIQUILPAN,9,241,8,258,1492
HIDALGO,IXMIQUILPAN,16,252,12,280,1492
HIDALGO,IXMIQUILPAN,7,248,3,258,1339
HIDALGO,IXMIQUILPAN,11,249,10,270,1338
HIDALGO,IXMIQUILPAN,19,351,10,380,1756
HIDALGO,IXMIQUILPAN,13,357,9,379,1755
HIDALGO,IXMIQUILPAN,12,366,9,387,1755
HIDALGO,IXMIQUILPAN,9,413,5,427,1886
HIDALGO,IXMIQUILPAN,13,374,6,393,1886
HIDALGO,IXMIQUILPAN,13,366,8,387,1885
HIDALGO,IXMIQUILPAN,17,541,17,575,1841
HIDALGO,IXMIQUILPAN,23,485,9,517,1841
HIDALGO,IXMIQUILPAN,17,486,10,513,1840
HIDALGO,ACTOPAN,22,294,4,320,1502
HIDALGO,ACTOPAN,14,312,7,333,1501
HIDALGO,ACTOPAN,17,318,2,337,1501
HIDALGO,ACTOPAN,26,363,8,397,1975
HIDALGO,ACTOPAN,20,372,1,393,1975
HIDALGO,ACTOPAN,28,358,5,391,1659
HIDALGO,ACTOPAN,19,397,6,422,1659
HIDALGO,ACTOPAN,32,346,3,381,1739
HIDALGO,ACTOPAN,40,360,4,404,1738
HIDALGO,ACTOPAN,34,377,7,418,1911
HIDALGO,ACTOPAN,23,406,5,434,1910
HIDALGO,ACTOPAN,23,372,1,396,1720
HIDALGO,ACTOPAN,31,383,11,425,1719
HIDALGO,ACTOPAN,29,313,6,348,1448
HIDALGO,ACTOPAN,38,329,6,373,1447
HIDALGO,ACTOPAN,5,222,4,231,1561
HIDALGO,ACTOPAN,4,258,4,266,1561
HIDALGO,ACTOPAN,27,320,5,352,1661
HIDALGO,ACTOPAN,15,259,9,283,1661
HIDALGO,ACTOPAN,8,84,6,98,1020
HIDALGO,ACTOPAN,10,75,6,91,1020
HIDALGO,ACTOPAN,9,219,5,233,1017
HIDALGO,ACTOPAN,17,231,4,252,1016
HIDALGO,ACTOPAN,26,288,3,317,1753
HIDALGO,ACTOPAN,11,312,4,327,1753
HIDALGO,ACTOPAN,9,318,7,334,1870
HIDALGO,ACTOPAN,8,339,2,349,1870
HIDALGO,ACTOPAN,15,324,8,347,1774
HIDALGO,ACTOPAN,18,338,3,359,1774
HIDALGO,ACTOPAN,12,240,6,258,1350
HIDALGO,ACTOPAN,2,226,6,234,1349
HIDALGO,ACTOPAN,11,279,10,300,1581
HIDALGO,ACTOPAN,11,268,7,286,1580
HIDALGO,ACTOPAN,6,271,4,281,1580
HIDALGO,ACTOPAN,7,267,3,277,1580
HIDALGO,ACTOPAN,12,320,6,338,1420
HIDALGO,ACTOPAN,13,320,7,340,1419
HIDALGO,ACTOPAN,23,399,9,431,1698
HIDALGO,ACTOPAN,29,349,11,389,1697
HIDALGO,ACTOPAN,10,285,0,295,1366
HIDALGO,ACTOPAN,15,257,3,275,1365
HIDALGO,ACTOPAN,8,250,6,264,1365
HIDALGO,ACTOPAN,12,209,2,223,1694
HIDALGO,ACTOPAN,13,165,7,185,1693
HIDALGO,ACTOPAN,19,222,6,247,1693
HIDALGO,ACTOPAN,16,231,3,250,1481
HIDALGO,ACTOPAN,17,252,7,276,1481
HIDALGO,ACTOPAN,14,253,7,274,1481
HIDALGO,ACTOPAN,13,123,11,147,1675
HIDALGO,ACTOPAN,10,138,10,158,1675
HIDALGO,ACTOPAN,6,136,3,145,1417
HIDALGO,ACTOPAN,7,172,6,185,1416
HIDALGO,ACTOPAN,10,145,3,158,1416
HIDALGO,ACTOPAN,10,212,9,231,1888
HIDALGO,ACTOPAN,7,240,6,253,1887
HIDALGO,ACTOPAN,11,290,12,313,1811
HIDALGO,ACTOPAN,8,304,9,321,1810
HIDALGO,ACTOPAN,15,242,9,266,1886
HIDALGO,ACTOPAN,10,270,3,283,1885
HIDALGO,ACTOPAN,17,262,5,284,1926
HIDALGO,ACTOPAN,12,330,10,352,1926
HIDALGO,ACTOPAN,5,298,8,311,1971
HIDALGO,ACTOPAN,8,242,5,255,1970
HIDALGO,ACTOPAN,5,165,4,174,1711
HIDALGO,ACTOPAN,6,160,11,177,1711
HIDALGO,ACTOPAN,5,146,1,152,1711
HIDALGO,ACTOPAN,19,570,7,596,1819
HIDALGO,ACTOPAN,24,531,10,565,1819
HIDALGO,ACTOPAN,19,638,8,665,1892
HIDALGO,ACTOPAN,13,595,8,616,1891
HIDALGO,ACTOPAN,17,420,5,442,1319
HIDALGO,ACTOPAN,14,397,2,413,1319
HIDALGO,ACTOPAN,4,338,4,346,1642
HIDALGO,ACTOPAN,4,338,4,346,1642
HIDALGO,ACTOPAN,7,316,7,330,1642
HIDALGO,ACTOPAN,7,430,6,443,1391
HIDALGO,ACTOPAN,17,401,5,423,1391
HIDALGO,ACTOPAN,13,403,10,426,1390
HIDALGO,ACTOPAN,13,357,4,374,1185
HIDALGO,ACTOPAN,10,335,4,349,1184
HIDALGO,ACTOPAN,12,337,0,349,1201
HIDALGO,ACTOPAN,14,315,8,337,1201
HIDALGO,ACTOPAN,14,326,1,341,1333
HIDALGO,ACTOPAN,3,365,0,368,1333
HIDALGO,ACTOPAN,15,369,5,389,1332
HIDALGO,ACTOPAN,17,225,6,248,1662
HIDALGO,ACTOPAN,14,239,8,261,1662
HIDALGO,ACTOPAN,9,195,5,209,1298
HIDALGO,ACTOPAN,9,150,3,162,1298
HIDALGO,ACTOPAN,15,250,3,268,1848
HIDALGO,ACTOPAN,13,239,5,257,1848
HIDALGO,ACTOPAN,23,244,10,277,1847
HIDALGO,ACTOPAN,12,491,14,517,0
HIDALGO,ACTOPAN,7,208,13,228,1485
HIDALGO,ACTOPAN,14,238,14,266,1485
HIDALGO,ACTOPAN,14,231,11,256,1485
HIDALGO,ACTOPAN,25,345,12,382,1951
HIDALGO,ACTOPAN,19,269,5,293,1951
HIDALGO,ACTOPAN,9,151,6,166,1418
HIDALGO,ACTOPAN,8,168,2,178,1418
HIDALGO,ACTOPAN,7,107,5,119,1418
HIDALGO,ACTOPAN,8,98,15,121,1484
HIDALGO,ACTOPAN,17,96,7,120,1484
HIDALGO,ACTOPAN,10,127,11,148,1483
HIDALGO,ACTOPAN,8,226,12,246,1347
HIDALGO,ACTOPAN,9,222,7,238,1347
HIDALGO,ACTOPAN,7,217,3,227,1347
HIDALGO,ACTOPAN,12,205,8,225,1951
HIDALGO,ACTOPAN,15,273,5,293,1951
HIDALGO,ACTOPAN,16,286,10,312,1950
HIDALGO,ACTOPAN,9,213,11,233,1834
HIDALGO,ACTOPAN,19,267,12,298,1834
HIDALGO,ACTOPAN,8,266,5,279,1525
HIDALGO,ACTOPAN,23,245,1,269,1524
HIDALGO,ACTOPAN,15,265,8,288,1524
HIDALGO,ACTOPAN,16,252,7,275,1524
HIDALGO,ACTOPAN,15,322,6,343,1524
HIDALGO,ACTOPAN,15,314,5,334,1524
HIDALGO,ACTOPAN,18,335,4,357,1523
HIDALGO,ACTOPAN,21,363,7,391,1708
HIDALGO,ACTOPAN,27,408,4,439,1707
HIDALGO,ACTOPAN,21,340,3,364,1612
HIDALGO,ACTOPAN,16,322,5,343,1612
HIDALGO,ACTOPAN,26,368,3,397,1714
HIDALGO,ACTOPAN,17,349,4,370,1713
HIDALGO,ACTOPAN,20,358,3,381,1713
HIDALGO,ACTOPAN,17,282,4,303,1225
HIDALGO,ACTOPAN,15,278,4,297,1225
HIDALGO,ACTOPAN,12,292,5,309,1340
HIDALGO,ACTOPAN,8,249,5,262,1339
HIDALGO,ACTOPAN,11,248,7,266,1339
HIDALGO,ACTOPAN,16,347,6,369,1671
HIDALGO,ACTOPAN,24,378,2,404,1671
HIDALGO,ACTOPAN,9,440,4,453,1685
HIDALGO,ACTOPAN,9,393,5,407,1684
HIDALGO,ACTOPAN,10,388,6,404,1684
HIDALGO,ACTOPAN,12,389,4,405,1879
HIDALGO,ACTOPAN,11,328,3,342,1878
HIDALGO,ACTOPAN,11,327,9,347,1107
HIDALGO,ACTOPAN,6,323,4,333,1107
HIDALGO,ACTOPAN,25,338,5,368,1707
HIDALGO,ACTOPAN,13,370,3,386,1707
HIDALGO,ACTOPAN,20,319,11,350,1707
HIDALGO,ACTOPAN,29,311,4,344,1706
HIDALGO,ACTOPAN,12,427,7,446,1519
HIDALGO,ACTOPAN,12,446,8,466,1518
HIDALGO,ACTOPAN,4,391,7,402,1518
HIDALGO,ACTOPAN,5,253,3,261,1601
HIDALGO,ACTOPAN,12,198,5,215,1600
HIDALGO,ACTOPAN,19,374,12,405,1917
HIDALGO,ACTOPAN,14,395,4,413,1917
HIDALGO,ACTOPAN,13,324,5,342,1744
HIDALGO,ACTOPAN,7,289,6,302,1743
HIDALGO,ACTOPAN,10,359,7,376,1866
HIDALGO,ACTOPAN,13,370,9,392,1865
HIDALGO,ACTOPAN,21,381,4,406,1690
HIDALGO,ACTOPAN,21,320,8,349,1689
HIDALGO,ACTOPAN,11,283,7,301,1659
HIDALGO,ACTOPAN,12,266,3,281,1659
HIDALGO,ACTOPAN,12,233,3,248,1851
HIDALGO,ACTOPAN,14,219,1,234,1851
HIDALGO,ACTOPAN,18,250,6,274,1315
HIDALGO,ACTOPAN,22,243,6,271,1315
HIDALGO,ACTOPAN,10,515,5,530,1898
HIDALGO,ACTOPAN,11,483,9,503,1897
HIDALGO,ACTOPAN,16,496,8,520,1763
HIDALGO,ACTOPAN,13,418,6,437,1763
HIDALGO,ACTOPAN,16,472,10,498,1762
HIDALGO,ACTOPAN,10,392,4,406,1662
HIDALGO,ACTOPAN,18,430,0,448,1662
HIDALGO,ACTOPAN,16,422,5,443,1481
HIDALGO,ACTOPAN,18,376,4,398,1481
HIDALGO,ACTOPAN,14,377,3,394,1481
HIDALGO,ACTOPAN,11,354,4,369,1375
HIDALGO,ACTOPAN,12,349,5,366,1374
HIDALGO,ACTOPAN,18,398,5,421,1435
HIDALGO,ACTOPAN,16,410,8,434,1435
HIDALGO,ACTOPAN,7,143,7,157,1096
HIDALGO,ACTOPAN,6,158,10,174,1096
HIDALGO,ACTOPAN,29,240,7,276,1065
HIDALGO,ACTOPAN,19,201,6,226,1064
HIDALGO,ACTOPAN,10,302,7,319,1654
HIDALGO,ACTOPAN,12,254,9,275,1654
HIDALGO,ACTOPAN,11,276,5,292,1653
HIDALGO,ACTOPAN,7,213,6,226,1027
HIDALGO,ACTOPAN,11,203,1,215,1027
HIDALGO,ACTOPAN,6,228,5,239,1357
HIDALGO,ACTOPAN,9,246,3,258,1357
HIDALGO,ACTOPAN,12,256,3,271,1596
HIDALGO,ACTOPAN,15,245,3,263,1596
HIDALGO,ACTOPAN,12,244,2,258,1803
HIDALGO,ACTOPAN,14,286,0,300,1802
HIDALGO,ACTOPAN,16,271,15,302,1619
HIDALGO,ACTOPAN,2,253,5,260,1618
HIDALGO,ACTOPAN,9,290,3,302,1894
HIDALGO,ACTOPAN,16,338,7,361,1893
HIDALGO,ACTOPAN,8,231,3,242,1733
HIDALGO,ACTOPAN,5,279,5,289,1732
HIDALGO,TULANCINGO DE BRAVO,18,141,3,162,1286
HIDALGO,TULANCINGO DE BRAVO,6,103,2,111,1285
HIDALGO,TULANCINGO DE BRAVO,14,125,5,144,1623
HIDALGO,TULANCINGO DE BRAVO,6,99,5,110,1622
HIDALGO,TULANCINGO DE BRAVO,8,118,11,137,1622
HIDALGO,TULANCINGO DE BRAVO,6,98,2,106,1622
HIDALGO,TULANCINGO DE BRAVO,7,76,3,86,1023
HIDALGO,TULANCINGO DE BRAVO,9,92,1,102,1023
HIDALGO,TULANCINGO DE BRAVO,10,118,1,129,1503
HIDALGO,TULANCINGO DE BRAVO,11,165,4,180,1503
HIDALGO,TULANCINGO DE BRAVO,5,105,0,110,1503
HIDALGO,TULANCINGO DE BRAVO,1,77,3,81,1481
HIDALGO,TULANCINGO DE BRAVO,12,100,2,114,1481
HIDALGO,TULANCINGO DE BRAVO,5,89,0,94,1481
HIDALGO,TULANCINGO DE BRAVO,10,115,4,129,1082
HIDALGO,TULANCINGO DE BRAVO,7,120,4,131,1082
HIDALGO,TULANCINGO DE BRAVO,15,297,7,319,1879
HIDALGO,TULANCINGO DE BRAVO,15,320,8,343,1879
HIDALGO,TULANCINGO DE BRAVO,9,153,4,166,1914
HIDALGO,TULANCINGO DE BRAVO,6,196,2,204,1913
HIDALGO,TULANCINGO DE BRAVO,6,32,1,39,1492
HIDALGO,TULANCINGO DE BRAVO,4,38,1,43,1492
HIDALGO,TULANCINGO DE BRAVO,5,187,3,195,1962
HIDALGO,TULANCINGO DE BRAVO,3,158,8,169,1962
HIDALGO,TULANCINGO DE BRAVO,18,149,6,173,1447
HIDALGO,TULANCINGO DE BRAVO,18,169,4,191,1447
HIDALGO,TULANCINGO DE BRAVO,4,182,3,189,1415
HIDALGO,TULANCINGO DE BRAVO,2,180,4,186,1414
HIDALGO,TULANCINGO DE BRAVO,9,182,4,195,1414
HIDALGO,TULANCINGO DE BRAVO,14,117,9,140,1441
HIDALGO,TULANCINGO DE BRAVO,10,105,4,119,1440
HIDALGO,TULANCINGO DE BRAVO,8,119,1,128,1440
HIDALGO,TULANCINGO DE BRAVO,7,327,7,341,1509
HIDALGO,TULANCINGO DE BRAVO,7,256,4,267,1509
HIDALGO,TULANCINGO DE BRAVO,24,174,18,216,1854
HIDALGO,TULANCINGO DE BRAVO,22,165,19,206,1854
HIDALGO,TULANCINGO DE BRAVO,20,178,15,213,1963
HIDALGO,TULANCINGO DE BRAVO,35,249,13,297,1962
HIDALGO,TULANCINGO DE BRAVO,30,227,16,273,1962
HIDALGO,TULANCINGO DE BRAVO,9,206,2,217,1689
HIDALGO,TULANCINGO DE BRAVO,12,268,3,283,1688
HIDALGO,TULANCINGO DE BRAVO,11,324,4,339,1949
HIDALGO,TULANCINGO DE BRAVO,16,301,10,327,1949
HIDALGO,TULANCINGO DE BRAVO,15,239,4,258,1506
HIDALGO,TULANCINGO DE BRAVO,13,254,3,270,1506
HIDALGO,TULANCINGO DE BRAVO,23,227,2,252,1985
HIDALGO,TULANCINGO DE BRAVO,8,272,2,282,1985
HIDALGO,TULANCINGO DE BRAVO,12,252,5,269,1909
HIDALGO,TULANCINGO DE BRAVO,11,206,4,221,1908
HIDALGO,TULANCINGO DE BRAVO,12,261,3,276,1225
HIDALGO,TULANCINGO DE BRAVO,10,262,8,280,1225
HIDALGO,TULANCINGO DE BRAVO,15,166,4,185,1840
HIDALGO,TULANCINGO DE BRAVO,2,155,6,163,1840
HIDALGO,TULANCINGO DE BRAVO,16,247,8,271,1991
HIDALGO,TULANCINGO DE BRAVO,12,181,2,195,1990
HIDALGO,TULANCINGO DE BRAVO,11,212,1,224,1619
HIDALGO,TULANCINGO DE BRAVO,7,225,2,234,1619
HIDALGO,TULANCINGO DE BRAVO,12,224,3,239,1635
HIDALGO,TULANCINGO DE BRAVO,3,271,1,275,1635
HIDALGO,TULANCINGO DE BRAVO,10,297,2,309,1634
HIDALGO,TULANCINGO DE BRAVO,12,162,3,177,1852
HIDALGO,TULANCINGO DE BRAVO,21,166,5,192,1851
HIDALGO,TULANCINGO DE BRAVO,9,387,3,399,1678
HIDALGO,TULANCINGO DE BRAVO,15,353,11,379,1678
HIDALGO,TULANCINGO DE BRAVO,11,233,4,248,1882
HIDALGO,TULANCINGO DE BRAVO,13,200,5,218,1881
HIDALGO,TULANCINGO DE BRAVO,13,638,16,667,1827
HIDALGO,TULANCINGO DE BRAVO,17,611,20,648,1826
HIDALGO,TULANCINGO DE BRAVO,35,360,29,424,1537
HIDALGO,TULANCINGO DE BRAVO,46,397,47,490,1536
HIDALGO,TULANCINGO DE BRAVO,46,354,40,440,1536
HIDALGO,TULANCINGO DE BRAVO,23,386,8,417,1827
HIDALGO,TULANCINGO DE BRAVO,21,384,12,417,1827
HIDALGO,TULANCINGO DE BRAVO,2,350,2,354,1934
HIDALGO,TULANCINGO DE BRAVO,12,299,16,327,1934
HIDALGO,TULANCINGO DE BRAVO,25,479,24,528,1726
HIDALGO,TULANCINGO DE BRAVO,16,542,7,565,1725
HIDALGO,TULANCINGO DE BRAVO,9,122,1,132,1871
HIDALGO,TULANCINGO DE BRAVO,8,142,7,157,1871
HIDALGO,TULANCINGO DE BRAVO,9,167,2,178,1320
HIDALGO,TULANCINGO DE BRAVO,6,229,3,238,1320
HIDALGO,TULANCINGO DE BRAVO,4,130,1,135,1131
HIDALGO,TULANCINGO DE BRAVO,6,191,2,199,1130
HIDALGO,TULANCINGO DE BRAVO,16,219,16,251,1356
HIDALGO,TULANCINGO DE BRAVO,16,234,15,265,1355
HIDALGO,TULANCINGO DE BRAVO,16,257,13,286,1355
HIDALGO,TULANCINGO DE BRAVO,24,284,17,325,1536
HIDALGO,TULANCINGO DE BRAVO,23,336,19,378,1536
HIDALGO,TULANCINGO DE BRAVO,16,213,15,244,1795
HIDALGO,TULANCINGO DE BRAVO,20,295,23,338,1794
HIDALGO,TULANCINGO DE BRAVO,12,269,4,285,1719
HIDALGO,TULANCINGO DE BRAVO,19,274,6,299,1718
HIDALGO,TULANCINGO DE BRAVO,12,367,3,382,1930
HIDALGO,TULANCINGO DE BRAVO,20,344,2,366,1929
HIDALGO,TULANCINGO DE BRAVO,18,282,3,303,1459
HIDALGO,TULANCINGO DE BRAVO,10,273,3,286,1458
HIDALGO,TULANCINGO DE BRAVO,10,223,1,234,1775
HIDALGO,TULANCINGO DE BRAVO,15,183,2,200,1775
HIDALGO,TULANCINGO DE BRAVO,200,11,15,226,1774
HIDALGO,TULANCINGO DE BRAVO,17,238,1,256,1724
HIDALGO,TULANCINGO DE BRAVO,17,222,2,241,1724
HIDALGO,TULANCINGO DE BRAVO,20,223,4,247,1724
HIDALGO,TULANCINGO DE BRAVO,12,241,2,255,1724
HIDALGO,TULANCINGO DE BRAVO,7,183,6,196,1352
HIDALGO,TULANCINGO DE BRAVO,0,113,2,115,1352
HIDALGO,TULANCINGO DE BRAVO,6,134,2,142,1351
HIDALGO,TULANCINGO DE BRAVO,8,181,11,200,1304
HIDALGO,TULANCINGO DE BRAVO,13,228,13,254,1304
HIDALGO,TULANCINGO DE BRAVO,19,323,10,352,1916
HIDALGO,TULANCINGO DE BRAVO,16,359,10,385,1915
HIDALGO,TULANCINGO DE BRAVO,16,269,20,305,1849
HIDALGO,TULANCINGO DE BRAVO,24,267,18,309,1848
HIDALGO,TULANCINGO DE BRAVO,17,237,12,266,1052
HIDALGO,TULANCINGO DE BRAVO,17,263,12,292,1051
HIDALGO,TULANCINGO DE BRAVO,13,279,3,295,1714
HIDALGO,TULANCINGO DE BRAVO,12,247,4,263,1714
HIDALGO,TULANCINGO DE BRAVO,7,213,6,226,1714
HIDALGO,TULANCINGO DE BRAVO,2,254,0,256,1714
HIDALGO,TULANCINGO DE BRAVO,10,276,3,289,1714
HIDALGO,TULANCINGO DE BRAVO,8,262,3,273,1714
HIDALGO,TULANCINGO DE BRAVO,13,231,2,246,1438
HIDALGO,TULANCINGO DE BRAVO,6,235,8,249,1438
HIDALGO,TULANCINGO DE BRAVO,21,212,9,242,1437
HIDALGO,TULANCINGO DE BRAVO,16,299,4,319,1765
HIDALGO,TULANCINGO DE BRAVO,16,289,5,310,1764
HIDALGO,TULANCINGO DE BRAVO,23,298,3,324,1764
HIDALGO,TULANCINGO DE BRAVO,17,238,2,257,1396
HIDALGO,TULANCINGO DE BRAVO,19,271,0,290,1395
HIDALGO,TULANCINGO DE BRAVO,20,239,2,261,1395
HIDALGO,TULANCINGO DE BRAVO,25,289,1,315,1843
HIDALGO,TULANCINGO DE BRAVO,28,313,2,343,1843
HIDALGO,TULANCINGO DE BRAVO,19,256,1,276,1619
HIDALGO,TULANCINGO DE BRAVO,18,270,2,290,1618
HIDALGO,TULANCINGO DE BRAVO,30,341,7,378,1972
HIDALGO,TULANCINGO DE BRAVO,28,355,5,388,1972
HIDALGO,TULANCINGO DE BRAVO,6,271,5,282,1622
HIDALGO,TULANCINGO DE BRAVO,7,255,4,266,1621
HIDALGO,TULANCINGO DE BRAVO,15,246,3,264,1612
HIDALGO,TULANCINGO DE BRAVO,9,208,4,221,1611
HIDALGO,TULANCINGO DE BRAVO,15,208,7,230,1611
HIDALGO,TULANCINGO DE BRAVO,8,225,3,236,1611
HIDALGO,TULANCINGO DE BRAVO,7,266,6,279,1539
HIDALGO,TULANCINGO DE BRAVO,17,235,3,255,1539
HIDALGO,TULANCINGO DE BRAVO,19,253,5,277,1710
HIDALGO,TULANCINGO DE BRAVO,18,270,2,290,1709
HIDALGO,TULANCINGO DE BRAVO,19,287,3,309,1625
HIDALGO,TULANCINGO DE BRAVO,20,294,3,317,1624
HIDALGO,TULANCINGO DE BRAVO,15,280,1,296,1823
HIDALGO,TULANCINGO DE BRAVO,23,285,2,310,1823
HIDALGO,TULANCINGO DE BRAVO,17,282,1,300,1923
HIDALGO,TULANCINGO DE BRAVO,22,255,8,285,1923
HIDALGO,TULANCINGO DE BRAVO,13,257,7,277,1394
HIDALGO,TULANCINGO DE BRAVO,16,273,3,292,1393
HIDALGO,TULANCINGO DE BRAVO,2,232,8,242,1393
HIDALGO,TULANCINGO DE BRAVO,8,259,9,276,1777
HIDALGO,TULANCINGO DE BRAVO,10,283,4,297,1777
HIDALGO,TULANCINGO DE BRAVO,13,232,6,251,1777
HIDALGO,TULANCINGO DE BRAVO,10,234,3,247,1192
HIDALGO,TULANCINGO DE BRAVO,6,233,1,240,1191
HIDALGO,TULANCINGO DE BRAVO,15,236,2,253,1477
HIDALGO,TULANCINGO DE BRAVO,13,267,4,284,1476
HIDALGO,TULANCINGO DE BRAVO,15,320,2,337,1726
HIDALGO,TULANCINGO DE BRAVO,23,306,3,332,1726
HIDALGO,TULANCINGO DE BRAVO,26,319,2,347,1791
HIDALGO,TULANCINGO DE BRAVO,24,264,3,291,1791
HIDALGO,TULANCINGO DE BRAVO,23,303,1,327,1576
HIDALGO,TULANCINGO DE BRAVO,0,265,2,267,1576
HIDALGO,TULANCINGO DE BRAVO,20,268,1,289,1575
HIDALGO,TULANCINGO DE BRAVO,15,339,3,357,1763
HIDALGO,TULANCINGO DE BRAVO,18,305,1,324,1762
HIDALGO,TULANCINGO DE BRAVO,23,324,1,348,1762
HIDALGO,TULANCINGO DE BRAVO,14,232,0,246,1605
HIDALGO,TULANCINGO DE BRAVO,5,211,4,220,1604
HIDALGO,TULANCINGO DE BRAVO,7,173,3,183,1604
HIDALGO,TULANCINGO DE BRAVO,16,233,13,262,1966
HIDALGO,TULANCINGO DE BRAVO,11,246,10,267,1966
HIDALGO,TULANCINGO DE BRAVO,16,188,6,210,1279
HIDALGO,TULANCINGO DE BRAVO,10,158,2,170,1279
HIDALGO,TULANCINGO DE BRAVO,13,318,4,335,1587
HIDALGO,TULANCINGO DE BRAVO,21,307,4,332,1586
HIDALGO,TULANCINGO DE BRAVO,12,302,0,314,1586
HIDALGO,TULANCINGO DE BRAVO,11,189,2,202,1493
HIDALGO,TULANCINGO DE BRAVO,7,163,4,174,1493
HIDALGO,TULANCINGO DE BRAVO,12,178,2,192,1493
HIDALGO,TULANCINGO DE BRAVO,13,172,6,191,1439
HIDALGO,TULANCINGO DE BRAVO,14,222,6,242,1438
HIDALGO,TULANCINGO DE BRAVO,9,253,1,263,1597
HIDALGO,TULANCINGO DE BRAVO,13,233,4,250,1597
HIDALGO,TULANCINGO DE BRAVO,16,251,5,272,1597
HIDALGO,TULANCINGO DE BRAVO,17,245,1,263,1597
HIDALGO,TULANCINGO DE BRAVO,14,247,9,270,1596
HIDALGO,TULANCINGO DE BRAVO,75,1132,6,1213,0
HIDALGO,TULA DE ALLENDE,12,294,1,307,1372
HIDALGO,TULA DE ALLENDE,12,238,3,253,1372
HIDALGO,TULA DE ALLENDE,19,273,3,295,1371
HIDALGO,TULA DE ALLENDE,15,344,3,362,1531
HIDALGO,TULA DE ALLENDE,15,322,6,343,1530
HIDALGO,TULA DE ALLENDE,17,471,8,496,1901
HIDALGO,TULA DE ALLENDE,21,478,2,501,1901
HIDALGO,TULA DE ALLENDE,22,493,5,520,1911
HIDALGO,TULA DE ALLENDE,26,559,4,589,1911
HIDALGO,TULA DE ALLENDE,20,259,3,282,1254
HIDALGO,TULA DE ALLENDE,16,270,5,291,1253
HIDALGO,TULA DE ALLENDE,12,383,4,399,1418
HIDALGO,TULA DE ALLENDE,16,391,6,413,1418
HIDALGO,TULA DE ALLENDE,19,362,5,386,1417
HIDALGO,TULA DE ALLENDE,8,317,3,328,1475
HIDALGO,TULA DE ALLENDE,22,309,2,333,1474
HIDALGO,TULA DE ALLENDE,8,297,2,307,1474
HIDALGO,TULA DE ALLENDE,12,366,4,382,1462
HIDALGO,TULA DE ALLENDE,12,335,4,351,1462
HIDALGO,TULA DE ALLENDE,9,352,3,364,1461
HIDALGO,TULA DE ALLENDE,9,317,3,329,1589
HIDALGO,TULA DE ALLENDE,19,326,1,346,1589
HIDALGO,TULA DE ALLENDE,7,294,2,303,1589
HIDALGO,TULA DE ALLENDE,18,272,3,293,1359
HIDALGO,TULA DE ALLENDE,9,280,1,290,1359
HIDALGO,TULA DE ALLENDE,14,255,3,272,1359
HIDALGO,TULA DE ALLENDE,6,151,1,158,1494
HIDALGO,TULA DE ALLENDE,11,124,6,141,1494
HIDALGO,TULA DE ALLENDE,11,131,1,143,1493
HIDALGO,TULA DE ALLENDE,4,96,0,100,1721
HIDALGO,TULA DE ALLENDE,9,90,0,99,1721
HIDALGO,TULA DE ALLENDE,8,103,1,112,1720
HIDALGO,TULA DE ALLENDE,7,114,1,122,1720
HIDALGO,TULA DE ALLENDE,11,110,0,121,1720
HIDALGO,TULA DE ALLENDE,11,97,0,108,1720
HIDALGO,TULA DE ALLENDE,16,344,6,366,1506
HIDALGO,TULA DE ALLENDE,12,374,1,387,1506
HIDALGO,TULA DE ALLENDE,22,375,0,397,1506
HIDALGO,TULA DE ALLENDE,9,172,6,187,1650
HIDALGO,TULA DE ALLENDE,14,127,4,145,1650
HIDALGO,TULA DE ALLENDE,11,159,0,170,1650
HIDALGO,TULA DE ALLENDE,11,201,5,217,1639
HIDALGO,TULA DE ALLENDE,12,114,3,129,1639
HIDALGO,TULA DE ALLENDE,14,199,3,216,1639
HIDALGO,TULA DE ALLENDE,3,128,2,133,1340
HIDALGO,TULA DE ALLENDE,9,169,2,180,1340
HIDALGO,TULA DE ALLENDE,15,134,2,151,1340
HIDALGO,TULA DE ALLENDE,8,112,1,121,1441
HIDALGO,TULA DE ALLENDE,0,122,2,124,1441
HIDALGO,TULA DE ALLENDE,24,133,2,159,1440
HIDALGO,TULA DE ALLENDE,7,154,3,164,1414
HIDALGO,TULA DE ALLENDE,14,144,3,161,1414
HIDALGO,TULA DE ALLENDE,12,151,4,167,1414
HIDALGO,TULA DE ALLENDE,20,272,6,298,1992
HIDALGO,TULA DE ALLENDE,26,223,11,260,1991
HIDALGO,TULA DE ALLENDE,7,89,3,99,1714
HIDALGO,TULA DE ALLENDE,14,85,4,103,1713
HIDALGO,TULA DE ALLENDE,19,221,6,246,1890
HIDALGO,TULA DE ALLENDE,15,242,8,265,1889
HIDALGO,TULA DE ALLENDE,18,231,7,256,1422
HIDALGO,TULA DE ALLENDE,10,249,4,263,1422
HIDALGO,TULA DE ALLENDE,20,228,6,254,1421
HIDALGO,TULA DE ALLENDE,11,197,11,219,1970
HIDALGO,TULA DE ALLENDE,17,191,10,218,1969
HIDALGO,TULA DE ALLENDE,12,190,5,207,1818
HIDALGO,TULA DE ALLENDE,11,186,14,211,1817
HIDALGO,TULA DE ALLENDE,19,117,2,138,1430
HIDALGO,TULA DE ALLENDE,16,131,7,154,1430
HIDALGO,TULA DE ALLENDE,19,155,7,181,1429
HIDALGO,TULA DE ALLENDE,25,210,9,244,1797
HIDALGO,TULA DE ALLENDE,42,251,15,308,1796
HIDALGO,TULA DE ALLENDE,18,103,4,125,1914
HIDALGO,TULA DE ALLENDE,13,125,8,146,1913
HIDALGO,TULA DE ALLENDE,14,288,1,303,1603
HIDALGO,TULA DE ALLENDE,12,305,1,318,1602
HIDALGO,TULA DE ALLENDE,8,331,0,339,1602
HIDALGO,TULA DE ALLENDE,12,256,2,270,1591
HIDALGO,TULA DE ALLENDE,6,286,0,292,1591
HIDALGO,TULA DE ALLENDE,12,265,2,279,1591
HIDALGO,TULA DE ALLENDE,9,379,3,391,1570
HIDALGO,TULA DE ALLENDE,19,342,2,363,1569
HIDALGO,TULA DE ALLENDE,3,357,2,362,1569
HIDALGO,TULA DE ALLENDE,17,318,6,341,1536
HIDALGO,TULA DE ALLENDE,20,316,4,340,1535
HIDALGO,TULA DE ALLENDE,17,293,3,313,1535
HIDALGO,TULA DE ALLENDE,8,404,1,413,1673
HIDALGO,TULA DE ALLENDE,8,338,3,349,1673
HIDALGO,TULA DE ALLENDE,11,375,3,389,1673
HIDALGO,TULA DE ALLENDE,14,273,0,287,1516
HIDALGO,TULA DE ALLENDE,17,256,1,274,1516
HIDALGO,TULA DE ALLENDE,18,324,3,345,1516
HIDALGO,TULA DE ALLENDE,30,423,6,459,1970
HIDALGO,TULA DE ALLENDE,22,475,4,501,1970
HIDALGO,TULA DE ALLENDE,12,683,18,713,1894
HIDALGO,TULA DE ALLENDE,29,708,0,737,1893
HIDALGO,TULA DE ALLENDE,16,307,3,326,1742
HIDALGO,TULA DE ALLENDE,16,335,5,356,1742
HIDALGO,TULA DE ALLENDE,9,287,3,299,1741
HIDALGO,TULA DE ALLENDE,18,361,7,386,1699
HIDALGO,TULA DE ALLENDE,22,333,2,357,1699
HIDALGO,TULA DE ALLENDE,15,334,8,357,1589
HIDALGO,TULA DE ALLENDE,25,350,6,381,1588
HIDALGO,TULA DE ALLENDE,23,293,7,323,1588
HIDALGO,TULA DE ALLENDE,12,426,7,445,1707
HIDALGO,TULA DE ALLENDE,15,291,3,309,1707
HIDALGO,TULA DE ALLENDE,15,317,5,337,1707
HIDALGO,TULA DE ALLENDE,10,320,10,340,1698
HIDALGO,TULA DE ALLENDE,10,303,9,322,1698
HIDALGO,TULA DE ALLENDE,9,114,8,131,1634
HIDALGO,TULA DE ALLENDE,13,128,2,143,1633
HIDALGO,TULA DE ALLENDE,17,248,8,273,1943
HIDALGO,TULA DE ALLENDE,25,225,16,266,1943
HIDALGO,TULA DE ALLENDE,15,191,6,212,1428
HIDALGO,TULA DE ALLENDE,15,214,4,233,1427
HIDALGO,TULA DE ALLENDE,7,246,6,259,1427
HIDALGO,TULA DE ALLENDE,10,292,8,310,1918
HIDALGO,TULA DE ALLENDE,10,263,9,282,1917
HIDALGO,TULA DE ALLENDE,15,338,1,354,1373
HIDALGO,TULA DE ALLENDE,5,323,6,334,1373
HIDALGO,TULA DE ALLENDE,7,346,1,354,1372
HIDALGO,TULA DE ALLENDE,12,385,1,398,1509
HIDALGO,TULA DE ALLENDE,12,396,8,416,1509
HIDALGO,TULA DE ALLENDE,8,416,4,428,1509
HIDALGO,TULA DE ALLENDE,13,336,1,350,1425
HIDALGO,TULA DE ALLENDE,14,291,1,306,1424
HIDALGO,TULA DE ALLENDE,16,322,3,341,1424
HIDALGO,TULA DE ALLENDE,20,404,5,429,1585
HIDALGO,TULA DE ALLENDE,15,334,3,352,1584
HIDALGO,TULA DE ALLENDE,15,311,0,326,1522
HIDALGO,TULA DE ALLENDE,10,304,5,319,1522
HIDALGO,TULA DE ALLENDE,9,302,4,315,1484
HIDALGO,TULA DE ALLENDE,15,349,4,368,1484
HIDALGO,TULA DE ALLENDE,27,395,4,426,1969
HIDALGO,TULA DE ALLENDE,19,454,4,477,1969
HIDALGO,TULA DE ALLENDE,16,383,9,408,1641
HIDALGO,TULA DE ALLENDE,16,353,0,369,1641
HIDALGO,TULA DE ALLENDE,10,296,1,307,1543
HIDALGO,TULA DE ALLENDE,8,268,9,285,1543
HIDALGO,TULA DE ALLENDE,11,318,1,330,1542
HIDALGO,TULA DE ALLENDE,5,317,9,331,1331
HIDALGO,TULA DE ALLENDE,9,278,4,291,1331
HIDALGO,TULA DE ALLENDE,10,309,4,323,1331
HIDALGO,TULA DE ALLENDE,22,422,5,449,1707
HIDALGO,TULA DE ALLENDE,27,390,6,423,1707
HIDALGO,TULA DE ALLENDE,14,361,2,377,1545
HIDALGO,TULA DE ALLENDE,16,385,4,405,1544
HIDALGO,TULA DE ALLENDE,16,317,0,333,1544
HIDALGO,TULA DE ALLENDE,25,429,7,461,1860
HIDALGO,TULA DE ALLENDE,12,443,6,461,1859
HIDALGO,TULA DE ALLENDE,11,409,10,430,1742
HIDALGO,TULA DE ALLENDE,14,486,7,507,1742
HIDALGO,TULA DE ALLENDE,10,400,3,413,1573
HIDALGO,TULA DE ALLENDE,5,396,6,407,1573
HIDALGO,TULA DE ALLENDE,19,392,3,414,1702
HIDALGO,TULA DE ALLENDE,18,425,2,445,1702
HIDALGO,TULA DE ALLENDE,6,343,6,355,1803
HIDALGO,TULA DE ALLENDE,0,330,0,330,1803
HIDALGO,TULA DE ALLENDE,23,359,2,384,1673
HIDALGO,TULA DE ALLENDE,23,357,3,383,1673
HIDALGO,TULA DE ALLENDE,22,301,2,325,1576
HIDALGO,TULA DE ALLENDE,24,287,2,313,1575
HIDALGO,TULA DE ALLENDE,13,329,2,344,1429
HIDALGO,TULA DE ALLENDE,21,305,2,328,1429
HIDALGO,TULA DE ALLENDE,68,1111,5,1184,0
HIDALGO,TULA DE ALLENDE,17,379,3,399,1794
HIDALGO,TULA DE ALLENDE,12,381,2,395,1794
HIDALGO,TULA DE ALLENDE,9,376,9,394,1705
HIDALGO,TULA DE ALLENDE,11,345,5,361,1704
HIDALGO,TULA DE ALLENDE,16,335,2,353,1686
HIDALGO,TULA DE ALLENDE,15,326,5,346,1686
HIDALGO,TULA DE ALLENDE,0,305,11,316,1650
HIDALGO,TULA DE ALLENDE,20,354,3,377,1650
HIDALGO,TULA DE ALLENDE,18,251,5,274,1463
HIDALGO,TULA DE ALLENDE,14,300,6,320,1462
HIDALGO,TULA DE ALLENDE,9,218,3,230,1571
HIDALGO,TULA DE ALLENDE,5,226,3,234,1571
HIDALGO,TULA DE ALLENDE,5,231,1,237,1571
HIDALGO,TULA DE ALLENDE,8,210,8,226,1476
HIDALGO,TULA DE ALLENDE,11,258,3,272,1475
HIDALGO,TULA DE ALLENDE,10,238,5,253,1475
HIDALGO,TULA DE ALLENDE,16,302,4,322,1600
HIDALGO,TULA DE ALLENDE,20,293,8,321,1600
HIDALGO,TULA DE ALLENDE,14,330,3,347,1794
HIDALGO,TULA DE ALLENDE,16,337,4,357,1794
HIDALGO,TULA DE ALLENDE,14,361,6,381,1794
HIDALGO,TULA DE ALLENDE,7,279,3,289,1225
HIDALGO,TULA DE ALLENDE,23,290,1,314,1224
HIDALGO,TULA DE ALLENDE,27,464,1,492,1844
HIDALGO,TULA DE ALLENDE,22,468,2,492,1844
HIDALGO,TULA DE ALLENDE,10,317,2,329,1355
HIDALGO,TULA DE ALLENDE,14,262,3,279,1354
HIDALGO,TULA DE ALLENDE,12,256,7,275,1354
HIDALGO,TULA DE ALLENDE,6,310,0,316,1609
HIDALGO,TULA DE ALLENDE,18,282,0,300,1609
HIDALGO,TULA DE ALLENDE,14,270,4,288,1608
HIDALGO,TULA DE ALLENDE,0,334,4,338,1485
HIDALGO,TULA DE ALLENDE,8,315,0,323,1485
HIDALGO,TULA DE ALLENDE,19,298,3,320,1484
HIDALGO,TULA DE ALLENDE,22,354,3,379,1760
HIDALGO,TULA DE ALLENDE,17,340,4,361,1759
HIDALGO,TULA DE ALLENDE,22,345,6,373,1759
HIDALGO,TULA DE ALLENDE,16,304,16,336,1593
HIDALGO,TULA DE ALLENDE,15,307,3,325,1592
HIDALGO,TULA DE ALLENDE,15,420,5,440,1882
HIDALGO,TULA DE ALLENDE,22,414,1,437,1881
HIDALGO,TULA DE ALLENDE,12,395,4,411,1675
HIDALGO,TULA DE ALLENDE,20,349,0,369,1674
HIDALGO,TULA DE ALLENDE,14,363,5,382,1770
HIDALGO,TULA DE ALLENDE,31,332,7,370,1769
HIDALGO,TULA DE ALLENDE,13,318,8,339,1769
HIDALGO,PACHUCA DE SOTO,14,282,3,299,1547
HIDALGO,PACHUCA DE SOTO,16,295,7,318,1547
HIDALGO,PACHUCA DE SOTO,21,290,4,315,1547
HIDALGO,PACHUCA DE SOTO,11,242,3,256,1640
HIDALGO,PACHUCA DE SOTO,16,260,5,281,1639
HIDALGO,PACHUCA DE SOTO,18,335,3,356,1596
HIDALGO,PACHUCA DE SOTO,21,350,8,379,1596
HIDALGO,PACHUCA DE SOTO,21,305,3,329,1796
HIDALGO,PACHUCA DE SOTO,1,318,5,324,1796
HIDALGO,PACHUCA DE SOTO,13,313,1,327,1796
HIDALGO,PACHUCA DE SOTO,14,282,4,300,1796
HIDALGO,PACHUCA DE SOTO,11,293,6,310,1795
HIDALGO,PACHUCA DE SOTO,0,284,3,287,1795
HIDALGO,PACHUCA DE SOTO,17,308,5,330,1795
HIDALGO,PACHUCA DE SOTO,26,344,3,373,1729
HIDALGO,PACHUCA DE SOTO,37,357,1,395,1729
HIDALGO,PACHUCA DE SOTO,27,375,1,403,1729
HIDALGO,PACHUCA DE SOTO,13,277,3,293,1425
HIDALGO,PACHUCA DE SOTO,22,318,10,350,1425
HIDALGO,PACHUCA DE SOTO,17,279,4,300,1424
HIDALGO,PACHUCA DE SOTO,20,265,1,286,1541
HIDALGO,PACHUCA DE SOTO,19,250,3,272,1540
HIDALGO,PACHUCA DE SOTO,11,268,6,285,1646
HIDALGO,PACHUCA DE SOTO,11,260,4,275,1645
HIDALGO,PACHUCA DE SOTO,14,265,3,282,1900
HIDALGO,PACHUCA DE SOTO,13,297,5,315,1899
HIDALGO,PACHUCA DE SOTO,34,305,4,343,1919
HIDALGO,PACHUCA DE SOTO,41,333,4,378,1919
HIDALGO,PACHUCA DE SOTO,35,443,8,486,1808
HIDALGO,PACHUCA DE SOTO,32,410,3,445,1807
HIDALGO,PACHUCA DE SOTO,20,327,5,352,1494
HIDALGO,PACHUCA DE SOTO,26,312,3,341,1493
HIDALGO,PACHUCA DE SOTO,24,297,2,323,1493
HIDALGO,PACHUCA DE SOTO,34,418,2,454,1961
HIDALGO,PACHUCA DE SOTO,37,385,4,426,1961
HIDALGO,PACHUCA DE SOTO,32,356,8,396,1961
HIDALGO,PACHUCA DE SOTO,30,357,4,391,1961
HIDALGO,PACHUCA DE SOTO,52,361,2,415,1961
HIDALGO,PACHUCA DE SOTO,32,401,3,436,1789
HIDALGO,PACHUCA DE SOTO,32,392,3,427,1788
HIDALGO,PACHUCA DE SOTO,25,335,2,362,1633
HIDALGO,PACHUCA DE SOTO,35,295,4,334,1633
HIDALGO,PACHUCA DE SOTO,26,323,1,350,1633
HIDALGO,PACHUCA DE SOTO,37,302,1,340,1526
HIDALGO,PACHUCA DE SOTO,16,307,6,329,1525
HIDALGO,PACHUCA DE SOTO,20,363,5,388,1646
HIDALGO,PACHUCA DE SOTO,15,323,4,342,1645
HIDALGO,PACHUCA DE SOTO,21,331,6,358,1645
HIDALGO,PACHUCA DE SOTO,24,357,5,386,1909
HIDALGO,PACHUCA DE SOTO,18,407,7,432,1909
HIDALGO,PACHUCA DE SOTO,27,274,2,303,1539
HIDALGO,PACHUCA DE SOTO,13,273,2,288,1539
HIDALGO,PACHUCA DE SOTO,16,286,4,306,1539
HIDALGO,PACHUCA DE SOTO,33,402,4,439,1913
HIDALGO,PACHUCA DE SOTO,24,384,1,409,1912
HIDALGO,PACHUCA DE SOTO,18,220,4,242,1016
HIDALGO,PACHUCA DE SOTO,13,187,3,203,1015
HIDALGO,PACHUCA DE SOTO,31,442,5,478,1801
HIDALGO,PACHUCA DE SOTO,28,450,0,478,1801
HIDALGO,PACHUCA DE SOTO,22,371,1,394,1795
HIDALGO,PACHUCA DE SOTO,17,325,2,344,1795
HIDALGO,PACHUCA DE SOTO,24,358,3,385,1795
HIDALGO,PACHUCA DE SOTO,19,299,2,320,1764
HIDALGO,PACHUCA DE SOTO,17,270,3,290,1763
HIDALGO,PACHUCA DE SOTO,20,265,3,288,1763
HIDALGO,PACHUCA DE SOTO,19,301,8,328,1763
HIDALGO,PACHUCA DE SOTO,20,269,3,292,1763
HIDALGO,PACHUCA DE SOTO,27,283,0,310,1763
HIDALGO,PACHUCA DE SOTO,19,265,3,287,1763
HIDALGO,PACHUCA DE SOTO,17,314,1,332,1763
HIDALGO,PACHUCA DE SOTO,26,314,5,345,1312
HIDALGO,PACHUCA DE SOTO,10,273,4,287,1312
HIDALGO,PACHUCA DE SOTO,15,205,0,220,1026
HIDALGO,PACHUCA DE SOTO,10,203,1,214,1026
HIDALGO,PACHUCA DE SOTO,24,219,4,247,1385
HIDALGO,PACHUCA DE SOTO,20,220,3,243,1384
HIDALGO,PACHUCA DE SOTO,23,288,3,314,1732
HIDALGO,PACHUCA DE SOTO,10,267,3,280,1732
HIDALGO,PACHUCA DE SOTO,21,267,4,292,1731
HIDALGO,PACHUCA DE SOTO,16,274,3,293,1731
HIDALGO,PACHUCA DE SOTO,16,244,3,263,1409
HIDALGO,PACHUCA DE SOTO,12,232,1,245,1409
HIDALGO,PACHUCA DE SOTO,17,275,2,294,1409
HIDALGO,PACHUCA DE SOTO,17,288,9,314,1755
HIDALGO,PACHUCA DE SOTO,17,252,7,276,1754
HIDALGO,PACHUCA DE SOTO,19,264,6,289,1470
HIDALGO,PACHUCA DE SOTO,19,240,4,263,1469
HIDALGO,PACHUCA DE SOTO,22,149,1,172,1495
HIDALGO,PACHUCA DE SOTO,22,132,0,154,1494
HIDALGO,PACHUCA DE SOTO,30,247,2,279,1781
HIDALGO,PACHUCA DE SOTO,28,296,1,325,1781
HIDALGO,PACHUCA DE SOTO,32,289,0,321,1780
HIDALGO,PACHUCA DE SOTO,24,286,0,310,1780
HIDALGO,PACHUCA DE SOTO,32,283,4,319,1780
HIDALGO,PACHUCA DE SOTO,14,243,8,265,1561
HIDALGO,PACHUCA DE SOTO,9,216,5,230,1560
HIDALGO,PACHUCA DE SOTO,12,249,10,271,1560
HIDALGO,PACHUCA DE SOTO,34,390,2,426,1948
HIDALGO,PACHUCA DE SOTO,37,388,6,431,1947
HIDALGO,PACHUCA DE SOTO,25,267,5,297,1481
HIDALGO,PACHUCA DE SOTO,24,276,3,303,1481
HIDALGO,PACHUCA DE SOTO,32,278,5,315,1481
HIDALGO,PACHUCA DE SOTO,35,286,3,324,1813
HIDALGO,PACHUCA DE SOTO,32,295,6,333,1812
HIDALGO,PACHUCA DE SOTO,22,276,1,299,1419
HIDALGO,PACHUCA DE SOTO,24,309,0,333,1419
HIDALGO,PACHUCA DE SOTO,27,288,3,318,1418
HIDALGO,PACHUCA DE SOTO,108,1833,13,1954,0
HIDALGO,PACHUCA DE SOTO,29,311,2,342,1566
HIDALGO,PACHUCA DE SOTO,33,287,0,320,1566
HIDALGO,PACHUCA DE SOTO,15,289,1,305,1912
HIDALGO,PACHUCA DE SOTO,29,291,2,322,1912
HIDALGO,PACHUCA DE SOTO,37,283,2,322,1911
HIDALGO,PACHUCA DE SOTO,29,275,1,305,1754
HIDALGO,PACHUCA DE SOTO,30,265,5,300,1753
HIDALGO,PACHUCA DE SOTO,24,282,4,310,1753
HIDALGO,PACHUCA DE SOTO,25,284,4,313,1753
HIDALGO,PACHUCA DE SOTO,19,281,2,302,1753
HIDALGO,PACHUCA DE SOTO,28,356,8,392,1880
HIDALGO,PACHUCA DE SOTO,24,353,0,377,1880
HIDALGO,PACHUCA DE SOTO,25,361,0,386,1880
HIDALGO,PACHUCA DE SOTO,6,302,5,313,1479
HIDALGO,PACHUCA DE SOTO,23,247,10,280,1479
HIDALGO,PACHUCA DE SOTO,13,308,3,324,1694
HIDALGO,PACHUCA DE SOTO,9,278,3,290,1694
HIDALGO,PACHUCA DE SOTO,21,271,2,294,1694
HIDALGO,PACHUCA DE SOTO,12,298,4,314,1694
HIDALGO,PACHUCA DE SOTO,24,248,1,273,1875
HIDALGO,PACHUCA DE SOTO,23,265,1,289,1875
HIDALGO,PACHUCA DE SOTO,28,262,1,291,1874
HIDALGO,PACHUCA DE SOTO,28,356,7,391,1696
HIDALGO,PACHUCA DE SOTO,15,334,2,351,1695
HIDALGO,PACHUCA DE SOTO,19,366,3,388,1695
HIDALGO,PACHUCA DE SOTO,36,283,4,323,1888
HIDALGO,PACHUCA DE SOTO,34,262,2,298,1888
HIDALGO,PACHUCA DE SOTO,46,263,4,313,1887
HIDALGO,PACHUCA DE SOTO,23,253,0,276,1887
HIDALGO,PACHUCA DE SOTO,26,265,0,291,1887
HIDALGO,PACHUCA DE SOTO,21,307,1,329,1887
HIDALGO,PACHUCA DE SOTO,33,294,3,330,1688
HIDALGO,PACHUCA DE SOTO,21,225,3,249,1688
HIDALGO,PACHUCA DE SOTO,19,324,5,348,1687
HIDALGO,PACHUCA DE SOTO,24,232,2,258,1621
HIDALGO,PACHUCA DE SOTO,15,253,4,272,1620
HIDALGO,PACHUCA DE SOTO,34,258,4,296,1949
HIDALGO,PACHUCA DE SOTO,35,281,12,328,1948
HIDALGO,PACHUCA DE SOTO,22,199,0,221,1405
HIDALGO,PACHUCA DE SOTO,14,203,0,217,1404
HIDALGO,PACHUCA DE SOTO,10,277,3,290,1621
HIDALGO,PACHUCA DE SOTO,18,247,6,271,1621
HIDALGO,PACHUCA DE SOTO,22,264,4,290,1621
HIDALGO,PACHUCA DE SOTO,14,219,2,235,1885
HIDALGO,PACHUCA DE SOTO,14,241,1,256,1885
HIDALGO,PACHUCA DE SOTO,12,218,3,233,1885
HIDALGO,PACHUCA DE SOTO,20,212,0,232,1885
HIDALGO,PACHUCA DE SOTO,21,221,2,244,1560
HIDALGO,PACHUCA DE SOTO,19,209,3,231,1560
HIDALGO,PACHUCA DE SOTO,21,230,3,254,1560
HIDALGO,PACHUCA DE SOTO,18,287,3,308,1522
HIDALGO,PACHUCA DE SOTO,18,302,2,322,1522
HIDALGO,PACHUCA DE SOTO,20,284,0,304,1802
HIDALGO,PACHUCA DE SOTO,24,321,5,350,1802
HIDALGO,PACHUCA DE SOTO,19,323,3,345,1801
HIDALGO,PACHUCA DE SOTO,22,236,4,262,1779
HIDALGO,PACHUCA DE SOTO,11,209,0,220,1779
HIDALGO,PACHUCA DE SOTO,18,237,1,256,1779
HIDALGO,PACHUCA DE SOTO,16,234,5,255,1778
HIDALGO,PACHUCA DE SOTO,16,229,1,246,1778
HIDALGO,PACHUCA DE SOTO,17,206,4,227,1778
HIDALGO,PACHUCA DE SOTO,12,207,2,221,1778
HIDALGO,PACHUCA DE SOTO,18,203,1,222,1658
HIDALGO,PACHUCA DE SOTO,10,168,1,179,1658
HIDALGO,PACHUCA DE SOTO,13,182,1,196,1658
HIDALGO,PACHUCA DE SOTO,11,214,1,226,1658
HIDALGO,PACHUCA DE SOTO,15,239,3,257,1594
HIDALGO,PACHUCA DE SOTO,18,249,1,268,1593
HIDALGO,PACHUCA DE SOTO,14,215,4,233,1252
HIDALGO,PACHUCA DE SOTO,15,197,0,212,1251
HIDALGO,PACHUCA DE SOTO,11,202,46,259,1442
HIDALGO,PACHUCA DE SOTO,16,223,4,243,1441
HIDALGO,PACHUCA DE SOTO,9,224,4,237,1441
HIDALGO,PACHUCA DE SOTO,18,253,5,276,1893
HIDALGO,PACHUCA DE SOTO,20,253,0,273,1893
HIDALGO,PACHUCA DE SOTO,22,234,1,257,1893
HIDALGO,PACHUCA DE SOTO,20,247,2,269,1893
HIDALGO,PACHUCA DE SOTO,16,240,5,261,1893
HIDALGO,PACHUCA DE SOTO,15,355,4,374,1900
HIDALGO,PACHUCA DE SOTO,19,351,4,374,1899
HIDALGO,PACHUCA DE SOTO,13,264,2,279,1216
HIDALGO,PACHUCA DE SOTO,14,252,4,270,1216
HIDALGO,PACHUCA DE SOTO,16,309,9,334,1720
HIDALGO,PACHUCA DE SOTO,15,335,7,357,1719
HIDALGO,PACHUCA DE SOTO,15,348,6,369,1697
HIDALGO,PACHUCA DE SOTO,22,286,3,311,1697
HIDALGO,PACHUCA DE SOTO,26,311,4,341,1803
HIDALGO,PACHUCA DE SOTO,23,295,5,323,1802
HIDALGO,PACHUCA DE SOTO,24,356,6,386,1974
HIDALGO,PACHUCA DE SOTO,17,193,4,214,1493
HIDALGO,PACHUCA DE SOTO,16,205,10,231,1493
HIDALGO,PACHUCA DE SOTO,19,312,5,336,1802
HIDALGO,PACHUCA DE SOTO,14,272,2,288,1802
HIDALGO,PACHUCA DE SOTO,26,289,8,323,1987
HIDALGO,PACHUCA DE SOTO,19,295,4,318,1987
HIDALGO,PACHUCA DE SOTO,15,181,1,197,1673
HIDALGO,PACHUCA DE SOTO,16,200,1,217,1673
HIDALGO,PACHUCA DE SOTO,8,130,8,146,1505
HIDALGO,PACHUCA DE SOTO,10,151,2,163,1505
HIDALGO,PACHUCA DE SOTO,18,154,1,173,1505
HIDALGO,PACHUCA DE SOTO,17,197,0,214,1593
HIDALGO,PACHUCA DE SOTO,26,166,0,192,1593
HIDALGO,PACHUCA DE SOTO,20,168,1,189,1593
HIDALGO,PACHUCA DE SOTO,13,172,0,185,1592
HIDALGO,PACHUCA DE SOTO,20,167,1,188,1592
HIDALGO,PACHUCA DE SOTO,11,147,2,160,1133
HIDALGO,PACHUCA DE SOTO,12,162,1,175,1133
HIDALGO,PACHUCA DE SOTO,14,195,2,211,1691
HIDALGO,PACHUCA DE SOTO,14,184,0,198,1690
HIDALGO,PACHUCA DE SOTO,29,235,5,269,1833
HIDALGO,PACHUCA DE SOTO,26,245,6,277,1833
HIDALGO,PACHUCA DE SOTO,17,163,0,180,1355
HIDALGO,PACHUCA DE SOTO,23,145,2,170,1355
HIDALGO,PACHUCA DE SOTO,15,165,0,180,1355
HIDALGO,PACHUCA DE SOTO,20,192,1,213,1275
HIDALGO,PACHUCA DE SOTO,33,161,1,195,1274
HIDALGO,PACHUCA DE SOTO,21,241,4,266,1925
HIDALGO,PACHUCA DE SOTO,18,263,0,281,1924
HIDALGO,TEPEAPULCO,11,258,8,277,1482
HIDALGO,TEPEAPULCO,9,233,6,248,1481
HIDALGO,TEPEAPULCO,9,312,9,330,1481
HIDALGO,TEPEAPULCO,14,207,10,231,1901
HIDALGO,TEPEAPULCO,14,204,5,223,1900
HIDALGO,TEPEAPULCO,13,199,4,216,1900
HIDALGO,TEPEAPULCO,14,304,2,320,1850
HIDALGO,TEPEAPULCO,14,309,2,325,1850
HIDALGO,TEPEAPULCO,20,341,6,367,1688
HIDALGO,TEPEAPULCO,11,317,7,335,1687
HIDALGO,TEPEAPULCO,21,325,3,349,1716
HIDALGO,TEPEAPULCO,15,346,4,365,1716
HIDALGO,TEPEAPULCO,19,253,0,272,1608
HIDALGO,TEPEAPULCO,13,291,4,308,1607
HIDALGO,TEPEAPULCO,29,290,2,321,1436
HIDALGO,TEPEAPULCO,15,290,5,310,1436
HIDALGO,TEPEAPULCO,9,249,5,263,1631
HIDALGO,TEPEAPULCO,12,237,5,254,1630
HIDALGO,TEPEAPULCO,19,233,1,253,1230
HIDALGO,TEPEAPULCO,14,255,2,271,1230
HIDALGO,TEPEAPULCO,15,280,3,298,1539
HIDALGO,TEPEAPULCO,10,327,2,339,1539
HIDALGO,TEPEAPULCO,13,235,3,251,1098
HIDALGO,TEPEAPULCO,8,211,3,222,1098
HIDALGO,TEPEAPULCO,14,292,6,312,1813
HIDALGO,TEPEAPULCO,13,257,7,277,1813
HIDALGO,TEPEAPULCO,3,113,0,116,1208
HIDALGO,TEPEAPULCO,9,140,3,152,1207
HIDALGO,TEPEAPULCO,18,290,1,309,1692
HIDALGO,TEPEAPULCO,16,304,4,324,1692
HIDALGO,TEPEAPULCO,19,286,7,312,1692
HIDALGO,TEPEAPULCO,13,377,7,397,1955
HIDALGO,TEPEAPULCO,17,360,8,385,1954
HIDALGO,TEPEAPULCO,24,341,3,368,1635
HIDALGO,TEPEAPULCO,14,280,6,300,1635
HIDALGO,TEPEAPULCO,10,216,6,232,1636
HIDALGO,TEPEAPULCO,11,229,10,250,1635
HIDALGO,TEPEAPULCO,13,342,5,360,1716
HIDALGO,TEPEAPULCO,14,366,4,384,1715
HIDALGO,TEPEAPULCO,23,283,7,313,1850
HIDALGO,TEPEAPULCO,28,352,10,390,1849
HIDALGO,TEPEAPULCO,14,323,1,338,1784
HIDALGO,TEPEAPULCO,21,285,6,312,1783
HIDALGO,TEPEAPULCO,15,277,4,296,1783
HIDALGO,TEPEAPULCO,10,212,4,226,1482
HIDALGO,TEPEAPULCO,14,226,5,245,1482
HIDALGO,TEPEAPULCO,11,223,5,239,1482
HIDALGO,TEPEAPULCO,18,302,5,325,1688
HIDALGO,TEPEAPULCO,15,258,9,282,1688
HIDALGO,TEPEAPULCO,13,326,5,344,1349
HIDALGO,TEPEAPULCO,19,265,1,285,1349
HIDALGO,TEPEAPULCO,23,334,2,359,1747
HIDALGO,TEPEAPULCO,23,307,3,333,1747
HIDALGO,TEPEAPULCO,15,307,0,322,1890
HIDALGO,TEPEAPULCO,33,326,4,363,1890
HIDALGO,TEPEAPULCO,26,311,1,338,1890
HIDALGO,TEPEAPULCO,20,313,2,335,1890
HIDALGO,TEPEAPULCO,26,302,2,330,1890
HIDALGO,TEPEAPULCO,19,299,3,321,1889
HIDALGO,TEPEAPULCO,19,296,3,318,1889
HIDALGO,TEPEAPULCO,19,304,4,327,1397
HIDALGO,TEPEAPULCO,24,299,1,324,1397
HIDALGO,TEPEAPULCO,19,306,5,330,1397
HIDALGO,TEPEAPULCO,39,306,1,346,1962
HIDALGO,TEPEAPULCO,27,287,1,315,1961
HIDALGO,TEPEAPULCO,29,286,1,316,1961
HIDALGO,TEPEAPULCO,20,309,4,333,1884
HIDALGO,TEPEAPULCO,18,299,4,321,1884
HIDALGO,TEPEAPULCO,8,320,6,334,1884
HIDALGO,TEPEAPULCO,22,281,1,304,1884
HIDALGO,TEPEAPULCO,19,306,4,329,1884
HIDALGO,TEPEAPULCO,14,296,6,316,1883
HIDALGO,TEPEAPULCO,29,297,3,329,1963
HIDALGO,TEPEAPULCO,20,264,1,285,1963
HIDALGO,TEPEAPULCO,28,280,1,309,1962
HIDALGO,TEPEAPULCO,15,217,6,238,1878
HIDALGO,TEPEAPULCO,18,205,1,224,1878
HIDALGO,TEPEAPULCO,15,217,4,236,1878
HIDALGO,TEPEAPULCO,18,215,6,239,1878
HIDALGO,TEPEAPULCO,18,183,3,204,1878
HIDALGO,TEPEAPULCO,9,214,2,225,1878
HIDALGO,TEPEAPULCO,13,230,1,244,1878
HIDALGO,TEPEAPULCO,7,209,6,222,1878
HIDALGO,TEPEAPULCO,7,216,2,225,1878
HIDALGO,TEPEAPULCO,7,201,2,210,1878
HIDALGO,TEPEAPULCO,16,198,1,215,1877
HIDALGO,TEPEAPULCO,8,225,1,234,1877
HIDALGO,TEPEAPULCO,19,221,1,241,1877
HIDALGO,TEPEAPULCO,16,160,1,177,1382
HIDALGO,TEPEAPULCO,12,113,3,128,1381
HIDALGO,TEPEAPULCO,19,169,4,192,1381
HIDALGO,TEPEAPULCO,19,342,9,370,1872
HIDALGO,TEPEAPULCO,21,345,1,367,1872
HIDALGO,TEPEAPULCO,24,376,6,406,1872
HIDALGO,TEPEAPULCO,26,247,1,274,1786
HIDALGO,TEPEAPULCO,21,248,5,274,1786
HIDALGO,TEPEAPULCO,10,167,2,179,1329
HIDALGO,TEPEAPULCO,7,171,3,181,1329
HIDALGO,TEPEAPULCO,7,141,5,153,1329
HIDALGO,TEPEAPULCO,13,152,5,170,1037
HIDALGO,TEPEAPULCO,5,134,5,144,1037
HIDALGO,TEPEAPULCO,13,254,6,273,1545
HIDALGO,TEPEAPULCO,25,286,2,313,1545
HIDALGO,TEPEAPULCO,17,242,4,263,1916
HIDALGO,TEPEAPULCO,12,226,2,240,1915
HIDALGO,TEPEAPULCO,12,313,4,329,1545
HIDALGO,TEPEAPULCO,29,318,7,354,1545
HIDALGO,TEPEAPULCO,17,274,6,297,1519
HIDALGO,TEPEAPULCO,19,285,4,308,1518
HIDALGO,TEPEAPULCO,16,246,8,270,1373
HIDALGO,TEPEAPULCO,13,260,6,279,1373
HIDALGO,TEPEAPULCO,10,221,4,235,1874
HIDALGO,TEPEAPULCO,6,229,0,235,1873
HIDALGO,TEPEAPULCO,29,351,3,383,1700
HIDALGO,TEPEAPULCO,22,363,3,388,1700
HIDALGO,TEPEAPULCO,10,288,6,304,1738
HIDALGO,TEPEAPULCO,10,364,3,377,1737
HIDALGO,TEPEAPULCO,21,335,1,357,1546
HIDALGO,TEPEAPULCO,21,332,6,359,1546
HIDALGO,TEPEAPULCO,28,366,2,396,1546
HIDALGO,TEPEAPULCO,19,356,4,379,1546
HIDALGO,TEPEAPULCO,25,372,1,398,1659
HIDALGO,TEPEAPULCO,32,381,6,419,1659
HIDALGO,TEPEAPULCO,22,382,4,408,1659
HIDALGO,TEPEAPULCO,10,328,1,339,1717
HIDALGO,TEPEAPULCO,18,316,3,337,1716
HIDALGO,TEPEAPULCO,43,534,3,580,0
HIDALGO,TEPEAPULCO,22,275,1,298,1549
HIDALGO,TEPEAPULCO,24,283,2,309,1549
HIDALGO,TEPEAPULCO,19,274,3,296,1548
HIDALGO,TEPEAPULCO,9,274,2,285,1062
HIDALGO,TEPEAPULCO,23,266,1,290,1061
HIDALGO,TEPEAPULCO,20,497,7,524,1813
HIDALGO,TEPEAPULCO,19,453,5,477,1812
HIDALGO,TEPEAPULCO,16,407,1,424,1641
HIDALGO,TEPEAPULCO,11,405,3,419,1640
HIDALGO,TEPEAPULCO,18,266,1,285,1606
HIDALGO,TEPEAPULCO,20,237,1,258,1606
HIDALGO,TEPEAPULCO,13,247,6,266,1606
HIDALGO,TEPEAPULCO,31,248,7,286,1605
HIDALGO,TEPEAPULCO,9,139,6,154,1033
HIDALGO,TEPEAPULCO,10,157,6,173,1032
HIDALGO,TEPEAPULCO,15,268,7,290,1544
HIDALGO,TEPEAPULCO,11,291,4,306,1543
HIDALGO,TEPEAPULCO,14,306,5,325,1543
HIDALGO,TEPEAPULCO,10,264,4,278,1543
HIDALGO,TEPEAPULCO,15,277,4,296,1543
HIDALGO,TEPEAPULCO,28,259,0,287,1833
HIDALGO,TEPEAPULCO,18,213,4,235,1833
HIDALGO,TEPEAPULCO,31,221,1,253,1833
HIDALGO,TEPEAPULCO,23,237,4,264,1833
HIDALGO,TEPEAPULCO,23,232,1,256,1833
HIDALGO,TEPEAPULCO,24,232,1,257,1833
HIDALGO,TEPEAPULCO,18,209,2,229,1833
HIDALGO,TEPEAPULCO,26,233,0,259,1833
HIDALGO,TEPEAPULCO,11,257,6,274,1524
HIDALGO,TEPEAPULCO,7,257,5,269,1524
HIDALGO,TEPEAPULCO,23,254,8,285,1597
HIDALGO,TEPEAPULCO,28,237,9,274,1596
HIDALGO,TEPEAPULCO,15,278,4,297,1588
HIDALGO,TEPEAPULCO,10,213,1,224,1588
HIDALGO,TEPEAPULCO,11,267,1,279,1587
HIDALGO,TEPEAPULCO,8,151,4,163,1017
HIDALGO,TEPEAPULCO,6,175,7,188,1017
HIDALGO,TEPEAPULCO,3,169,3,175,1428
HIDALGO,TEPEAPULCO,8,135,6,149,1428
HIDALGO,TEPEAPULCO,23,201,5,229,1428
HIDALGO,TEPEAPULCO,15,262,8,285,1872
HIDALGO,TEPEAPULCO,5,298,3,306,1871
HIDALGO,TEPEAPULCO,11,378,4,393,1986
HIDALGO,TEPEAPULCO,43,220,1,264,1450
HIDALGO,TEPEAPULCO,37,240,6,283,1450
HIDALGO,TEPEAPULCO,39,312,1,352,1297
HIDALGO,TEPEAPULCO,28,294,2,324,1296
HIDALGO,TEPEAPULCO,22,320,4,346,1844
HIDALGO,TEPEAPULCO,32,357,2,391,1844
HIDALGO,TEPEAPULCO,20,223,2,245,1381
HIDALGO,TEPEAPULCO,20,226,0,246,1380
HIDALGO,TEPEAPULCO,23,248,4,275,1473
HIDALGO,TEPEAPULCO,35,252,1,288,1473
HIDALGO,TEPEAPULCO,20,247,2,269,1472
HIDALGO,TEPEAPULCO,36,319,1,356,1845
HIDALGO,TEPEAPULCO,28,304,2,334,1844
HIDALGO,TEPEAPULCO,36,284,4,324,1884
HIDALGO,TEPEAPULCO,35,276,2,313,1884
HIDALGO,TEPEAPULCO,29,277,4,310,1665
HIDALGO,TEPEAPULCO,29,269,2,300,1665
HIDALGO,TEPEAPULCO,19,290,1,310,1665
HIDALGO,TEPEAPULCO,5,242,2,249,1347
HIDALGO,TEPEAPULCO,8,222,1,231,1347
HIDALGO,TEPEAPULCO,10,235,3,248,1346
HIDALGO,TEPEAPULCO,14,264,4,282,1575
HIDALGO,TEPEAPULCO,19,233,4,256,1575
HIDALGO,TEPEAPULCO,13,266,2,281,1575
HIDALGO,TEPEAPULCO,23,223,4,250,1475
HIDALGO,TEPEAPULCO,30,231,2,263,1475
HIDALGO,TEPEAPULCO,20,246,2,268,1475
JALISCO,TEQUILA,8,138,5,151,1595
JALISCO,TEQUILA,11,155,2,168,1595
JALISCO,TEQUILA,3,149,1,153,1595
JALISCO,TEQUILA,6,193,2,201,1857
JALISCO,TEQUILA,4,219,5,228,1856
JALISCO,TEQUILA,14,197,0,211,2069
JALISCO,TEQUILA,5,237,3,245,2068
JALISCO,TEQUILA,7,190,3,200,1659
JALISCO,TEQUILA,2,196,2,200,1658
JALISCO,TEQUILA,1,157,1,159,1365
JALISCO,TEQUILA,5,122,0,127,1755
JALISCO,TEQUILA,4,125,1,130,1754
JALISCO,TEQUILA,5,198,2,205,2022
JALISCO,TEQUILA,5,143,3,151,1984
JALISCO,TEQUILA,14,138,0,152,1983
JALISCO,TEQUILA,5,143,0,148,1983
JALISCO,TEQUILA,6,166,1,173,1693
JALISCO,TEQUILA,4,196,5,205,1692
JALISCO,TEQUILA,3,159,4,166,1646
JALISCO,TEQUILA,8,92,0,100,1088
JALISCO,TEQUILA,0,110,2,112,1088
JALISCO,TEQUILA,10,108,1,119,1873
JALISCO,TEQUILA,2,119,0,121,1872
JALISCO,TEQUILA,8,107,2,117,1872
JALISCO,TEQUILA,7,71,1,79,1606
JALISCO,TEQUILA,8,68,2,78,1606
JALISCO,TEQUILA,6,81,2,89,1605
JALISCO,TEQUILA,4,98,4,106,1493
JALISCO,TEQUILA,5,83,0,88,1492
JALISCO,TEQUILA,2,89,1,92,1492
JALISCO,TEQUILA,9,121,2,132,2021
JALISCO,TEQUILA,11,158,0,169,2021
JALISCO,TEQUILA,4,147,7,158,2021
JALISCO,TEQUILA,6,127,3,136,1406
JALISCO,TEQUILA,9,147,3,159,1406
JALISCO,TEQUILA,4,152,0,156,1406
JALISCO,TEQUILA,8,153,3,164,1453
JALISCO,TEQUILA,14,160,4,178,1452
JALISCO,TEQUILA,6,138,2,146,1399
JALISCO,TEQUILA,6,132,3,141,1398
JALISCO,TEQUILA,8,112,1,121,1398
JALISCO,TEQUILA,10,229,2,241,1983
JALISCO,TEQUILA,12,221,3,236,1982
JALISCO,TEQUILA,8,133,2,143,1987
JALISCO,TEQUILA,7,109,3,119,1987
JALISCO,TEQUILA,9,95,4,108,1986
JALISCO,TEQUILA,5,66,2,73,1394
JALISCO,TEQUILA,6,87,2,95,1394
JALISCO,TEQUILA,9,67,1,77,1393
JALISCO,TEQUILA,26,127,1,154,1979
JALISCO,TEQUILA,16,77,0,93,1979
JALISCO,TEQUILA,5,108,0,113,1302
JALISCO,TEQUILA,8,71,4,83,1301
JALISCO,TEQUILA,6,187,2,195,1699
JALISCO,TEQUILA,4,205,4,213,1698
JALISCO,TEQUILA,13,178,1,192,2042
JALISCO,TEQUILA,16,204,0,220,2041
JALISCO,TEQUILA,5,180,2,187,1900
JALISCO,TEQUILA,9,161,6,176,1900
JALISCO,TEQUILA,6,174,2,182,1835
JALISCO,TEQUILA,2,106,0,108,1590
JALISCO,TEQUILA,3,47,1,51,1677
JALISCO,TEQUILA,1,47,1,49,1677
JALISCO,TEQUILA,7,144,2,153,1563
JALISCO,TEQUILA,4,116,1,121,1563
JALISCO,TEQUILA,9,118,1,128,1800
JALISCO,TEQUILA,5,108,2,115,1799
JALISCO,TEQUILA,10,146,2,158,1799
JALISCO,TEQUILA,4,91,0,95,1547
JALISCO,TEQUILA,9,69,0,78,1547
JALISCO,TEQUILA,8,96,2,106,1391
JALISCO,TEQUILA,10,85,5,100,1390
JALISCO,TEQUILA,5,96,4,105,1390
JALISCO,TEQUILA,7,51,1,59,1743
JALISCO,TEQUILA,12,44,1,57,1743
JALISCO,TEQUILA,15,55,2,72,1742
JALISCO,TEQUILA,14,46,1,61,1870
JALISCO,TEQUILA,11,39,3,53,1869
JALISCO,TEQUILA,8,61,0,69,1456
JALISCO,TEQUILA,16,55,2,73,1456
JALISCO,TEQUILA,10,37,0,47,1456
JALISCO,TEQUILA,10,100,0,110,1992
JALISCO,TEQUILA,6,110,3,119,1934
JALISCO,TEQUILA,9,96,1,106,1934
JALISCO,TEQUILA,5,127,0,132,1727
JALISCO,TEQUILA,7,119,0,126,1727
JALISCO,TEQUILA,10,114,2,126,1726
JALISCO,TEQUILA,6,108,1,115,1968
JALISCO,TEQUILA,8,121,2,131,1968
JALISCO,TEQUILA,6,88,2,96,1967
JALISCO,TEQUILA,6,83,8,97,1886
JALISCO,TEQUILA,5,73,10,88,1886
JALISCO,TEQUILA,13,102,15,130,1886
JALISCO,TEQUILA,6,84,8,98,1886
JALISCO,TEQUILA,6,73,2,81,1048
JALISCO,TEQUILA,3,70,3,76,1048
JALISCO,TEQUILA,25,179,7,211,1654
JALISCO,TEQUILA,20,135,12,167,1654
JALISCO,TEQUILA,23,192,14,229,1654
JALISCO,TEQUILA,9,54,0,63,1480
JALISCO,TEQUILA,9,41,4,54,1479
JALISCO,TEQUILA,1,187,1,189,1503
JALISCO,TEQUILA,4,187,3,194,1503
JALISCO,TEQUILA,7,234,0,241,1192
JALISCO,TEQUILA,17,187,0,204,1191
JALISCO,TEQUILA,7,89,4,100,1672
JALISCO,TEQUILA,13,95,0,108,1671
JALISCO,TEQUILA,10,160,1,171,1645
JALISCO,TEQUILA,9,196,1,206,1645
JALISCO,TEQUILA,10,152,0,162,1421
JALISCO,TEQUILA,7,126,1,134,1420
JALISCO,TEQUILA,1,140,1,142,1420
JALISCO,TEQUILA,8,115,1,124,1354
JALISCO,TEQUILA,8,136,2,146,1353
JALISCO,TEQUILA,16,278,0,294,1967
JALISCO,TEQUILA,3,199,0,202,1454
JALISCO,TEQUILA,7,181,1,189,1454
JALISCO,TEQUILA,7,170,2,179,1736
JALISCO,TEQUILA,3,168,3,174,1735
JALISCO,TEQUILA,5,199,6,210,1736
JALISCO,TEQUILA,6,184,0,190,1735
JALISCO,TEQUILA,18,161,0,179,1859
JALISCO,TEQUILA,12,173,0,185,1858
JALISCO,TEQUILA,10,163,1,174,1529
JALISCO,TEQUILA,6,191,0,197,1529
JALISCO,TEQUILA,5,223,1,229,1628
JALISCO,TEQUILA,8,271,3,282,1627
JALISCO,TEQUILA,7,271,4,282,1627
JALISCO,TEQUILA,4,198,2,204,1907
JALISCO,TEQUILA,8,115,1,124,1952
JALISCO,TEQUILA,6,87,1,94,1952
JALISCO,TEQUILA,6,117,0,123,1952
JALISCO,TEQUILA,6,109,0,115,1951
JALISCO,TEQUILA,6,230,8,244,1288
JALISCO,TEQUILA,7,191,4,202,1651
JALISCO,TEQUILA,4,160,3,167,1651
JALISCO,TEQUILA,3,176,2,181,1651
JALISCO,TEQUILA,10,133,1,144,1613
JALISCO,TEQUILA,3,135,0,138,1613
JALISCO,TEQUILA,5,101,0,106,1886
JALISCO,TEQUILA,8,96,1,105,1886
JALISCO,TEQUILA,6,167,6,179,2051
JALISCO,TEQUILA,9,179,2,190,2051
JALISCO,TEQUILA,5,165,2,172,2050
JALISCO,TEQUILA,114,501,4,619,0
JALISCO,TEQUILA,3,184,2,189,1781
JALISCO,TEQUILA,3,157,0,160,1780
JALISCO,TEQUILA,15,139,2,156,1539
JALISCO,TEQUILA,14,166,1,181,1539
JALISCO,TEQUILA,5,151,1,157,1539
JALISCO,TEQUILA,5,199,4,208,1615
JALISCO,TEQUILA,3,158,1,162,1614
JALISCO,TEQUILA,2,176,1,179,1948
JALISCO,TEQUILA,7,175,1,183,1947
JALISCO,TEQUILA,4,197,2,203,1890
JALISCO,TEQUILA,3,166,3,172,1889
JALISCO,TEQUILA,11,36,0,47,1426
JALISCO,TEQUILA,19,28,0,47,1426
JALISCO,TEQUILA,3,37,0,40,1425
JALISCO,TEQUILA,4,98,0,102,1125
JALISCO,TEQUILA,77,6,3,86,1124
JALISCO,TEQUILA,5,281,4,290,1981
JALISCO,TEQUILA,5,293,5,303,1980
JALISCO,TEQUILA,8,288,4,300,1878
JALISCO,TEQUILA,4,314,2,320,1877
JALISCO,TEQUILA,7,49,0,56,1992
JALISCO,TEQUILA,8,62,0,70,1992
JALISCO,TEQUILA,6,72,1,79,1531
JALISCO,TEQUILA,6,110,0,116,1530
JALISCO,TEQUILA,10,89,1,100,1530
JALISCO,LAGOS DE MORENO,25,216,3,244,1920
JALISCO,LAGOS DE MORENO,12,180,5,197,1919
JALISCO,LAGOS DE MORENO,6,108,4,118,1501
JALISCO,LAGOS DE MORENO,8,120,2,130,1501
JALISCO,LAGOS DE MORENO,9,79,0,88,1390
JALISCO,LAGOS DE MORENO,10,101,1,112,1390
JALISCO,LAGOS DE MORENO,21,98,5,124,1389
JALISCO,LAGOS DE MORENO,17,213,5,235,1879
JALISCO,LAGOS DE MORENO,20,188,2,210,1878
JALISCO,LAGOS DE MORENO,25,143,2,170,1991
JALISCO,LAGOS DE MORENO,26,128,1,155,1991
JALISCO,LAGOS DE MORENO,14,130,1,145,1954
JALISCO,LAGOS DE MORENO,20,143,3,166,1954
JALISCO,LAGOS DE MORENO,25,135,6,166,1605
JALISCO,LAGOS DE MORENO,20,115,3,138,1604
JALISCO,LAGOS DE MORENO,23,81,2,106,1179
JALISCO,LAGOS DE MORENO,19,51,2,72,1179
JALISCO,LAGOS DE MORENO,10,76,0,86,1739
JALISCO,LAGOS DE MORENO,9,79,1,89,1739
JALISCO,LAGOS DE MORENO,6,64,3,73,1424
JALISCO,LAGOS DE MORENO,3,85,3,91,1423
JALISCO,LAGOS DE MORENO,11,138,2,151,1511
JALISCO,LAGOS DE MORENO,21,140,1,162,1511
JALISCO,LAGOS DE MORENO,15,135,0,150,1511
JALISCO,LAGOS DE MORENO,13,98,1,112,1706
JALISCO,LAGOS DE MORENO,10,103,3,116,1706
JALISCO,LAGOS DE MORENO,11,120,1,132,1705
JALISCO,LAGOS DE MORENO,14,169,4,187,1760
JALISCO,LAGOS DE MORENO,9,180,1,190,1760
JALISCO,LAGOS DE MORENO,16,145,3,164,1805
JALISCO,LAGOS DE MORENO,19,134,2,155,1805
JALISCO,LAGOS DE MORENO,8,173,0,181,1702
JALISCO,LAGOS DE MORENO,1,150,0,151,1702
JALISCO,LAGOS DE MORENO,12,75,2,89,1283
JALISCO,LAGOS DE MORENO,5,104,1,110,1283
JALISCO,LAGOS DE MORENO,6,105,1,112,1496
JALISCO,LAGOS DE MORENO,8,115,2,125,1496
JALISCO,LAGOS DE MORENO,9,114,2,125,1495
JALISCO,LAGOS DE MORENO,15,127,5,147,1973
JALISCO,LAGOS DE MORENO,10,133,0,143,1973
JALISCO,LAGOS DE MORENO,8,127,0,135,1972
JALISCO,LAGOS DE MORENO,9,130,1,140,1972
JALISCO,LAGOS DE MORENO,17,127,1,145,1668
JALISCO,LAGOS DE MORENO,23,139,2,164,1668
JALISCO,LAGOS DE MORENO,9,94,1,104,1970
JALISCO,LAGOS DE MORENO,11,82,3,96,1970
JALISCO,LAGOS DE MORENO,9,97,1,107,1969
JALISCO,LAGOS DE MORENO,4,106,1,111,1969
JALISCO,LAGOS DE MORENO,3,82,5,90,1969
JALISCO,LAGOS DE MORENO,14,116,2,132,1586
JALISCO,LAGOS DE MORENO,21,103,1,125,1586
JALISCO,LAGOS DE MORENO,8,107,1,116,1586
JALISCO,LAGOS DE MORENO,9,107,1,117,1648
JALISCO,LAGOS DE MORENO,22,127,2,151,1648
JALISCO,LAGOS DE MORENO,15,82,0,97,1135
JALISCO,LAGOS DE MORENO,6,84,0,90,1134
JALISCO,LAGOS DE MORENO,15,126,3,144,1468
JALISCO,LAGOS DE MORENO,9,143,0,152,1468
JALISCO,LAGOS DE MORENO,6,132,0,138,1467
JALISCO,LAGOS DE MORENO,15,96,0,111,1360
JALISCO,LAGOS DE MORENO,6,116,0,122,1359
JALISCO,LAGOS DE MORENO,13,183,0,196,2071
JALISCO,LAGOS DE MORENO,12,134,0,146,2070
JALISCO,LAGOS DE MORENO,15,120,1,136,1778
JALISCO,LAGOS DE MORENO,7,112,3,122,1778
JALISCO,LAGOS DE MORENO,48,283,2,333,0
JALISCO,LAGOS DE MORENO,9,69,0,78,1423
JALISCO,LAGOS DE MORENO,6,70,1,77,1422
JALISCO,LAGOS DE MORENO,8,58,2,68,1422
JALISCO,LAGOS DE MORENO,8,168,8,184,1807
JALISCO,LAGOS DE MORENO,15,157,5,177,1806
JALISCO,LAGOS DE MORENO,12,119,2,133,1420
JALISCO,LAGOS DE MORENO,8,119,1,128,1420
JALISCO,LAGOS DE MORENO,7,70,1,78,1648
JALISCO,LAGOS DE MORENO,2,61,0,63,1647
JALISCO,LAGOS DE MORENO,50,82,4,136,1695
JALISCO,LAGOS DE MORENO,5,32,2,39,1632
JALISCO,LAGOS DE MORENO,15,53,1,69,1632
JALISCO,LAGOS DE MORENO,7,46,5,58,1631
JALISCO,LAGOS DE MORENO,7,76,1,84,1380
JALISCO,LAGOS DE MORENO,11,65,2,78,1380
JALISCO,LAGOS DE MORENO,5,74,0,79,2046
JALISCO,LAGOS DE MORENO,12,86,2,100,2046
JALISCO,LAGOS DE MORENO,10,102,0,112,1488
JALISCO,LAGOS DE MORENO,7,111,1,119,1487
JALISCO,LAGOS DE MORENO,6,97,2,105,1487
JALISCO,LAGOS DE MORENO,7,68,1,76,2057
JALISCO,LAGOS DE MORENO,5,28,1,34,2056
JALISCO,LAGOS DE MORENO,3,148,3,154,1452
JALISCO,LAGOS DE MORENO,6,192,2,200,1451
JALISCO,LAGOS DE MORENO,10,167,5,182,1451
JALISCO,LAGOS DE MORENO,13,243,5,261,1893
JALISCO,LAGOS DE MORENO,9,244,3,256,1893
JALISCO,LAGOS DE MORENO,20,256,3,279,1892
JALISCO,LAGOS DE MORENO,13,266,13,292,1857
JALISCO,LAGOS DE MORENO,19,175,7,201,2053
JALISCO,LAGOS DE MORENO,16,208,1,225,2052
JALISCO,LAGOS DE MORENO,10,183,3,196,1500
JALISCO,LAGOS DE MORENO,11,242,2,255,1499
JALISCO,LAGOS DE MORENO,21,314,9,344,1198
JALISCO,LAGOS DE MORENO,14,309,10,333,1198
JALISCO,LAGOS DE MORENO,9,93,2,104,1819
JALISCO,LAGOS DE MORENO,10,79,2,91,1819
JALISCO,LAGOS DE MORENO,17,60,7,84,1818
JALISCO,LAGOS DE MORENO,16,85,0,101,1435
JALISCO,LAGOS DE MORENO,4,70,1,75,1435
JALISCO,LAGOS DE MORENO,13,67,1,81,1435
JALISCO,LAGOS DE MORENO,16,82,1,99,1591
JALISCO,LAGOS DE MORENO,9,74,1,84,1591
JALISCO,LAGOS DE MORENO,4,70,2,76,1591
JALISCO,LAGOS DE MORENO,12,81,2,95,1591
JALISCO,LAGOS DE MORENO,8,123,5,136,1798
JALISCO,LAGOS DE MORENO,10,126,1,137,1798
JALISCO,LAGOS DE MORENO,12,86,0,98,1925
JALISCO,LAGOS DE MORENO,17,83,1,101,1924
JALISCO,LAGOS DE MORENO,11,89,1,101,1863
JALISCO,LAGOS DE MORENO,7,56,2,65,1862
JALISCO,LAGOS DE MORENO,15,77,2,94,1533
JALISCO,LAGOS DE MORENO,20,76,1,97,1533
JALISCO,LAGOS DE MORENO,8,78,2,88,1491
JALISCO,LAGOS DE MORENO,15,70,1,86,1490
JALISCO,LAGOS DE MORENO,6,84,2,92,1886
JALISCO,LAGOS DE MORENO,14,70,0,84,1886
JALISCO,LAGOS DE MORENO,14,44,1,59,1548
JALISCO,LAGOS DE MORENO,4,43,1,48,1547
JALISCO,LAGOS DE MORENO,4,15,0,19,1321
JALISCO,LAGOS DE MORENO,7,21,1,29,1320
JALISCO,LAGOS DE MORENO,2,52,0,54,1133
JALISCO,LAGOS DE MORENO,4,48,0,52,1132
JALISCO,LAGOS DE MORENO,4,31,1,36,1334
JALISCO,LAGOS DE MORENO,2,27,3,32,1334
JALISCO,LAGOS DE MORENO,5,56,2,63,1697
JALISCO,LAGOS DE MORENO,7,53,1,61,1696
JALISCO,LAGOS DE MORENO,8,84,2,94,1463
JALISCO,LAGOS DE MORENO,2,52,8,62,1462
JALISCO,LAGOS DE MORENO,16,67,2,85,1699
JALISCO,LAGOS DE MORENO,9,43,1,53,1699
JALISCO,LAGOS DE MORENO,5,51,0,56,1698
JALISCO,LAGOS DE MORENO,16,46,1,63,1814
JALISCO,LAGOS DE MORENO,16,27,0,43,1814
JALISCO,LAGOS DE MORENO,10,34,0,44,1398
JALISCO,LAGOS DE MORENO,10,28,1,39,1398
JALISCO,LAGOS DE MORENO,9,33,1,43,1398
JALISCO,LAGOS DE MORENO,6,59,0,65,1764
JALISCO,LAGOS DE MORENO,16,67,3,86,1764
JALISCO,LAGOS DE MORENO,9,60,0,69,1585
JALISCO,LAGOS DE MORENO,10,72,3,85,1584
JALISCO,LAGOS DE MORENO,19,219,16,254,1950
JALISCO,LAGOS DE MORENO,20,90,5,115,2033
JALISCO,LAGOS DE MORENO,20,32,1,53,1640
JALISCO,LAGOS DE MORENO,7,17,2,26,1639
JALISCO,LAGOS DE MORENO,34,124,2,160,1550
JALISCO,LAGOS DE MORENO,27,116,1,144,1549
JALISCO,LAGOS DE MORENO,16,95,1,112,1922
JALISCO,LAGOS DE MORENO,11,128,5,144,1922
JALISCO,LAGOS DE MORENO,18,96,6,120,1306
JALISCO,LAGOS DE MORENO,27,119,8,154,1305
JALISCO,LAGOS DE MORENO,7,72,1,80,1618
JALISCO,LAGOS DE MORENO,7,54,3,64,1617
JALISCO,LAGOS DE MORENO,3,51,0,54,1617
JALISCO,LAGOS DE MORENO,4,55,3,62,1475
JALISCO,LAGOS DE MORENO,5,58,0,63,1474
JALISCO,LAGOS DE MORENO,11,61,0,72,1378
JALISCO,LAGOS DE MORENO,13,48,0,61,1378
JALISCO,TEPATITLAN DE MORELOS,5,31,0,36,1353
JALISCO,TEPATITLAN DE MORELOS,6,49,1,56,1352
JALISCO,TEPATITLAN DE MORELOS,8,41,1,50,1099
JALISCO,TEPATITLAN DE MORELOS,13,49,1,63,1099
JALISCO,TEPATITLAN DE MORELOS,6,48,0,54,1452
JALISCO,TEPATITLAN DE MORELOS,9,43,1,53,1451
JALISCO,TEPATITLAN DE MORELOS,9,64,2,75,1626
JALISCO,TEPATITLAN DE MORELOS,8,74,0,82,1626
JALISCO,TEPATITLAN DE MORELOS,52,7,6,65,1625
JALISCO,TEPATITLAN DE MORELOS,5,48,0,53,1764
JALISCO,TEPATITLAN DE MORELOS,9,44,0,53,1763
JALISCO,TEPATITLAN DE MORELOS,8,52,1,61,1763
JALISCO,TEPATITLAN DE MORELOS,10,55,1,66,1763
JALISCO,TEPATITLAN DE MORELOS,10,62,0,72,1844
JALISCO,TEPATITLAN DE MORELOS,12,57,0,69,1844
JALISCO,TEPATITLAN DE MORELOS,3,33,0,36,1567
JALISCO,TEPATITLAN DE MORELOS,4,44,0,48,1567
JALISCO,TEPATITLAN DE MORELOS,6,30,0,36,1566
JALISCO,TEPATITLAN DE MORELOS,14,61,0,75,2007
JALISCO,TEPATITLAN DE MORELOS,11,52,1,64,2006
JALISCO,TEPATITLAN DE MORELOS,11,52,0,63,1817
JALISCO,TEPATITLAN DE MORELOS,10,33,0,43,1816
JALISCO,TEPATITLAN DE MORELOS,6,49,0,55,1816
JALISCO,TEPATITLAN DE MORELOS,12,74,0,86,1809
JALISCO,TEPATITLAN DE MORELOS,16,63,4,83,1809
JALISCO,TEPATITLAN DE MORELOS,9,81,3,93,1693
JALISCO,TEPATITLAN DE MORELOS,13,63,2,78,1692
JALISCO,TEPATITLAN DE MORELOS,17,55,2,74,1902
JALISCO,TEPATITLAN DE MORELOS,15,52,0,67,1902
JALISCO,TEPATITLAN DE MORELOS,10,80,0,90,1902
JALISCO,TEPATITLAN DE MORELOS,16,42,1,59,1759
JALISCO,TEPATITLAN DE MORELOS,11,41,1,53,1759
JALISCO,TEPATITLAN DE MORELOS,18,45,0,63,1852
JALISCO,TEPATITLAN DE MORELOS,34,38,0,72,1851
JALISCO,TEPATITLAN DE MORELOS,38,28,4,70,1851
JALISCO,TEPATITLAN DE MORELOS,25,30,0,55,1712
JALISCO,TEPATITLAN DE MORELOS,33,54,0,87,1712
JALISCO,TEPATITLAN DE MORELOS,38,41,2,81,1712
JALISCO,TEPATITLAN DE MORELOS,9,26,1,36,2048
JALISCO,TEPATITLAN DE MORELOS,7,27,0,34,2002
JALISCO,TEPATITLAN DE MORELOS,11,13,0,24,1469
JALISCO,TEPATITLAN DE MORELOS,18,23,2,43,1468
JALISCO,TEPATITLAN DE MORELOS,16,16,1,33,1468
JALISCO,TEPATITLAN DE MORELOS,28,109,1,138,0
JALISCO,TEPATITLAN DE MORELOS,24,81,0,105,1912
JALISCO,TEPATITLAN DE MORELOS,12,84,1,97,1912
JALISCO,TEPATITLAN DE MORELOS,25,58,2,85,1956
JALISCO,TEPATITLAN DE MORELOS,26,46,1,73,1955
JALISCO,TEPATITLAN DE MORELOS,15,52,0,67,1634
JALISCO,TEPATITLAN DE MORELOS,18,52,2,72,1634
JALISCO,TEPATITLAN DE MORELOS,17,33,0,50,1622
JALISCO,TEPATITLAN DE MORELOS,17,34,0,51,1622
JALISCO,TEPATITLAN DE MORELOS,20,38,0,58,2055
JALISCO,TEPATITLAN DE MORELOS,11,34,0,45,2054
JALISCO,TEPATITLAN DE MORELOS,9,36,0,45,1935
JALISCO,TEPATITLAN DE MORELOS,19,41,0,60,1935
JALISCO,TEPATITLAN DE MORELOS,7,48,1,56,1935
JALISCO,TEPATITLAN DE MORELOS,13,107,2,122,1911
JALISCO,TEPATITLAN DE MORELOS,23,15,0,38,1098
JALISCO,TEPATITLAN DE MORELOS,14,16,1,31,1097
JALISCO,TEPATITLAN DE MORELOS,22,31,1,54,1621
JALISCO,TEPATITLAN DE MORELOS,15,34,0,49,1621
JALISCO,TEPATITLAN DE MORELOS,18,32,0,50,1816
JALISCO,TEPATITLAN DE MORELOS,19,43,2,64,1816
JALISCO,TEPATITLAN DE MORELOS,9,34,1,44,1569
JALISCO,TEPATITLAN DE MORELOS,8,32,0,40,1568
JALISCO,TEPATITLAN DE MORELOS,21,48,0,69,1991
JALISCO,TEPATITLAN DE MORELOS,8,39,2,49,1990
JALISCO,TEPATITLAN DE MORELOS,14,221,7,242,1624
JALISCO,TEPATITLAN DE MORELOS,7,238,7,252,1623
JALISCO,TEPATITLAN DE MORELOS,14,180,6,200,1623
JALISCO,TEPATITLAN DE MORELOS,22,61,2,85,1810
JALISCO,TEPATITLAN DE MORELOS,17,49,1,67,1810
JALISCO,TEPATITLAN DE MORELOS,15,47,2,64,1625
JALISCO,TEPATITLAN DE MORELOS,21,48,1,70,1625
JALISCO,TEPATITLAN DE MORELOS,21,59,3,83,1907
JALISCO,TEPATITLAN DE MORELOS,10,60,1,71,1906
JALISCO,TEPATITLAN DE MORELOS,17,47,2,66,1655
JALISCO,TEPATITLAN DE MORELOS,17,45,1,63,1655
JALISCO,TEPATITLAN DE MORELOS,17,51,2,70,1323
JALISCO,TEPATITLAN DE MORELOS,10,43,2,55,1322
JALISCO,TEPATITLAN DE MORELOS,11,45,0,56,1436
JALISCO,TEPATITLAN DE MORELOS,7,44,0,51,1436
JALISCO,TEPATITLAN DE MORELOS,10,73,1,84,1436
JALISCO,TEPATITLAN DE MORELOS,30,31,3,64,1842
JALISCO,TEPATITLAN DE MORELOS,13,21,1,35,1892
JALISCO,TEPATITLAN DE MORELOS,10,114,1,125,1788
JALISCO,TEPATITLAN DE MORELOS,7,84,1,92,1788
JALISCO,TEPATITLAN DE MORELOS,5,99,4,108,1788
JALISCO,TEPATITLAN DE MORELOS,14,111,3,128,1887
JALISCO,TEPATITLAN DE MORELOS,14,121,1,136,1887
JALISCO,TEPATITLAN DE MORELOS,13,81,1,95,1548
JALISCO,TEPATITLAN DE MORELOS,9,79,1,89,1548
JALISCO,TEPATITLAN DE MORELOS,10,83,2,95,1548
JALISCO,TEPATITLAN DE MORELOS,18,149,1,168,1943
JALISCO,TEPATITLAN DE MORELOS,3,147,3,153,1943
JALISCO,TEPATITLAN DE MORELOS,8,101,1,110,1747
JALISCO,TEPATITLAN DE MORELOS,6,102,8,116,1747
JALISCO,TEPATITLAN DE MORELOS,7,99,0,106,1747
JALISCO,TEPATITLAN DE MORELOS,9,99,2,110,1437
JALISCO,TEPATITLAN DE MORELOS,7,91,2,100,1437
JALISCO,TEPATITLAN DE MORELOS,3,90,1,94,1437
JALISCO,TEPATITLAN DE MORELOS,6,96,4,106,1795
JALISCO,TEPATITLAN DE MORELOS,8,90,2,100,1794
JALISCO,TEPATITLAN DE MORELOS,11,40,0,51,1357
JALISCO,TEPATITLAN DE MORELOS,18,36,0,54,1357
JALISCO,TEPATITLAN DE MORELOS,27,45,1,73,1391
JALISCO,TEPATITLAN DE MORELOS,19,35,2,56,1390
JALISCO,TEPATITLAN DE MORELOS,19,37,2,58,1266
JALISCO,TEPATITLAN DE MORELOS,20,33,1,54,1266
JALISCO,TEPATITLAN DE MORELOS,14,52,0,66,1508
JALISCO,TEPATITLAN DE MORELOS,19,49,1,69,1508
JALISCO,TEPATITLAN DE MORELOS,15,38,0,53,1508
JALISCO,TEPATITLAN DE MORELOS,16,51,1,68,1507
JALISCO,TEPATITLAN DE MORELOS,12,34,0,46,1456
JALISCO,TEPATITLAN DE MORELOS,23,26,1,50,1455
JALISCO,TEPATITLAN DE MORELOS,5,37,0,42,1455
JALISCO,TEPATITLAN DE MORELOS,50,65,2,117,1889
JALISCO,TEPATITLAN DE MORELOS,33,62,1,96,1888
JALISCO,TEPATITLAN DE MORELOS,23,29,2,54,1579
JALISCO,TEPATITLAN DE MORELOS,31,24,0,55,1578
JALISCO,TEPATITLAN DE MORELOS,22,22,0,44,1578
JALISCO,TEPATITLAN DE MORELOS,21,33,2,56,1532
JALISCO,TEPATITLAN DE MORELOS,26,32,0,58,1532
JALISCO,TEPATITLAN DE MORELOS,20,54,1,75,1657
JALISCO,TEPATITLAN DE MORELOS,23,67,1,91,1657
JALISCO,TEPATITLAN DE MORELOS,23,62,0,85,1657
JALISCO,TEPATITLAN DE MORELOS,22,32,1,55,1537
JALISCO,TEPATITLAN DE MORELOS,26,42,2,70,1537
JALISCO,TEPATITLAN DE MORELOS,24,37,0,61,1492
JALISCO,TEPATITLAN DE MORELOS,24,30,0,54,1492
JALISCO,TEPATITLAN DE MORELOS,52,30,2,84,1989
JALISCO,TEPATITLAN DE MORELOS,10,34,0,44,1989
JALISCO,TEPATITLAN DE MORELOS,22,50,0,72,1989
JALISCO,TEPATITLAN DE MORELOS,36,36,0,72,1868
JALISCO,TEPATITLAN DE MORELOS,24,36,0,60,1867
JALISCO,TEPATITLAN DE MORELOS,30,47,2,79,1763
JALISCO,TEPATITLAN DE MORELOS,38,50,1,89,1762
JALISCO,TEPATITLAN DE MORELOS,37,41,1,79,1557
JALISCO,TEPATITLAN DE MORELOS,21,44,1,66,1557
JALISCO,TEPATITLAN DE MORELOS,31,49,0,80,1557
JALISCO,TEPATITLAN DE MORELOS,26,64,3,93,1800
JALISCO,TEPATITLAN DE MORELOS,28,53,4,85,1799
JALISCO,TEPATITLAN DE MORELOS,25,37,2,64,1799
JALISCO,TEPATITLAN DE MORELOS,23,53,3,79,1799
JALISCO,TEPATITLAN DE MORELOS,20,69,0,89,1799
JALISCO,TEPATITLAN DE MORELOS,42,50,2,94,1799
JALISCO,TEPATITLAN DE MORELOS,44,51,0,95,1444
JALISCO,TEPATITLAN DE MORELOS,25,45,1,71,1444
JALISCO,TEPATITLAN DE MORELOS,16,52,0,68,1443
JALISCO,TEPATITLAN DE MORELOS,27,45,0,72,1956
JALISCO,TEPATITLAN DE MORELOS,26,55,1,82,1955
JALISCO,TEPATITLAN DE MORELOS,18,38,3,59,1535
JALISCO,TEPATITLAN DE MORELOS,13,43,0,56,1535
JALISCO,TEPATITLAN DE MORELOS,9,46,1,56,1535
JALISCO,TEPATITLAN DE MORELOS,8,41,2,51,1534
JALISCO,TEPATITLAN DE MORELOS,22,33,1,56,1354
JALISCO,TEPATITLAN DE MORELOS,25,32,2,59,1354
JALISCO,TEPATITLAN DE MORELOS,28,58,6,92,2093
JALISCO,TEPATITLAN DE MORELOS,7,15,0,22,1578
JALISCO,TEPATITLAN DE MORELOS,6,8,0,14,1578
JALISCO,TEPATITLAN DE MORELOS,26,20,1,47,1949
JALISCO,TEPATITLAN DE MORELOS,34,24,1,59,1949
JALISCO,TEPATITLAN DE MORELOS,18,27,1,46,1949
JALISCO,TEPATITLAN DE MORELOS,24,34,2,60,2028
JALISCO,TEPATITLAN DE MORELOS,29,28,4,61,2028
JALISCO,TEPATITLAN DE MORELOS,29,23,0,52,1793
JALISCO,TEPATITLAN DE MORELOS,27,16,0,43,1793
JALISCO,TEPATITLAN DE MORELOS,5,28,0,33,1532
JALISCO,TEPATITLAN DE MORELOS,5,44,1,50,1532
JALISCO,TEPATITLAN DE MORELOS,0,25,2,27,1532
JALISCO,TEPATITLAN DE MORELOS,15,53,1,69,1572
JALISCO,TEPATITLAN DE MORELOS,9,32,3,44,1571
JALISCO,TEPATITLAN DE MORELOS,23,37,2,62,1658
JALISCO,TEPATITLAN DE MORELOS,25,27,1,53,1658
JALISCO,TEPATITLAN DE MORELOS,7,32,2,41,1767
JALISCO,TEPATITLAN DE MORELOS,8,37,4,49,1767
JALISCO,TEPATITLAN DE MORELOS,5,28,0,33,1766
JALISCO,TEPATITLAN DE MORELOS,23,23,1,47,1559
JALISCO,TEPATITLAN DE MORELOS,14,32,1,47,1559
JALISCO,TEPATITLAN DE MORELOS,14,32,0,46,1559
JALISCO,TEPATITLAN DE MORELOS,18,23,0,41,1558
JALISCO,TEPATITLAN DE MORELOS,5,86,3,94,1950
JALISCO,TEPATITLAN DE MORELOS,9,95,0,104,1950
JALISCO,TEPATITLAN DE MORELOS,23,119,0,142,2047
JALISCO,TEPATITLAN DE MORELOS,16,60,0,76,1633
JALISCO,TEPATITLAN DE MORELOS,9,80,0,89,1632
JALISCO,TEPATITLAN DE MORELOS,16,77,0,93,1734
JALISCO,TEPATITLAN DE MORELOS,12,63,1,76,1734
JALISCO,TEPATITLAN DE MORELOS,7,75,4,86,1249
JALISCO,TEPATITLAN DE MORELOS,1,74,0,75,1249
JALISCO,TEPATITLAN DE MORELOS,13,173,2,188,1865
JALISCO,TEPATITLAN DE MORELOS,16,179,9,204,1865
JALISCO,TEPATITLAN DE MORELOS,12,115,3,130,1700
JALISCO,TEPATITLAN DE MORELOS,6,134,0,140,1700
JALISCO,TEPATITLAN DE MORELOS,17,161,1,179,1758
JALISCO,TEPATITLAN DE MORELOS,20,134,2,156,1757
JALISCO,TEPATITLAN DE MORELOS,15,109,1,125,1505
JALISCO,TEPATITLAN DE MORELOS,17,123,2,142,1504
JALISCO,TEPATITLAN DE MORELOS,3,101,1,105,1896
JALISCO,TEPATITLAN DE MORELOS,5,86,1,92,1896
JALISCO,TEPATITLAN DE MORELOS,8,112,4,124,1404
JALISCO,TEPATITLAN DE MORELOS,8,103,1,112,1404
JALISCO,TEPATITLAN DE MORELOS,20,40,1,61,1757
JALISCO,TEPATITLAN DE MORELOS,9,48,1,58,1756
JALISCO,ZAPOPAN,16,111,0,127,1273
JALISCO,ZAPOPAN,15,103,2,120,1272
JALISCO,ZAPOPAN,37,117,1,155,1985
JALISCO,ZAPOPAN,25,143,1,169,1984
JALISCO,ZAPOPAN,13,91,0,104,1655
JALISCO,ZAPOPAN,18,117,0,135,1655
JALISCO,ZAPOPAN,23,116,0,139,1861
JALISCO,ZAPOPAN,23,151,4,178,1861
JALISCO,ZAPOPAN,13,150,2,165,1912
JALISCO,ZAPOPAN,18,155,4,177,1912
JALISCO,ZAPOPAN,31,106,0,137,1406
JALISCO,ZAPOPAN,37,93,0,130,1405
JALISCO,ZAPOPAN,29,73,0,102,1396
JALISCO,ZAPOPAN,26,68,0,94,1395
JALISCO,ZAPOPAN,30,104,1,135,1575
JALISCO,ZAPOPAN,30,104,1,135,1574
JALISCO,ZAPOPAN,39,152,1,192,1906
JALISCO,ZAPOPAN,45,148,2,195,1905
JALISCO,ZAPOPAN,23,120,4,147,1477
JALISCO,ZAPOPAN,36,157,4,197,1476
JALISCO,ZAPOPAN,43,182,2,227,1941
JALISCO,ZAPOPAN,34,167,2,203,1941
JALISCO,ZAPOPAN,37,159,0,196,1895
JALISCO,ZAPOPAN,45,149,1,195,1895
JALISCO,ZAPOPAN,25,176,6,207,1666
JALISCO,ZAPOPAN,24,176,1,201,1665
JALISCO,ZAPOPAN,26,146,3,175,1627
JALISCO,ZAPOPAN,15,152,1,168,1626
JALISCO,ZAPOPAN,22,176,0,198,1739
JALISCO,ZAPOPAN,14,150,1,165,1738
JALISCO,ZAPOPAN,23,137,3,163,1513
JALISCO,ZAPOPAN,22,152,1,175,1512
JALISCO,ZAPOPAN,24,209,2,235,1829
JALISCO,ZAPOPAN,10,204,4,218,1829
JALISCO,ZAPOPAN,23,167,2,192,1938
JALISCO,ZAPOPAN,24,183,5,212,1937
JALISCO,ZAPOPAN,25,137,0,162,1867
JALISCO,ZAPOPAN,32,163,1,196,1866
JALISCO,ZAPOPAN,19,130,2,151,1453
JALISCO,ZAPOPAN,18,123,5,146,1453
JALISCO,ZAPOPAN,23,124,2,149,1452
JALISCO,ZAPOPAN,12,100,1,113,1469
JALISCO,ZAPOPAN,18,111,2,131,1469
JALISCO,ZAPOPAN,16,174,2,192,1970
JALISCO,ZAPOPAN,19,181,0,200,1585
JALISCO,ZAPOPAN,32,186,2,220,1585
JALISCO,ZAPOPAN,19,134,0,153,1766
JALISCO,ZAPOPAN,21,116,0,137,1765
JALISCO,ZAPOPAN,26,191,2,219,2068
JALISCO,ZAPOPAN,22,191,2,215,2007
JALISCO,ZAPOPAN,35,147,2,184,1903
JALISCO,ZAPOPAN,31,144,0,175,1902
JALISCO,ZAPOPAN,25,103,0,128,1771
JALISCO,ZAPOPAN,20,114,0,134,1771
JALISCO,ZAPOPAN,17,73,0,90,1771
JALISCO,ZAPOPAN,17,99,0,116,1771
JALISCO,ZAPOPAN,21,93,1,115,1770
JALISCO,ZAPOPAN,22,132,0,154,1757
JALISCO,ZAPOPAN,22,146,1,169,1756
JALISCO,ZAPOPAN,41,149,0,190,2053
JALISCO,ZAPOPAN,29,176,2,207,2052
JALISCO,ZAPOPAN,22,121,0,143,1724
JALISCO,ZAPOPAN,26,139,0,165,1723
JALISCO,ZAPOPAN,31,180,0,211,1973
JALISCO,ZAPOPAN,32,183,2,217,1972
JALISCO,ZAPOPAN,36,168,6,210,1856
JALISCO,ZAPOPAN,32,128,3,163,1856
JALISCO,ZAPOPAN,20,148,2,170,1638
JALISCO,ZAPOPAN,28,172,0,200,1637
JALISCO,ZAPOPAN,12,136,3,151,1448
JALISCO,ZAPOPAN,14,121,2,137,1448
JALISCO,ZAPOPAN,6,115,0,121,1487
JALISCO,ZAPOPAN,15,150,4,169,1487
JALISCO,ZAPOPAN,17,125,2,144,1486
JALISCO,ZAPOPAN,21,130,3,154,1527
JALISCO,ZAPOPAN,17,155,0,172,1526
JALISCO,ZAPOPAN,17,142,0,159,1571
JALISCO,ZAPOPAN,23,164,0,187,1571
JALISCO,ZAPOPAN,25,159,2,186,1888
JALISCO,ZAPOPAN,36,177,1,214,1888
JALISCO,ZAPOPAN,20,139,2,161,1576
JALISCO,ZAPOPAN,23,143,0,166,1575
JALISCO,ZAPOPAN,27,186,2,215,1575
JALISCO,ZAPOPAN,3,86,3,92,1067
JALISCO,ZAPOPAN,11,89,1,101,1066
JALISCO,ZAPOPAN,14,95,2,111,1067
JALISCO,ZAPOPAN,10,94,1,105,1066
JALISCO,ZAPOPAN,7,135,3,145,2030
JALISCO,ZAPOPAN,14,141,4,159,2030
JALISCO,ZAPOPAN,8,135,0,143,2030
JALISCO,ZAPOPAN,11,124,2,137,2030
JALISCO,ZAPOPAN,18,101,1,120,1236
JALISCO,ZAPOPAN,19,89,3,111,1236
JALISCO,ZAPOPAN,21,128,0,149,1116
JALISCO,ZAPOPAN,25,99,3,127,1115
JALISCO,ZAPOPAN,15,93,0,108,1186
JALISCO,ZAPOPAN,19,89,1,109,1186
JALISCO,ZAPOPAN,11,92,0,103,1048
JALISCO,ZAPOPAN,4,91,2,97,1047
JALISCO,ZAPOPAN,13,141,3,157,1234
JALISCO,ZAPOPAN,11,128,2,141,1233
JALISCO,ZAPOPAN,7,135,7,149,1757
JALISCO,ZAPOPAN,12,157,1,170,1756
JALISCO,ZAPOPAN,13,105,2,120,1657
JALISCO,ZAPOPAN,11,117,1,129,1657
JALISCO,ZAPOPAN,9,112,1,122,1657
JALISCO,ZAPOPAN,11,104,3,118,1657
JALISCO,ZAPOPAN,13,137,0,150,1397
JALISCO,ZAPOPAN,10,135,0,145,1397
JALISCO,ZAPOPAN,11,110,4,125,1396
JALISCO,ZAPOPAN,14,139,0,153,1681
JALISCO,ZAPOPAN,19,116,2,137,1681
JALISCO,ZAPOPAN,12,101,1,114,1474
JALISCO,ZAPOPAN,14,95,3,112,1474
JALISCO,ZAPOPAN,8,116,2,126,1474
JALISCO,ZAPOPAN,15,126,0,141,1706
JALISCO,ZAPOPAN,16,127,3,146,1706
JALISCO,ZAPOPAN,15,121,2,138,1705
JALISCO,ZAPOPAN,11,105,0,116,1809
JALISCO,ZAPOPAN,16,106,0,122,1808
JALISCO,ZAPOPAN,6,106,0,112,1808
JALISCO,ZAPOPAN,14,106,0,120,1808
JALISCO,ZAPOPAN,19,99,1,119,1808
JALISCO,ZAPOPAN,7,89,3,99,1808
JALISCO,ZAPOPAN,12,108,2,122,1795
JALISCO,ZAPOPAN,14,133,1,148,1795
JALISCO,ZAPOPAN,116,33,1,150,1795
JALISCO,ZAPOPAN,9,106,0,115,1795
JALISCO,ZAPOPAN,10,108,4,122,1794
JALISCO,ZAPOPAN,7,105,3,115,1409
JALISCO,ZAPOPAN,13,95,4,112,1409
JALISCO,ZAPOPAN,13,80,2,95,1408
JALISCO,ZAPOPAN,14,98,2,114,1451
JALISCO,ZAPOPAN,15,96,1,112,1451
JALISCO,ZAPOPAN,10,81,2,93,1451
JALISCO,ZAPOPAN,24,137,9,170,1936
JALISCO,ZAPOPAN,12,143,2,157,1936
JALISCO,ZAPOPAN,11,91,102,204,1744
JALISCO,ZAPOPAN,12,131,2,145,1744
JALISCO,ZAPOPAN,7,90,1,98,1624
JALISCO,ZAPOPAN,9,92,0,101,1624
JALISCO,ZAPOPAN,7,92,0,99,1623
JALISCO,ZAPOPAN,10,121,0,131,1753
JALISCO,ZAPOPAN,13,115,0,128,1753
JALISCO,ZAPOPAN,14,103,2,119,1753
JALISCO,ZAPOPAN,13,95,2,110,1752
JALISCO,ZAPOPAN,14,109,3,126,1752
JALISCO,ZAPOPAN,5,69,0,74,1628
JALISCO,ZAPOPAN,14,95,2,111,1628
JALISCO,ZAPOPAN,7,87,0,94,1628
JALISCO,ZAPOPAN,9,84,1,94,1628
JALISCO,ZAPOPAN,14,106,1,121,2024
JALISCO,ZAPOPAN,17,130,2,149,2024
JALISCO,ZAPOPAN,14,127,2,143,2023
JALISCO,ZAPOPAN,18,107,3,128,2023
JALISCO,ZAPOPAN,11,96,0,107,1482
JALISCO,ZAPOPAN,12,133,1,146,1482
JALISCO,ZAPOPAN,17,94,1,112,1482
JALISCO,ZAPOPAN,11,107,6,124,1808
JALISCO,ZAPOPAN,17,126,0,143,1807
JALISCO,ZAPOPAN,13,107,0,120,1807
JALISCO,ZAPOPAN,142,704,10,856,0
JALISCO,ZAPOPAN,23,86,0,109,1861
JALISCO,ZAPOPAN,45,90,1,136,1860
JALISCO,ZAPOPAN,35,85,0,120,1860
JALISCO,ZAPOPAN,38,122,0,160,1671
JALISCO,ZAPOPAN,25,104,0,129,1670
JALISCO,ZAPOPAN,35,105,0,140,1670
JALISCO,ZAPOPAN,23,106,0,129,1817
JALISCO,ZAPOPAN,31,81,0,112,1816
JALISCO,ZAPOPAN,28,116,0,144,1816
JALISCO,ZAPOPAN,33,127,1,161,1624
JALISCO,ZAPOPAN,29,115,2,146,1623
JALISCO,ZAPOPAN,29,98,1,128,1623
JALISCO,ZAPOPAN,20,129,0,149,1597
JALISCO,ZAPOPAN,17,116,0,133,1596
JALISCO,ZAPOPAN,31,83,0,114,1572
JALISCO,ZAPOPAN,30,83,0,113,1571
JALISCO,ZAPOPAN,37,88,1,126,1571
JALISCO,ZAPOPAN,29,87,0,116,1571
JALISCO,PUERTO VALLARTA,13,152,1,166,1781
JALISCO,PUERTO VALLARTA,11,121,5,137,1780
JALISCO,PUERTO VALLARTA,7,155,6,168,1612
JALISCO,PUERTO VALLARTA,2,199,1,202,1612
JALISCO,PUERTO VALLARTA,5,163,0,168,1612
JALISCO,PUERTO VALLARTA,2,200,1,203,1612
JALISCO,PUERTO VALLARTA,1,199,1,201,1248
JALISCO,PUERTO VALLARTA,0,166,2,168,1248
JALISCO,PUERTO VALLARTA,5,100,0,105,1819
JALISCO,PUERTO VALLARTA,10,115,4,129,1819
JALISCO,PUERTO VALLARTA,11,151,3,165,1773
JALISCO,PUERTO VALLARTA,11,180,2,193,1773
JALISCO,PUERTO VALLARTA,10,145,4,159,1773
JALISCO,PUERTO VALLARTA,12,183,2,197,1773
JALISCO,PUERTO VALLARTA,5,97,2,104,1398
JALISCO,PUERTO VALLARTA,9,100,0,109,1398
JALISCO,PUERTO VALLARTA,4,84,0,88,1397
JALISCO,PUERTO VALLARTA,15,75,2,92,1589
JALISCO,PUERTO VALLARTA,10,81,0,91,1589
JALISCO,PUERTO VALLARTA,14,177,1,192,1874
JALISCO,PUERTO VALLARTA,5,152,3,160,1874
JALISCO,PUERTO VALLARTA,8,182,0,190,1874
JALISCO,PUERTO VALLARTA,16,159,1,176,1873
JALISCO,PUERTO VALLARTA,11,150,1,162,1873
JALISCO,PUERTO VALLARTA,9,158,10,177,1873
JALISCO,PUERTO VALLARTA,10,175,2,187,1873
JALISCO,PUERTO VALLARTA,12,166,1,179,1873
JALISCO,PUERTO VALLARTA,4,206,2,212,1884
JALISCO,PUERTO VALLARTA,7,247,2,256,1884
JALISCO,PUERTO VALLARTA,11,149,0,160,1867
JALISCO,PUERTO VALLARTA,5,175,9,189,1867
JALISCO,PUERTO VALLARTA,3,176,1,180,1866
JALISCO,PUERTO VALLARTA,12,151,2,165,1866
JALISCO,PUERTO VALLARTA,9,163,0,172,1866
JALISCO,PUERTO VALLARTA,9,155,0,164,1866
JALISCO,PUERTO VALLARTA,5,181,7,193,1866
JALISCO,PUERTO VALLARTA,8,142,4,154,1866
JALISCO,PUERTO VALLARTA,6,164,3,173,1866
JALISCO,PUERTO VALLARTA,6,188,2,196,1530
JALISCO,PUERTO VALLARTA,8,179,2,189,1530
JALISCO,PUERTO VALLARTA,6,169,4,179,1530
JALISCO,PUERTO VALLARTA,27,207,2,236,1791
JALISCO,PUERTO VALLARTA,26,192,2,220,1791
JALISCO,PUERTO VALLARTA,17,215,3,235,1791
JALISCO,PUERTO VALLARTA,17,204,1,222,1791
JALISCO,PUERTO VALLARTA,5,209,2,216,1968
JALISCO,PUERTO VALLARTA,4,216,1,221,1968
JALISCO,PUERTO VALLARTA,6,218,4,228,1968
JALISCO,PUERTO VALLARTA,7,228,2,237,1798
JALISCO,PUERTO VALLARTA,7,209,3,219,1797
JALISCO,PUERTO VALLARTA,15,214,3,232,1797
JALISCO,PUERTO VALLARTA,12,173,2,187,1739
JALISCO,PUERTO VALLARTA,7,243,7,257,1739
JALISCO,PUERTO VALLARTA,4,198,1,203,1537
JALISCO,PUERTO VALLARTA,10,185,4,199,1537
JALISCO,PUERTO VALLARTA,8,156,4,168,1536
JALISCO,PUERTO VALLARTA,4,160,1,165,1536
JALISCO,PUERTO VALLARTA,10,259,3,272,1748
JALISCO,PUERTO VALLARTA,14,236,2,252,1748
JALISCO,PUERTO VALLARTA,6,191,4,201,1612
JALISCO,PUERTO VALLARTA,10,199,1,210,1611
JALISCO,PUERTO VALLARTA,11,186,2,199,1611
JALISCO,PUERTO VALLARTA,15,124,1,140,1759
JALISCO,PUERTO VALLARTA,26,138,0,164,1759
JALISCO,PUERTO VALLARTA,17,117,0,134,1758
JALISCO,PUERTO VALLARTA,20,131,1,152,1666
JALISCO,PUERTO VALLARTA,21,148,1,170,1665
JALISCO,PUERTO VALLARTA,14,131,0,145,1665
JALISCO,PUERTO VALLARTA,26,226,0,252,1852
JALISCO,PUERTO VALLARTA,31,209,1,241,1851
JALISCO,PUERTO VALLARTA,178,1435,14,1627,0
JALISCO,PUERTO VALLARTA,14,283,3,300,1983
JALISCO,PUERTO VALLARTA,14,286,4,304,1983
JALISCO,PUERTO VALLARTA,14,293,3,310,1982
JALISCO,PUERTO VALLARTA,17,135,0,152,1641
JALISCO,PUERTO VALLARTA,10,149,1,160,1641
JALISCO,PUERTO VALLARTA,13,164,1,178,1641
JALISCO,PUERTO VALLARTA,5,152,0,157,1641
JALISCO,PUERTO VALLARTA,12,215,1,228,1837
JALISCO,PUERTO VALLARTA,14,210,4,228,1837
JALISCO,PUERTO VALLARTA,22,157,2,181,1579
JALISCO,PUERTO VALLARTA,8,170,4,182,1579
JALISCO,PUERTO VALLARTA,18,183,2,203,1579
JALISCO,PUERTO VALLARTA,20,184,1,205,1409
JALISCO,PUERTO VALLARTA,17,153,1,171,1409
JALISCO,PUERTO VALLARTA,5,222,2,229,1642
JALISCO,PUERTO VALLARTA,10,186,5,201,1641
JALISCO,PUERTO VALLARTA,10,186,3,199,1641
JALISCO,PUERTO VALLARTA,12,186,0,198,1641
JALISCO,PUERTO VALLARTA,4,244,1,249,1641
JALISCO,PUERTO VALLARTA,1,186,3,190,1808
JALISCO,PUERTO VALLARTA,5,223,2,230,1807
JALISCO,PUERTO VALLARTA,9,159,1,169,1604
JALISCO,PUERTO VALLARTA,5,184,2,191,1604
JALISCO,PUERTO VALLARTA,3,131,1,135,1603
JALISCO,PUERTO VALLARTA,4,204,3,211,1508
JALISCO,PUERTO VALLARTA,5,192,1,198,1508
JALISCO,PUERTO VALLARTA,5,164,2,171,1576
JALISCO,PUERTO VALLARTA,15,178,0,193,1575
JALISCO,PUERTO VALLARTA,16,196,2,214,1955
JALISCO,PUERTO VALLARTA,11,212,4,227,1954
JALISCO,PUERTO VALLARTA,16,199,3,218,1631
JALISCO,PUERTO VALLARTA,1,184,1,186,1630
JALISCO,PUERTO VALLARTA,17,160,2,179,1296
JALISCO,PUERTO VALLARTA,13,158,2,173,1296
JALISCO,PUERTO VALLARTA,0,0,0,0,1529
JALISCO,PUERTO VALLARTA,0,0,0,0,1529
JALISCO,PUERTO VALLARTA,9,176,2,187,1727
JALISCO,PUERTO VALLARTA,19,169,2,190,1727
JALISCO,PUERTO VALLARTA,18,202,2,222,1726
JALISCO,PUERTO VALLARTA,5,200,3,208,1878
JALISCO,PUERTO VALLARTA,12,192,4,208,1877
JALISCO,PUERTO VALLARTA,3,278,15,296,1780
JALISCO,PUERTO VALLARTA,6,252,4,262,1780
JALISCO,PUERTO VALLARTA,3,288,11,302,1779
JALISCO,PUERTO VALLARTA,9,184,1,194,1417
JALISCO,PUERTO VALLARTA,5,154,3,162,1417
JALISCO,PUERTO VALLARTA,8,167,0,175,1416
JALISCO,PUERTO VALLARTA,6,215,4,225,1956
JALISCO,PUERTO VALLARTA,4,203,2,209,1956
JALISCO,PUERTO VALLARTA,7,199,2,208,1956
JALISCO,PUERTO VALLARTA,4,196,5,205,1956
JALISCO,PUERTO VALLARTA,11,191,2,204,1355
JALISCO,PUERTO VALLARTA,10,162,3,175,1355
JALISCO,PUERTO VALLARTA,8,163,2,173,1355
JALISCO,PUERTO VALLARTA,10,172,0,182,1825
JALISCO,PUERTO VALLARTA,8,197,3,208,1825
JALISCO,PUERTO VALLARTA,9,178,1,188,1825
JALISCO,PUERTO VALLARTA,12,176,2,190,1825
JALISCO,PUERTO VALLARTA,13,203,0,216,1824
JALISCO,PUERTO VALLARTA,7,163,2,172,1824
JALISCO,PUERTO VALLARTA,6,194,2,202,1824
JALISCO,PUERTO VALLARTA,3,174,1,178,1824
JALISCO,PUERTO VALLARTA,7,241,5,253,1620
JALISCO,PUERTO VALLARTA,7,233,3,243,1620
JALISCO,PUERTO VALLARTA,8,229,1,238,1794
JALISCO,PUERTO VALLARTA,11,203,3,217,1794
JALISCO,PUERTO VALLARTA,3,205,3,211,1794
JALISCO,PUERTO VALLARTA,9,183,0,192,1793
JALISCO,PUERTO VALLARTA,2,132,2,136,1386
JALISCO,PUERTO VALLARTA,6,121,4,131,1386
JALISCO,PUERTO VALLARTA,9,74,1,84,1252
JALISCO,PUERTO VALLARTA,4,55,0,59,1251
JALISCO,PUERTO VALLARTA,4,168,1,173,1070
JALISCO,PUERTO VALLARTA,2,161,1,164,1069
JALISCO,PUERTO VALLARTA,6,150,2,158,1133
JALISCO,PUERTO VALLARTA,12,138,1,151,1132
JALISCO,PUERTO VALLARTA,7,243,7,257,1726
JALISCO,PUERTO VALLARTA,18,221,4,243,1726
JALISCO,PUERTO VALLARTA,10,229,9,248,1725
JALISCO,PUERTO VALLARTA,5,144,3,152,1360
JALISCO,PUERTO VALLARTA,7,166,2,175,1360
JALISCO,PUERTO VALLARTA,3,163,4,170,1360
JALISCO,PUERTO VALLARTA,8,231,3,242,1587
JALISCO,PUERTO VALLARTA,10,234,5,249,1587
JALISCO,PUERTO VALLARTA,3,222,1,226,1914
JALISCO,PUERTO VALLARTA,3,176,3,182,1913
JALISCO,PUERTO VALLARTA,3,133,6,142,1551
JALISCO,PUERTO VALLARTA,4,153,2,159,1551
JALISCO,PUERTO VALLARTA,9,112,0,121,1551
JALISCO,PUERTO VALLARTA,1,125,1,127,1599
JALISCO,PUERTO VALLARTA,4,133,2,139,1599
JALISCO,PUERTO VALLARTA,1,137,0,138,1599
JALISCO,PUERTO VALLARTA,2,217,4,223,1472
JALISCO,PUERTO VALLARTA,7,195,1,203,1472
JALISCO,PUERTO VALLARTA,9,273,3,285,1583
JALISCO,PUERTO VALLARTA,8,285,5,298,1583
JALISCO,PUERTO VALLARTA,5,178,2,185,1540
JALISCO,PUERTO VALLARTA,7,238,2,247,1540
JALISCO,PUERTO VALLARTA,7,184,2,193,1863
JALISCO,PUERTO VALLARTA,1,167,1,169,1862
JALISCO,PUERTO VALLARTA,4,175,0,179,1890
JALISCO,PUERTO VALLARTA,5,206,1,212,1890
JALISCO,PUERTO VALLARTA,4,176,1,181,1432
JALISCO,PUERTO VALLARTA,6,166,0,172,1431
JALISCO,PUERTO VALLARTA,8,179,0,187,1431
JALISCO,PUERTO VALLARTA,9,189,3,201,1626
JALISCO,PUERTO VALLARTA,9,197,7,213,1625
JALISCO,PUERTO VALLARTA,2,175,4,181,1628
JALISCO,PUERTO VALLARTA,8,137,2,147,1628
JALISCO,ZAPOPAN,128,9,0,137,1214
JALISCO,ZAPOPAN,22,126,3,151,1214
JALISCO,ZAPOPAN,18,137,0,155,1974
JALISCO,ZAPOPAN,22,123,2,147,1973
JALISCO,ZAPOPAN,74,438,3,515,0
JALISCO,ZAPOPAN,14,101,2,117,1660
JALISCO,ZAPOPAN,19,126,3,148,1660
JALISCO,ZAPOPAN,11,137,3,151,1685
JALISCO,ZAPOPAN,14,118,8,140,1685
JALISCO,ZAPOPAN,16,120,2,138,1654
JALISCO,ZAPOPAN,28,109,1,138,1654
JALISCO,ZAPOPAN,26,81,0,107,1235
JALISCO,ZAPOPAN,36,120,0,156,1235
JALISCO,ZAPOPAN,28,111,0,139,1905
JALISCO,ZAPOPAN,35,131,0,166,1905
JALISCO,ZAPOPAN,19,118,2,139,1905
JALISCO,ZAPOPAN,19,115,1,135,1905
JALISCO,ZAPOPAN,28,109,1,138,1905
JALISCO,ZAPOPAN,40,122,0,162,1904
JALISCO,ZAPOPAN,28,138,0,166,1904
JALISCO,ZAPOPAN,35,169,2,206,2044
JALISCO,ZAPOPAN,17,136,0,153,1757
JALISCO,ZAPOPAN,17,115,1,133,1757
JALISCO,ZAPOPAN,20,72,1,93,1971
JALISCO,ZAPOPAN,9,84,1,94,1971
JALISCO,ZAPOPAN,18,90,1,109,1970
JALISCO,ZAPOPAN,17,115,2,134,1970
JALISCO,ZAPOPAN,20,85,3,108,1970
JALISCO,ZAPOPAN,11,73,1,85,1892
JALISCO,ZAPOPAN,15,87,2,104,1892
JALISCO,ZAPOPAN,13,94,0,107,1892
JALISCO,ZAPOPAN,10,93,1,104,1892
JALISCO,ZAPOPAN,11,104,1,116,1892
JALISCO,ZAPOPAN,13,117,0,130,1892
JALISCO,ZAPOPAN,12,87,1,100,1782
JALISCO,ZAPOPAN,31,95,2,128,1782
JALISCO,ZAPOPAN,20,92,7,119,1782
JALISCO,ZAPOPAN,25,117,1,143,1782
JALISCO,ZAPOPAN,20,109,0,129,1781
JALISCO,ZAPOPAN,19,132,1,152,1781
JALISCO,ZAPOPAN,14,80,3,97,1441
JALISCO,ZAPOPAN,12,73,1,86,1440
JALISCO,ZAPOPAN,18,85,0,103,1448
JALISCO,ZAPOPAN,20,80,2,102,1448
JALISCO,ZAPOPAN,11,82,4,97,1448
JALISCO,ZAPOPAN,15,88,0,103,1985
JALISCO,ZAPOPAN,13,100,4,117,1985
JALISCO,ZAPOPAN,15,116,1,132,1985
JALISCO,ZAPOPAN,11,104,2,117,1985
JALISCO,ZAPOPAN,10,82,3,95,1985
JALISCO,ZAPOPAN,10,117,3,130,1984
JALISCO,ZAPOPAN,14,83,2,99,2022
JALISCO,ZAPOPAN,12,88,0,100,2022
JALISCO,ZAPOPAN,16,86,2,104,2022
JALISCO,ZAPOPAN,10,96,3,109,2022
JALISCO,ZAPOPAN,4,96,0,100,2022
JALISCO,ZAPOPAN,13,100,0,113,2022
JALISCO,ZAPOPAN,95,14,2,111,2022
JALISCO,ZAPOPAN,6,100,2,108,2022
JALISCO,ZAPOPAN,4,97,2,103,2022
JALISCO,ZAPOPAN,14,79,6,99,1887
JALISCO,ZAPOPAN,12,65,2,79,1886
JALISCO,ZAPOPAN,7,67,1,75,1886
JALISCO,ZAPOPAN,12,71,0,83,1728
JALISCO,ZAPOPAN,18,71,0,89,1728
JALISCO,ZAPOPAN,31,66,1,98,1727
JALISCO,ZAPOPAN,7,154,6,167,1596
JALISCO,ZAPOPAN,5,125,1,131,1595
JALISCO,ZAPOPAN,32,104,1,137,2076
JALISCO,ZAPOPAN,29,112,0,141,2076
JALISCO,ZAPOPAN,18,128,3,149,2076
JALISCO,ZAPOPAN,22,121,0,143,2076
JALISCO,ZAPOPAN,30,113,0,143,2076
JALISCO,ZAPOPAN,41,123,1,165,2076
JALISCO,ZAPOPAN,17,203,2,222,1743
JALISCO,ZAPOPAN,23,205,7,235,1743
JALISCO,ZAPOPAN,25,191,0,216,1742
JALISCO,ZAPOPAN,20,116,4,140,1704
JALISCO,ZAPOPAN,24,139,0,163,1704
JALISCO,ZAPOPAN,30,163,1,194,1752
JALISCO,ZAPOPAN,31,185,2,218,1751
JALISCO,ZAPOPAN,21,194,0,215,1656
JALISCO,ZAPOPAN,21,185,3,209,1655
JALISCO,ZAPOPAN,24,177,4,205,1828
JALISCO,ZAPOPAN,22,151,4,177,1827
JALISCO,ZAPOPAN,12,71,1,84,1096
JALISCO,ZAPOPAN,18,96,0,114,1095
JALISCO,ZAPOPAN,27,158,0,185,1945
JALISCO,ZAPOPAN,25,154,0,179,1945
JALISCO,ZAPOPAN,17,163,4,184,1870
JALISCO,ZAPOPAN,15,138,1,154,1869
JALISCO,ZAPOPAN,11,110,4,125,1441
JALISCO,ZAPOPAN,8,95,4,107,1440
JALISCO,ZAPOPAN,20,131,4,155,1592
JALISCO,ZAPOPAN,27,117,4,148,1591
JALISCO,ZAPOPAN,25,105,2,132,1591
JALISCO,ZAPOPAN,18,156,2,176,1989
JALISCO,ZAPOPAN,15,166,2,183,1989
JALISCO,ZAPOPAN,110,26,0,136,1627
JALISCO,ZAPOPAN,10,128,2,140,1627
JALISCO,ZAPOPAN,21,134,0,155,1627
JALISCO,ZAPOPAN,20,136,1,157,1818
JALISCO,ZAPOPAN,23,148,2,173,1817
JALISCO,ZAPOPAN,31,79,1,111,1894
JALISCO,ZAPOPAN,29,76,0,105,1894
JALISCO,ZAPOPAN,21,51,0,72,1748
JALISCO,ZAPOPAN,16,40,0,56,1748
JALISCO,ZAPOPAN,13,49,1,63,1747
JALISCO,ZAPOPAN,23,59,0,82,1747
JALISCO,ZAPOPAN,17,50,0,67,1689
JALISCO,ZAPOPAN,34,71,0,105,1689
JALISCO,ZAPOPAN,25,129,1,155,1746
JALISCO,ZAPOPAN,18,124,0,142,1745
JALISCO,ZAPOPAN,10,96,1,107,1845
JALISCO,ZAPOPAN,23,80,1,104,1845
JALISCO,ZAPOPAN,13,85,3,101,1695
JALISCO,ZAPOPAN,9,85,1,95,1695
JALISCO,ZAPOPAN,12,70,0,82,1808
JALISCO,ZAPOPAN,9,75,1,85,1808
JALISCO,ZAPOPAN,14,98,1,113,1923
JALISCO,ZAPOPAN,15,95,0,110,1923
JALISCO,ZAPOPAN,16,88,1,105,1923
JALISCO,ZAPOPAN,16,81,0,97,1923
JALISCO,ZAPOPAN,18,87,0,105,1923
JALISCO,ZAPOPAN,10,90,1,101,1923
JALISCO,ZAPOPAN,14,95,0,109,1923
JALISCO,ZAPOPAN,11,95,0,106,1440
JALISCO,ZAPOPAN,13,71,4,88,1440
JALISCO,ZAPOPAN,8,94,1,103,1440
JALISCO,ZAPOPAN,11,121,1,133,1853
JALISCO,ZAPOPAN,12,118,1,131,1853
JALISCO,ZAPOPAN,10,96,1,107,1853
JALISCO,ZAPOPAN,14,96,1,111,1556
JALISCO,ZAPOPAN,20,96,2,118,1556
JALISCO,ZAPOPAN,24,91,2,117,1769
JALISCO,ZAPOPAN,15,89,2,106,1768
JALISCO,ZAPOPAN,20,100,1,121,1768
JALISCO,ZAPOPAN,25,92,2,119,1768
JALISCO,ZAPOPAN,38,47,0,85,2069
JALISCO,ZAPOPAN,28,33,0,61,2068
JALISCO,ZAPOPAN,8,83,2,93,1896
JALISCO,ZAPOPAN,14,77,2,93,1895
JALISCO,ZAPOPAN,31,119,4,154,1604
JALISCO,ZAPOPAN,23,111,0,134,1604
JALISCO,ZAPOPAN,41,91,0,132,1603
JALISCO,ZAPOPAN,26,118,0,144,1925
JALISCO,ZAPOPAN,27,123,0,150,1924
JALISCO,ZAPOPAN,33,104,0,137,1596
JALISCO,ZAPOPAN,10,96,0,106,1596
JALISCO,ZAPOPAN,29,95,1,125,1595
JALISCO,ZAPOPAN,35,102,0,137,1686
JALISCO,ZAPOPAN,28,83,0,111,1685
JALISCO,ZAPOPAN,21,61,1,83,1713
JALISCO,ZAPOPAN,21,74,0,95,1712
JALISCO,ZAPOPAN,15,78,0,93,1428
JALISCO,ZAPOPAN,30,64,1,95,1428
JALISCO,ZAPOPAN,23,104,2,129,1335
JALISCO,ZAPOPAN,21,87,0,108,1335
JALISCO,ZAPOPAN,37,131,0,168,1845
JALISCO,ZAPOPAN,22,106,1,129,1844
JALISCO,ZAPOPAN,24,85,2,111,1520
JALISCO,ZAPOPAN,27,82,1,110,1520
JALISCO,ZAPOPAN,47,132,2,181,2048
JALISCO,ZAPOPAN,20,83,103,206,1282
JALISCO,ZAPOPAN,33,73,1,107,1282
JALISCO,ZAPOPAN,30,102,0,132,1874
JALISCO,ZAPOPAN,31,77,0,108,1874
JALISCO,ZAPOPAN,33,121,1,155,1874
JALISCO,ZAPOPAN,24,121,0,145,2044
JALISCO,ZAPOPAN,20,131,0,151,2044
JALISCO,ZAPOPAN,16,83,1,100,1775
JALISCO,ZAPOPAN,17,105,3,125,1775
JALISCO,ZAPOPAN,27,108,0,135,1775
JALISCO,ZAPOPAN,32,103,0,135,1911
JALISCO,ZAPOPAN,28,117,2,147,1911
JALISCO,ZAPOPAN,12,72,0,84,1136
JALISCO,ZAPOPAN,3,63,4,70,1136
JALISCO,ZAPOPAN,6,69,2,77,1093
JALISCO,ZAPOPAN,17,51,1,69,1092
JALISCO,ZAPOPAN,38,97,0,135,1863
JALISCO,ZAPOPAN,54,87,1,142,1862
JALISCO,ZAPOPAN,39,75,1,115,1632
JALISCO,ZAPOPAN,22,85,0,107,1631
JALISCO,ZAPOPAN,42,35,1,78,1450
JALISCO,ZAPOPAN,25,32,1,58,1450
JALISCO,ZAPOPAN,38,16,0,54,1763
JALISCO,ZAPOPAN,39,20,0,59,1763
JALISCO,ZAPOPAN,25,46,0,71,2052
JALISCO,ZAPOPAN,28,56,0,84,2051
JALISCO,ZAPOPAN,22,41,1,64,1798
JALISCO,ZAPOPAN,23,34,0,57,1797
JALISCO,ZAPOPAN,7,79,1,87,1250
JALISCO,ZAPOPAN,6,67,0,73,1249
JALISCO,ZAPOPAN,18,115,1,134,1733
JALISCO,ZAPOPAN,28,119,0,147,1732
JALISCO,ZAPOPAN,14,94,0,108,1521
JALISCO,ZAPOPAN,18,111,0,129,1520
JALISCO,ZAPOPAN,16,109,1,126,1978
JALISCO,ZAPOPAN,16,109,1,126,1978
JALISCO,ZAPOPAN,8,100,0,108,1410
JALISCO,ZAPOPAN,12,93,1,106,1410
JALISCO,ZAPOPAN,10,88,0,98,1410
JALISCO,ZAPOPAN,19,77,2,98,1398
JALISCO,ZAPOPAN,20,86,1,107,1398
JALISCO,ZAPOPAN,13,70,0,83,1397
JALISCO,TONALA,16,167,1,184,1652
JALISCO,TONALA,20,140,0,160,1651
JALISCO,TONALA,10,158,1,169,1651
JALISCO,TONALA,7,117,0,124,1636
JALISCO,TONALA,8,126,1,135,1636
JALISCO,TONALA,13,118,1,132,1636
JALISCO,TONALA,7,106,1,114,1636
JALISCO,TONALA,11,165,7,183,1910
JALISCO,TONALA,16,152,7,175,1909
JALISCO,TONALA,17,140,3,160,1850
JALISCO,TONALA,10,176,4,190,1850
JALISCO,TONALA,9,150,1,160,1849
JALISCO,TONALA,11,145,2,158,1630
JALISCO,TONALA,9,135,0,144,1630
JALISCO,TONALA,10,133,1,144,1653
JALISCO,TONALA,5,135,2,142,1653
JALISCO,TONALA,8,117,1,126,1653
JALISCO,TONALA,11,124,3,138,1863
JALISCO,TONALA,16,135,2,153,1862
JALISCO,TONALA,15,123,0,138,1862
JALISCO,TONALA,13,163,6,182,1862
JALISCO,TONALA,12,130,5,147,1862
JALISCO,TONALA,18,141,5,164,1788
JALISCO,TONALA,22,163,0,185,1788
JALISCO,TONALA,25,149,1,175,1788
JALISCO,TONALA,26,142,0,168,1788
JALISCO,TONALA,13,155,5,173,1788
JALISCO,TONALA,13,143,2,158,1787
JALISCO,TONALA,4,122,3,129,1617
JALISCO,TONALA,3,113,1,117,1617
JALISCO,TONALA,8,120,1,129,1617
JALISCO,TONALA,9,100,1,110,1617
JALISCO,TONALA,7,100,1,108,1617
JALISCO,TONALA,11,142,4,157,1458
JALISCO,TONALA,12,127,1,140,1457
JALISCO,TONALA,15,115,3,133,1457
JALISCO,TONALA,31,165,3,199,1979
JALISCO,TONALA,24,183,1,208,1978
JALISCO,TONALA,9,110,1,120,1413
JALISCO,TONALA,6,157,0,163,1413
JALISCO,TONALA,12,161,2,175,1885
JALISCO,TONALA,13,155,2,170,1884
JALISCO,TONALA,12,112,1,125,1051
JALISCO,TONALA,8,109,0,117,1051
JALISCO,TONALA,11,112,1,124,1595
JALISCO,TONALA,5,102,1,108,1595
JALISCO,TONALA,10,152,1,163,1522
JALISCO,TONALA,19,135,3,157,1521
JALISCO,TONALA,4,151,2,157,1327
JALISCO,TONALA,5,119,1,125,1327
JALISCO,TONALA,12,172,3,187,1615
JALISCO,TONALA,14,126,7,147,1614
JALISCO,TONALA,11,116,3,130,1227
JALISCO,TONALA,11,137,0,148,1227
JALISCO,TONALA,8,96,0,104,1727
JALISCO,TONALA,9,82,2,93,1727
JALISCO,TONALA,8,82,2,92,1727
JALISCO,TONALA,5,96,3,104,1727
JALISCO,TONALA,11,104,0,115,1727
JALISCO,TONALA,8,79,0,87,1727
JALISCO,TONALA,4,90,1,95,1727
JALISCO,TONALA,9,94,1,104,1852
JALISCO,TONALA,4,103,0,107,1852
JALISCO,TONALA,11,130,1,142,1852
JALISCO,TONALA,13,88,0,101,1852
JALISCO,TONALA,9,98,2,109,1852
JALISCO,TONALA,13,112,0,125,1852
JALISCO,TONALA,11,70,0,81,1852
JALISCO,TONALA,19,108,0,127,1852
JALISCO,TONALA,11,123,1,135,1973
JALISCO,TONALA,16,131,2,149,1973
JALISCO,TONALA,8,111,1,120,1973
JALISCO,TONALA,15,128,1,144,1972
JALISCO,TONALA,13,135,1,149,1972
JALISCO,TONALA,17,153,4,174,1972
JALISCO,TONALA,14,157,4,175,1392
JALISCO,TONALA,11,129,1,141,1391
JALISCO,TONALA,12,105,1,118,1506
JALISCO,TONALA,6,123,1,130,1505
JALISCO,TONALA,5,109,1,115,1505
JALISCO,TONALA,13,88,0,101,1505
JALISCO,TONALA,11,124,1,136,1504
JALISCO,TONALA,13,123,2,138,1504
JALISCO,TONALA,26,147,2,175,1692
JALISCO,TONALA,9,164,2,175,1692
JALISCO,TONALA,15,130,2,147,1823
JALISCO,TONALA,15,138,0,153,1822
JALISCO,TONALA,19,117,2,138,1976
JALISCO,TONALA,13,141,2,156,1976
JALISCO,TONALA,28,150,4,182,1976
JALISCO,TONALA,14,132,1,147,1975
JALISCO,TONALA,16,130,0,146,1943
JALISCO,TONALA,16,168,3,187,1943
JALISCO,TONALA,11,132,1,144,1652
JALISCO,TONALA,19,129,0,148,1651
JALISCO,TONALA,21,138,1,160,1651
JALISCO,TONALA,8,78,1,87,1118
JALISCO,TONALA,11,92,2,105,1118
JALISCO,TONALA,136,955,23,1114,0
JALISCO,TONALA,6,89,0,95,1048
JALISCO,TONALA,9,79,1,89,1048
JALISCO,TONALA,12,92,2,106,1741
JALISCO,TONALA,8,103,3,114,1741
JALISCO,TONALA,14,117,2,133,1338
JALISCO,TONALA,18,127,1,146,1338
JALISCO,TONALA,19,129,3,151,1338
JALISCO,TONALA,8,92,1,101,1641
JALISCO,TONALA,18,123,0,141,1641
JALISCO,TONALA,12,112,1,125,1641
JALISCO,TONALA,12,135,1,148,1641
JALISCO,TONALA,13,115,1,129,1641
JALISCO,TONALA,13,97,2,112,1422
JALISCO,TONALA,13,95,1,109,1422
JALISCO,TONALA,12,147,2,161,1713
JALISCO,TONALA,20,121,2,143,1713
JALISCO,TONALA,9,159,2,170,1723
JALISCO,TONALA,14,147,2,163,1723
JALISCO,TONALA,13,141,2,156,1543
JALISCO,TONALA,18,125,4,147,1543
JALISCO,TONALA,30,186,4,220,1816
JALISCO,TONALA,27,182,2,211,1815
JALISCO,TONALA,16,143,0,159,1209
JALISCO,TONALA,17,146,0,163,1209
JALISCO,TONALA,18,134,4,156,1752
JALISCO,TONALA,11,132,2,145,1752
JALISCO,TONALA,19,123,4,146,1752
JALISCO,TONALA,20,131,0,151,1751
JALISCO,TONALA,15,148,2,165,1550
JALISCO,TONALA,20,188,3,211,1550
JALISCO,TONALA,19,153,1,173,1884
JALISCO,TONALA,19,136,1,156,1884
JALISCO,TONALA,17,155,2,174,1884
JALISCO,TONALA,21,146,0,167,1884
JALISCO,TONALA,21,141,2,164,1884
JALISCO,TONALA,15,140,3,158,1656
JALISCO,TONALA,20,126,1,147,1655
JALISCO,TONALA,15,141,0,156,1655
JALISCO,TONALA,33,127,3,163,1655
JALISCO,TONALA,22,128,0,150,1908
JALISCO,TONALA,22,130,2,154,1908
JALISCO,TONALA,21,136,1,158,1908
JALISCO,TONALA,19,124,3,146,1908
JALISCO,TONALA,19,112,3,134,1908
JALISCO,TONALA,10,139,1,150,1633
JALISCO,TONALA,19,144,0,163,1632
JALISCO,TONALA,15,91,0,106,1031
JALISCO,TONALA,12,90,1,103,1031
JALISCO,TONALA,19,149,0,168,1750
JALISCO,TONALA,17,182,2,201,1750
JALISCO,TONALA,13,146,2,161,1749
JALISCO,TONALA,7,103,3,113,1327
JALISCO,TONALA,10,94,1,105,1327
JALISCO,TONALA,7,98,3,108,1326
JALISCO,TONALA,16,160,3,179,1482
JALISCO,TONALA,12,131,0,143,1482
JALISCO,TONALA,18,187,0,205,1381
JALISCO,TONALA,11,168,2,181,1381
JALISCO,TONALA,13,148,2,163,1354
JALISCO,TONALA,17,116,2,135,1354
JALISCO,TONALA,21,139,6,166,1592
JALISCO,TONALA,14,124,3,141,1591
JALISCO,TONALA,14,147,2,163,1591
JALISCO,GUADALAJARA,38,137,2,177,1822
JALISCO,GUADALAJARA,29,166,0,195,1822
JALISCO,GUADALAJARA,41,129,0,170,1726
JALISCO,GUADALAJARA,40,105,0,145,1725
JALISCO,GUADALAJARA,57,54,0,111,1711
JALISCO,GUADALAJARA,66,53,1,120,1711
JALISCO,GUADALAJARA,32,104,0,136,1670
JALISCO,GUADALAJARA,29,89,0,118,1670
JALISCO,GUADALAJARA,50,87,1,138,1669
JALISCO,GUADALAJARA,34,120,2,156,1618
JALISCO,GUADALAJARA,20,131,0,151,1617
JALISCO,GUADALAJARA,36,123,1,160,1698
JALISCO,GUADALAJARA,32,136,0,168,1697
JALISCO,GUADALAJARA,37,121,0,158,1759
JALISCO,GUADALAJARA,46,176,2,224,1758
JALISCO,GUADALAJARA,18,87,1,106,1220
JALISCO,GUADALAJARA,16,79,1,96,1219
JALISCO,GUADALAJARA,16,134,0,150,1760
JALISCO,GUADALAJARA,13,141,3,157,1759
JALISCO,GUADALAJARA,31,110,2,143,1667
JALISCO,GUADALAJARA,32,87,0,119,1667
JALISCO,GUADALAJARA,36,125,1,162,1548
JALISCO,GUADALAJARA,25,117,2,144,1548
JALISCO,GUADALAJARA,28,72,0,100,1088
JALISCO,GUADALAJARA,21,87,3,111,1087
JALISCO,GUADALAJARA,48,82,1,131,1751
JALISCO,GUADALAJARA,39,106,1,146,1750
JALISCO,GUADALAJARA,46,73,0,119,1883
JALISCO,GUADALAJARA,52,51,4,107,1882
JALISCO,GUADALAJARA,23,156,3,182,1754
JALISCO,GUADALAJARA,19,161,3,183,1753
JALISCO,GUADALAJARA,14,109,0,123,1466
JALISCO,GUADALAJARA,14,106,3,123,1466
JALISCO,GUADALAJARA,14,104,2,120,1466
JALISCO,GUADALAJARA,31,154,1,186,1712
JALISCO,GUADALAJARA,29,180,2,211,1711
JALISCO,GUADALAJARA,24,133,1,158,1789
JALISCO,GUADALAJARA,10,132,1,143,1789
JALISCO,GUADALAJARA,26,150,3,179,1738
JALISCO,GUADALAJARA,11,148,4,163,1737
JALISCO,GUADALAJARA,17,178,3,198,1783
JALISCO,GUADALAJARA,24,137,1,162,1783
JALISCO,GUADALAJARA,11,86,1,98,1410
JALISCO,GUADALAJARA,12,81,0,93,1410
JALISCO,GUADALAJARA,12,102,0,114,1410
JALISCO,GUADALAJARA,40,45,0,85,1484
JALISCO,GUADALAJARA,63,56,0,119,1484
JALISCO,GUADALAJARA,61,78,2,141,1869
JALISCO,GUADALAJARA,50,68,2,120,1869
JALISCO,GUADALAJARA,72,83,1,156,2000
JALISCO,GUADALAJARA,40,70,0,110,1377
JALISCO,GUADALAJARA,45,65,0,110,1376
JALISCO,GUADALAJARA,16,110,0,126,1402
JALISCO,GUADALAJARA,11,104,0,115,1402
JALISCO,GUADALAJARA,29,154,0,183,1808
JALISCO,GUADALAJARA,23,158,1,182,1808
JALISCO,GUADALAJARA,9,100,2,111,1779
JALISCO,GUADALAJARA,7,100,0,107,1779
JALISCO,GUADALAJARA,19,126,1,146,1468
JALISCO,GUADALAJARA,18,119,1,138,1468
JALISCO,GUADALAJARA,25,135,0,160,1467
JALISCO,GUADALAJARA,31,119,2,152,1711
JALISCO,GUADALAJARA,21,156,1,178,1711
JALISCO,GUADALAJARA,16,133,2,151,1710
JALISCO,GUADALAJARA,39,119,1,159,1919
JALISCO,GUADALAJARA,40,138,0,178,1918
JALISCO,GUADALAJARA,36,107,1,144,1463
JALISCO,GUADALAJARA,25,104,3,132,1462
JALISCO,GUADALAJARA,21,144,2,167,1761
JALISCO,GUADALAJARA,20,152,4,176,1761
JALISCO,GUADALAJARA,9,131,2,142,1517
JALISCO,GUADALAJARA,17,131,0,148,1517
JALISCO,GUADALAJARA,22,118,0,140,1860
JALISCO,GUADALAJARA,19,131,0,150,1860
JALISCO,GUADALAJARA,19,139,1,159,2001
JALISCO,GUADALAJARA,21,144,1,166,2001
JALISCO,GUADALAJARA,30,112,2,144,1593
JALISCO,GUADALAJARA,20,111,3,134,1592
JALISCO,GUADALAJARA,20,100,1,121,1592
JALISCO,GUADALAJARA,206,1274,6,1486,0
JALISCO,GUADALAJARA,28,91,0,119,1648
JALISCO,GUADALAJARA,30,113,0,143,1648
JALISCO,GUADALAJARA,24,88,1,113,1085
JALISCO,GUADALAJARA,20,88,0,108,1084
JALISCO,GUADALAJARA,12,86,1,99,1553
JALISCO,GUADALAJARA,22,95,0,117,1553
JALISCO,GUADALAJARA,25,127,2,154,1441
JALISCO,GUADALAJARA,21,112,0,133,1440
JALISCO,GUADALAJARA,30,150,1,181,1846
JALISCO,GUADALAJARA,33,160,1,194,1845
JALISCO,GUADALAJARA,43,68,0,111,1471
JALISCO,GUADALAJARA,43,63,3,109,1470
JALISCO,GUADALAJARA,42,57,1,100,1204
JALISCO,GUADALAJARA,39,43,2,84,1203
JALISCO,GUADALAJARA,22,168,3,193,1690
JALISCO,GUADALAJARA,17,162,4,183,1690
JALISCO,GUADALAJARA,44,31,0,75,1760
JALISCO,GUADALAJARA,34,43,0,77,1759
JALISCO,GUADALAJARA,64,44,1,109,1870
JALISCO,GUADALAJARA,59,51,1,111,1869
JALISCO,GUADALAJARA,33,106,3,142,1658
JALISCO,GUADALAJARA,30,101,1,132,1658
JALISCO,GUADALAJARA,32,116,5,153,1658
JALISCO,GUADALAJARA,46,111,0,157,1847
JALISCO,GUADALAJARA,67,115,1,183,1846
JALISCO,GUADALAJARA,30,141,8,179,1855
JALISCO,GUADALAJARA,41,184,0,225,1854
JALISCO,GUADALAJARA,27,180,3,210,1802
JALISCO,GUADALAJARA,40,192,2,234,1802
JALISCO,GUADALAJARA,27,166,4,197,1559
JALISCO,GUADALAJARA,31,134,3,168,1559
JALISCO,GUADALAJARA,46,148,0,194,1875
JALISCO,GUADALAJARA,42,164,0,206,1875
JALISCO,GUADALAJARA,28,119,1,148,1680
JALISCO,GUADALAJARA,30,124,1,155,1680
JALISCO,GUADALAJARA,19,132,1,152,1459
JALISCO,GUADALAJARA,33,127,1,161,1459
JALISCO,GUADALAJARA,17,105,1,123,1458
JALISCO,GUADALAJARA,19,118,0,137,1402
JALISCO,GUADALAJARA,27,102,3,132,1401
JALISCO,GUADALAJARA,66,49,4,119,1833
JALISCO,GUADALAJARA,75,48,1,124,1833
JALISCO,GUADALAJARA,26,23,2,51,1168
JALISCO,GUADALAJARA,39,39,3,81,1167
JALISCO,GUADALAJARA,54,56,3,113,1744
JALISCO,GUADALAJARA,35,61,2,98,1744
JALISCO,GUADALAJARA,52,50,0,102,1571
JALISCO,GUADALAJARA,43,62,2,107,1570
JALISCO,GUADALAJARA,53,132,1,186,1692
JALISCO,GUADALAJARA,42,119,0,161,1691
JALISCO,GUADALAJARA,26,164,3,193,1796
JALISCO,GUADALAJARA,16,149,4,169,1795
JALISCO,GUADALAJARA,33,150,3,186,1659
JALISCO,GUADALAJARA,28,118,1,147,1659
JALISCO,GUADALAJARA,37,83,1,121,1623
JALISCO,GUADALAJARA,25,113,6,144,1623
JALISCO,GUADALAJARA,22,171,2,195,1502
JALISCO,GUADALAJARA,9,123,3,135,1502
JALISCO,GUADALAJARA,15,136,3,154,1501
JALISCO,GUADALAJARA,30,126,2,158,1624
JALISCO,GUADALAJARA,27,112,2,141,1624
JALISCO,GUADALAJARA,32,206,2,240,2028
JALISCO,GUADALAJARA,43,193,0,236,2027
JALISCO,GUADALAJARA,39,126,0,165,1831
JALISCO,GUADALAJARA,40,127,1,168,1830
JALISCO,GUADALAJARA,31,72,1,104,1537
JALISCO,GUADALAJARA,31,103,0,134,1536
JALISCO,GUADALAJARA,25,85,3,113,1536
JALISCO,GUADALAJARA,49,37,2,88,1473
JALISCO,GUADALAJARA,51,46,1,98,1473
JALISCO,GUADALAJARA,48,44,1,93,1472
JALISCO,GUADALAJARA,65,50,2,117,2032
JALISCO,GUADALAJARA,25,129,1,155,1778
JALISCO,GUADALAJARA,26,121,1,148,1777
JALISCO,GUADALAJARA,30,129,2,161,1767
JALISCO,GUADALAJARA,25,158,0,183,1767
JALISCO,GUADALAJARA,25,148,2,175,1701
JALISCO,GUADALAJARA,26,159,0,185,1700
JALISCO,GUADALAJARA,22,147,0,169,1786
JALISCO,GUADALAJARA,18,136,1,155,1786
JALISCO,GUADALAJARA,30,155,6,191,1908
JALISCO,GUADALAJARA,24,171,4,199,1907
JALISCO,GUADALAJARA,20,125,2,147,1231
JALISCO,GUADALAJARA,9,109,3,121,1230
JALISCO,GUADALAJARA,20,160,2,182,1632
JALISCO,GUADALAJARA,26,192,1,219,1632
JALISCO,GUADALAJARA,28,178,2,208,1885
JALISCO,GUADALAJARA,21,155,2,178,1884
JALISCO,GUADALAJARA,43,191,2,236,2020
JALISCO,GUADALAJARA,31,178,5,214,2020
JALISCO,GUADALAJARA,28,95,0,123,1179
JALISCO,GUADALAJARA,28,109,1,138,1179
JALISCO,GUADALAJARA,28,174,1,203,1601
JALISCO,GUADALAJARA,24,159,0,183,1601
JALISCO,GUADALAJARA,18,144,4,166,1656
JALISCO,GUADALAJARA,19,135,2,156,1656
JALISCO,GUADALAJARA,26,129,1,156,1655
JALISCO,GUADALAJARA,48,118,3,169,1561
JALISCO,GUADALAJARA,44,120,3,167,1560
JALISCO,GUADALAJARA,22,76,0,98,1143
JALISCO,GUADALAJARA,28,97,0,125,1143
JALISCO,GUADALAJARA,30,93,0,123,1354
JALISCO,GUADALAJARA,90,39,1,130,1353
JALISCO,GUADALAJARA,39,134,2,175,1845
JALISCO,GUADALAJARA,38,154,0,192,1844
JALISCO,GUADALAJARA,25,134,0,159,1470
JALISCO,GUADALAJARA,37,149,1,187,1469
JALISCO,GUADALAJARA,24,91,1,116,1185
JALISCO,GUADALAJARA,15,68,1,84,1184
JALISCO,GUADALAJARA,39,139,0,178,1840
JALISCO,GUADALAJARA,44,113,0,157,1839
JALISCO,GUADALAJARA,35,124,0,159,1826
JALISCO,GUADALAJARA,18,135,0,153,1825
JALISCO,GUADALAJARA,35,49,0,84,1385
JALISCO,GUADALAJARA,24,47,2,73,1385
JALISCO,GUADALAJARA,21,155,0,176,1538
JALISCO,GUADALAJARA,11,149,3,163,1537
JALISCO,GUADALAJARA,17,144,1,162,1396
JALISCO,GUADALAJARA,14,128,0,142,1395
JALISCO,GUADALAJARA,15,146,0,161,1332
JALISCO,GUADALAJARA,12,121,2,135,1332
JALISCO,GUADALAJARA,10,147,2,159,1331
JALISCO,GUADALAJARA,11,110,1,122,1418
JALISCO,GUADALAJARA,8,150,5,163,1418
JALISCO,GUADALAJARA,3,165,0,168,1607
JALISCO,GUADALAJARA,14,151,0,165,1606
JALISCO,GUADALAJARA,8,137,1,146,1606
JALISCO,GUADALAJARA,6,143,2,151,1341
JALISCO,GUADALAJARA,7,160,0,167,1340
JALISCO,GUADALAJARA,17,122,1,140,1897
JALISCO,GUADALAJARA,24,129,1,154,1897
JALISCO,GUADALAJARA,14,92,0,106,1506
JALISCO,GUADALAJARA,5,94,1,100,1505
JALISCO,GUADALAJARA,11,105,1,117,1505
JALISCO,GUADALAJARA,23,181,2,206,1805
JALISCO,GUADALAJARA,14,143,4,161,1804
JALISCO,GUADALAJARA,19,132,1,152,1493
JALISCO,GUADALAJARA,21,149,0,170,1492
JALISCO,GUADALAJARA,35,159,2,196,1933
JALISCO,GUADALAJARA,19,164,0,183,1932
JALISCO,GUADALAJARA,24,128,0,152,1717
JALISCO,GUADALAJARA,19,133,1,153,1716
JALISCO,GUADALAJARA,28,165,2,195,1794
JALISCO,GUADALAJARA,26,154,4,184,1794
JALISCO,GUADALAJARA,15,162,2,179,1794
JALISCO,GUADALAJARA,20,88,3,111,1335
JALISCO,GUADALAJARA,20,91,4,115,1335
JALISCO,GUADALAJARA,7,86,1,94,1335
JALISCO,GUADALAJARA,14,130,1,145,1621
JALISCO,GUADALAJARA,13,125,1,139,1621
JALISCO,GUADALAJARA,9,124,1,134,1620
JALISCO,GUADALAJARA,7,128,1,136,1301
JALISCO,GUADALAJARA,7,171,0,178,1300
JALISCO,GUADALAJARA,17,172,2,191,1886
JALISCO,GUADALAJARA,25,128,2,155,1886
JALISCO,GUADALAJARA,15,107,1,123,1318
JALISCO,GUADALAJARA,28,116,1,145,1318
JALISCO,GUADALAJARA,17,108,1,126,1193
JALISCO,GUADALAJARA,8,110,0,118,1192
JALISCO,GUADALAJARA,25,148,0,173,1670
JALISCO,GUADALAJARA,29,137,2,168,1669
JALISCO,GUADALAJARA,26,123,3,152,1669
JALISCO,GUADALAJARA,25,130,1,156,1669
JALISCO,GUADALAJARA,34,147,0,181,1927
JALISCO,GUADALAJARA,24,150,1,175,1927
JALISCO,GUADALAJARA,7,159,2,168,1638
JALISCO,GUADALAJARA,9,145,5,159,1637
JALISCO,GUADALAJARA,22,96,2,120,1451
JALISCO,GUADALAJARA,17,110,1,128,1450
JALISCO,GUADALAJARA,30,131,1,162,1796
JALISCO,GUADALAJARA,15,146,2,163,1796
JALISCO,GUADALAJARA,26,158,3,187,1901
JALISCO,GUADALAJARA,15,155,0,170,1901
JALISCO,GUADALAJARA,20,99,1,120,1456
JALISCO,GUADALAJARA,16,104,0,120,1455
JALISCO,GUADALAJARA,19,130,1,150,1467
JALISCO,GUADALAJARA,21,127,0,148,1467
JALISCO,GUADALAJARA,18,139,2,159,1467
JALISCO,GUADALAJARA,23,170,2,195,1671
JALISCO,GUADALAJARA,15,166,4,185,1670
JALISCO,GUADALAJARA,5,86,3,94,1048
JALISCO,GUADALAJARA,4,72,2,78,1047
JALISCO,GUADALAJARA,18,131,3,152,1845
JALISCO,GUADALAJARA,13,150,0,163,1845
JALISCO,GUADALAJARA,14,136,2,152,1279
JALISCO,GUADALAJARA,10,120,1,131,1279
JALISCO,GUADALAJARA,13,80,1,94,1049
JALISCO,GUADALAJARA,9,78,1,88,1049
JALISCO,GUADALAJARA,13,177,4,194,1879
JALISCO,GUADALAJARA,13,175,3,191,1878
JALISCO,GUADALAJARA,14,110,4,128,1162
JALISCO,GUADALAJARA,15,104,0,119,1161
JALISCO,GUADALAJARA,16,140,3,159,1483
JALISCO,GUADALAJARA,10,124,1,135,1483
JALISCO,GUADALAJARA,15,142,4,161,1623
JALISCO,GUADALAJARA,13,168,2,183,1622
JALISCO,GUADALAJARA,16,144,0,160,1862
JALISCO,GUADALAJARA,25,144,0,169,1862
JALISCO,GUADALAJARA,20,107,0,127,1394
JALISCO,GUADALAJARA,17,136,2,155,1394
JALISCO,GUADALAJARA,14,129,1,144,1394
JALISCO,GUADALAJARA,29,160,1,190,1502
JALISCO,GUADALAJARA,35,164,1,200,1502
JALISCO,GUADALAJARA,6,136,1,143,1664
JALISCO,GUADALAJARA,18,126,2,146,1663
JALISCO,GUADALAJARA,18,144,4,166,1758
JALISCO,GUADALAJARA,17,141,0,158,1757
JALISCO,GUADALAJARA,9,129,3,141,1812
JALISCO,GUADALAJARA,14,155,1,170,1812
JALISCO,GUADALAJARA,8,118,1,127,1322
JALISCO,GUADALAJARA,6,94,3,103,1321
JALISCO,GUADALAJARA,19,118,3,140,1678
JALISCO,GUADALAJARA,22,120,2,144,1677
JALISCO,GUADALAJARA,13,120,1,134,1147
JALISCO,GUADALAJARA,5,108,1,114,1146
JALISCO,GUADALAJARA,10,122,3,135,1828
JALISCO,GUADALAJARA,14,155,2,171,1828
JALISCO,GUADALAJARA,28,160,0,188,1619
JALISCO,GUADALAJARA,23,167,0,190,1619
JALISCO,GUADALAJARA,21,109,4,134,1522
JALISCO,GUADALAJARA,10,107,1,118,1521
JALISCO,GUADALAJARA,11,144,0,155,1521
JALISCO,GUADALAJARA,14,185,1,200,1958
JALISCO,GUADALAJARA,39,170,5,214,1566
JALISCO,GUADALAJARA,29,166,2,197,1565
JALISCO,GUADALAJARA,87,499,5,591,0
JALISCO,GUADALAJARA,24,164,3,191,1696
JALISCO,GUADALAJARA,29,172,1,202,1696
JALISCO,GUADALAJARA,29,197,6,232,1872
JALISCO,GUADALAJARA,33,188,2,223,1871
JALISCO,GUADALAJARA,27,183,3,213,1764
JALISCO,GUADALAJARA,16,158,1,175,1764
JALISCO,GUADALAJARA,16,141,0,157,1765
JALISCO,GUADALAJARA,16,158,3,177,1764
JALISCO,GUADALAJARA,20,169,3,192,1710
JALISCO,GUADALAJARA,21,156,2,179,1709
JALISCO,GUADALAJARA,14,98,0,112,1469
JALISCO,GUADALAJARA,13,110,1,124,1468
JALISCO,GUADALAJARA,7,134,3,144,1855
JALISCO,GUADALAJARA,16,148,1,165,1855
JALISCO,GUADALAJARA,23,137,1,161,1648
JALISCO,GUADALAJARA,11,135,2,148,1647
JALISCO,GUADALAJARA,18,150,3,171,1866
JALISCO,GUADALAJARA,14,159,4,177,1865
JALISCO,GUADALAJARA,20,198,6,224,1920
JALISCO,GUADALAJARA,16,195,0,211,1920
JALISCO,GUADALAJARA,16,120,5,141,1705
JALISCO,GUADALAJARA,22,160,4,186,1704
JALISCO,GUADALAJARA,33,153,3,189,1366
JALISCO,GUADALAJARA,13,139,1,153,1366
JALISCO,GUADALAJARA,18,145,3,166,1365
JALISCO,GUADALAJARA,31,155,0,186,1866
JALISCO,GUADALAJARA,20,173,2,195,1866
JALISCO,GUADALAJARA,28,127,4,159,1400
JALISCO,GUADALAJARA,19,122,1,142,1400
JALISCO,GUADALAJARA,31,134,2,167,1400
JALISCO,GUADALAJARA,21,167,4,192,1437
JALISCO,GUADALAJARA,15,119,0,134,1437
JALISCO,GUADALAJARA,24,123,1,148,1436
JALISCO,GUADALAJARA,15,135,3,153,1816
JALISCO,GUADALAJARA,19,144,0,163,1816
JALISCO,GUADALAJARA,13,170,4,187,1535
JALISCO,GUADALAJARA,14,150,0,164,1535
JALISCO,GUADALAJARA,12,169,1,182,1603
JALISCO,GUADALAJARA,12,162,4,178,1603
JALISCO,GUADALAJARA,12,140,1,153,1558
JALISCO,GUADALAJARA,14,151,1,166,1558
JALISCO,GUADALAJARA,6,160,6,172,1856
JALISCO,GUADALAJARA,12,166,5,183,1855
JALISCO,GUADALAJARA,10,104,3,117,1306
JALISCO,GUADALAJARA,10,108,2,120,1305
JALISCO,GUADALAJARA,14,162,1,177,1858
JALISCO,GUADALAJARA,10,152,3,165,1857
JALISCO,GUADALAJARA,12,158,2,172,1352
JALISCO,GUADALAJARA,10,158,0,168,1351
JALISCO,GUADALAJARA,6,142,2,150,1351
JALISCO,GUADALAJARA,19,128,4,151,1427
JALISCO,GUADALAJARA,11,133,0,144,1427
JALISCO,GUADALAJARA,16,126,1,143,1427
JALISCO,GUADALAJARA,14,132,0,146,1409
JALISCO,GUADALAJARA,8,113,0,121,1408
JALISCO,GUADALAJARA,10,133,9,152,1413
JALISCO,GUADALAJARA,12,115,1,128,1412
JALISCO,GUADALAJARA,13,144,4,161,1863
JALISCO,GUADALAJARA,13,142,2,157,1862
JALISCO,GUADALAJARA,15,185,0,200,1673
JALISCO,GUADALAJARA,14,151,5,170,1672
JALISCO,GUADALAJARA,20,154,3,177,1502
JALISCO,GUADALAJARA,18,124,1,143,1501
JALISCO,GUADALAJARA,16,137,1,154,1425
JALISCO,GUADALAJARA,11,104,3,118,1424
JALISCO,GUADALAJARA,21,122,1,144,1424
JALISCO,GUADALAJARA,18,162,2,182,1500
JALISCO,GUADALAJARA,14,161,0,175,1499
JALISCO,GUADALAJARA,17,155,3,175,1408
JALISCO,GUADALAJARA,9,153,0,162,1408
JALISCO,GUADALAJARA,27,169,0,196,1901
JALISCO,GUADALAJARA,23,162,1,186,1901
JALISCO,GUADALAJARA,19,148,3,170,1737
JALISCO,GUADALAJARA,21,182,2,205,1737
JALISCO,GUADALAJARA,18,149,0,167,1737
JALISCO,GUADALAJARA,17,125,2,144,1665
JALISCO,GUADALAJARA,12,113,3,128,1665
JALISCO,GUADALAJARA,20,160,3,183,1967
JALISCO,GUADALAJARA,25,170,4,199,1967
JALISCO,ZAPOPAN,37,37,0,74,1555
JALISCO,ZAPOPAN,34,22,0,56,1554
JALISCO,ZAPOPAN,33,26,2,61,1262
JALISCO,ZAPOPAN,37,28,1,66,1261
JALISCO,ZAPOPAN,35,27,2,64,1041
JALISCO,ZAPOPAN,36,30,2,68,1040
JALISCO,ZAPOPAN,43,62,1,106,1601
JALISCO,ZAPOPAN,43,61,1,105,1600
JALISCO,ZAPOPAN,30,45,0,75,1406
JALISCO,ZAPOPAN,37,38,0,75,1405
JALISCO,ZAPOPAN,51,68,0,119,1803
JALISCO,ZAPOPAN,59,67,2,128,1802
JALISCO,ZAPOPAN,60,45,1,106,1934
JALISCO,ZAPOPAN,50,55,2,107,1933
JALISCO,ZAPOPAN,37,57,0,94,1746
JALISCO,ZAPOPAN,31,94,0,125,1745
JALISCO,ZAPOPAN,19,85,0,104,1745
JALISCO,ZAPOPAN,34,66,1,101,1745
JALISCO,ZAPOPAN,35,62,0,97,1745
JALISCO,ZAPOPAN,36,50,1,87,1982
JALISCO,ZAPOPAN,40,44,1,85,1982
JALISCO,ZAPOPAN,48,53,1,102,1982
JALISCO,ZAPOPAN,32,39,0,71,1981
JALISCO,ZAPOPAN,27,45,1,73,1981
JALISCO,ZAPOPAN,73,64,0,137,1858
JALISCO,ZAPOPAN,51,67,0,118,1858
JALISCO,ZAPOPAN,64,89,1,154,1904
JALISCO,ZAPOPAN,59,79,1,139,1903
JALISCO,ZAPOPAN,61,54,0,115,1656
JALISCO,ZAPOPAN,56,58,1,115,1656
JALISCO,ZAPOPAN,64,67,0,131,1802
JALISCO,ZAPOPAN,79,86,0,165,1802
JALISCO,ZAPOPAN,77,92,0,169,1953
JALISCO,ZAPOPAN,23,77,1,101,1803
JALISCO,ZAPOPAN,26,86,1,113,1803
JALISCO,ZAPOPAN,29,70,2,101,1754
JALISCO,ZAPOPAN,32,80,5,117,1754
JALISCO,ZAPOPAN,22,71,1,94,1531
JALISCO,ZAPOPAN,28,88,0,116,1530
JALISCO,ZAPOPAN,21,56,0,77,1688
JALISCO,ZAPOPAN,34,73,2,109,1688
JALISCO,ZAPOPAN,54,71,2,127,1355
JALISCO,ZAPOPAN,44,81,0,125,1355
JALISCO,ZAPOPAN,36,63,0,99,1355
JALISCO,ZAPOPAN,69,58,0,127,1843
JALISCO,ZAPOPAN,45,50,0,95,1842
JALISCO,ZAPOPAN,57,71,0,128,1894
JALISCO,ZAPOPAN,45,84,0,129,1893
JALISCO,ZAPOPAN,35,59,0,94,1597
JALISCO,ZAPOPAN,41,57,0,98,1597
JALISCO,ZAPOPAN,43,70,0,113,1597
JALISCO,ZAPOPAN,37,69,0,106,1596
JALISCO,ZAPOPAN,31,63,0,94,1596
JALISCO,ZAPOPAN,52,63,1,116,1746
JALISCO,ZAPOPAN,78,80,3,161,1746
JALISCO,ZAPOPAN,30,60,0,90,1422
JALISCO,ZAPOPAN,38,68,0,106,1421
JALISCO,ZAPOPAN,49,54,1,104,1421
JALISCO,ZAPOPAN,48,110,0,158,1960
JALISCO,ZAPOPAN,38,127,1,166,1960
JALISCO,ZAPOPAN,40,92,4,136,1960
JALISCO,ZAPOPAN,35,103,1,139,1960
JALISCO,ZAPOPAN,26,90,0,116,1583
JALISCO,ZAPOPAN,44,84,0,128,1582
JALISCO,ZAPOPAN,12,96,2,110,1959
JALISCO,ZAPOPAN,6,94,5,105,1958
JALISCO,ZAPOPAN,9,120,2,131,1958
JALISCO,ZAPOPAN,185,616,10,811,0
JALISCO,ZAPOPAN,12,64,1,77,1508
JALISCO,ZAPOPAN,11,83,2,96,1508
JALISCO,ZAPOPAN,6,55,0,61,1508
JALISCO,ZAPOPAN,17,130,1,148,1665
JALISCO,ZAPOPAN,13,143,2,158,1665
JALISCO,ZAPOPAN,21,141,0,162,1664
JALISCO,ZAPOPAN,25,167,3,195,1937
JALISCO,ZAPOPAN,30,125,1,156,1937
JALISCO,ZAPOPAN,25,118,5,148,1936
JALISCO,ZAPOPAN,17,173,3,193,1977
JALISCO,ZAPOPAN,34,130,1,165,1585
JALISCO,ZAPOPAN,25,145,4,174,1584
JALISCO,ZAPOPAN,41,96,0,137,1772
JALISCO,ZAPOPAN,33,90,0,123,1771
JALISCO,ZAPOPAN,41,87,1,129,1771
JALISCO,ZAPOPAN,28,160,1,189,1399
JALISCO,ZAPOPAN,21,168,0,189,1398
JALISCO,ZAPOPAN,34,193,1,228,1768
JALISCO,ZAPOPAN,32,191,2,225,1768
JALISCO,ZAPOPAN,22,120,1,143,1929
JALISCO,ZAPOPAN,35,116,2,153,1929
JALISCO,ZAPOPAN,48,83,0,131,1796
JALISCO,ZAPOPAN,51,90,2,143,1796
JALISCO,ZAPOPAN,43,59,2,104,1309
JALISCO,ZAPOPAN,48,54,0,102,1309
JALISCO,ZAPOPAN,41,75,0,116,1215
JALISCO,ZAPOPAN,30,76,0,106,1214
JALISCO,ZAPOPAN,54,63,1,118,1732
JALISCO,ZAPOPAN,53,69,1,123,1731
JALISCO,ZAPOPAN,37,44,0,81,1286
JALISCO,ZAPOPAN,42,52,0,94,1286
JALISCO,ZAPOPAN,37,79,2,118,1630
JALISCO,ZAPOPAN,80,59,1,140,1630
JALISCO,ZAPOPAN,36,87,3,126,1629
JALISCO,ZAPOPAN,21,109,1,131,1266
JALISCO,ZAPOPAN,32,93,6,131,1266
JALISCO,ZAPOPAN,57,81,1,139,1925
JALISCO,ZAPOPAN,63,88,3,154,1924
JALISCO,ZAPOPAN,19,95,2,116,1004
JALISCO,ZAPOPAN,19,105,1,125,1003
JALISCO,ZAPOPAN,11,106,2,119,1336
JALISCO,ZAPOPAN,4,118,1,123,1335
JALISCO,ZAPOPAN,11,94,2,107,1335
JALISCO,ZAPOPAN,9,82,4,95,1938
JALISCO,ZAPOPAN,12,126,1,139,1938
JALISCO,ZAPOPAN,15,110,2,127,1937
JALISCO,ZAPOPAN,16,105,2,123,1937
JALISCO,ZAPOPAN,9,85,0,94,1937
JALISCO,ZAPOPAN,14,79,0,93,1937
JALISCO,ZAPOPAN,15,80,0,95,1828
JALISCO,ZAPOPAN,10,77,0,87,1828
JALISCO,ZAPOPAN,14,84,0,98,1827
JALISCO,ZAPOPAN,12,92,2,106,1670
JALISCO,ZAPOPAN,9,124,1,134,1670
JALISCO,ZAPOPAN,5,102,2,109,1669
JALISCO,ZAPOPAN,8,129,3,140,1895
JALISCO,ZAPOPAN,22,157,0,179,1895
JALISCO,ZAPOPAN,13,88,0,101,1808
JALISCO,ZAPOPAN,14,90,0,104,1808
JALISCO,ZAPOPAN,7,100,0,107,1808
JALISCO,ZAPOPAN,17,115,1,133,1632
JALISCO,ZAPOPAN,13,94,0,107,1631
JALISCO,ZAPOPAN,7,105,0,112,1631
JALISCO,ZAPOPAN,26,122,2,150,1400
JALISCO,ZAPOPAN,28,96,3,127,1400
JALISCO,ZAPOPAN,27,112,1,140,1399
JALISCO,ZAPOPAN,20,148,3,171,1736
JALISCO,ZAPOPAN,34,118,0,152,1735
JALISCO,ZAPOPAN,57,84,0,141,1657
JALISCO,ZAPOPAN,58,96,0,154,1657
JALISCO,ZAPOPAN,46,86,2,134,1657
JALISCO,ZAPOPAN,39,66,0,105,1317
JALISCO,ZAPOPAN,42,89,1,132,1317
JALISCO,ZAPOPAN,35,82,0,117,1317
JALISCO,ZAPOPAN,18,90,4,112,1679
JALISCO,ZAPOPAN,20,84,1,105,1679
JALISCO,ZAPOPAN,25,93,3,121,1678
JALISCO,ZAPOPAN,18,82,0,100,1716
JALISCO,ZAPOPAN,15,71,1,87,1715
JALISCO,ZAPOPAN,19,102,2,123,1977
JALISCO,ZAPOPAN,15,118,1,134,1976
JALISCO,ZAPOPAN,21,114,2,137,1976
JALISCO,ZAPOPAN,19,79,3,101,1419
JALISCO,ZAPOPAN,33,60,0,93,1418
JALISCO,ZAPOPAN,28,84,1,113,1418
JALISCO,ZAPOPAN,8,90,2,100,1544
JALISCO,ZAPOPAN,11,95,2,108,1544
JALISCO,ZAPOPAN,5,76,0,81,1550
JALISCO,ZAPOPAN,8,52,3,63,1549
JALISCO,ZAPOPAN,5,51,1,57,1549
JALISCO,ZAPOPAN,18,124,1,143,1977
JALISCO,ZAPOPAN,18,84,3,105,1977
JALISCO,ZAPOPAN,19,68,0,87,1481
JALISCO,ZAPOPAN,15,66,3,84,1480
JALISCO,ZAPOPAN,3,48,1,52,1161
JALISCO,ZAPOPAN,4,41,0,45,1161
JALISCO,ZAPOPAN,10,105,3,118,1569
JALISCO,ZAPOPAN,10,103,1,114,1569
JALISCO,ZAPOPAN,27,107,1,135,1648
JALISCO,ZAPOPAN,32,84,1,117,1647
JALISCO,ZAPOPAN,25,100,0,125,1233
JALISCO,ZAPOPAN,24,78,0,102,1233
JALISCO,ZAPOPAN,24,51,1,76,1371
JALISCO,ZAPOPAN,21,70,0,91,1371
JALISCO,ZAPOPAN,27,60,2,89,1371
JALISCO,ZAPOPAN,37,90,0,127,1884
JALISCO,ZAPOPAN,42,81,1,124,1883
JALISCO,ZAPOPAN,10,67,0,77,1421
JALISCO,ZAPOPAN,11,45,1,57,1421
JALISCO,ZAPOPAN,21,98,3,122,1943
JALISCO,ZAPOPAN,38,38,1,77,1415
JALISCO,ZAPOPAN,58,49,0,107,1415
JALISCO,ZAPOPAN,53,51,1,105,1415
JALISCO,ZAPOPAN,28,43,0,71,1077
JALISCO,ZAPOPAN,22,50,0,72,1077
JALISCO,ZAPOPAN,10,65,0,75,1336
JALISCO,ZAPOPAN,14,41,0,55,1336
JALISCO,ZAPOPAN,13,57,0,70,1335
JALISCO,GUADALAJARA,14,171,3,188,1767
JALISCO,GUADALAJARA,17,156,1,174,1766
JALISCO,GUADALAJARA,18,149,2,169,1650
JALISCO,GUADALAJARA,19,140,3,162,1649
JALISCO,GUADALAJARA,14,107,0,121,1364
JALISCO,GUADALAJARA,21,107,0,128,1363
JALISCO,GUADALAJARA,22,180,5,207,1925
JALISCO,GUADALAJARA,12,182,0,194,1924
JALISCO,GUADALAJARA,16,113,0,129,1382
JALISCO,GUADALAJARA,20,125,1,146,1382
JALISCO,GUADALAJARA,15,119,2,136,1369
JALISCO,GUADALAJARA,17,118,2,137,1369
JALISCO,GUADALAJARA,9,134,0,143,1368
JALISCO,GUADALAJARA,21,157,1,179,1965
JALISCO,GUADALAJARA,17,140,0,157,1964
JALISCO,GUADALAJARA,18,173,4,195,1730
JALISCO,GUADALAJARA,18,169,1,188,1729
JALISCO,GUADALAJARA,9,123,2,134,1054
JALISCO,GUADALAJARA,12,143,3,158,1053
JALISCO,GUADALAJARA,13,189,5,207,1404
JALISCO,GUADALAJARA,11,165,1,177,1404
JALISCO,GUADALAJARA,13,165,1,179,1403
JALISCO,GUADALAJARA,18,189,0,207,1610
JALISCO,GUADALAJARA,15,228,8,251,1609
JALISCO,GUADALAJARA,25,190,4,219,1946
JALISCO,GUADALAJARA,13,226,4,243,1945
JALISCO,GUADALAJARA,5,118,3,126,998
JALISCO,GUADALAJARA,8,124,0,132,997
JALISCO,GUADALAJARA,30,154,2,186,1452
JALISCO,GUADALAJARA,21,129,1,151,1451
JALISCO,GUADALAJARA,65,646,4,715,0
JALISCO,GUADALAJARA,14,186,1,201,1465
JALISCO,GUADALAJARA,5,187,2,194,1464
JALISCO,GUADALAJARA,15,137,4,156,1599
JALISCO,GUADALAJARA,18,142,2,162,1599
JALISCO,GUADALAJARA,15,145,3,163,1660
JALISCO,GUADALAJARA,7,175,4,186,1660
JALISCO,GUADALAJARA,13,130,4,147,1716
JALISCO,GUADALAJARA,21,154,1,176,1715
JALISCO,GUADALAJARA,25,144,4,173,1916
JALISCO,GUADALAJARA,19,176,8,203,1915
JALISCO,GUADALAJARA,19,178,0,197,1939
JALISCO,GUADALAJARA,20,189,0,209,1938
JALISCO,GUADALAJARA,17,165,1,183,1892
JALISCO,GUADALAJARA,30,174,1,205,1891
JALISCO,GUADALAJARA,18,99,3,120,1322
JALISCO,GUADALAJARA,11,125,1,137,1322
JALISCO,GUADALAJARA,24,107,2,133,1322
JALISCO,GUADALAJARA,27,158,3,188,1921
JALISCO,GUADALAJARA,14,118,1,133,1362
JALISCO,GUADALAJARA,15,82,0,97,1361
JALISCO,GUADALAJARA,17,149,1,167,1501
JALISCO,GUADALAJARA,12,141,0,153,1501
JALISCO,GUADALAJARA,11,94,3,108,1207
JALISCO,GUADALAJARA,13,106,3,122,1207
JALISCO,GUADALAJARA,24,158,1,183,1932
JALISCO,GUADALAJARA,22,164,2,188,1931
JALISCO,GUADALAJARA,26,116,0,142,1468
JALISCO,GUADALAJARA,27,124,1,152,1467
JALISCO,GUADALAJARA,22,115,0,137,1467
JALISCO,GUADALAJARA,15,180,3,198,1600
JALISCO,GUADALAJARA,32,166,1,199,1600
JALISCO,GUADALAJARA,35,183,17,235,1802
JALISCO,GUADALAJARA,32,227,6,265,1802
JALISCO,GUADALAJARA,27,121,3,151,1392
JALISCO,GUADALAJARA,18,122,3,143,1391
JALISCO,GUADALAJARA,11,128,4,143,1384
JALISCO,GUADALAJARA,10,132,0,142,1384
JALISCO,GUADALAJARA,6,184,5,195,1852
JALISCO,GUADALAJARA,9,162,2,173,1852
JALISCO,GUADALAJARA,14,152,5,171,1622
JALISCO,GUADALAJARA,14,129,0,143,1621
JALISCO,GUADALAJARA,16,118,3,137,1319
JALISCO,GUADALAJARA,13,108,2,123,1318
JALISCO,GUADALAJARA,10,123,5,138,1318
JALISCO,GUADALAJARA,18,169,0,187,1619
JALISCO,GUADALAJARA,18,158,2,178,1619
JALISCO,GUADALAJARA,16,229,1,246,1843
JALISCO,GUADALAJARA,3,204,4,211,1842
JALISCO,GUADALAJARA,12,122,1,135,1394
JALISCO,GUADALAJARA,24,127,2,153,1394
JALISCO,GUADALAJARA,17,142,2,161,1394
JALISCO,GUADALAJARA,11,145,13,169,1163
JALISCO,GUADALAJARA,12,112,1,125,1163
JALISCO,GUADALAJARA,10,139,3,152,1837
JALISCO,GUADALAJARA,17,182,1,200,1836
JALISCO,GUADALAJARA,12,119,0,131,1549
JALISCO,GUADALAJARA,23,103,2,128,1549
JALISCO,GUADALAJARA,13,145,0,158,1818
JALISCO,GUADALAJARA,13,171,4,188,1817
JALISCO,GUADALAJARA,29,138,1,168,1815
JALISCO,GUADALAJARA,23,140,1,164,1814
JALISCO,GUADALAJARA,13,132,1,146,1834
JALISCO,GUADALAJARA,13,132,1,146,1834
JALISCO,GUADALAJARA,17,143,0,160,1260
JALISCO,GUADALAJARA,19,110,1,130,1259
JALISCO,GUADALAJARA,9,159,2,170,1673
JALISCO,GUADALAJARA,11,143,2,156,1673
JALISCO,GUADALAJARA,27,176,0,203,1534
JALISCO,GUADALAJARA,16,171,3,190,1534
JALISCO,GUADALAJARA,21,126,0,147,1784
JALISCO,GUADALAJARA,21,146,2,169,1783
JALISCO,GUADALAJARA,20,129,0,149,1741
JALISCO,GUADALAJARA,10,119,0,129,1741
JALISCO,GUADALAJARA,9,142,1,152,1740
JALISCO,GUADALAJARA,19,157,1,177,1918
JALISCO,GUADALAJARA,11,150,3,164,1917
JALISCO,GUADALAJARA,16,130,2,148,1647
JALISCO,GUADALAJARA,28,166,0,194,1647
JALISCO,GUADALAJARA,14,144,1,159,1867
JALISCO,GUADALAJARA,26,141,2,169,1867
JALISCO,GUADALAJARA,22,109,2,133,1423
JALISCO,GUADALAJARA,22,113,0,135,1423
JALISCO,GUADALAJARA,35,133,0,168,1733
JALISCO,GUADALAJARA,34,144,4,182,1732
JALISCO,GUADALAJARA,14,124,1,139,1707
JALISCO,GUADALAJARA,19,169,0,188,1707
JALISCO,GUADALAJARA,27,105,3,135,1159
JALISCO,GUADALAJARA,23,103,1,127,1158
JALISCO,GUADALAJARA,22,178,1,201,1753
JALISCO,GUADALAJARA,24,157,0,181,1753
JALISCO,GUADALAJARA,13,158,4,175,1753
JALISCO,GUADALAJARA,20,140,1,161,1600
JALISCO,GUADALAJARA,18,139,3,160,1600
JALISCO,GUADALAJARA,13,149,2,164,1600
JALISCO,GUADALAJARA,18,129,1,148,1405
JALISCO,GUADALAJARA,24,138,0,162,1404
JALISCO,GUADALAJARA,18,147,4,169,1716
JALISCO,GUADALAJARA,20,144,0,164,1716
JALISCO,GUADALAJARA,20,139,2,161,1818
JALISCO,GUADALAJARA,22,153,0,175,1817
JALISCO,GUADALAJARA,23,107,1,131,1443
JALISCO,GUADALAJARA,17,104,1,122,1442
JALISCO,GUADALAJARA,10,110,1,121,1442
JALISCO,GUADALAJARA,23,126,0,149,1442
JALISCO,GUADALAJARA,14,129,3,146,1442
JALISCO,GUADALAJARA,19,136,4,159,1370
JALISCO,GUADALAJARA,14,131,2,147,1370
JALISCO,GUADALAJARA,6,135,2,143,1369
JALISCO,GUADALAJARA,14,124,0,138,1526
JALISCO,GUADALAJARA,11,152,5,168,1526
JALISCO,GUADALAJARA,17,146,4,167,1699
JALISCO,GUADALAJARA,17,157,1,175,1698
JALISCO,GUADALAJARA,12,139,1,152,1509
JALISCO,GUADALAJARA,16,129,2,147,1508
JALISCO,GUADALAJARA,18,111,1,130,1474
JALISCO,GUADALAJARA,14,111,0,125,1473
JALISCO,GUADALAJARA,13,132,1,146,1846
JALISCO,GUADALAJARA,17,127,3,147,1846
JALISCO,GUADALAJARA,5,85,2,92,1102
JALISCO,GUADALAJARA,7,80,0,87,1101
JALISCO,GUADALAJARA,11,170,3,184,1634
JALISCO,GUADALAJARA,14,194,4,212,1633
JALISCO,GUADALAJARA,17,176,2,195,1604
JALISCO,GUADALAJARA,21,172,1,194,1604
JALISCO,GUADALAJARA,11,147,6,164,1357
JALISCO,GUADALAJARA,12,124,2,138,1357
JALISCO,GUADALAJARA,22,149,4,175,1660
JALISCO,GUADALAJARA,18,165,1,184,1660
JALISCO,GUADALAJARA,17,124,0,141,1849
JALISCO,GUADALAJARA,27,134,0,161,1848
JALISCO,GUADALAJARA,17,150,1,168,1848
JALISCO,GUADALAJARA,19,147,0,166,1662
JALISCO,GUADALAJARA,18,156,0,174,1661
JALISCO,GUADALAJARA,23,159,0,182,1589
JALISCO,GUADALAJARA,31,138,2,171,1589
JALISCO,GUADALAJARA,28,161,2,191,1646
JALISCO,GUADALAJARA,14,148,1,163,1645
JALISCO,GUADALAJARA,26,161,1,188,1941
JALISCO,GUADALAJARA,19,170,0,189,1940
JALISCO,GUADALAJARA,23,152,1,176,1733
JALISCO,GUADALAJARA,40,142,2,184,1732
JALISCO,GUADALAJARA,28,103,0,131,1559
JALISCO,GUADALAJARA,23,141,0,164,1559
JALISCO,GUADALAJARA,23,117,1,141,1559
JALISCO,GUADALAJARA,12,109,0,121,1131
JALISCO,GUADALAJARA,17,114,1,132,1131
JALISCO,GUADALAJARA,23,106,3,132,1429
JALISCO,GUADALAJARA,24,114,2,140,1428
JALISCO,GUADALAJARA,31,128,3,162,1485
JALISCO,GUADALAJARA,36,123,2,161,1485
JALISCO,GUADALAJARA,40,141,2,183,1484
JALISCO,GUADALAJARA,28,93,0,121,1222
JALISCO,GUADALAJARA,26,122,1,149,1221
JALISCO,GUADALAJARA,14,157,2,173,1518
JALISCO,GUADALAJARA,14,121,0,135,1518
JALISCO,GUADALAJARA,22,103,2,127,1170
JALISCO,GUADALAJARA,17,97,0,114,1169
JALISCO,GUADALAJARA,38,155,2,195,1483
JALISCO,GUADALAJARA,25,136,0,161,1483
JALISCO,GUADALAJARA,29,173,0,202,1644
JALISCO,GUADALAJARA,38,146,2,186,1643
JALISCO,GUADALAJARA,52,140,3,195,1545
JALISCO,GUADALAJARA,41,153,1,195,1544
JALISCO,SANTA CRUZ DE LAS FLORES,7,115,2,124,1798
JALISCO,SANTA CRUZ DE LAS FLORES,11,131,1,143,1798
JALISCO,SANTA CRUZ DE LAS FLORES,11,138,2,151,1577
JALISCO,SANTA CRUZ DE LAS FLORES,3,128,0,131,1577
JALISCO,SANTA CRUZ DE LAS FLORES,9,139,0,148,1576
JALISCO,SANTA CRUZ DE LAS FLORES,9,70,0,79,1714
JALISCO,SANTA CRUZ DE LAS FLORES,18,57,1,76,1714
JALISCO,SANTA CRUZ DE LAS FLORES,13,82,0,95,1713
JALISCO,SANTA CRUZ DE LAS FLORES,17,52,0,69,1713
JALISCO,SANTA CRUZ DE LAS FLORES,16,75,0,91,1713
JALISCO,SANTA CRUZ DE LAS FLORES,24,81,2,107,1799
JALISCO,SANTA CRUZ DE LAS FLORES,33,92,1,126,1799
JALISCO,SANTA CRUZ DE LAS FLORES,26,98,0,124,1799
JALISCO,SANTA CRUZ DE LAS FLORES,34,77,2,113,1798
JALISCO,SANTA CRUZ DE LAS FLORES,25,77,3,105,1335
JALISCO,SANTA CRUZ DE LAS FLORES,17,66,0,83,1334
JALISCO,SANTA CRUZ DE LAS FLORES,24,110,0,134,1919
JALISCO,SANTA CRUZ DE LAS FLORES,18,89,2,109,1919
JALISCO,SANTA CRUZ DE LAS FLORES,15,114,1,130,1770
JALISCO,SANTA CRUZ DE LAS FLORES,10,125,1,136,1769
JALISCO,SANTA CRUZ DE LAS FLORES,5,86,0,91,1639
JALISCO,SANTA CRUZ DE LAS FLORES,12,95,2,109,1639
JALISCO,SANTA CRUZ DE LAS FLORES,7,87,0,94,1639
JALISCO,SANTA CRUZ DE LAS FLORES,10,103,1,114,1833
JALISCO,SANTA CRUZ DE LAS FLORES,11,88,2,101,1832
JALISCO,SANTA CRUZ DE LAS FLORES,11,93,0,104,1832
JALISCO,SANTA CRUZ DE LAS FLORES,10,76,0,86,1832
JALISCO,SANTA CRUZ DE LAS FLORES,13,105,0,118,1832
JALISCO,SANTA CRUZ DE LAS FLORES,6,83,2,91,1322
JALISCO,SANTA CRUZ DE LAS FLORES,14,78,0,92,1321
JALISCO,SANTA CRUZ DE LAS FLORES,13,93,1,107,1321
JALISCO,SANTA CRUZ DE LAS FLORES,6,90,0,96,1750
JALISCO,SANTA CRUZ DE LAS FLORES,7,84,3,94,1750
JALISCO,SANTA CRUZ DE LAS FLORES,8,89,3,100,1750
JALISCO,SANTA CRUZ DE LAS FLORES,11,84,2,97,1750
JALISCO,SANTA CRUZ DE LAS FLORES,4,105,4,113,1749
JALISCO,SANTA CRUZ DE LAS FLORES,7,96,3,106,1749
JALISCO,SANTA CRUZ DE LAS FLORES,8,81,2,91,1749
JALISCO,SANTA CRUZ DE LAS FLORES,20,129,0,149,1490
JALISCO,SANTA CRUZ DE LAS FLORES,22,117,2,141,1489
JALISCO,SANTA CRUZ DE LAS FLORES,23,141,3,167,1489
JALISCO,SANTA CRUZ DE LAS FLORES,23,167,2,192,1670
JALISCO,SANTA CRUZ DE LAS FLORES,24,142,3,169,1670
JALISCO,SANTA CRUZ DE LAS FLORES,7,141,0,148,1670
JALISCO,SANTA CRUZ DE LAS FLORES,14,197,1,212,1382
JALISCO,SANTA CRUZ DE LAS FLORES,3,212,3,218,1382
JALISCO,SANTA CRUZ DE LAS FLORES,4,110,2,116,1633
JALISCO,SANTA CRUZ DE LAS FLORES,11,105,4,120,1633
JALISCO,SANTA CRUZ DE LAS FLORES,16,253,4,273,1869
JALISCO,SANTA CRUZ DE LAS FLORES,7,90,0,97,1653
JALISCO,SANTA CRUZ DE LAS FLORES,5,88,0,93,1652
JALISCO,SANTA CRUZ DE LAS FLORES,7,100,1,108,1621
JALISCO,SANTA CRUZ DE LAS FLORES,13,81,1,95,1621
JALISCO,SANTA CRUZ DE LAS FLORES,6,59,2,67,1620
JALISCO,SANTA CRUZ DE LAS FLORES,27,23,1,51,1332
JALISCO,SANTA CRUZ DE LAS FLORES,30,27,0,57,1332
JALISCO,SANTA CRUZ DE LAS FLORES,29,23,1,53,1332
JALISCO,SANTA CRUZ DE LAS FLORES,8,118,1,127,1679
JALISCO,SANTA CRUZ DE LAS FLORES,10,98,0,108,1679
JALISCO,SANTA CRUZ DE LAS FLORES,13,93,0,106,1679
JALISCO,SANTA CRUZ DE LAS FLORES,4,100,0,104,1678
JALISCO,SANTA CRUZ DE LAS FLORES,7,93,1,101,1678
JALISCO,SANTA CRUZ DE LAS FLORES,8,94,2,104,1678
JALISCO,SANTA CRUZ DE LAS FLORES,193,565,2,760,0
JALISCO,SANTA CRUZ DE LAS FLORES,5,128,2,135,1603
JALISCO,SANTA CRUZ DE LAS FLORES,8,107,0,115,1602
JALISCO,SANTA CRUZ DE LAS FLORES,8,128,1,137,1602
JALISCO,SANTA CRUZ DE LAS FLORES,9,124,0,133,1602
JALISCO,SANTA CRUZ DE LAS FLORES,14,77,0,91,1132
JALISCO,SANTA CRUZ DE LAS FLORES,5,75,3,83,1131
JALISCO,SANTA CRUZ DE LAS FLORES,20,96,0,116,1834
JALISCO,SANTA CRUZ DE LAS FLORES,11,97,0,108,1834
JALISCO,SANTA CRUZ DE LAS FLORES,15,94,0,109,1608
JALISCO,SANTA CRUZ DE LAS FLORES,13,88,0,101,1607
JALISCO,SANTA CRUZ DE LAS FLORES,15,80,1,96,1393
JALISCO,SANTA CRUZ DE LAS FLORES,5,79,2,86,1393
JALISCO,SANTA CRUZ DE LAS FLORES,8,74,2,84,1299
JALISCO,SANTA CRUZ DE LAS FLORES,9,63,0,72,1298
JALISCO,SANTA CRUZ DE LAS FLORES,16,100,0,116,1513
JALISCO,SANTA CRUZ DE LAS FLORES,12,98,1,111,1512
JALISCO,SANTA CRUZ DE LAS FLORES,7,104,0,111,1751
JALISCO,SANTA CRUZ DE LAS FLORES,10,90,1,101,1751
JALISCO,SANTA CRUZ DE LAS FLORES,4,72,0,76,1379
JALISCO,SANTA CRUZ DE LAS FLORES,7,66,0,73,1379
JALISCO,SANTA CRUZ DE LAS FLORES,7,69,1,77,1379
JALISCO,SANTA CRUZ DE LAS FLORES,13,132,1,146,1749
JALISCO,SANTA CRUZ DE LAS FLORES,12,147,0,159,1748
JALISCO,SANTA CRUZ DE LAS FLORES,6,105,4,115,1708
JALISCO,SANTA CRUZ DE LAS FLORES,16,100,0,116,1707
JALISCO,SANTA CRUZ DE LAS FLORES,5,76,0,81,1524
JALISCO,SANTA CRUZ DE LAS FLORES,8,58,1,67,1523
JALISCO,SANTA CRUZ DE LAS FLORES,6,59,0,65,1523
JALISCO,SANTA CRUZ DE LAS FLORES,9,100,0,109,1920
JALISCO,SANTA CRUZ DE LAS FLORES,11,110,0,121,1920
JALISCO,SANTA CRUZ DE LAS FLORES,5,83,1,89,1377
JALISCO,SANTA CRUZ DE LAS FLORES,10,58,2,70,1376
JALISCO,SANTA CRUZ DE LAS FLORES,11,98,1,110,1667
JALISCO,SANTA CRUZ DE LAS FLORES,9,84,1,94,1666
JALISCO,SANTA CRUZ DE LAS FLORES,4,81,0,85,1402
JALISCO,SANTA CRUZ DE LAS FLORES,7,83,0,90,1401
JALISCO,SANTA CRUZ DE LAS FLORES,7,49,0,56,1792
JALISCO,SANTA CRUZ DE LAS FLORES,6,46,0,52,1792
JALISCO,SANTA CRUZ DE LAS FLORES,8,58,0,66,1792
JALISCO,SANTA CRUZ DE LAS FLORES,6,52,0,58,1791
JALISCO,SANTA CRUZ DE LAS FLORES,3,66,0,69,1791
JALISCO,SANTA CRUZ DE LAS FLORES,3,53,0,56,1791
JALISCO,SANTA CRUZ DE LAS FLORES,4,38,1,43,1791
JALISCO,SANTA CRUZ DE LAS FLORES,6,45,3,54,1298
JALISCO,SANTA CRUZ DE LAS FLORES,12,53,0,65,1298
JALISCO,SANTA CRUZ DE LAS FLORES,2,41,1,44,1609
JALISCO,SANTA CRUZ DE LAS FLORES,2,55,0,57,1609
JALISCO,SANTA CRUZ DE LAS FLORES,4,54,1,59,1609
JALISCO,SANTA CRUZ DE LAS FLORES,5,60,0,65,1608
JALISCO,SANTA CRUZ DE LAS FLORES,7,54,0,61,1608
JALISCO,SANTA CRUZ DE LAS FLORES,7,70,0,77,1702
JALISCO,SANTA CRUZ DE LAS FLORES,3,101,0,104,1702
JALISCO,SANTA CRUZ DE LAS FLORES,5,88,1,94,1701
JALISCO,SANTA CRUZ DE LAS FLORES,7,78,2,87,1701
JALISCO,SANTA CRUZ DE LAS FLORES,6,83,0,89,1701
JALISCO,SANTA CRUZ DE LAS FLORES,7,94,0,101,1941
JALISCO,SANTA CRUZ DE LAS FLORES,7,67,1,75,1940
JALISCO,SANTA CRUZ DE LAS FLORES,19,106,1,126,1711
JALISCO,SANTA CRUZ DE LAS FLORES,17,101,1,119,1711
JALISCO,SANTA CRUZ DE LAS FLORES,17,98,1,116,1683
JALISCO,SANTA CRUZ DE LAS FLORES,13,92,1,106,1683
JALISCO,SANTA CRUZ DE LAS FLORES,12,71,0,83,1911
JALISCO,SANTA CRUZ DE LAS FLORES,7,78,0,85,1911
JALISCO,SANTA CRUZ DE LAS FLORES,8,83,0,91,1910
JALISCO,SANTA CRUZ DE LAS FLORES,13,114,1,128,1840
JALISCO,SANTA CRUZ DE LAS FLORES,15,105,0,120,1840
JALISCO,SANTA CRUZ DE LAS FLORES,4,72,0,76,1883
JALISCO,SANTA CRUZ DE LAS FLORES,5,77,1,83,1883
JALISCO,SANTA CRUZ DE LAS FLORES,7,73,0,80,1883
JALISCO,SANTA CRUZ DE LAS FLORES,0,80,8,88,1547
JALISCO,SANTA CRUZ DE LAS FLORES,6,90,0,96,1547
JALISCO,SANTA CRUZ DE LAS FLORES,17,102,0,119,1541
JALISCO,SANTA CRUZ DE LAS FLORES,6,90,0,96,1541
JALISCO,SANTA CRUZ DE LAS FLORES,13,83,2,98,1541
JALISCO,SANTA CRUZ DE LAS FLORES,5,116,0,121,1546
JALISCO,SANTA CRUZ DE LAS FLORES,11,98,1,110,1546
JALISCO,SANTA CRUZ DE LAS FLORES,7,112,4,123,1545
JALISCO,SANTA CRUZ DE LAS FLORES,3,76,1,80,1545
JALISCO,SANTA CRUZ DE LAS FLORES,10,85,0,95,1443
JALISCO,SANTA CRUZ DE LAS FLORES,12,93,0,105,1442
JALISCO,SANTA CRUZ DE LAS FLORES,5,92,1,98,1442
JALISCO,SANTA CRUZ DE LAS FLORES,14,76,0,90,1172
JALISCO,SANTA CRUZ DE LAS FLORES,10,85,0,95,1171
JALISCO,SANTA CRUZ DE LAS FLORES,16,154,1,171,1980
JALISCO,SANTA CRUZ DE LAS FLORES,19,137,1,157,1979
JALISCO,SANTA CRUZ DE LAS FLORES,12,121,1,134,1979
JALISCO,SANTA CRUZ DE LAS FLORES,14,96,3,113,2011
JALISCO,SANTA CRUZ DE LAS FLORES,8,89,1,98,1666
JALISCO,SANTA CRUZ DE LAS FLORES,5,84,1,90,1665
JALISCO,SANTA CRUZ DE LAS FLORES,11,65,0,76,1584
JALISCO,SANTA CRUZ DE LAS FLORES,10,64,1,75,1583
JALISCO,SANTA CRUZ DE LAS FLORES,8,72,0,80,1583
JALISCO,SANTA CRUZ DE LAS FLORES,21,65,0,86,1567
JALISCO,SANTA CRUZ DE LAS FLORES,30,58,1,89,1567
JALISCO,SANTA CRUZ DE LAS FLORES,23,92,0,115,1473
JALISCO,SANTA CRUZ DE LAS FLORES,19,93,1,113,1472
JALISCO,SANTA CRUZ DE LAS FLORES,10,83,0,93,1472
JALISCO,SANTA CRUZ DE LAS FLORES,15,88,1,104,1568
JALISCO,SANTA CRUZ DE LAS FLORES,14,112,0,126,1568
JALISCO,SANTA CRUZ DE LAS FLORES,12,124,0,136,1567
JALISCO,SANTA CRUZ DE LAS FLORES,77,10,0,87,1870
JALISCO,SANTA CRUZ DE LAS FLORES,9,60,0,69,1870
JALISCO,SANTA CRUZ DE LAS FLORES,8,63,0,71,1144
JALISCO,SANTA CRUZ DE LAS FLORES,6,56,1,63,1144
JALISCO,SANTA CRUZ DE LAS FLORES,5,66,0,71,1886
JALISCO,SANTA CRUZ DE LAS FLORES,8,62,0,70,1886
JALISCO,SANTA CRUZ DE LAS FLORES,3,76,0,79,1886
JALISCO,SANTA CRUZ DE LAS FLORES,8,60,0,68,1886
JALISCO,SANTA CRUZ DE LAS FLORES,7,88,0,95,1886
JALISCO,SANTA CRUZ DE LAS FLORES,10,60,0,70,1886
JALISCO,SANTA CRUZ DE LAS FLORES,2,59,1,62,1885
JALISCO,SANTA CRUZ DE LAS FLORES,7,72,0,79,1885
JALISCO,SANTA CRUZ DE LAS FLORES,15,85,0,100,1536
JALISCO,SANTA CRUZ DE LAS FLORES,6,97,0,103,1536
JALISCO,SANTA CRUZ DE LAS FLORES,8,81,1,90,1536
JALISCO,SANTA CRUZ DE LAS FLORES,10,87,0,97,1888
JALISCO,SANTA CRUZ DE LAS FLORES,9,90,1,100,1887
JALISCO,SANTA CRUZ DE LAS FLORES,10,121,0,131,1788
JALISCO,SANTA CRUZ DE LAS FLORES,7,103,1,111,1788
JALISCO,SANTA CRUZ DE LAS FLORES,16,65,2,83,1142
JALISCO,SANTA CRUZ DE LAS FLORES,14,79,0,93,1141
JALISCO,SANTA CRUZ DE LAS FLORES,17,159,1,177,1757
JALISCO,SANTA CRUZ DE LAS FLORES,18,124,1,143,1756
JALISCO,SANTA CRUZ DE LAS FLORES,14,111,0,125,1960
JALISCO,SANTA CRUZ DE LAS FLORES,11,111,0,122,1960
JALISCO,SANTA CRUZ DE LAS FLORES,18,102,1,121,1960
JALISCO,SANTA CRUZ DE LAS FLORES,17,104,2,123,1960
JALISCO,SANTA CRUZ DE LAS FLORES,19,115,1,135,1545
JALISCO,SANTA CRUZ DE LAS FLORES,10,114,0,124,1545
JALISCO,SANTA CRUZ DE LAS FLORES,13,121,0,134,1545
JALISCO,SANTA CRUZ DE LAS FLORES,15,84,0,99,1519
JALISCO,SANTA CRUZ DE LAS FLORES,12,91,0,103,1518
JALISCO,SANTA CRUZ DE LAS FLORES,19,57,0,76,1654
JALISCO,SANTA CRUZ DE LAS FLORES,15,60,1,76,1654
JALISCO,SANTA CRUZ DE LAS FLORES,31,71,1,103,1935
JALISCO,SANTA CRUZ DE LAS FLORES,42,80,0,122,1935
JALISCO,SANTA CRUZ DE LAS FLORES,45,82,1,128,1832
JALISCO,SANTA CRUZ DE LAS FLORES,39,69,0,108,1831
JALISCO,SANTA CRUZ DE LAS FLORES,13,40,0,53,1314
JALISCO,SANTA CRUZ DE LAS FLORES,6,45,0,51,1314
JALISCO,SANTA CRUZ DE LAS FLORES,36,82,1,119,1877
JALISCO,SANTA CRUZ DE LAS FLORES,38,97,2,137,1876
JALISCO,SANTA CRUZ DE LAS FLORES,8,62,0,70,1676
JALISCO,SANTA CRUZ DE LAS FLORES,10,71,0,81,1675
JALISCO,SANTA CRUZ DE LAS FLORES,13,78,0,91,1541
JALISCO,SANTA CRUZ DE LAS FLORES,13,80,1,94,1540
JALISCO,SANTA CRUZ DE LAS FLORES,16,75,0,91,1540
JALISCO,SANTA CRUZ DE LAS FLORES,14,81,1,96,1587
JALISCO,SANTA CRUZ DE LAS FLORES,15,83,1,99,1586
JALISCO,SANTA CRUZ DE LAS FLORES,3,84,0,87,1393
JALISCO,SANTA CRUZ DE LAS FLORES,8,51,0,59,1392
JALISCO,SANTA CRUZ DE LAS FLORES,13,75,0,88,1138
JALISCO,SANTA CRUZ DE LAS FLORES,1,82,0,83,1137
JALISCO,SANTA CRUZ DE LAS FLORES,16,112,2,130,1517
JALISCO,SANTA CRUZ DE LAS FLORES,15,122,2,139,1516
JALISCO,SANTA CRUZ DE LAS FLORES,10,109,1,120,1575
JALISCO,SANTA CRUZ DE LAS FLORES,5,96,0,101,1575
JALISCO,SANTA CRUZ DE LAS FLORES,19,124,0,143,1616
JALISCO,SANTA CRUZ DE LAS FLORES,10,117,0,127,1615
JALISCO,SANTA CRUZ DE LAS FLORES,12,83,1,96,1719
JALISCO,SANTA CRUZ DE LAS FLORES,7,64,1,72,1719
JALISCO,SANTA CRUZ DE LAS FLORES,8,77,1,86,1719
JALISCO,SANTA CRUZ DE LAS FLORES,22,99,0,121,1642
JALISCO,SANTA CRUZ DE LAS FLORES,12,98,1,111,1642
JALISCO,SANTA CRUZ DE LAS FLORES,25,39,0,64,1362
JALISCO,SANTA CRUZ DE LAS FLORES,46,50,0,96,1362
JALISCO,SANTA CRUZ DE LAS FLORES,36,60,0,96,1361
JALISCO,SANTA CRUZ DE LAS FLORES,8,83,2,93,1447
JALISCO,SANTA CRUZ DE LAS FLORES,9,77,1,87,1446
JALISCO,SANTA CRUZ DE LAS FLORES,27,44,1,72,1338
JALISCO,SANTA CRUZ DE LAS FLORES,29,54,1,84,1338
JALISCO,SANTA CRUZ DE LAS FLORES,31,42,0,73,1374
JALISCO,SANTA CRUZ DE LAS FLORES,31,38,0,69,1374
JALISCO,SANTA CRUZ DE LAS FLORES,19,42,0,61,1373
JALISCO,SANTA CRUZ DE LAS FLORES,10,176,1,187,1612
JALISCO,SANTA CRUZ DE LAS FLORES,8,137,2,147,1611
JALISCO,SANTA CRUZ DE LAS FLORES,8,149,1,158,1803
JALISCO,SANTA CRUZ DE LAS FLORES,4,135,2,141,1802
JALISCO,TLAQUEPAQUE,10,193,5,208,1643
JALISCO,TLAQUEPAQUE,15,149,7,171,1643
JALISCO,TLAQUEPAQUE,8,116,0,124,1004
JALISCO,TLAQUEPAQUE,11,114,3,128,1003
JALISCO,TLAQUEPAQUE,14,158,5,177,1050
JALISCO,TLAQUEPAQUE,16,146,3,165,1050
JALISCO,TLAQUEPAQUE,13,150,5,168,1595
JALISCO,TLAQUEPAQUE,9,149,4,162,1595
JALISCO,TLAQUEPAQUE,17,167,1,185,1480
JALISCO,TLAQUEPAQUE,13,171,2,186,1480
JALISCO,TLAQUEPAQUE,38,193,1,232,1947
JALISCO,TLAQUEPAQUE,33,174,1,208,1947
JALISCO,TLAQUEPAQUE,25,135,1,161,1531
JALISCO,TLAQUEPAQUE,19,116,3,138,1531
JALISCO,TLAQUEPAQUE,5,98,1,104,1076
JALISCO,TLAQUEPAQUE,5,93,1,99,1076
JALISCO,TLAQUEPAQUE,10,93,1,104,1344
JALISCO,TLAQUEPAQUE,16,98,3,117,1344
JALISCO,TLAQUEPAQUE,8,73,1,82,1343
JALISCO,TLAQUEPAQUE,5,149,1,155,1889
JALISCO,TLAQUEPAQUE,10,152,2,164,1888
JALISCO,TLAQUEPAQUE,9,96,0,105,1349
JALISCO,TLAQUEPAQUE,3,84,0,87,1349
JALISCO,TLAQUEPAQUE,4,105,0,109,1348
JALISCO,TLAQUEPAQUE,3,123,2,128,1449
JALISCO,TLAQUEPAQUE,8,91,3,102,1449
JALISCO,TLAQUEPAQUE,8,139,3,150,1449
JALISCO,TLAQUEPAQUE,10,86,1,97,1037
JALISCO,TLAQUEPAQUE,15,90,2,107,1037
JALISCO,TLAQUEPAQUE,16,121,0,137,1381
JALISCO,TLAQUEPAQUE,10,120,3,133,1381
JALISCO,TLAQUEPAQUE,12,144,2,158,1927
JALISCO,TLAQUEPAQUE,13,177,2,192,1926
JALISCO,TLAQUEPAQUE,7,115,2,124,1462
JALISCO,TLAQUEPAQUE,86,10,1,97,1461
JALISCO,TLAQUEPAQUE,15,82,2,99,1461
JALISCO,TLAQUEPAQUE,10,93,2,105,1696
JALISCO,TLAQUEPAQUE,13,122,1,136,1696
JALISCO,TLAQUEPAQUE,10,69,0,79,1696
JALISCO,TLAQUEPAQUE,21,93,1,115,1749
JALISCO,TLAQUEPAQUE,18,87,0,105,1749
JALISCO,TLAQUEPAQUE,18,113,1,132,1748
JALISCO,TLAQUEPAQUE,6,103,3,112,1748
JALISCO,TLAQUEPAQUE,16,77,2,95,1663
JALISCO,TLAQUEPAQUE,20,100,1,121,1662
JALISCO,TLAQUEPAQUE,32,78,0,110,1662
JALISCO,TLAQUEPAQUE,19,107,0,126,1797
JALISCO,TLAQUEPAQUE,21,149,1,171,1797
JALISCO,TLAQUEPAQUE,17,139,0,156,1797
JALISCO,TLAQUEPAQUE,8,139,2,149,1796
JALISCO,TLAQUEPAQUE,17,125,0,142,1796
JALISCO,TLAQUEPAQUE,27,121,1,149,1796
JALISCO,TLAQUEPAQUE,14,54,0,68,1787
JALISCO,TLAQUEPAQUE,21,67,0,88,1787
JALISCO,TLAQUEPAQUE,14,82,1,97,1787
JALISCO,TLAQUEPAQUE,27,135,2,164,1791
JALISCO,TLAQUEPAQUE,20,124,0,144,1791
JALISCO,TLAQUEPAQUE,10,66,0,76,1716
JALISCO,TLAQUEPAQUE,24,78,0,102,1715
JALISCO,TLAQUEPAQUE,23,55,0,78,1715
JALISCO,TLAQUEPAQUE,30,71,1,102,1715
JALISCO,TLAQUEPAQUE,38,79,0,117,1715
JALISCO,TLAQUEPAQUE,22,99,1,122,1715
JALISCO,TLAQUEPAQUE,24,80,1,105,1715
JALISCO,TLAQUEPAQUE,161,662,2,825,0
JALISCO,TLAQUEPAQUE,40,129,1,170,1841
JALISCO,TLAQUEPAQUE,34,106,2,142,1840
JALISCO,TLAQUEPAQUE,22,76,0,98,1461
JALISCO,TLAQUEPAQUE,18,60,1,79,1461
JALISCO,TLAQUEPAQUE,19,88,0,107,1461
JALISCO,TLAQUEPAQUE,33,103,1,137,1651
JALISCO,TLAQUEPAQUE,14,102,4,120,1651
JALISCO,TLAQUEPAQUE,14,86,2,102,1708
JALISCO,TLAQUEPAQUE,18,96,3,117,1707
JALISCO,TLAQUEPAQUE,15,98,1,114,1707
JALISCO,TLAQUEPAQUE,64,78,0,142,1691
JALISCO,TLAQUEPAQUE,56,70,1,127,1691
JALISCO,TLAQUEPAQUE,55,80,0,135,1691
JALISCO,TLAQUEPAQUE,46,63,0,109,1655
JALISCO,TLAQUEPAQUE,52,74,0,126,1654
JALISCO,TLAQUEPAQUE,25,79,0,104,1680
JALISCO,TLAQUEPAQUE,46,100,0,146,1679
JALISCO,TLAQUEPAQUE,36,60,0,96,1521
JALISCO,TLAQUEPAQUE,31,61,3,95,1520
JALISCO,TLAQUEPAQUE,147,24,2,173,1689
JALISCO,TLAQUEPAQUE,27,135,1,163,1688
JALISCO,TLAQUEPAQUE,20,112,2,134,1180
JALISCO,TLAQUEPAQUE,16,84,0,100,1180
JALISCO,TLAQUEPAQUE,25,160,3,188,1760
JALISCO,TLAQUEPAQUE,19,130,1,150,1759
JALISCO,TLAQUEPAQUE,36,108,0,144,1673
JALISCO,TLAQUEPAQUE,43,130,2,175,1672
JALISCO,TLAQUEPAQUE,35,76,1,112,1557
JALISCO,TLAQUEPAQUE,29,114,0,143,1556
JALISCO,TLAQUEPAQUE,44,84,0,128,1368
JALISCO,TLAQUEPAQUE,43,71,2,116,1368
JALISCO,TLAQUEPAQUE,43,80,1,124,1367
JALISCO,TLAQUEPAQUE,52,125,0,177,1815
JALISCO,TLAQUEPAQUE,54,109,2,165,1815
JALISCO,TLAQUEPAQUE,38,79,1,118,1295
JALISCO,TLAQUEPAQUE,38,66,0,104,1295
JALISCO,TLAQUEPAQUE,31,62,1,94,1253
JALISCO,TLAQUEPAQUE,33,76,0,109,1253
JALISCO,TLAQUEPAQUE,58,82,2,142,1810
JALISCO,TLAQUEPAQUE,67,94,0,161,1809
JALISCO,TLAQUEPAQUE,35,84,0,119,1366
JALISCO,TLAQUEPAQUE,31,90,0,121,1365
JALISCO,TLAQUEPAQUE,30,136,1,167,1713
JALISCO,TLAQUEPAQUE,31,170,1,202,1713
JALISCO,TLAQUEPAQUE,27,99,2,128,1420
JALISCO,TLAQUEPAQUE,42,113,0,155,1420
JALISCO,TLAQUEPAQUE,39,92,0,131,1522
JALISCO,TLAQUEPAQUE,47,107,2,156,1521
JALISCO,TLAQUEPAQUE,37,180,2,219,1738
JALISCO,TLAQUEPAQUE,19,193,1,213,1738
JALISCO,TLAQUEPAQUE,11,95,1,107,1473
JALISCO,TLAQUEPAQUE,15,111,2,128,1473
JALISCO,TLAQUEPAQUE,28,144,4,176,1768
JALISCO,TLAQUEPAQUE,30,174,2,206,1768
JALISCO,TLAQUEPAQUE,16,122,1,139,1278
JALISCO,TLAQUEPAQUE,27,109,0,136,1278
JALISCO,TLAQUEPAQUE,20,106,0,126,1128
JALISCO,TLAQUEPAQUE,19,111,1,131,1127
JALISCO,TLAQUEPAQUE,23,108,1,132,1818
JALISCO,TLAQUEPAQUE,26,101,3,130,1818
JALISCO,TLAQUEPAQUE,13,83,0,96,1363
JALISCO,TLAQUEPAQUE,14,85,1,100,1362
JALISCO,TLAQUEPAQUE,8,84,0,92,1401
JALISCO,TLAQUEPAQUE,9,86,3,98,1401
JALISCO,TLAQUEPAQUE,14,94,2,110,1401
JALISCO,TLAQUEPAQUE,25,96,1,122,1446
JALISCO,TLAQUEPAQUE,17,119,1,137,1445
JALISCO,TLAQUEPAQUE,12,123,2,137,1599
JALISCO,TLAQUEPAQUE,10,135,0,145,1599
JALISCO,TLAQUEPAQUE,34,93,0,127,1676
JALISCO,TLAQUEPAQUE,15,113,3,131,1675
JALISCO,TLAQUEPAQUE,18,97,2,117,1400
JALISCO,TLAQUEPAQUE,20,98,2,120,1400
JALISCO,TLAQUEPAQUE,24,76,3,103,1399
JALISCO,TLAQUEPAQUE,17,73,1,91,1350
JALISCO,TLAQUEPAQUE,18,66,1,85,1350
JALISCO,TLAQUEPAQUE,31,59,0,90,1350
JALISCO,TLAQUEPAQUE,33,76,2,111,1614
JALISCO,TLAQUEPAQUE,46,69,0,115,1614
JALISCO,TLAQUEPAQUE,53,41,1,95,1633
JALISCO,TLAQUEPAQUE,59,45,1,105,1633
JALISCO,TLAQUEPAQUE,60,52,0,112,1633
JALISCO,TLAQUEPAQUE,64,50,0,114,1633
JALISCO,TLAQUEPAQUE,12,44,2,58,1081
JALISCO,TLAQUEPAQUE,16,55,0,71,1081
JALISCO,TLAQUEPAQUE,64,12,0,76,1480
JALISCO,TLAQUEPAQUE,10,73,2,85,1480
JALISCO,TLAQUEPAQUE,16,56,72,144,1480
JALISCO,TLAQUEPAQUE,13,80,0,93,998
JALISCO,TLAQUEPAQUE,9,62,0,71,997
JALISCO,TLAQUEPAQUE,9,122,4,135,1712
JALISCO,TLAQUEPAQUE,10,102,2,114,1712
JALISCO,TLAQUEPAQUE,9,112,0,121,1711
JALISCO,TLAQUEPAQUE,5,83,0,88,1711
JALISCO,TLAQUEPAQUE,9,142,0,151,1368
JALISCO,TLAQUEPAQUE,10,133,3,146,1368
JALISCO,TLAQUEPAQUE,8,129,4,141,1368
JALISCO,TLAQUEPAQUE,34,118,1,153,1698
JALISCO,TLAQUEPAQUE,24,141,2,167,1698
JALISCO,TLAQUEPAQUE,37,121,2,160,1697
JALISCO,TLAQUEPAQUE,31,133,2,166,1697
JALISCO,TLAQUEPAQUE,19,152,2,173,1491
JALISCO,TLAQUEPAQUE,7,119,2,128,1491
JALISCO,TLAQUEPAQUE,40,108,1,149,1889
JALISCO,TLAQUEPAQUE,56,108,4,168,1888
JALISCO,TLAQUEPAQUE,27,112,3,142,1671
JALISCO,TLAQUEPAQUE,24,118,2,144,1671
JALISCO,TLAQUEPAQUE,18,109,1,128,1670
JALISCO,TLAQUEPAQUE,17,104,2,123,1670
JALISCO,TLAQUEPAQUE,14,131,2,147,1635
JALISCO,TLAQUEPAQUE,10,140,2,152,1635
JALISCO,TLAQUEPAQUE,13,77,3,93,1031
JALISCO,TLAQUEPAQUE,11,77,2,90,1030
JALISCO,TLAQUEPAQUE,10,94,2,106,1709
JALISCO,TLAQUEPAQUE,8,70,1,79,1709
JALISCO,TLAQUEPAQUE,7,89,2,98,1709
JALISCO,TLAQUEPAQUE,15,94,0,109,1636
JALISCO,TLAQUEPAQUE,7,114,0,121,1635
JALISCO,TLAQUEPAQUE,18,108,0,126,1871
JALISCO,TLAQUEPAQUE,11,131,2,144,1871
JALISCO,TLAQUEPAQUE,4,99,2,105,1357
JALISCO,TLAQUEPAQUE,6,93,0,99,1357
JALISCO,TLAQUEPAQUE,5,110,0,115,1357
JALISCO,GUADALAJARA,56,150,4,210,1913
JALISCO,GUADALAJARA,24,195,1,220,1913
JALISCO,GUADALAJARA,27,160,0,187,1616
JALISCO,GUADALAJARA,22,146,2,170,1616
JALISCO,GUADALAJARA,26,134,3,163,1615
JALISCO,GUADALAJARA,28,162,1,191,1696
JALISCO,GUADALAJARA,31,180,3,214,1696
JALISCO,GUADALAJARA,29,124,2,155,1522
JALISCO,GUADALAJARA,14,158,4,176,1522
JALISCO,GUADALAJARA,26,184,2,212,1912
JALISCO,GUADALAJARA,17,166,4,187,1911
JALISCO,GUADALAJARA,8,160,1,169,1702
JALISCO,GUADALAJARA,22,160,3,185,1702
JALISCO,GUADALAJARA,29,159,4,192,1708
JALISCO,GUADALAJARA,22,141,0,163,1708
JALISCO,GUADALAJARA,13,140,6,159,1762
JALISCO,GUADALAJARA,20,108,7,135,1762
JALISCO,GUADALAJARA,16,86,1,103,1080
JALISCO,GUADALAJARA,15,85,0,100,1080
JALISCO,GUADALAJARA,20,110,0,130,1590
JALISCO,GUADALAJARA,29,98,0,127,1589
JALISCO,GUADALAJARA,23,119,0,142,1589
JALISCO,GUADALAJARA,28,70,1,99,1313
JALISCO,GUADALAJARA,41,57,2,100,1312
JALISCO,GUADALAJARA,60,74,1,135,1873
JALISCO,GUADALAJARA,62,59,1,122,1873
JALISCO,GUADALAJARA,51,96,0,147,1745
JALISCO,GUADALAJARA,53,94,1,148,1744
JALISCO,GUADALAJARA,38,132,1,171,1949
JALISCO,GUADALAJARA,41,112,2,155,1948
JALISCO,GUADALAJARA,33,135,2,170,1549
JALISCO,GUADALAJARA,26,142,2,170,1548
JALISCO,GUADALAJARA,44,150,0,194,1616
JALISCO,GUADALAJARA,34,131,3,168,1615
JALISCO,GUADALAJARA,18,137,4,159,1438
JALISCO,GUADALAJARA,27,136,2,165,1438
JALISCO,GUADALAJARA,30,171,3,204,1560
JALISCO,GUADALAJARA,30,161,2,193,1559
JALISCO,GUADALAJARA,35,154,1,190,1509
JALISCO,GUADALAJARA,27,171,0,198,1508
JALISCO,GUADALAJARA,21,141,1,163,1813
JALISCO,GUADALAJARA,31,127,0,158,1813
JALISCO,GUADALAJARA,63,181,0,244,1794
JALISCO,GUADALAJARA,46,160,0,206,1793
JALISCO,GUADALAJARA,38,152,1,191,1663
JALISCO,GUADALAJARA,36,138,2,176,1662
JALISCO,GUADALAJARA,30,124,0,154,1515
JALISCO,GUADALAJARA,34,113,2,149,1515
JALISCO,GUADALAJARA,32,127,0,159,1514
JALISCO,GUADALAJARA,26,131,6,163,1680
JALISCO,GUADALAJARA,23,153,2,178,1680
JALISCO,GUADALAJARA,41,108,0,149,1748
JALISCO,GUADALAJARA,42,128,1,171,1748
JALISCO,GUADALAJARA,18,154,1,173,1478
JALISCO,GUADALAJARA,14,155,4,173,1477
JALISCO,GUADALAJARA,22,169,2,193,1390
JALISCO,GUADALAJARA,17,161,1,179,1390
JALISCO,GUADALAJARA,16,164,3,183,1389
JALISCO,GUADALAJARA,6,201,0,207,1534
JALISCO,GUADALAJARA,6,156,2,164,1534
JALISCO,GUADALAJARA,17,163,2,182,1534
JALISCO,GUADALAJARA,21,150,1,172,1747
JALISCO,GUADALAJARA,21,158,4,183,1747
JALISCO,GUADALAJARA,18,189,2,209,1792
JALISCO,GUADALAJARA,10,164,4,178,1792
JALISCO,GUADALAJARA,19,146,5,170,1499
JALISCO,GUADALAJARA,13,157,0,170,1499
JALISCO,GUADALAJARA,28,138,2,168,1499
JALISCO,GUADALAJARA,21,121,1,143,1083
JALISCO,GUADALAJARA,11,107,1,119,1083
JALISCO,GUADALAJARA,18,197,2,217,1949
JALISCO,GUADALAJARA,16,128,1,145,1176
JALISCO,GUADALAJARA,8,128,1,137,1175
JALISCO,GUADALAJARA,20,160,2,182,1728
JALISCO,GUADALAJARA,27,189,4,220,1728
JALISCO,GUADALAJARA,14,137,0,151,1103
JALISCO,GUADALAJARA,15,135,1,151,1103
JALISCO,GUADALAJARA,19,191,1,211,1852
JALISCO,GUADALAJARA,32,169,4,205,1852
JALISCO,GUADALAJARA,11,109,2,122,1439
JALISCO,GUADALAJARA,7,127,1,135,1439
JALISCO,GUADALAJARA,20,169,0,189,1970
JALISCO,GUADALAJARA,16,183,2,201,1970
JALISCO,GUADALAJARA,13,119,2,134,1064
JALISCO,GUADALAJARA,9,116,1,126,1064
JALISCO,GUADALAJARA,7,117,4,128,1218
JALISCO,GUADALAJARA,2,123,0,125,1217
JALISCO,GUADALAJARA,19,103,1,123,1114
JALISCO,GUADALAJARA,11,123,3,137,1113
JALISCO,GUADALAJARA,18,131,3,152,1337
JALISCO,GUADALAJARA,12,131,1,144,1336
JALISCO,GUADALAJARA,9,94,0,103,1048
JALISCO,GUADALAJARA,8,85,0,93,1047
JALISCO,GUADALAJARA,10,190,1,201,1879
JALISCO,GUADALAJARA,16,173,1,190,1878
JALISCO,GUADALAJARA,16,184,0,200,2019
JALISCO,GUADALAJARA,14,169,0,183,2018
JALISCO,GUADALAJARA,20,142,0,162,1408
JALISCO,GUADALAJARA,17,150,1,168,1408
JALISCO,GUADALAJARA,21,113,0,134,1424
JALISCO,GUADALAJARA,14,124,0,138,1423
JALISCO,GUADALAJARA,19,157,3,179,1550
JALISCO,GUADALAJARA,23,168,1,192,1549
JALISCO,GUADALAJARA,35,139,1,175,1769
JALISCO,GUADALAJARA,45,141,0,186,1769
JALISCO,GUADALAJARA,32,114,0,146,1422
JALISCO,GUADALAJARA,22,99,2,123,1422
JALISCO,GUADALAJARA,28,123,1,152,1421
JALISCO,GUADALAJARA,16,113,1,130,1144
JALISCO,GUADALAJARA,7,128,1,136,1143
JALISCO,GUADALAJARA,9,83,1,93,1044
JALISCO,GUADALAJARA,12,91,4,107,1044
JALISCO,GUADALAJARA,16,111,0,127,1099
JALISCO,GUADALAJARA,18,111,3,132,1099
JALISCO,GUADALAJARA,23,135,2,160,1634
JALISCO,GUADALAJARA,16,125,2,143,1634
JALISCO,GUADALAJARA,15,178,2,195,1839
JALISCO,GUADALAJARA,15,177,4,196,1838
JALISCO,GUADALAJARA,15,150,0,165,1450
JALISCO,GUADALAJARA,19,127,2,148,1450
JALISCO,GUADALAJARA,13,151,4,168,1915
JALISCO,GUADALAJARA,14,191,1,206,1914
JALISCO,GUADALAJARA,9,160,6,175,1835
JALISCO,GUADALAJARA,16,141,3,160,1835
JALISCO,GUADALAJARA,13,92,109,214,1108
JALISCO,GUADALAJARA,11,83,1,95,1107
JALISCO,GUADALAJARA,12,150,1,163,1530
JALISCO,GUADALAJARA,22,128,1,151,1529
JALISCO,GUADALAJARA,18,151,0,169,1529
JALISCO,GUADALAJARA,17,148,1,166,1740
JALISCO,GUADALAJARA,14,117,0,131,1740
JALISCO,GUADALAJARA,31,124,0,155,1486
JALISCO,GUADALAJARA,18,135,0,153,1486
JALISCO,GUADALAJARA,20,135,4,159,1485
JALISCO,GUADALAJARA,27,208,2,237,1842
JALISCO,GUADALAJARA,25,180,2,207,1842
JALISCO,GUADALAJARA,8,99,2,109,1138
JALISCO,GUADALAJARA,8,119,0,127,1137
JALISCO,GUADALAJARA,8,130,3,141,1420
JALISCO,GUADALAJARA,8,105,1,114,1420
JALISCO,GUADALAJARA,25,91,3,119,1420
JALISCO,GUADALAJARA,17,118,1,136,1271
JALISCO,GUADALAJARA,6,117,2,125,1271
JALISCO,GUADALAJARA,10,125,1,136,1359
JALISCO,GUADALAJARA,6,139,2,147,1359
JALISCO,GUADALAJARA,5,125,0,130,1358
JALISCO,GUADALAJARA,20,203,1,224,1649
JALISCO,GUADALAJARA,15,206,5,226,1648
JALISCO,GUADALAJARA,10,113,0,123,1397
JALISCO,GUADALAJARA,7,129,0,136,1396
JALISCO,GUADALAJARA,4,53,3,60,1359
JALISCO,GUADALAJARA,12,130,2,144,1359
JALISCO,GUADALAJARA,9,106,3,118,1114
JALISCO,GUADALAJARA,14,106,0,120,1114
JALISCO,GUADALAJARA,40,96,2,138,1545
JALISCO,GUADALAJARA,27,127,2,156,1545
JALISCO,GUADALAJARA,16,121,0,137,1544
JALISCO,GUADALAJARA,18,143,1,162,1802
JALISCO,GUADALAJARA,34,174,1,209,1801
JALISCO,GUADALAJARA,12,119,0,131,1624
JALISCO,GUADALAJARA,12,107,1,120,1624
JALISCO,GUADALAJARA,30,135,0,165,1623
JALISCO,GUADALAJARA,104,642,4,750,0
JALISCO,GUADALAJARA,13,96,1,110,1552
JALISCO,GUADALAJARA,26,84,1,111,1551
JALISCO,GUADALAJARA,12,121,0,133,1558
JALISCO,GUADALAJARA,16,135,1,152,1558
JALISCO,GUADALAJARA,21,213,1,235,1937
JALISCO,GUADALAJARA,30,207,6,243,1937
JALISCO,GUADALAJARA,15,162,2,179,1383
JALISCO,GUADALAJARA,11,133,3,147,1383
JALISCO,GUADALAJARA,21,159,0,180,1382
JALISCO,GUADALAJARA,32,192,2,226,2005
JALISCO,GUADALAJARA,25,169,3,197,2005
JALISCO,GUADALAJARA,41,132,1,174,1649
JALISCO,GUADALAJARA,36,141,1,178,1648
JALISCO,GUADALAJARA,14,133,2,149,1763
JALISCO,GUADALAJARA,16,142,3,161,1762
JALISCO,GUADALAJARA,25,130,5,160,1344
JALISCO,GUADALAJARA,28,100,1,129,1343
JALISCO,GUADALAJARA,18,151,1,170,1633
JALISCO,GUADALAJARA,27,153,2,182,1632
JALISCO,GUADALAJARA,18,155,4,177,1579
JALISCO,GUADALAJARA,21,126,1,148,1578
JALISCO,GUADALAJARA,31,129,0,160,1347
JALISCO,GUADALAJARA,24,143,1,168,1347
JALISCO,GUADALAJARA,20,126,3,149,1347
JALISCO,GUADALAJARA,16,178,5,199,1904
JALISCO,GUADALAJARA,51,209,3,263,1903
JALISCO,GUADALAJARA,27,175,1,203,1709
JALISCO,GUADALAJARA,32,153,10,195,1708
JALISCO,GUADALAJARA,21,107,1,129,1249
JALISCO,GUADALAJARA,30,139,3,172,1249
JALISCO,GUADALAJARA,27,169,4,200,1699
JALISCO,GUADALAJARA,23,153,0,176,1699
JALISCO,GUADALAJARA,16,119,0,135,1491
JALISCO,GUADALAJARA,21,133,2,156,1490
JALISCO,GUADALAJARA,12,187,4,203,1975
JALISCO,GUADALAJARA,8,171,4,183,1975
JALISCO,LA BARCA,4,49,0,53,1295
JALISCO,LA BARCA,3,46,1,50,1295
JALISCO,LA BARCA,11,70,1,82,1718
JALISCO,LA BARCA,10,62,0,72,1718
JALISCO,LA BARCA,14,65,2,81,1718
JALISCO,LA BARCA,7,81,1,89,1718
JALISCO,LA BARCA,15,93,1,109,1889
JALISCO,LA BARCA,23,86,2,111,1888
JALISCO,LA BARCA,7,82,0,89,1574
JALISCO,LA BARCA,6,72,1,79,1573
JALISCO,LA BARCA,7,77,0,84,1508
JALISCO,LA BARCA,4,60,1,65,1507
JALISCO,LA BARCA,6,69,0,75,1507
JALISCO,LA BARCA,15,92,2,109,1365
JALISCO,LA BARCA,15,77,0,92,1365
JALISCO,LA BARCA,9,59,0,68,1339
JALISCO,LA BARCA,22,60,1,83,1339
JALISCO,LA BARCA,3,67,1,71,1646
JALISCO,LA BARCA,11,68,1,80,1645
JALISCO,LA BARCA,20,172,2,194,1703
JALISCO,LA BARCA,16,170,4,190,1703
JALISCO,LA BARCA,9,24,1,34,1275
JALISCO,LA BARCA,15,28,2,45,1275
JALISCO,LA BARCA,11,22,1,34,1216
JALISCO,LA BARCA,11,25,1,37,1216
JALISCO,LA BARCA,15,33,0,48,1657
JALISCO,LA BARCA,9,29,1,39,1657
JALISCO,LA BARCA,6,83,4,93,1558
JALISCO,LA BARCA,4,101,1,106,1558
JALISCO,LA BARCA,9,99,3,111,1557
JALISCO,LA BARCA,9,45,1,55,1441
JALISCO,LA BARCA,2,43,0,45,1441
JALISCO,LA BARCA,4,44,2,50,1367
JALISCO,LA BARCA,8,49,3,60,1366
JALISCO,LA BARCA,6,71,0,77,1963
JALISCO,LA BARCA,6,51,1,58,1963
JALISCO,LA BARCA,3,55,0,58,1156
JALISCO,LA BARCA,4,48,0,52,1155
JALISCO,LA BARCA,5,78,0,83,1519
JALISCO,LA BARCA,9,55,1,65,1518
JALISCO,LA BARCA,4,65,0,69,1518
JALISCO,LA BARCA,4,120,1,125,1841
JALISCO,LA BARCA,7,117,2,126,1841
JALISCO,LA BARCA,10,132,8,150,1903
JALISCO,LA BARCA,4,121,3,128,1902
JALISCO,LA BARCA,6,159,3,168,1902
JALISCO,LA BARCA,14,10,0,24,1442
JALISCO,LA BARCA,9,4,0,13,1442
JALISCO,LA BARCA,3,152,0,155,1492
JALISCO,LA BARCA,4,132,3,139,1491
JALISCO,LA BARCA,5,153,3,161,1491
JALISCO,LA BARCA,30,182,10,222,1530
JALISCO,LA BARCA,28,162,2,192,1530
JALISCO,LA BARCA,10,129,2,141,1811
JALISCO,LA BARCA,6,134,0,140,1810
JALISCO,LA BARCA,9,169,0,178,1804
JALISCO,LA BARCA,14,150,1,165,1803
JALISCO,LA BARCA,15,190,1,206,1803
JALISCO,LA BARCA,8,109,3,120,1125
JALISCO,LA BARCA,5,113,1,119,1124
JALISCO,LA BARCA,24,114,3,141,1359
JALISCO,LA BARCA,19,137,1,157,1358
JALISCO,LA BARCA,12,171,0,183,1855
JALISCO,LA BARCA,12,191,0,203,1854
JALISCO,LA BARCA,48,347,3,398,0
JALISCO,LA BARCA,7,111,2,120,1164
JALISCO,LA BARCA,6,107,0,113,1164
JALISCO,LA BARCA,31,180,1,212,1875
JALISCO,LA BARCA,31,137,0,168,1874
JALISCO,LA BARCA,36,115,1,152,1257
JALISCO,LA BARCA,40,111,0,151,1257
JALISCO,LA BARCA,17,60,2,79,1327
JALISCO,LA BARCA,16,75,1,92,1327
JALISCO,LA BARCA,9,152,0,161,1954
JALISCO,LA BARCA,15,147,2,164,1954
JALISCO,LA BARCA,15,176,2,193,2059
JALISCO,LA BARCA,4,127,0,131,1514
JALISCO,LA BARCA,8,174,3,185,1513
JALISCO,LA BARCA,6,166,2,174,1270
JALISCO,LA BARCA,4,144,1,149,1270
JALISCO,LA BARCA,7,128,0,135,1877
JALISCO,LA BARCA,14,104,1,119,1877
JALISCO,LA BARCA,1,138,3,142,1493
JALISCO,LA BARCA,3,88,5,96,1493
JALISCO,LA BARCA,3,115,0,118,1353
JALISCO,LA BARCA,7,122,2,131,1352
JALISCO,LA BARCA,13,113,0,126,1368
JALISCO,LA BARCA,11,139,2,152,1367
JALISCO,LA BARCA,9,77,2,88,1822
JALISCO,LA BARCA,16,82,0,98,1822
JALISCO,LA BARCA,7,67,0,74,1821
JALISCO,LA BARCA,7,71,3,81,1299
JALISCO,LA BARCA,14,73,1,88,1298
JALISCO,LA BARCA,9,66,2,77,1419
JALISCO,LA BARCA,10,67,2,79,1419
JALISCO,LA BARCA,12,79,0,91,1418
JALISCO,LA BARCA,10,48,2,60,1470
JALISCO,LA BARCA,9,63,2,74,1470
JALISCO,LA BARCA,12,61,1,74,1470
JALISCO,LA BARCA,12,108,1,121,1888
JALISCO,LA BARCA,4,198,1,203,1741
JALISCO,LA BARCA,0,209,0,209,1740
JALISCO,LA BARCA,8,135,5,148,1369
JALISCO,LA BARCA,8,186,0,194,1368
JALISCO,LA BARCA,7,242,2,251,1940
JALISCO,LA BARCA,7,222,2,231,1940
JALISCO,LA BARCA,16,179,3,198,1649
JALISCO,LA BARCA,8,192,3,203,1649
JALISCO,LA BARCA,10,160,3,173,1167
JALISCO,LA BARCA,7,158,2,167,1167
JALISCO,LA BARCA,7,235,0,242,1632
JALISCO,LA BARCA,6,236,3,245,1632
JALISCO,LA BARCA,11,132,1,144,1435
JALISCO,LA BARCA,8,151,6,165,1434
JALISCO,LA BARCA,7,153,1,161,1434
JALISCO,LA BARCA,9,233,0,242,1981
JALISCO,LA BARCA,10,172,2,184,1654
JALISCO,LA BARCA,11,189,1,201,1653
JALISCO,LA BARCA,13,204,2,219,1464
JALISCO,LA BARCA,11,198,2,211,1463
JALISCO,LA BARCA,7,210,1,218,1927
JALISCO,LA BARCA,9,235,2,246,1926
JALISCO,LA BARCA,19,219,3,241,1583
JALISCO,LA BARCA,26,227,1,254,1582
JALISCO,LA BARCA,24,223,2,249,1582
JALISCO,LA BARCA,14,235,2,251,1728
JALISCO,LA BARCA,19,215,4,238,1727
JALISCO,LA BARCA,17,182,1,200,1685
JALISCO,LA BARCA,23,174,4,201,1684
JALISCO,LA BARCA,4,244,5,253,1493
JALISCO,LA BARCA,7,264,2,273,1493
JALISCO,LA BARCA,14,204,1,219,1499
JALISCO,LA BARCA,10,214,2,226,1498
JALISCO,LA BARCA,11,190,4,205,1849
JALISCO,LA BARCA,17,211,4,232,1849
JALISCO,LA BARCA,7,262,1,270,1850
JALISCO,LA BARCA,9,286,3,298,1849
JALISCO,LA BARCA,14,217,0,231,1772
JALISCO,LA BARCA,16,212,1,229,1772
JALISCO,LA BARCA,9,142,3,154,1146
JALISCO,LA BARCA,23,167,0,190,1146
JALISCO,LA BARCA,17,231,3,251,1581
JALISCO,LA BARCA,8,209,2,219,1580
JALISCO,LA BARCA,12,258,5,275,2013
JALISCO,LA BARCA,10,255,0,265,2013
JALISCO,LA BARCA,2,151,2,155,1663
JALISCO,LA BARCA,3,138,2,143,1663
JALISCO,LA BARCA,10,137,0,147,1663
JALISCO,LA BARCA,3,153,3,159,1662
JALISCO,LA BARCA,10,214,3,227,1809
JALISCO,LA BARCA,4,253,1,258,1809
JALISCO,LA BARCA,5,186,3,194,1425
JALISCO,LA BARCA,9,166,2,177,1425
JALISCO,LA BARCA,10,139,0,149,1561
JALISCO,LA BARCA,18,159,2,179,1561
JALISCO,LA BARCA,3,109,1,113,1261
JALISCO,LA BARCA,2,101,1,104,1261
JALISCO,LA BARCA,1,142,0,143,1383
JALISCO,LA BARCA,6,131,2,139,1382
JALISCO,LA BARCA,4,154,1,159,1382
JALISCO,LA BARCA,16,147,0,163,1562
JALISCO,LA BARCA,6,152,1,159,1561
JALISCO,LA BARCA,9,134,1,144,1419
JALISCO,LA BARCA,7,146,2,155,1419
JALISCO,LA BARCA,10,183,1,194,1725
JALISCO,LA BARCA,7,223,3,233,1725
JALISCO,LA BARCA,10,125,1,136,1562
JALISCO,LA BARCA,7,164,2,173,1562
JALISCO,LA BARCA,10,262,1,273,1602
JALISCO,LA BARCA,5,260,3,268,1601
JALISCO,LA BARCA,13,262,2,277,1601
JALISCO,LA BARCA,10,138,6,154,1572
JALISCO,LA BARCA,3,132,3,138,1572
JALISCO,LA BARCA,9,153,5,167,1571
JALISCO,LA BARCA,9,155,3,167,2040
JALISCO,LA BARCA,4,146,0,150,2039
JALISCO,LA BARCA,7,146,4,157,1905
JALISCO,LA BARCA,16,234,4,254,2025
JALISCO,LA BARCA,7,176,6,189,1664
JALISCO,LA BARCA,3,182,3,188,1663
JALISCO,LA BARCA,2,31,0,33,1797
JALISCO,LA BARCA,0,37,1,38,1797
JALISCO,LA BARCA,4,44,1,49,1796
JALISCO,LA BARCA,5,64,0,69,1553
JALISCO,LA BARCA,2,60,1,63,1552
JALISCO,LA BARCA,7,52,1,60,1552
JALISCO,LA BARCA,11,130,0,141,2019
JALISCO,LA BARCA,9,137,0,146,2018
JALISCO,LA BARCA,11,88,2,101,1725
JALISCO,LA BARCA,13,115,2,130,1724
JALISCO,LA BARCA,8,122,2,132,1724
JALISCO,LA BARCA,7,37,0,44,1443
JALISCO,LA BARCA,4,27,0,31,1442
JALISCO,LA BARCA,10,42,0,52,1442
JALISCO,LA BARCA,3,99,4,106,1615
JALISCO,LA BARCA,5,81,0,86,1615
JALISCO,LA BARCA,3,88,1,92,1615
JALISCO,LA BARCA,5,125,5,135,2012
JALISCO,LA BARCA,2,85,0,87,2012
JALISCO,LA BARCA,0,85,1,86,1918
JALISCO,LA BARCA,10,89,1,100,1917
JALISCO,LA BARCA,1,104,1,106,1917
JALISCO,TLAQUEPAQUE,33,120,1,154,1817
JALISCO,TLAQUEPAQUE,25,133,1,159,1817
JALISCO,TLAQUEPAQUE,27,127,0,154,1816
JALISCO,TLAQUEPAQUE,319,1284,17,1620,0
JALISCO,TLAQUEPAQUE,19,165,1,185,1653
JALISCO,TLAQUEPAQUE,19,148,1,168,1652
JALISCO,TLAQUEPAQUE,20,136,1,157,1451
JALISCO,TLAQUEPAQUE,16,96,0,112,1450
JALISCO,TLAQUEPAQUE,25,138,2,165,1450
JALISCO,TLAQUEPAQUE,23,180,4,207,1921
JALISCO,TLAQUEPAQUE,24,179,0,203,1921
JALISCO,TLAQUEPAQUE,27,145,4,176,1576
JALISCO,TLAQUEPAQUE,20,155,2,177,1576
JALISCO,TLAQUEPAQUE,30,146,1,177,1310
JALISCO,TLAQUEPAQUE,30,131,1,162,1310
JALISCO,TLAQUEPAQUE,13,133,1,147,1330
JALISCO,TLAQUEPAQUE,15,125,5,145,1330
JALISCO,TLAQUEPAQUE,11,144,1,156,1509
JALISCO,TLAQUEPAQUE,20,149,0,169,1508
JALISCO,TLAQUEPAQUE,27,114,0,141,1873
JALISCO,TLAQUEPAQUE,21,110,1,132,1873
JALISCO,TLAQUEPAQUE,29,136,0,165,1873
JALISCO,TLAQUEPAQUE,25,138,2,165,1873
JALISCO,TLAQUEPAQUE,15,137,3,155,1400
JALISCO,TLAQUEPAQUE,17,116,1,134,1399
JALISCO,TLAQUEPAQUE,26,100,1,127,1399
JALISCO,TLAQUEPAQUE,28,117,3,148,1826
JALISCO,TLAQUEPAQUE,19,116,0,135,1825
JALISCO,TLAQUEPAQUE,18,125,2,145,1505
JALISCO,TLAQUEPAQUE,16,130,2,148,1505
JALISCO,TLAQUEPAQUE,23,93,0,116,1618
JALISCO,TLAQUEPAQUE,18,115,1,134,1618
JALISCO,TLAQUEPAQUE,17,110,0,127,1617
JALISCO,TLAQUEPAQUE,22,124,0,146,1476
JALISCO,TLAQUEPAQUE,16,136,0,152,1476
JALISCO,TLAQUEPAQUE,27,124,3,154,1624
JALISCO,TLAQUEPAQUE,22,126,5,153,1624
JALISCO,TLAQUEPAQUE,15,113,1,129,1624
JALISCO,TLAQUEPAQUE,13,107,1,121,1692
JALISCO,TLAQUEPAQUE,11,132,1,144,1691
JALISCO,TLAQUEPAQUE,17,180,1,198,1687
JALISCO,TLAQUEPAQUE,18,139,1,158,1687
JALISCO,TLAQUEPAQUE,29,142,0,171,1523
JALISCO,TLAQUEPAQUE,21,116,0,137,1523
JALISCO,TLAQUEPAQUE,16,118,1,135,1522
JALISCO,TLAQUEPAQUE,25,119,2,146,1572
JALISCO,TLAQUEPAQUE,31,119,2,152,1572
JALISCO,TLAQUEPAQUE,31,124,1,156,1572
JALISCO,TLAQUEPAQUE,12,104,0,116,1475
JALISCO,TLAQUEPAQUE,7,90,1,98,1475
JALISCO,TLAQUEPAQUE,7,100,0,107,1474
JALISCO,TLAQUEPAQUE,37,144,1,182,1879
JALISCO,TLAQUEPAQUE,17,167,1,185,1878
JALISCO,TLAQUEPAQUE,15,109,1,125,1508
JALISCO,TLAQUEPAQUE,19,108,2,129,1507
JALISCO,TLAQUEPAQUE,30,165,3,198,1803
JALISCO,TLAQUEPAQUE,21,140,2,163,1803
JALISCO,TLAQUEPAQUE,25,157,3,185,1803
JALISCO,TLAQUEPAQUE,15,103,1,119,1576
JALISCO,TLAQUEPAQUE,19,86,1,106,1576
JALISCO,TLAQUEPAQUE,19,103,2,124,1576
JALISCO,TLAQUEPAQUE,26,95,1,122,1418
JALISCO,TLAQUEPAQUE,16,113,2,131,1418
JALISCO,TLAQUEPAQUE,17,106,1,124,1417
JALISCO,TLAQUEPAQUE,20,116,0,136,1784
JALISCO,TLAQUEPAQUE,29,133,2,164,1783
JALISCO,TLAQUEPAQUE,17,188,6,211,1903
JALISCO,TLAQUEPAQUE,14,202,2,218,1903
JALISCO,TLAQUEPAQUE,25,123,0,148,1641
JALISCO,TLAQUEPAQUE,30,125,0,155,1640
JALISCO,TLAQUEPAQUE,6,112,4,122,1095
JALISCO,TLAQUEPAQUE,5,128,2,135,1094
JALISCO,TLAQUEPAQUE,20,157,2,179,1647
JALISCO,TLAQUEPAQUE,28,169,1,198,1646
JALISCO,TLAQUEPAQUE,19,156,1,176,1641
JALISCO,TLAQUEPAQUE,16,116,2,134,1641
JALISCO,TLAQUEPAQUE,15,118,1,134,1641
JALISCO,TLAQUEPAQUE,19,99,0,118,1316
JALISCO,TLAQUEPAQUE,9,78,0,87,1315
JALISCO,TLAQUEPAQUE,6,78,1,85,1177
JALISCO,TLAQUEPAQUE,14,82,4,100,1177
JALISCO,TLAQUEPAQUE,14,111,1,126,1183
JALISCO,TLAQUEPAQUE,13,99,1,113,1183
JALISCO,TLAQUEPAQUE,6,112,0,118,1339
JALISCO,TLAQUEPAQUE,4,120,0,124,1339
JALISCO,TLAQUEPAQUE,13,141,0,154,1532
JALISCO,TLAQUEPAQUE,18,131,0,149,1532
JALISCO,TLAQUEPAQUE,16,176,4,196,2028
JALISCO,TLAQUEPAQUE,22,138,1,161,1676
JALISCO,TLAQUEPAQUE,10,126,4,140,1676
JALISCO,TLAQUEPAQUE,21,166,0,187,1676
JALISCO,TLAQUEPAQUE,15,182,0,197,1960
JALISCO,TLAQUEPAQUE,7,168,1,176,1959
JALISCO,TLAQUEPAQUE,15,184,1,200,1722
JALISCO,TLAQUEPAQUE,16,180,3,199,1722
JALISCO,TLAQUEPAQUE,12,111,0,123,1146
JALISCO,TLAQUEPAQUE,5,108,0,113,1145
JALISCO,TLAQUEPAQUE,10,126,0,136,1325
JALISCO,TLAQUEPAQUE,12,128,2,142,1325
JALISCO,TLAQUEPAQUE,22,167,2,191,1983
JALISCO,TLAQUEPAQUE,17,153,3,173,1982
JALISCO,TLAQUEPAQUE,16,160,0,176,1982
JALISCO,TLAQUEPAQUE,11,163,2,176,1982
JALISCO,TLAQUEPAQUE,16,157,2,175,1555
JALISCO,TLAQUEPAQUE,10,121,2,133,1554
JALISCO,TLAQUEPAQUE,8,89,0,97,1107
JALISCO,TLAQUEPAQUE,6,100,2,108,1107
JALISCO,TLAQUEPAQUE,6,120,2,128,1363
JALISCO,TLAQUEPAQUE,7,101,3,111,1362
JALISCO,TLAQUEPAQUE,2,123,0,125,1693
JALISCO,TLAQUEPAQUE,5,108,1,114,1692
JALISCO,TLAQUEPAQUE,15,117,2,134,1780
JALISCO,TLAQUEPAQUE,10,121,0,131,1780
JALISCO,TLAQUEPAQUE,13,122,3,138,1780
JALISCO,TLAQUEPAQUE,13,143,4,160,1780
JALISCO,TLAQUEPAQUE,10,152,0,162,1779
JALISCO,TLAQUEPAQUE,15,123,2,140,1779
JALISCO,TLAQUEPAQUE,9,120,1,130,1943
JALISCO,TLAQUEPAQUE,5,115,1,121,1943
JALISCO,TLAQUEPAQUE,11,96,0,107,1943
JALISCO,TLAQUEPAQUE,6,61,3,70,1943
JALISCO,TLAQUEPAQUE,12,108,1,121,1826
JALISCO,TLAQUEPAQUE,4,125,3,132,1825
JALISCO,TLAQUEPAQUE,6,120,1,127,1825
JALISCO,TLAQUEPAQUE,9,88,2,99,1825
JALISCO,TLAQUEPAQUE,5,94,1,100,1825
JALISCO,TLAQUEPAQUE,4,85,1,90,1825
JALISCO,TLAQUEPAQUE,10,105,4,119,1825
JALISCO,TLAQUEPAQUE,4,100,2,106,1825
JALISCO,TLAQUEPAQUE,5,141,3,149,1706
JALISCO,TLAQUEPAQUE,2,147,2,151,1705
JALISCO,TLAQUEPAQUE,6,158,0,164,1844
JALISCO,TLAQUEPAQUE,6,138,1,145,1843
JALISCO,TLAQUEPAQUE,8,99,2,109,1756
JALISCO,TLAQUEPAQUE,12,114,2,128,1756
JALISCO,TLAQUEPAQUE,14,117,2,133,1756
JALISCO,TLAQUEPAQUE,7,111,0,118,1755
JALISCO,TLAQUEPAQUE,10,125,2,137,1755
JALISCO,TLAQUEPAQUE,8,141,4,153,1718
JALISCO,TLAQUEPAQUE,11,119,4,134,1717
JALISCO,TLAQUEPAQUE,7,142,1,150,1717
JALISCO,TLAQUEPAQUE,12,160,1,173,1833
JALISCO,TLAQUEPAQUE,8,129,2,139,1833
JALISCO,TLAQUEPAQUE,17,171,1,189,1811
JALISCO,TLAQUEPAQUE,20,141,1,162,1811
JALISCO,TLAQUEPAQUE,18,140,2,160,1643
JALISCO,TLAQUEPAQUE,12,135,4,151,1643
JALISCO,TLAQUEPAQUE,13,151,1,165,1528
JALISCO,TLAQUEPAQUE,13,129,0,142,1527
JALISCO,TLAQUEPAQUE,16,101,1,118,1527
JALISCO,TLAQUEPAQUE,19,146,1,166,2007
JALISCO,TLAQUEPAQUE,16,173,3,192,2007
JALISCO,TLAQUEPAQUE,113,138,2,253,2007
JALISCO,TLAQUEPAQUE,11,135,2,148,2007
JALISCO,TLAQUEPAQUE,16,164,2,182,1531
JALISCO,TLAQUEPAQUE,11,142,0,153,1531
JALISCO,TLAQUEPAQUE,14,128,1,143,1531
JALISCO,TLAQUEPAQUE,19,130,1,150,1316
JALISCO,TLAQUEPAQUE,9,121,2,132,1316
JALISCO,TLAQUEPAQUE,15,159,1,175,1743
JALISCO,TLAQUEPAQUE,25,144,1,170,1742
JALISCO,TLAQUEPAQUE,20,120,3,143,1278
JALISCO,TLAQUEPAQUE,10,115,2,127,1277
JALISCO,TLAQUEPAQUE,10,176,2,188,1988
JALISCO,TLAQUEPAQUE,7,176,4,187,1988
JALISCO,TLAQUEPAQUE,16,119,3,138,1599
JALISCO,TLAQUEPAQUE,20,158,3,181,1599
JALISCO,TLAQUEPAQUE,9,163,1,173,2012
JALISCO,TLAQUEPAQUE,17,133,3,153,2011
JALISCO,TLAQUEPAQUE,12,107,3,122,1403
JALISCO,TLAQUEPAQUE,15,108,5,128,1402
JALISCO,TLAQUEPAQUE,17,176,1,194,1758
JALISCO,TLAQUEPAQUE,9,138,6,153,1757
JALISCO,TLAQUEPAQUE,23,140,5,168,1807
JALISCO,TLAQUEPAQUE,33,113,1,147,1807
JALISCO,TLAQUEPAQUE,27,99,0,126,1461
JALISCO,TLAQUEPAQUE,22,95,0,117,1461
JALISCO,TLAQUEPAQUE,21,77,1,99,1438
JALISCO,TLAQUEPAQUE,14,63,0,77,1437
JALISCO,TLAQUEPAQUE,15,103,1,119,1545
JALISCO,TLAQUEPAQUE,19,82,1,102,1545
JALISCO,TLAQUEPAQUE,18,78,3,99,1140
JALISCO,TLAQUEPAQUE,21,99,0,120,1140
JALISCO,TLAQUEPAQUE,18,101,0,119,1237
JALISCO,TLAQUEPAQUE,17,103,0,120,1236
JALISCO,TLAQUEPAQUE,26,111,1,138,1794
JALISCO,TLAQUEPAQUE,30,123,0,153,1794
JALISCO,TLAQUEPAQUE,16,111,0,127,1571
JALISCO,TLAQUEPAQUE,25,122,1,148,1571
JALISCO,JOCOTEPEC,6,227,1,234,1933
JALISCO,JOCOTEPEC,4,197,6,207,1932
JALISCO,JOCOTEPEC,13,135,1,149,1740
JALISCO,JOCOTEPEC,8,178,2,188,1740
JALISCO,JOCOTEPEC,9,239,1,249,1977
JALISCO,JOCOTEPEC,8,206,3,217,1873
JALISCO,JOCOTEPEC,9,241,6,256,1872
JALISCO,JOCOTEPEC,10,210,1,221,1127
JALISCO,JOCOTEPEC,8,236,0,244,1126
JALISCO,JOCOTEPEC,5,157,3,165,1074
JALISCO,JOCOTEPEC,7,162,4,173,1074
JALISCO,JOCOTEPEC,12,140,11,163,1707
JALISCO,JOCOTEPEC,6,133,8,147,1706
JALISCO,JOCOTEPEC,7,174,3,184,1706
JALISCO,JOCOTEPEC,16,133,1,150,1963
JALISCO,JOCOTEPEC,12,111,3,126,1661
JALISCO,JOCOTEPEC,5,117,0,122,1661
JALISCO,JOCOTEPEC,4,65,1,70,1559
JALISCO,JOCOTEPEC,7,55,0,62,1559
JALISCO,JOCOTEPEC,13,109,1,123,1523
JALISCO,JOCOTEPEC,6,94,1,101,1523
JALISCO,JOCOTEPEC,6,63,0,69,1374
JALISCO,JOCOTEPEC,3,76,0,79,1373
JALISCO,JOCOTEPEC,0,89,0,89,1669
JALISCO,JOCOTEPEC,3,97,4,104,1668
JALISCO,JOCOTEPEC,3,117,3,123,1556
JALISCO,JOCOTEPEC,2,114,0,116,1556
JALISCO,JOCOTEPEC,3,189,7,199,1984
JALISCO,JOCOTEPEC,21,216,8,245,1605
JALISCO,JOCOTEPEC,13,189,0,202,1605
JALISCO,JOCOTEPEC,4,202,9,215,1904
JALISCO,JOCOTEPEC,6,104,0,110,1832
JALISCO,JOCOTEPEC,10,114,2,126,1831
JALISCO,JOCOTEPEC,4,113,2,119,1748
JALISCO,JOCOTEPEC,5,124,1,130,1748
JALISCO,JOCOTEPEC,15,145,0,160,2018
JALISCO,JOCOTEPEC,13,173,1,187,2018
JALISCO,JOCOTEPEC,10,116,0,126,1635
JALISCO,JOCOTEPEC,4,132,1,137,1635
JALISCO,JOCOTEPEC,4,150,2,156,1814
JALISCO,JOCOTEPEC,10,92,3,105,1813
JALISCO,JOCOTEPEC,11,135,3,149,1307
JALISCO,JOCOTEPEC,20,120,5,145,1307
JALISCO,JOCOTEPEC,9,139,5,153,1090
JALISCO,JOCOTEPEC,10,130,5,145,1090
JALISCO,JOCOTEPEC,19,170,1,190,1748
JALISCO,JOCOTEPEC,22,165,0,187,1747
JALISCO,JOCOTEPEC,10,244,0,254,1530
JALISCO,JOCOTEPEC,9,207,3,219,1530
JALISCO,JOCOTEPEC,6,194,5,205,1483
JALISCO,JOCOTEPEC,18,207,5,230,1483
JALISCO,JOCOTEPEC,8,118,1,127,1516
JALISCO,JOCOTEPEC,10,93,2,105,1515
JALISCO,JOCOTEPEC,39,164,2,205,1827
JALISCO,JOCOTEPEC,31,166,3,200,1826
JALISCO,JOCOTEPEC,8,204,0,212,1662
JALISCO,JOCOTEPEC,21,193,0,214,1662
JALISCO,JOCOTEPEC,17,220,5,242,1915
JALISCO,JOCOTEPEC,26,198,2,226,1915
JALISCO,JOCOTEPEC,13,238,1,252,1265
JALISCO,JOCOTEPEC,10,196,3,209,1264
JALISCO,JOCOTEPEC,9,117,3,129,1847
JALISCO,JOCOTEPEC,10,125,2,137,1847
JALISCO,JOCOTEPEC,6,94,1,101,1847
JALISCO,JOCOTEPEC,9,88,1,98,1847
JALISCO,JOCOTEPEC,4,73,1,78,1847
JALISCO,JOCOTEPEC,5,216,2,223,1498
JALISCO,JOCOTEPEC,8,215,2,225,1497
JALISCO,JOCOTEPEC,2,65,2,69,1956
JALISCO,JOCOTEPEC,6,64,0,70,1956
JALISCO,JOCOTEPEC,2,69,0,71,1956
JALISCO,JOCOTEPEC,3,79,0,82,1956
JALISCO,JOCOTEPEC,5,64,0,69,1956
JALISCO,JOCOTEPEC,2,73,0,75,1955
JALISCO,JOCOTEPEC,13,103,3,119,1371
JALISCO,JOCOTEPEC,4,120,0,124,1371
JALISCO,JOCOTEPEC,7,148,1,156,1204
JALISCO,JOCOTEPEC,4,113,1,118,1204
JALISCO,JOCOTEPEC,0,100,5,105,1250
JALISCO,JOCOTEPEC,9,104,0,113,1249
JALISCO,JOCOTEPEC,7,124,1,132,1624
JALISCO,JOCOTEPEC,4,148,3,155,1624
JALISCO,JOCOTEPEC,97,433,8,538,0
JALISCO,JOCOTEPEC,8,156,3,167,1905
JALISCO,JOCOTEPEC,9,148,1,158,1904
JALISCO,JOCOTEPEC,5,129,0,134,1840
JALISCO,JOCOTEPEC,12,123,0,135,1840
JALISCO,JOCOTEPEC,9,125,1,135,1496
JALISCO,JOCOTEPEC,5,120,0,125,1495
JALISCO,JOCOTEPEC,15,92,1,108,1581
JALISCO,JOCOTEPEC,7,89,1,97,1580
JALISCO,JOCOTEPEC,5,69,2,76,1072
JALISCO,JOCOTEPEC,6,70,1,77,1072
JALISCO,JOCOTEPEC,4,59,1,64,1661
JALISCO,JOCOTEPEC,12,82,1,95,1660
JALISCO,JOCOTEPEC,9,51,1,61,1660
JALISCO,JOCOTEPEC,8,80,3,91,1209
JALISCO,JOCOTEPEC,6,69,1,76,1208
JALISCO,JOCOTEPEC,7,118,5,130,1627
JALISCO,JOCOTEPEC,2,142,1,145,1626
JALISCO,JOCOTEPEC,12,101,0,113,1689
JALISCO,JOCOTEPEC,9,116,3,128,1688
JALISCO,JOCOTEPEC,22,128,2,152,1428
JALISCO,JOCOTEPEC,17,174,2,193,1427
JALISCO,JOCOTEPEC,11,110,1,122,1427
JALISCO,JOCOTEPEC,11,152,2,165,1706
JALISCO,JOCOTEPEC,10,144,3,157,1706
JALISCO,JOCOTEPEC,8,84,3,95,1877
JALISCO,JOCOTEPEC,12,92,1,105,1877
JALISCO,JOCOTEPEC,10,114,3,127,1586
JALISCO,JOCOTEPEC,8,101,3,112,1586
JALISCO,JOCOTEPEC,6,114,1,121,1585
JALISCO,JOCOTEPEC,5,112,1,118,1478
JALISCO,JOCOTEPEC,9,113,1,123,1478
JALISCO,JOCOTEPEC,9,118,0,127,1477
JALISCO,JOCOTEPEC,6,131,4,141,1627
JALISCO,JOCOTEPEC,9,149,2,160,1627
JALISCO,JOCOTEPEC,7,170,0,177,1209
JALISCO,JOCOTEPEC,0,176,1,177,1209
JALISCO,JOCOTEPEC,17,227,0,244,1981
JALISCO,JOCOTEPEC,8,149,0,157,1980
JALISCO,JOCOTEPEC,10,205,0,215,1980
JALISCO,JOCOTEPEC,7,381,1,389,1684
JALISCO,JOCOTEPEC,3,363,4,370,1683
JALISCO,JOCOTEPEC,7,136,0,143,1660
JALISCO,JOCOTEPEC,12,152,10,174,1660
JALISCO,JOCOTEPEC,4,138,3,145,1659
JALISCO,JOCOTEPEC,3,191,2,196,1190
JALISCO,JOCOTEPEC,5,160,5,170,1189
JALISCO,JOCOTEPEC,4,71,1,76,1041
JALISCO,JOCOTEPEC,0,80,0,80,1041
JALISCO,JOCOTEPEC,7,267,2,276,1930
JALISCO,JOCOTEPEC,8,259,4,271,1929
JALISCO,JOCOTEPEC,6,233,0,239,1873
JALISCO,JOCOTEPEC,10,247,3,260,1873
JALISCO,JOCOTEPEC,6,184,0,190,1193
JALISCO,JOCOTEPEC,6,154,2,162,1192
JALISCO,JOCOTEPEC,4,92,0,96,1499
JALISCO,JOCOTEPEC,5,103,1,109,1498
JALISCO,JOCOTEPEC,2,110,2,114,1498
JALISCO,JOCOTEPEC,0,160,3,163,1231
JALISCO,JOCOTEPEC,4,148,2,154,1231
JALISCO,JOCOTEPEC,13,187,5,205,1899
JALISCO,JOCOTEPEC,10,182,2,194,1899
JALISCO,JOCOTEPEC,10,158,3,171,1898
JALISCO,JOCOTEPEC,5,152,3,160,1434
JALISCO,JOCOTEPEC,14,154,3,171,1434
JALISCO,JOCOTEPEC,12,139,1,152,1132
JALISCO,JOCOTEPEC,6,108,0,114,1132
JALISCO,JOCOTEPEC,14,193,4,211,1994
JALISCO,JOCOTEPEC,15,176,1,192,1122
JALISCO,JOCOTEPEC,19,194,2,215,1121
JALISCO,JOCOTEPEC,12,133,5,150,1711
JALISCO,JOCOTEPEC,7,155,2,164,1710
JALISCO,JOCOTEPEC,3,154,1,158,1710
JALISCO,JOCOTEPEC,3,170,0,173,1478
JALISCO,JOCOTEPEC,6,151,2,159,1478
JALISCO,JOCOTEPEC,9,131,0,140,1477
JALISCO,JOCOTEPEC,15,192,1,208,1660
JALISCO,JOCOTEPEC,14,172,0,186,1660
JALISCO,JOCOTEPEC,13,164,2,179,1659
JALISCO,JOCOTEPEC,5,215,3,223,1863
JALISCO,JOCOTEPEC,10,232,2,244,1863
JALISCO,JOCOTEPEC,6,227,4,237,1959
JALISCO,JOCOTEPEC,7,208,4,219,1958
JALISCO,JOCOTEPEC,3,187,2,192,1629
JALISCO,JOCOTEPEC,7,181,0,188,1629
JALISCO,JOCOTEPEC,3,109,4,116,1628
JALISCO,JOCOTEPEC,6,140,2,148,1628
JALISCO,JOCOTEPEC,2,103,3,108,1355
JALISCO,JOCOTEPEC,4,102,1,107,1355
JALISCO,AUTLAN DE NAVARRO,7,238,6,251,1936
JALISCO,AUTLAN DE NAVARRO,11,234,3,248,1935
JALISCO,AUTLAN DE NAVARRO,6,218,3,227,1792
JALISCO,AUTLAN DE NAVARRO,7,205,0,212,1791
JALISCO,AUTLAN DE NAVARRO,12,200,3,215,1579
JALISCO,AUTLAN DE NAVARRO,16,205,5,226,1579
JALISCO,AUTLAN DE NAVARRO,15,209,0,224,1578
JALISCO,AUTLAN DE NAVARRO,10,159,5,174,1943
JALISCO,AUTLAN DE NAVARRO,9,223,0,232,1942
JALISCO,AUTLAN DE NAVARRO,7,175,1,183,1942
JALISCO,AUTLAN DE NAVARRO,7,130,0,137,1310
JALISCO,AUTLAN DE NAVARRO,7,162,1,170,1309
JALISCO,AUTLAN DE NAVARRO,4,216,1,221,1501
JALISCO,AUTLAN DE NAVARRO,4,229,1,234,1500
JALISCO,AUTLAN DE NAVARRO,9,216,3,228,1831
JALISCO,AUTLAN DE NAVARRO,10,242,3,255,1830
JALISCO,AUTLAN DE NAVARRO,8,229,5,242,1769
JALISCO,AUTLAN DE NAVARRO,9,278,4,291,1768
JALISCO,AUTLAN DE NAVARRO,6,187,4,197,1611
JALISCO,AUTLAN DE NAVARRO,12,186,3,201,1611
JALISCO,AUTLAN DE NAVARRO,9,287,4,300,1518
JALISCO,AUTLAN DE NAVARRO,4,293,3,300,1517
JALISCO,AUTLAN DE NAVARRO,10,214,3,227,1600
JALISCO,AUTLAN DE NAVARRO,6,204,1,211,1600
JALISCO,AUTLAN DE NAVARRO,6,172,2,180,1600
JALISCO,AUTLAN DE NAVARRO,9,129,0,138,1423
JALISCO,AUTLAN DE NAVARRO,7,124,2,133,1422
JALISCO,AUTLAN DE NAVARRO,1,126,3,130,1411
JALISCO,AUTLAN DE NAVARRO,5,151,3,159,1411
JALISCO,AUTLAN DE NAVARRO,3,119,1,123,1411
JALISCO,AUTLAN DE NAVARRO,7,72,1,80,1488
JALISCO,AUTLAN DE NAVARRO,3,61,2,66,1488
JALISCO,AUTLAN DE NAVARRO,4,80,1,85,1488
JALISCO,AUTLAN DE NAVARRO,9,127,3,139,1745
JALISCO,AUTLAN DE NAVARRO,7,155,1,163,1745
JALISCO,AUTLAN DE NAVARRO,16,226,4,246,1878
JALISCO,AUTLAN DE NAVARRO,9,198,1,208,1877
JALISCO,AUTLAN DE NAVARRO,16,213,1,230,1740
JALISCO,AUTLAN DE NAVARRO,9,174,1,184,1740
JALISCO,AUTLAN DE NAVARRO,45,470,4,519,0
JALISCO,AUTLAN DE NAVARRO,12,289,4,305,1906
JALISCO,AUTLAN DE NAVARRO,12,177,0,189,1906
JALISCO,AUTLAN DE NAVARRO,1,159,0,160,1618
JALISCO,AUTLAN DE NAVARRO,6,160,0,166,1617
JALISCO,AUTLAN DE NAVARRO,1,126,0,127,1617
JALISCO,AUTLAN DE NAVARRO,9,174,2,185,1344
JALISCO,AUTLAN DE NAVARRO,19,185,1,205,1344
JALISCO,AUTLAN DE NAVARRO,25,217,2,244,1802
JALISCO,AUTLAN DE NAVARRO,14,160,0,174,1802
JALISCO,AUTLAN DE NAVARRO,12,123,1,136,1781
JALISCO,AUTLAN DE NAVARRO,7,136,0,143,1781
JALISCO,AUTLAN DE NAVARRO,9,158,1,168,1491
JALISCO,AUTLAN DE NAVARRO,12,165,1,178,1491
JALISCO,AUTLAN DE NAVARRO,9,139,2,150,1491
JALISCO,AUTLAN DE NAVARRO,9,217,0,226,1532
JALISCO,AUTLAN DE NAVARRO,5,222,2,229,1532
JALISCO,AUTLAN DE NAVARRO,4,166,1,171,1768
JALISCO,AUTLAN DE NAVARRO,2,174,0,176,1768
JALISCO,AUTLAN DE NAVARRO,9,206,4,219,1976
JALISCO,AUTLAN DE NAVARRO,12,185,6,203,1976
JALISCO,AUTLAN DE NAVARRO,4,154,4,162,2062
JALISCO,AUTLAN DE NAVARRO,0,62,0,62,1102
JALISCO,AUTLAN DE NAVARRO,3,100,1,104,1101
JALISCO,AUTLAN DE NAVARRO,2,90,0,92,1071
JALISCO,AUTLAN DE NAVARRO,3,120,1,124,1071
JALISCO,AUTLAN DE NAVARRO,4,157,3,164,1933
JALISCO,AUTLAN DE NAVARRO,3,128,1,132,1932
JALISCO,AUTLAN DE NAVARRO,2,105,6,113,1437
JALISCO,AUTLAN DE NAVARRO,7,79,0,86,1436
JALISCO,AUTLAN DE NAVARRO,10,63,0,73,1180
JALISCO,AUTLAN DE NAVARRO,11,56,1,68,1180
JALISCO,AUTLAN DE NAVARRO,8,222,5,235,2042
JALISCO,AUTLAN DE NAVARRO,3,202,2,207,2042
JALISCO,AUTLAN DE NAVARRO,11,234,3,248,2042
JALISCO,AUTLAN DE NAVARRO,3,127,1,131,1486
JALISCO,AUTLAN DE NAVARRO,8,164,3,175,1486
JALISCO,AUTLAN DE NAVARRO,0,147,1,148,1486
JALISCO,AUTLAN DE NAVARRO,6,147,0,153,1722
JALISCO,AUTLAN DE NAVARRO,3,194,0,197,1721
JALISCO,AUTLAN DE NAVARRO,15,193,3,211,1721
JALISCO,AUTLAN DE NAVARRO,3,336,3,342,1890
JALISCO,AUTLAN DE NAVARRO,4,294,4,302,1889
JALISCO,AUTLAN DE NAVARRO,0,232,2,234,1601
JALISCO,AUTLAN DE NAVARRO,3,186,2,191,1601
JALISCO,AUTLAN DE NAVARRO,3,195,2,200,1601
JALISCO,AUTLAN DE NAVARRO,7,347,0,354,1873
JALISCO,AUTLAN DE NAVARRO,9,367,7,383,1872
JALISCO,AUTLAN DE NAVARRO,10,276,2,288,1858
JALISCO,AUTLAN DE NAVARRO,6,299,2,307,1858
JALISCO,AUTLAN DE NAVARRO,1,259,1,261,1555
JALISCO,AUTLAN DE NAVARRO,6,271,2,279,1554
JALISCO,AUTLAN DE NAVARRO,5,266,3,274,1878
JALISCO,AUTLAN DE NAVARRO,7,313,3,323,1877
JALISCO,AUTLAN DE NAVARRO,6,304,0,310,1853
JALISCO,AUTLAN DE NAVARRO,4,308,0,312,1853
JALISCO,AUTLAN DE NAVARRO,9,281,9,299,1536
JALISCO,AUTLAN DE NAVARRO,12,301,6,319,1535
JALISCO,AUTLAN DE NAVARRO,5,288,15,308,1535
JALISCO,AUTLAN DE NAVARRO,0,330,19,349,1213
JALISCO,AUTLAN DE NAVARRO,27,283,26,336,1212
JALISCO,AUTLAN DE NAVARRO,3,267,3,273,1094
JALISCO,AUTLAN DE NAVARRO,9,236,11,256,1093
JALISCO,AUTLAN DE NAVARRO,9,617,22,648,1964
JALISCO,AUTLAN DE NAVARRO,9,231,3,243,1030
JALISCO,AUTLAN DE NAVARRO,2,241,1,244,1029
JALISCO,AUTLAN DE NAVARRO,8,101,0,109,1110
JALISCO,AUTLAN DE NAVARRO,6,102,4,112,1110
JALISCO,AUTLAN DE NAVARRO,10,263,5,278,1570
JALISCO,AUTLAN DE NAVARRO,12,214,6,232,1570
JALISCO,AUTLAN DE NAVARRO,16,208,3,227,1569
JALISCO,AUTLAN DE NAVARRO,5,113,2,120,1017
JALISCO,AUTLAN DE NAVARRO,11,119,3,133,1016
JALISCO,AUTLAN DE NAVARRO,11,175,2,188,1594
JALISCO,AUTLAN DE NAVARRO,10,156,1,167,1593
JALISCO,AUTLAN DE NAVARRO,13,162,3,178,1889
JALISCO,AUTLAN DE NAVARRO,5,139,6,150,1888
JALISCO,AUTLAN DE NAVARRO,1,89,1,91,1664
JALISCO,AUTLAN DE NAVARRO,2,74,0,76,1664
JALISCO,AUTLAN DE NAVARRO,4,121,3,128,1643
JALISCO,AUTLAN DE NAVARRO,12,128,1,141,1642
JALISCO,AUTLAN DE NAVARRO,13,153,0,166,1747
JALISCO,AUTLAN DE NAVARRO,15,150,5,170,1746
JALISCO,AUTLAN DE NAVARRO,20,139,0,159,1396
JALISCO,AUTLAN DE NAVARRO,17,177,1,195,1396
JALISCO,AUTLAN DE NAVARRO,4,229,3,236,1811
JALISCO,AUTLAN DE NAVARRO,5,232,3,240,1810
JALISCO,AUTLAN DE NAVARRO,9,227,3,239,2011
JALISCO,AUTLAN DE NAVARRO,8,253,1,262,2010
JALISCO,AUTLAN DE NAVARRO,2,175,5,182,1066
JALISCO,AUTLAN DE NAVARRO,2,146,2,150,1066
JALISCO,AUTLAN DE NAVARRO,7,188,2,197,1281
JALISCO,AUTLAN DE NAVARRO,4,199,6,209,1280
JALISCO,AUTLAN DE NAVARRO,1,260,1,262,1593
JALISCO,AUTLAN DE NAVARRO,3,291,6,300,1592
JALISCO,AUTLAN DE NAVARRO,4,179,0,183,1299
JALISCO,AUTLAN DE NAVARRO,4,175,3,182,1298
JALISCO,AUTLAN DE NAVARRO,21,226,5,252,1677
JALISCO,AUTLAN DE NAVARRO,15,260,1,276,1677
JALISCO,AUTLAN DE NAVARRO,13,250,1,264,1676
JALISCO,AUTLAN DE NAVARRO,9,222,6,237,1203
JALISCO,AUTLAN DE NAVARRO,7,221,3,231,1203
JALISCO,AUTLAN DE NAVARRO,11,305,3,319,1587
JALISCO,AUTLAN DE NAVARRO,20,244,3,267,1586
JALISCO,AUTLAN DE NAVARRO,12,254,1,267,1714
JALISCO,AUTLAN DE NAVARRO,8,245,3,256,1714
JALISCO,AUTLAN DE NAVARRO,0,144,2,146,1325
JALISCO,AUTLAN DE NAVARRO,5,195,0,200,1324
JALISCO,AUTLAN DE NAVARRO,5,170,6,181,1783
JALISCO,AUTLAN DE NAVARRO,6,173,7,186,1783
JALISCO,AUTLAN DE NAVARRO,2,221,2,225,1765
JALISCO,AUTLAN DE NAVARRO,10,221,5,236,1764
JALISCO,AUTLAN DE NAVARRO,7,145,3,155,1020
JALISCO,AUTLAN DE NAVARRO,4,126,3,133,1020
JALISCO,AUTLAN DE NAVARRO,9,166,2,177,1508
JALISCO,AUTLAN DE NAVARRO,10,150,4,164,1507
JALISCO,AUTLAN DE NAVARRO,2,147,1,150,1507
JALISCO,AUTLAN DE NAVARRO,5,274,3,282,1947
JALISCO,AUTLAN DE NAVARRO,7,258,1,266,1947
JALISCO,AUTLAN DE NAVARRO,8,188,7,203,1730
JALISCO,AUTLAN DE NAVARRO,8,199,3,210,1730
JALISCO,AUTLAN DE NAVARRO,8,159,2,169,1445
JALISCO,AUTLAN DE NAVARRO,2,147,1,150,1444
JALISCO,AUTLAN DE NAVARRO,8,263,9,280,1517
JALISCO,AUTLAN DE NAVARRO,3,166,0,169,1972
JALISCO,AUTLAN DE NAVARRO,1,136,3,140,1971
JALISCO,AUTLAN DE NAVARRO,8,209,4,221,1177
JALISCO,AUTLAN DE NAVARRO,4,217,6,227,1176
JALISCO,AUTLAN DE NAVARRO,11,98,0,109,1784
JALISCO,AUTLAN DE NAVARRO,9,81,0,90,1784
JALISCO,AUTLAN DE NAVARRO,10,105,2,117,1784
JALISCO,AUTLAN DE NAVARRO,8,254,6,268,1401
JALISCO,AUTLAN DE NAVARRO,4,215,5,224,1401
JALISCO,AUTLAN DE NAVARRO,6,220,2,228,1401
JALISCO,AUTLAN DE NAVARRO,10,143,6,159,1627
JALISCO,AUTLAN DE NAVARRO,10,174,3,187,1626
JALISCO,AUTLAN DE NAVARRO,19,139,1,159,1626
JALISCO,AUTLAN DE NAVARRO,8,192,15,215,1926
JALISCO,AUTLAN DE NAVARRO,3,196,1,200,1925
JALISCO,AUTLAN DE NAVARRO,5,140,3,148,1430
JALISCO,AUTLAN DE NAVARRO,4,104,0,108,1430
JALISCO,AUTLAN DE NAVARRO,14,356,2,372,1740
JALISCO,AUTLAN DE NAVARRO,13,343,4,360,1739
JALISCO,AUTLAN DE NAVARRO,7,345,5,357,1739
JALISCO,CIUDAD GUZMAN,9,156,5,170,1556
JALISCO,CIUDAD GUZMAN,7,153,0,160,1556
JALISCO,CIUDAD GUZMAN,11,153,2,166,1555
JALISCO,CIUDAD GUZMAN,6,154,1,161,1778
JALISCO,CIUDAD GUZMAN,13,166,2,181,1777
JALISCO,CIUDAD GUZMAN,7,121,4,132,1777
JALISCO,CIUDAD GUZMAN,6,112,2,120,1777
JALISCO,CIUDAD GUZMAN,15,196,2,213,1573
JALISCO,CIUDAD GUZMAN,17,166,1,184,1573
JALISCO,CIUDAD GUZMAN,15,183,3,201,1573
JALISCO,CIUDAD GUZMAN,23,179,2,204,1604
JALISCO,CIUDAD GUZMAN,21,171,0,192,1603
JALISCO,CIUDAD GUZMAN,6,87,0,93,1067
JALISCO,CIUDAD GUZMAN,4,77,0,81,1066
JALISCO,CIUDAD GUZMAN,5,174,4,183,1507
JALISCO,CIUDAD GUZMAN,13,166,1,180,1506
JALISCO,CIUDAD GUZMAN,9,194,3,206,1785
JALISCO,CIUDAD GUZMAN,13,202,0,215,1785
JALISCO,CIUDAD GUZMAN,19,165,4,188,1720
JALISCO,CIUDAD GUZMAN,25,159,2,186,1720
JALISCO,CIUDAD GUZMAN,10,191,0,201,1658
JALISCO,CIUDAD GUZMAN,8,194,1,203,1657
JALISCO,CIUDAD GUZMAN,31,204,2,237,2058
JALISCO,CIUDAD GUZMAN,35,204,2,241,2058
JALISCO,CIUDAD GUZMAN,74,674,5,753,0
JALISCO,CIUDAD GUZMAN,20,119,2,141,1624
JALISCO,CIUDAD GUZMAN,15,181,1,197,1624
JALISCO,CIUDAD GUZMAN,13,186,4,203,1624
JALISCO,CIUDAD GUZMAN,14,244,4,262,1702
JALISCO,CIUDAD GUZMAN,17,239,2,258,1702
JALISCO,CIUDAD GUZMAN,15,175,2,192,1601
JALISCO,CIUDAD GUZMAN,8,167,2,177,1600
JALISCO,CIUDAD GUZMAN,22,240,1,263,1752
JALISCO,CIUDAD GUZMAN,16,209,2,227,1751
JALISCO,CIUDAD GUZMAN,11,209,2,222,1692
JALISCO,CIUDAD GUZMAN,21,190,2,213,1691
JALISCO,CIUDAD GUZMAN,17,169,1,187,1273
JALISCO,CIUDAD GUZMAN,9,195,0,204,1273
JALISCO,CIUDAD GUZMAN,9,223,2,234,1397
JALISCO,CIUDAD GUZMAN,13,232,1,246,1397
JALISCO,CIUDAD GUZMAN,12,230,2,244,1397
JALISCO,CIUDAD GUZMAN,12,187,1,200,2008
JALISCO,CIUDAD GUZMAN,7,223,2,232,2007
JALISCO,CIUDAD GUZMAN,11,215,1,227,1608
JALISCO,CIUDAD GUZMAN,10,188,1,199,1607
JALISCO,CIUDAD GUZMAN,14,248,4,266,1766
JALISCO,CIUDAD GUZMAN,21,227,5,253,1765
JALISCO,CIUDAD GUZMAN,6,180,1,187,1901
JALISCO,CIUDAD GUZMAN,10,160,2,172,1901
JALISCO,CIUDAD GUZMAN,9,174,1,184,1900
JALISCO,CIUDAD GUZMAN,6,189,1,196,1900
JALISCO,CIUDAD GUZMAN,8,181,4,193,1900
JALISCO,CIUDAD GUZMAN,12,195,7,214,1870
JALISCO,CIUDAD GUZMAN,10,180,6,196,1870
JALISCO,CIUDAD GUZMAN,19,172,2,193,1846
JALISCO,CIUDAD GUZMAN,15,196,0,211,1846
JALISCO,CIUDAD GUZMAN,8,197,5,210,1760
JALISCO,CIUDAD GUZMAN,13,222,1,236,1760
JALISCO,CIUDAD GUZMAN,16,203,1,220,1806
JALISCO,CIUDAD GUZMAN,7,196,6,209,1806
JALISCO,CIUDAD GUZMAN,0,134,0,134,1497
JALISCO,CIUDAD GUZMAN,2,103,2,107,1497
JALISCO,CIUDAD GUZMAN,7,179,1,187,2027
JALISCO,CIUDAD GUZMAN,6,181,3,190,2026
JALISCO,CIUDAD GUZMAN,2,157,4,163,1247
JALISCO,CIUDAD GUZMAN,6,143,4,153,1246
JALISCO,CIUDAD GUZMAN,3,132,3,138,1500
JALISCO,CIUDAD GUZMAN,2,108,2,112,1500
JALISCO,CIUDAD GUZMAN,7,171,1,179,1527
JALISCO,CIUDAD GUZMAN,5,154,2,161,1526
JALISCO,CIUDAD GUZMAN,6,229,3,238,1889
JALISCO,CIUDAD GUZMAN,10,213,1,224,1888
JALISCO,CIUDAD GUZMAN,5,144,7,156,1381
JALISCO,CIUDAD GUZMAN,3,118,4,125,1381
JALISCO,CIUDAD GUZMAN,6,185,4,195,1433
JALISCO,CIUDAD GUZMAN,6,160,2,168,1433
JALISCO,CIUDAD GUZMAN,19,179,4,202,1593
JALISCO,CIUDAD GUZMAN,11,194,2,207,1592
JALISCO,CIUDAD GUZMAN,19,215,1,235,1592
JALISCO,CIUDAD GUZMAN,21,167,0,188,1592
JALISCO,CIUDAD GUZMAN,14,33,3,50,2013
JALISCO,CIUDAD GUZMAN,5,205,1,211,1711
JALISCO,CIUDAD GUZMAN,6,184,6,196,1710
JALISCO,CIUDAD GUZMAN,7,140,2,149,1773
JALISCO,CIUDAD GUZMAN,0,160,4,164,1773
JALISCO,CIUDAD GUZMAN,3,129,1,133,1773
JALISCO,CIUDAD GUZMAN,12,79,1,92,1410
JALISCO,CIUDAD GUZMAN,10,70,0,80,1409
JALISCO,CIUDAD GUZMAN,14,148,2,164,1678
JALISCO,CIUDAD GUZMAN,4,143,0,147,1678
JALISCO,CIUDAD GUZMAN,5,109,2,116,1113
JALISCO,CIUDAD GUZMAN,4,85,0,89,1112
JALISCO,CIUDAD GUZMAN,9,210,4,223,1957
JALISCO,CIUDAD GUZMAN,7,227,4,238,1957
JALISCO,CIUDAD GUZMAN,3,161,2,166,1086
JALISCO,CIUDAD GUZMAN,9,163,3,175,1085
JALISCO,CIUDAD GUZMAN,6,208,3,217,1462
JALISCO,CIUDAD GUZMAN,10,219,2,231,1461
JALISCO,CIUDAD GUZMAN,6,187,1,194,1778
JALISCO,CIUDAD GUZMAN,7,224,4,235,1777
JALISCO,CIUDAD GUZMAN,18,183,2,203,1777
JALISCO,CIUDAD GUZMAN,5,149,2,156,1065
JALISCO,CIUDAD GUZMAN,6,171,2,179,1064
JALISCO,CIUDAD GUZMAN,15,217,1,233,1781
JALISCO,CIUDAD GUZMAN,9,207,1,217,1780
JALISCO,CIUDAD GUZMAN,5,158,1,164,1450
JALISCO,CIUDAD GUZMAN,1,114,0,115,1450
JALISCO,CIUDAD GUZMAN,3,142,2,147,1450
JALISCO,CIUDAD GUZMAN,0,177,3,180,1639
JALISCO,CIUDAD GUZMAN,5,159,2,166,1638
JALISCO,CIUDAD GUZMAN,16,189,1,206,1800
JALISCO,CIUDAD GUZMAN,15,169,3,187,1799
JALISCO,CIUDAD GUZMAN,11,217,5,233,1687
JALISCO,CIUDAD GUZMAN,13,234,4,251,1686
JALISCO,CIUDAD GUZMAN,9,175,4,188,1500
JALISCO,CIUDAD GUZMAN,13,134,2,149,1500
JALISCO,CIUDAD GUZMAN,8,143,1,152,1710
JALISCO,CIUDAD GUZMAN,8,137,1,146,1709
JALISCO,CIUDAD GUZMAN,26,189,2,217,1955
JALISCO,CIUDAD GUZMAN,27,224,4,255,1954
JALISCO,CIUDAD GUZMAN,9,139,4,152,1523
JALISCO,CIUDAD GUZMAN,9,107,3,119,1523
JALISCO,CIUDAD GUZMAN,7,312,7,326,2050
JALISCO,CIUDAD GUZMAN,6,273,3,282,2050
JALISCO,CIUDAD GUZMAN,8,185,5,198,1721
JALISCO,CIUDAD GUZMAN,9,179,7,195,1721
JALISCO,CIUDAD GUZMAN,6,137,0,143,1543
JALISCO,CIUDAD GUZMAN,4,158,2,164,1543
JALISCO,CIUDAD GUZMAN,11,164,5,180,1791
JALISCO,CIUDAD GUZMAN,11,164,5,180,1790
JALISCO,CIUDAD GUZMAN,14,94,0,108,2029
JALISCO,CIUDAD GUZMAN,4,77,1,82,2028
JALISCO,CIUDAD GUZMAN,12,147,3,162,1653
JALISCO,CIUDAD GUZMAN,8,140,4,152,1652
JALISCO,CIUDAD GUZMAN,3,51,0,54,1716
JALISCO,CIUDAD GUZMAN,7,52,0,59,1715
JALISCO,CIUDAD GUZMAN,7,90,2,99,1990
JALISCO,CIUDAD GUZMAN,10,83,0,93,1989
JALISCO,CIUDAD GUZMAN,4,194,3,201,1859
JALISCO,CIUDAD GUZMAN,6,185,7,198,1859
JALISCO,CIUDAD GUZMAN,10,112,3,125,1178
JALISCO,CIUDAD GUZMAN,14,108,5,127,1177
JALISCO,CIUDAD GUZMAN,10,228,9,247,1495
JALISCO,CIUDAD GUZMAN,7,176,5,188,1494
JALISCO,CIUDAD GUZMAN,10,178,6,194,1444
JALISCO,CIUDAD GUZMAN,6,196,5,207,1444
JALISCO,CIUDAD GUZMAN,9,189,11,209,1443
JALISCO,CIUDAD GUZMAN,13,192,0,205,1583
JALISCO,CIUDAD GUZMAN,16,177,7,200,1583
JALISCO,CIUDAD GUZMAN,3,378,4,385,1988
JALISCO,CIUDAD GUZMAN,7,376,1,384,1987
JALISCO,CIUDAD GUZMAN,5,370,10,385,1987
JALISCO,CIUDAD GUZMAN,8,333,4,345,1900
JALISCO,CIUDAD GUZMAN,8,340,4,352,1899
JALISCO,CIUDAD GUZMAN,5,278,3,286,1860
JALISCO,CIUDAD GUZMAN,6,293,3,302,1860
JALISCO,CIUDAD GUZMAN,5,208,0,213,1221
JALISCO,CIUDAD GUZMAN,6,227,3,236,1220
JALISCO,CIUDAD GUZMAN,8,101,2,111,1148
JALISCO,CIUDAD GUZMAN,4,119,0,123,1148
JALISCO,CIUDAD GUZMAN,8,261,0,269,1411
JALISCO,CIUDAD GUZMAN,6,228,2,236,1410
JALISCO,CIUDAD GUZMAN,11,268,4,283,1995
JALISCO,CIUDAD GUZMAN,19,309,3,331,1994
JALISCO,CIUDAD GUZMAN,5,232,3,240,1044
JALISCO,CIUDAD GUZMAN,1,214,2,217,1043
JALISCO,CIUDAD GUZMAN,6,291,3,300,1599
JALISCO,CIUDAD GUZMAN,6,267,3,276,1599
JALISCO,CIUDAD GUZMAN,0,134,0,134,1492
JALISCO,CIUDAD GUZMAN,2,125,1,128,1492
JALISCO,CIUDAD GUZMAN,5,105,1,111,1492
JALISCO,CIUDAD GUZMAN,19,183,3,205,1497
JALISCO,CIUDAD GUZMAN,16,180,1,197,1497
JALISCO,CIUDAD GUZMAN,34,174,3,211,1321
JALISCO,CIUDAD GUZMAN,24,177,3,204,1320
JALISCO,CIUDAD GUZMAN,5,209,3,217,1433
JALISCO,CIUDAD GUZMAN,10,280,3,293,1432
JALISCO,CIUDAD GUZMAN,12,240,1,253,1432
JALISCO,CIUDAD GUZMAN,8,263,1,272,1647
JALISCO,CIUDAD GUZMAN,6,273,5,284,1647
JALISCO,CIUDAD GUZMAN,10,266,0,276,1904
JALISCO,CIUDAD GUZMAN,9,302,2,313,1904
JALISCO,CIUDAD GUZMAN,4,208,2,214,1178
JALISCO,CIUDAD GUZMAN,3,208,3,214,1178
JALISCO,CIUDAD GUZMAN,10,239,2,251,1314
JALISCO,CIUDAD GUZMAN,10,238,1,249,1313
JALISCO,CIUDAD GUZMAN,10,245,0,255,1423
JALISCO,CIUDAD GUZMAN,13,175,3,191,1422
JALISCO,CIUDAD GUZMAN,12,234,4,250,2040
JALISCO,CIUDAD GUZMAN,10,230,4,244,2039
JALISCO,CIUDAD GUZMAN,15,164,2,181,1252
JALISCO,CIUDAD GUZMAN,3,180,3,186,1251
JALISCO,TONALA,6,52,1,59,1901
JALISCO,TONALA,8,43,3,54,1900
JALISCO,TONALA,5,38,2,45,1115
JALISCO,TONALA,7,47,1,55,1115
JALISCO,TONALA,8,70,1,79,1584
JALISCO,TONALA,4,50,0,54,1584
JALISCO,TONALA,11,62,4,77,1584
JALISCO,TONALA,10,72,0,82,1584
JALISCO,TONALA,6,60,0,66,1494
JALISCO,TONALA,6,48,3,57,1494
JALISCO,TONALA,10,48,1,59,1493
JALISCO,TONALA,11,229,3,243,1934
JALISCO,TONALA,12,154,1,167,1933
JALISCO,TONALA,8,174,1,183,1044
JALISCO,TONALA,9,134,2,145,1044
JALISCO,TONALA,21,244,3,268,1939
JALISCO,TONALA,9,250,3,262,1938
JALISCO,TONALA,10,84,1,95,1534
JALISCO,TONALA,8,95,2,105,1533
JALISCO,TONALA,9,63,1,73,1533
JALISCO,TONALA,6,72,1,79,1533
JALISCO,TONALA,4,186,1,191,1952
JALISCO,TONALA,8,153,0,161,1952
JALISCO,TONALA,0,188,1,189,1952
JALISCO,TONALA,6,177,1,184,1951
JALISCO,TONALA,9,238,1,248,1441
JALISCO,TONALA,4,276,5,285,1441
JALISCO,TONALA,7,198,3,208,1441
JALISCO,TONALA,5,228,2,235,1521
JALISCO,TONALA,7,219,2,228,1521
JALISCO,TONALA,4,256,0,260,1521
JALISCO,TONALA,9,200,2,211,1520
JALISCO,TONALA,6,148,0,154,1837
JALISCO,TONALA,15,141,1,157,1837
JALISCO,TONALA,13,142,2,157,1837
JALISCO,TONALA,4,136,0,140,1836
JALISCO,TONALA,5,140,2,147,1836
JALISCO,TONALA,7,137,2,146,1836
JALISCO,TONALA,9,146,0,155,1836
JALISCO,TONALA,4,138,1,143,1836
JALISCO,TONALA,13,108,3,124,1298
JALISCO,TONALA,25,161,3,189,1297
JALISCO,TONALA,14,165,0,179,1455
JALISCO,TONALA,9,158,2,169,1455
JALISCO,TONALA,10,165,6,181,1455
JALISCO,TONALA,9,141,2,152,1019
JALISCO,TONALA,8,124,4,136,1018
JALISCO,TONALA,12,117,3,132,1730
JALISCO,TONALA,8,150,1,159,1730
JALISCO,TONALA,8,131,1,140,1730
JALISCO,TONALA,8,141,1,150,1730
JALISCO,TONALA,11,138,1,150,1730
JALISCO,TONALA,5,131,1,137,1729
JALISCO,TONALA,9,128,5,142,1729
JALISCO,TONALA,9,98,4,111,1573
JALISCO,TONALA,8,115,4,127,1573
JALISCO,TONALA,8,108,4,120,1573
JALISCO,TONALA,6,104,3,113,1573
JALISCO,TONALA,10,78,3,91,1202
JALISCO,TONALA,15,112,1,128,1201
JALISCO,TONALA,11,130,4,145,1788
JALISCO,TONALA,13,132,0,145,1787
JALISCO,TONALA,13,145,1,159,1787
JALISCO,TONALA,16,131,6,153,1720
JALISCO,TONALA,19,120,1,140,1720
JALISCO,TONALA,16,135,0,151,1719
JALISCO,TONALA,6,90,0,96,1341
JALISCO,TONALA,5,84,0,89,1340
JALISCO,TONALA,6,97,0,103,1340
JALISCO,TONALA,17,102,3,122,1757
JALISCO,TONALA,14,120,0,134,1757
JALISCO,TONALA,6,122,2,130,1933
JALISCO,TONALA,4,127,5,136,1933
JALISCO,TONALA,9,134,2,145,1932
JALISCO,TONALA,15,138,5,158,1932
JALISCO,TONALA,14,137,3,154,1932
JALISCO,TONALA,13,112,0,125,1682
JALISCO,TONALA,4,128,1,133,1682
JALISCO,TONALA,6,143,1,150,1681
JALISCO,TONALA,2,127,2,131,1681
JALISCO,TONALA,10,137,0,147,1681
JALISCO,TONALA,7,120,2,129,1681
JALISCO,TONALA,7,232,2,241,1331
JALISCO,TONALA,11,224,4,239,1330
JALISCO,TONALA,14,171,2,187,1559
JALISCO,TONALA,8,174,4,186,1559
JALISCO,TONALA,18,140,1,159,1883
JALISCO,TONALA,10,165,2,177,1883
JALISCO,TONALA,16,165,0,181,1882
JALISCO,TONALA,10,140,1,151,1882
JALISCO,TONALA,7,127,2,136,1964
JALISCO,TONALA,7,125,1,133,1964
JALISCO,TONALA,8,108,4,120,1964
JALISCO,TONALA,6,136,0,142,1964
JALISCO,TONALA,10,107,3,120,1963
JALISCO,TONALA,11,135,0,146,1963
JALISCO,TONALA,14,107,2,123,1963
JALISCO,TONALA,19,88,2,109,1889
JALISCO,TONALA,5,103,1,109,1888
JALISCO,TONALA,15,90,2,107,1888
JALISCO,TONALA,18,140,2,160,1833
JALISCO,TONALA,11,122,0,133,1832
JALISCO,TONALA,9,94,5,108,1832
JALISCO,TONALA,20,127,1,148,1909
JALISCO,TONALA,13,97,0,110,1909
JALISCO,TONALA,13,99,0,112,1909
JALISCO,TONALA,12,86,1,99,1909
JALISCO,TONALA,11,83,2,96,1909
JALISCO,TONALA,20,79,0,99,1908
JALISCO,TONALA,13,84,1,98,1908
JALISCO,TONALA,10,116,1,127,1865
JALISCO,TONALA,10,120,3,133,1865
JALISCO,TONALA,0,119,1,120,1865
JALISCO,TONALA,12,97,0,109,1865
JALISCO,TONALA,18,114,1,133,1865
JALISCO,TONALA,12,99,2,113,1865
JALISCO,TONALA,16,118,5,139,1865
JALISCO,TONALA,14,110,2,126,1864
JALISCO,TONALA,14,112,2,128,1811
JALISCO,TONALA,12,109,1,122,1811
JALISCO,TONALA,9,90,0,99,1811
JALISCO,TONALA,15,113,2,130,1811
JALISCO,TONALA,9,87,3,99,1811
JALISCO,TONALA,5,81,1,87,1811
JALISCO,TONALA,15,100,1,116,1811
JALISCO,TONALA,6,130,2,138,1639
JALISCO,TONALA,12,126,1,139,1639
JALISCO,TONALA,10,121,0,131,1638
JALISCO,TONALA,13,118,2,133,1638
JALISCO,TONALA,14,92,0,106,1819
JALISCO,TONALA,9,99,1,109,1819
JALISCO,TONALA,8,88,0,96,1819
JALISCO,TONALA,12,100,0,112,1818
JALISCO,TONALA,10,90,2,102,1525
JALISCO,TONALA,14,100,1,115,1524
JALISCO,TONALA,13,84,1,98,1524
JALISCO,TONALA,9,80,6,95,1524
JALISCO,TONALA,17,123,0,140,1897
JALISCO,TONALA,18,116,0,134,1897
JALISCO,TONALA,19,141,0,160,1897
JALISCO,TONALA,19,120,2,141,1896
JALISCO,TONALA,14,120,1,135,1896
JALISCO,TONALA,15,115,0,130,1896
JALISCO,TONALA,14,127,1,142,1896
JALISCO,TONALA,18,105,0,123,1896
JALISCO,TONALA,17,109,0,126,1896
JALISCO,TONALA,3,111,3,117,1578
JALISCO,TONALA,14,111,1,126,1577
JALISCO,TONALA,7,75,4,86,1577
JALISCO,TONALA,9,90,1,100,1577
JALISCO,TONALA,6,75,4,85,1871
JALISCO,TONALA,13,70,0,83,1870
JALISCO,TONALA,14,80,0,94,1841
JALISCO,TONALA,13,89,2,104,1841
JALISCO,TONALA,11,81,3,95,1346
JALISCO,TONALA,12,117,5,134,1346
JALISCO,TONALA,18,93,1,112,1864
JALISCO,TONALA,18,82,3,103,1864
JALISCO,TONALA,13,103,3,119,1787
JALISCO,TONALA,27,67,3,97,1787
JALISCO,TONALA,16,80,1,97,1662
JALISCO,TONALA,10,65,1,76,1662
JALISCO,TONALA,46,348,1,395,0
JALISCO,TONALA,15,89,0,104,1925
JALISCO,TONALA,18,96,2,116,1925
JALISCO,TONALA,5,78,0,83,1352
JALISCO,TONALA,11,65,2,78,1351
JALISCO,TONALA,6,59,0,65,1351
JALISCO,TONALA,10,34,0,44,1906
JALISCO,TONALA,17,40,1,58,1906
JALISCO,TONALA,14,46,0,60,1797
JALISCO,TONALA,12,45,2,59,1796
JALISCO,TONALA,6,38,0,44,1538
JALISCO,TONALA,3,27,0,30,1537
JALISCO,TONALA,5,34,0,39,1537
JALISCO,TONALA,6,29,0,35,1537
JALISCO,TONALA,5,66,1,72,1392
JALISCO,TONALA,6,67,1,74,1392
JALISCO,TONALA,2,46,1,49,1391
JALISCO,TONALA,11,85,2,98,1919
JALISCO,TONALA,18,97,1,116,1918
JALISCO,TONALA,6,50,3,59,1721
JALISCO,TONALA,10,48,0,58,1720
JALISCO,TONALA,3,47,0,50,1280
JALISCO,TONALA,3,54,1,58,1280
MÉXICO,JILOTEPEC DE ANDRES MOLINA ENRIQUEZ,26,272,3,301,1820
MÉXICO,JILOTEPEC DE ANDRES MOLINA ENRIQUEZ,27,270,5,302,1745
MÉXICO,JILOTEPEC DE ANDRES MOLINA ENRIQUEZ,15,206,4,225,1582
MÉXICO,JILOTEPEC DE ANDRES MOLINA ENRIQUEZ,11,183,4,198,1582
MÉXICO,JILOTEPEC DE ANDRES MOLINA ENRIQUEZ,7,190,2,199,1581
MÉXICO,JILOTEPEC DE ANDRES MOLINA ENRIQUEZ,9,135,2,146,1959
MÉXICO,JILOTEPEC DE ANDRES MOLINA ENRIQUEZ,12,99,2,113,1958
MÉXICO,JILOTEPEC DE ANDRES MOLINA ENRIQUEZ,10,212,5,227,1100
MÉXICO,JILOTEPEC DE ANDRES MOLINA ENRIQUEZ,11,239,10,260,1099
MÉXICO,JILOTEPEC DE ANDRES MOLINA ENRIQUEZ,17,108,1,126,1552
MÉXICO,JILOTEPEC DE ANDRES MOLINA ENRIQUEZ,14,102,10,126,1855
MÉXICO,JILOTEPEC DE ANDRES MOLINA ENRIQUEZ,14,97,1,112,1854
MÉXICO,JILOTEPEC DE ANDRES MOLINA ENRIQUEZ,17,267,12,296,1879
MÉXICO,JILOTEPEC DE ANDRES MOLINA ENRIQUEZ,19,112,7,138,1067
MÉXICO,JILOTEPEC DE ANDRES MOLINA ENRIQUEZ,7,103,6,116,1066
MÉXICO,JILOTEPEC DE ANDRES MOLINA ENRIQUEZ,15,166,12,193,1935
MÉXICO,JILOTEPEC DE ANDRES MOLINA ENRIQUEZ,7,125,9,141,1559
MÉXICO,JILOTEPEC DE ANDRES MOLINA ENRIQUEZ,4,134,2,140,1559
MÉXICO,JILOTEPEC DE ANDRES MOLINA ENRIQUEZ,6,160,8,174,1744
MÉXICO,JILOTEPEC DE ANDRES MOLINA ENRIQUEZ,17,176,5,198,1743
MÉXICO,JILOTEPEC DE ANDRES MOLINA ENRIQUEZ,12,196,11,219,1713
MÉXICO,JILOTEPEC DE ANDRES MOLINA ENRIQUEZ,14,189,4,207,1713
MÉXICO,JILOTEPEC DE ANDRES MOLINA ENRIQUEZ,25,295,11,331,1642
MÉXICO,JILOTEPEC DE ANDRES MOLINA ENRIQUEZ,17,243,4,264,1815
MÉXICO,JILOTEPEC DE ANDRES MOLINA ENRIQUEZ,32,214,13,259,1757
MÉXICO,JILOTEPEC DE ANDRES MOLINA ENRIQUEZ,10,130,7,147,1380
MÉXICO,JILOTEPEC DE ANDRES MOLINA ENRIQUEZ,5,158,2,165,1380
MÉXICO,JILOTEPEC DE ANDRES MOLINA ENRIQUEZ,12,320,8,340,1717
MÉXICO,JILOTEPEC DE ANDRES MOLINA ENRIQUEZ,13,299,1,313,1717
MÉXICO,JILOTEPEC DE ANDRES MOLINA ENRIQUEZ,19,317,9,345,1940
MÉXICO,JILOTEPEC DE ANDRES MOLINA ENRIQUEZ,27,215,19,261,1519
MÉXICO,JILOTEPEC DE ANDRES MOLINA ENRIQUEZ,14,101,5,120,1946
MÉXICO,JILOTEPEC DE ANDRES MOLINA ENRIQUEZ,8,99,8,115,1608
MÉXICO,JILOTEPEC DE ANDRES MOLINA ENRIQUEZ,12,148,9,169,1940
MÉXICO,JILOTEPEC DE ANDRES MOLINA ENRIQUEZ,12,156,7,175,1940
MÉXICO,JILOTEPEC DE ANDRES MOLINA ENRIQUEZ,10,101,6,117,1912
MÉXICO,JILOTEPEC DE ANDRES MOLINA ENRIQUEZ,15,112,2,129,1912
MÉXICO,JILOTEPEC DE ANDRES MOLINA ENRIQUEZ,21,126,6,153,1165
MÉXICO,JILOTEPEC DE ANDRES MOLINA ENRIQUEZ,9,138,3,150,1165
MÉXICO,JILOTEPEC DE ANDRES MOLINA ENRIQUEZ,13,137,0,150,1376
MÉXICO,JILOTEPEC DE ANDRES MOLINA ENRIQUEZ,12,157,4,173,1376
MÉXICO,JILOTEPEC DE ANDRES MOLINA ENRIQUEZ,5,178,2,185,1138
MÉXICO,JILOTEPEC DE ANDRES MOLINA ENRIQUEZ,7,160,4,171,1138
MÉXICO,JILOTEPEC DE ANDRES MOLINA ENRIQUEZ,16,160,6,182,1666
MÉXICO,JILOTEPEC DE ANDRES MOLINA ENRIQUEZ,22,217,4,243,1844
MÉXICO,JILOTEPEC DE ANDRES MOLINA ENRIQUEZ,23,189,7,219,1559
MÉXICO,JILOTEPEC DE ANDRES MOLINA ENRIQUEZ,30,170,5,205,1704
MÉXICO,JILOTEPEC DE ANDRES MOLINA ENRIQUEZ,13,151,7,171,1124
MÉXICO,JILOTEPEC DE ANDRES MOLINA ENRIQUEZ,11,157,3,171,1123
MÉXICO,JILOTEPEC DE ANDRES MOLINA ENRIQUEZ,20,250,9,279,1979
MÉXICO,JILOTEPEC DE ANDRES MOLINA ENRIQUEZ,13,251,13,277,1978
MÉXICO,JILOTEPEC DE ANDRES MOLINA ENRIQUEZ,8,251,11,270,1696
MÉXICO,JILOTEPEC DE ANDRES MOLINA ENRIQUEZ,10,267,8,285,1696
MÉXICO,JILOTEPEC DE ANDRES MOLINA ENRIQUEZ,11,259,5,275,1695
MÉXICO,JILOTEPEC DE ANDRES MOLINA ENRIQUEZ,20,243,6,269,1612
MÉXICO,JILOTEPEC DE ANDRES MOLINA ENRIQUEZ,7,184,3,194,1152
MÉXICO,JILOTEPEC DE ANDRES MOLINA ENRIQUEZ,12,203,11,226,1151
MÉXICO,JILOTEPEC DE ANDRES MOLINA ENRIQUEZ,16,229,6,251,1815
MÉXICO,JILOTEPEC DE ANDRES MOLINA ENRIQUEZ,12,181,12,205,1815
MÉXICO,JILOTEPEC DE ANDRES MOLINA ENRIQUEZ,27,179,7,213,1521
MÉXICO,JILOTEPEC DE ANDRES MOLINA ENRIQUEZ,20,273,10,303,2008
MÉXICO,JILOTEPEC DE ANDRES MOLINA ENRIQUEZ,14,193,3,210,1330
MÉXICO,JILOTEPEC DE ANDRES MOLINA ENRIQUEZ,15,187,3,205,1329
MÉXICO,JILOTEPEC DE ANDRES MOLINA ENRIQUEZ,14,241,1,256,2020
MÉXICO,JILOTEPEC DE ANDRES MOLINA ENRIQUEZ,14,185,2,201,2019
MÉXICO,JILOTEPEC DE ANDRES MOLINA ENRIQUEZ,34,233,2,269,1712
MÉXICO,JILOTEPEC DE ANDRES MOLINA ENRIQUEZ,71,787,4,862,0
MÉXICO,JILOTEPEC DE ANDRES MOLINA ENRIQUEZ,26,231,1,258,1706
MÉXICO,JILOTEPEC DE ANDRES MOLINA ENRIQUEZ,27,237,23,287,1907
MÉXICO,JILOTEPEC DE ANDRES MOLINA ENRIQUEZ,25,237,9,271,1870
MÉXICO,JILOTEPEC DE ANDRES MOLINA ENRIQUEZ,12,225,6,243,1870
MÉXICO,JILOTEPEC DE ANDRES MOLINA ENRIQUEZ,21,151,9,181,1489
MÉXICO,JILOTEPEC DE ANDRES MOLINA ENRIQUEZ,14,187,7,208,1488
MÉXICO,JILOTEPEC DE ANDRES MOLINA ENRIQUEZ,23,162,1,186,1488
MÉXICO,JILOTEPEC DE ANDRES MOLINA ENRIQUEZ,20,283,13,316,1791
MÉXICO,JILOTEPEC DE ANDRES MOLINA ENRIQUEZ,15,317,8,340,1907
MÉXICO,JILOTEPEC DE ANDRES MOLINA ENRIQUEZ,12,228,4,244,1965
MÉXICO,JILOTEPEC DE ANDRES MOLINA ENRIQUEZ,18,231,7,256,1965
MÉXICO,JILOTEPEC DE ANDRES MOLINA ENRIQUEZ,11,139,4,154,1868
MÉXICO,JILOTEPEC DE ANDRES MOLINA ENRIQUEZ,13,125,6,144,1868
MÉXICO,JILOTEPEC DE ANDRES MOLINA ENRIQUEZ,20,191,1,212,1190
MÉXICO,JILOTEPEC DE ANDRES MOLINA ENRIQUEZ,16,154,4,174,1190
MÉXICO,JILOTEPEC DE ANDRES MOLINA ENRIQUEZ,12,193,6,211,1488
MÉXICO,JILOTEPEC DE ANDRES MOLINA ENRIQUEZ,15,191,2,208,1488
MÉXICO,JILOTEPEC DE ANDRES MOLINA ENRIQUEZ,13,193,2,208,1487
MÉXICO,JILOTEPEC DE ANDRES MOLINA ENRIQUEZ,27,143,9,179,1926
MÉXICO,JILOTEPEC DE ANDRES MOLINA ENRIQUEZ,13,200,1,214,1567
MÉXICO,JILOTEPEC DE ANDRES MOLINA ENRIQUEZ,6,196,1,203,1567
MÉXICO,JILOTEPEC DE ANDRES MOLINA ENRIQUEZ,8,154,7,169,1566
MÉXICO,JILOTEPEC DE ANDRES MOLINA ENRIQUEZ,13,185,3,201,1566
MÉXICO,JILOTEPEC DE ANDRES MOLINA ENRIQUEZ,38,290,7,335,1955
MÉXICO,JILOTEPEC DE ANDRES MOLINA ENRIQUEZ,14,220,1,235,1282
MÉXICO,JILOTEPEC DE ANDRES MOLINA ENRIQUEZ,26,172,3,201,1281
MÉXICO,JILOTEPEC DE ANDRES MOLINA ENRIQUEZ,15,244,1,260,1926
MÉXICO,JILOTEPEC DE ANDRES MOLINA ENRIQUEZ,22,258,6,286,1925
MÉXICO,JILOTEPEC DE ANDRES MOLINA ENRIQUEZ,12,269,3,284,1925
MÉXICO,JILOTEPEC DE ANDRES MOLINA ENRIQUEZ,26,253,7,286,1754
MÉXICO,JILOTEPEC DE ANDRES MOLINA ENRIQUEZ,26,252,5,283,1400
MÉXICO,JILOTEPEC DE ANDRES MOLINA ENRIQUEZ,20,276,11,307,1400
MÉXICO,JILOTEPEC DE ANDRES MOLINA ENRIQUEZ,20,321,5,346,2074
MÉXICO,JILOTEPEC DE ANDRES MOLINA ENRIQUEZ,14,218,2,234,1326
MÉXICO,JILOTEPEC DE ANDRES MOLINA ENRIQUEZ,12,207,2,221,1325
MÉXICO,JILOTEPEC DE ANDRES MOLINA ENRIQUEZ,19,248,7,274,1789
MÉXICO,JILOTEPEC DE ANDRES MOLINA ENRIQUEZ,34,247,10,291,1912
MÉXICO,JILOTEPEC DE ANDRES MOLINA ENRIQUEZ,15,179,7,201,1698
MÉXICO,JILOTEPEC DE ANDRES MOLINA ENRIQUEZ,19,245,13,277,1864
MÉXICO,JILOTEPEC DE ANDRES MOLINA ENRIQUEZ,14,226,12,252,1864
MÉXICO,JILOTEPEC DE ANDRES MOLINA ENRIQUEZ,23,243,6,272,1864
MÉXICO,JILOTEPEC DE ANDRES MOLINA ENRIQUEZ,15,220,11,246,1864
MÉXICO,JILOTEPEC DE ANDRES MOLINA ENRIQUEZ,16,151,13,180,1509
MÉXICO,JILOTEPEC DE ANDRES MOLINA ENRIQUEZ,10,158,9,177,1509
MÉXICO,JILOTEPEC DE ANDRES MOLINA ENRIQUEZ,24,286,13,323,1970
MÉXICO,JILOTEPEC DE ANDRES MOLINA ENRIQUEZ,15,304,8,327,1754
MÉXICO,JILOTEPEC DE ANDRES MOLINA ENRIQUEZ,17,186,1,204,1482
MÉXICO,JILOTEPEC DE ANDRES MOLINA ENRIQUEZ,18,187,7,212,1482
MÉXICO,JILOTEPEC DE ANDRES MOLINA ENRIQUEZ,16,211,7,234,1711
MÉXICO,JILOTEPEC DE ANDRES MOLINA ENRIQUEZ,18,221,10,249,1710
MÉXICO,JILOTEPEC DE ANDRES MOLINA ENRIQUEZ,26,367,29,422,1876
MÉXICO,JILOTEPEC DE ANDRES MOLINA ENRIQUEZ,54,293,24,371,2086
MÉXICO,JILOTEPEC DE ANDRES MOLINA ENRIQUEZ,15,139,3,157,1555
MÉXICO,JILOTEPEC DE ANDRES MOLINA ENRIQUEZ,9,130,3,142,1554
MÉXICO,JILOTEPEC DE ANDRES MOLINA ENRIQUEZ,15,150,1,166,1554
MÉXICO,JILOTEPEC DE ANDRES MOLINA ENRIQUEZ,14,124,2,140,1692
MÉXICO,JILOTEPEC DE ANDRES MOLINA ENRIQUEZ,5,122,1,128,1692
MÉXICO,JILOTEPEC DE ANDRES MOLINA ENRIQUEZ,12,118,5,135,1510
MÉXICO,JILOTEPEC DE ANDRES MOLINA ENRIQUEZ,9,102,1,112,1510
MÉXICO,JILOTEPEC DE ANDRES MOLINA ENRIQUEZ,18,146,2,166,1553
MÉXICO,JILOTEPEC DE ANDRES MOLINA ENRIQUEZ,16,120,1,137,1552
MÉXICO,JILOTEPEC DE ANDRES MOLINA ENRIQUEZ,14,154,4,172,1552
MÉXICO,JILOTEPEC DE ANDRES MOLINA ENRIQUEZ,8,122,3,133,1946
MÉXICO,JILOTEPEC DE ANDRES MOLINA ENRIQUEZ,13,99,1,113,1713
MÉXICO,JILOTEPEC DE ANDRES MOLINA ENRIQUEZ,15,160,2,177,1712
MÉXICO,JILOTEPEC DE ANDRES MOLINA ENRIQUEZ,15,221,7,243,1833
MÉXICO,JILOTEPEC DE ANDRES MOLINA ENRIQUEZ,14,240,3,257,1853
MÉXICO,JILOTEPEC DE ANDRES MOLINA ENRIQUEZ,8,389,2,399,1937
MÉXICO,JILOTEPEC DE ANDRES MOLINA ENRIQUEZ,13,196,4,213,1616
MÉXICO,JILOTEPEC DE ANDRES MOLINA ENRIQUEZ,5,192,6,203,1616
MÉXICO,JILOTEPEC DE ANDRES MOLINA ENRIQUEZ,6,199,1,206,1616
MÉXICO,JILOTEPEC DE ANDRES MOLINA ENRIQUEZ,22,336,13,371,1919
MÉXICO,JILOTEPEC DE ANDRES MOLINA ENRIQUEZ,26,286,16,328,1919
MÉXICO,JILOTEPEC DE ANDRES MOLINA ENRIQUEZ,10,227,20,257,1967
MÉXICO,JILOTEPEC DE ANDRES MOLINA ENRIQUEZ,7,195,6,208,1966
MÉXICO,JILOTEPEC DE ANDRES MOLINA ENRIQUEZ,23,297,14,334,1771
MÉXICO,JILOTEPEC DE ANDRES MOLINA ENRIQUEZ,18,308,10,336,1770
MÉXICO,JILOTEPEC DE ANDRES MOLINA ENRIQUEZ,9,197,1,207,1212
MÉXICO,JILOTEPEC DE ANDRES MOLINA ENRIQUEZ,8,143,3,154,1212
MÉXICO,JILOTEPEC DE ANDRES MOLINA ENRIQUEZ,4,252,15,271,1500
MÉXICO,JILOTEPEC DE ANDRES MOLINA ENRIQUEZ,7,244,5,256,1499
MÉXICO,JILOTEPEC DE ANDRES MOLINA ENRIQUEZ,11,165,4,180,1476
MÉXICO,JILOTEPEC DE ANDRES MOLINA ENRIQUEZ,10,259,9,278,1695
MÉXICO,JILOTEPEC DE ANDRES MOLINA ENRIQUEZ,21,404,7,432,2038
MÉXICO,JILOTEPEC DE ANDRES MOLINA ENRIQUEZ,18,267,21,306,1913
MÉXICO,JILOTEPEC DE ANDRES MOLINA ENRIQUEZ,20,251,14,285,1912
MÉXICO,JILOTEPEC DE ANDRES MOLINA ENRIQUEZ,12,375,13,400,1648
MÉXICO,JILOTEPEC DE ANDRES MOLINA ENRIQUEZ,5,382,5,392,1507
MÉXICO,JILOTEPEC DE ANDRES MOLINA ENRIQUEZ,15,359,7,381,1507
MÉXICO,JILOTEPEC DE ANDRES MOLINA ENRIQUEZ,12,164,5,181,1785
MÉXICO,JILOTEPEC DE ANDRES MOLINA ENRIQUEZ,3,146,2,151,1785
MÉXICO,JILOTEPEC DE ANDRES MOLINA ENRIQUEZ,11,347,15,373,1764
MÉXICO,JILOTEPEC DE ANDRES MOLINA ENRIQUEZ,4,179,1,184,1928
MÉXICO,JILOTEPEC DE ANDRES MOLINA ENRIQUEZ,17,233,8,258,1928
MÉXICO,JILOTEPEC DE ANDRES MOLINA ENRIQUEZ,8,195,4,207,1927
MÉXICO,JILOTEPEC DE ANDRES MOLINA ENRIQUEZ,14,264,2,280,1440
MÉXICO,JILOTEPEC DE ANDRES MOLINA ENRIQUEZ,13,233,6,252,1440
MÉXICO,JILOTEPEC DE ANDRES MOLINA ENRIQUEZ,8,190,5,203,1440
MÉXICO,JILOTEPEC DE ANDRES MOLINA ENRIQUEZ,17,246,8,271,1744
MÉXICO,JILOTEPEC DE ANDRES MOLINA ENRIQUEZ,11,209,11,231,1743
MÉXICO,JILOTEPEC DE ANDRES MOLINA ENRIQUEZ,13,92,3,108,1273
MÉXICO,JILOTEPEC DE ANDRES MOLINA ENRIQUEZ,11,105,7,123,1272
MÉXICO,JILOTEPEC DE ANDRES MOLINA ENRIQUEZ,16,112,4,132,1524
MÉXICO,JILOTEPEC DE ANDRES MOLINA ENRIQUEZ,19,151,0,170,1524
MÉXICO,JILOTEPEC DE ANDRES MOLINA ENRIQUEZ,18,123,6,147,1071
MÉXICO,JILOTEPEC DE ANDRES MOLINA ENRIQUEZ,20,125,5,150,1070
MÉXICO,JILOTEPEC DE ANDRES MOLINA ENRIQUEZ,16,173,6,195,1729
MÉXICO,JILOTEPEC DE ANDRES MOLINA ENRIQUEZ,22,178,1,201,1728
MÉXICO,JILOTEPEC DE ANDRES MOLINA ENRIQUEZ,13,185,3,201,1815
MÉXICO,JILOTEPEC DE ANDRES MOLINA ENRIQUEZ,16,193,6,215,1814
MÉXICO,JILOTEPEC DE ANDRES MOLINA ENRIQUEZ,26,246,27,299,1817
MÉXICO,JILOTEPEC DE ANDRES MOLINA ENRIQUEZ,27,222,13,262,2016
MÉXICO,JILOTEPEC DE ANDRES MOLINA ENRIQUEZ,5,143,7,155,1573
MÉXICO,JILOTEPEC DE ANDRES MOLINA ENRIQUEZ,7,93,8,108,1572
MÉXICO,JILOTEPEC DE ANDRES MOLINA ENRIQUEZ,15,88,7,110,1473
MÉXICO,JILOTEPEC DE ANDRES MOLINA ENRIQUEZ,15,123,4,142,1472
MÉXICO,JILOTEPEC DE ANDRES MOLINA ENRIQUEZ,19,102,3,124,1472
MÉXICO,JILOTEPEC DE ANDRES MOLINA ENRIQUEZ,23,118,5,146,1804
MÉXICO,JILOTEPEC DE ANDRES MOLINA ENRIQUEZ,9,72,4,85,1141
MÉXICO,JILOTEPEC DE ANDRES MOLINA ENRIQUEZ,13,62,3,78,1140
MÉXICO,JILOTEPEC DE ANDRES MOLINA ENRIQUEZ,4,43,3,50,1210
MÉXICO,JILOTEPEC DE ANDRES MOLINA ENRIQUEZ,6,65,2,73,1209
MÉXICO,JILOTEPEC DE ANDRES MOLINA ENRIQUEZ,34,242,13,289,1510
MÉXICO,JILOTEPEC DE ANDRES MOLINA ENRIQUEZ,27,227,9,263,1509
MÉXICO,JILOTEPEC DE ANDRES MOLINA ENRIQUEZ,3,156,4,163,1474
MÉXICO,JILOTEPEC DE ANDRES MOLINA ENRIQUEZ,12,167,0,179,1473
MÉXICO,JILOTEPEC DE ANDRES MOLINA ENRIQUEZ,17,199,0,216,1608
MÉXICO,JILOTEPEC DE ANDRES MOLINA ENRIQUEZ,22,301,8,331,1799
MÉXICO,JILOTEPEC DE ANDRES MOLINA ENRIQUEZ,11,268,16,295,1445
MÉXICO,JILOTEPEC DE ANDRES MOLINA ENRIQUEZ,9,239,14,262,1444
MÉXICO,SANTA MARIA TULTEPEC,32,312,5,349,1480
MÉXICO,SANTA MARIA TULTEPEC,20,285,4,309,1480
MÉXICO,SANTA MARIA TULTEPEC,19,275,5,299,1557
MÉXICO,SANTA MARIA TULTEPEC,21,295,6,322,1556
MÉXICO,SANTA MARIA TULTEPEC,28,285,7,320,1485
MÉXICO,SANTA MARIA TULTEPEC,25,299,1,325,1484
MÉXICO,SANTA MARIA TULTEPEC,11,207,2,220,1301
MÉXICO,SANTA MARIA TULTEPEC,14,219,1,234,1301
MÉXICO,SANTA MARIA TULTEPEC,19,295,0,314,1551
MÉXICO,SANTA MARIA TULTEPEC,17,334,3,354,1551
MÉXICO,SANTA MARIA TULTEPEC,10,382,1,393,1917
MÉXICO,SANTA MARIA TULTEPEC,15,350,1,366,1917
MÉXICO,SANTA MARIA TULTEPEC,103,686,19,808,1868
MÉXICO,SANTA MARIA TULTEPEC,106,758,17,881,1867
MÉXICO,SANTA MARIA TULTEPEC,93,482,13,588,1364
MÉXICO,SANTA MARIA TULTEPEC,91,491,8,590,1364
MÉXICO,SANTA MARIA TULTEPEC,106,451,20,577,1363
MÉXICO,SANTA MARIA TULTEPEC,108,639,19,766,1670
MÉXICO,SANTA MARIA TULTEPEC,98,588,29,715,1532
MÉXICO,SANTA MARIA TULTEPEC,113,593,13,719,1531
MÉXICO,SANTA MARIA TULTEPEC,100,839,20,959,1919
MÉXICO,SANTA MARIA TULTEPEC,0,622,20,642,1586
MÉXICO,SANTA MARIA TULTEPEC,43,527,5,575,1585
MÉXICO,SANTA MARIA TULTEPEC,70,619,13,702,1844
MÉXICO,SANTA MARIA TULTEPEC,57,645,13,715,1844
MÉXICO,SANTA MARIA TULTEPEC,69,670,14,753,1844
MÉXICO,SANTA MARIA TULTEPEC,72,636,9,717,1844
MÉXICO,SANTA MARIA TULTEPEC,68,616,15,699,1843
MÉXICO,SANTA MARIA TULTEPEC,61,626,11,698,1843
MÉXICO,SANTA MARIA TULTEPEC,131,851,27,1009,1969
MÉXICO,SANTA MARIA TULTEPEC,107,805,18,930,1969
MÉXICO,SANTA MARIA TULTEPEC,24,324,8,356,1890
MÉXICO,SANTA MARIA TULTEPEC,42,334,5,381,1889
MÉXICO,SANTA MARIA TULTEPEC,29,379,11,419,1759
MÉXICO,SANTA MARIA TULTEPEC,36,397,8,441,1758
MÉXICO,SANTA MARIA TULTEPEC,18,330,5,353,1690
MÉXICO,SANTA MARIA TULTEPEC,27,327,7,361,1690
MÉXICO,SANTA MARIA TULTEPEC,27,285,9,321,1461
MÉXICO,SANTA MARIA TULTEPEC,20,339,6,365,1460
MÉXICO,SANTA MARIA TULTEPEC,30,371,16,417,1952
MÉXICO,SANTA MARIA TULTEPEC,27,372,9,408,1952
MÉXICO,SANTA MARIA TULTEPEC,35,369,12,416,1951
MÉXICO,SANTA MARIA TULTEPEC,32,422,7,461,1897
MÉXICO,SANTA MARIA TULTEPEC,22,398,13,433,1897
MÉXICO,SANTA MARIA TULTEPEC,22,398,9,429,1781
MÉXICO,SANTA MARIA TULTEPEC,34,382,7,423,1781
MÉXICO,SANTA MARIA TULTEPEC,31,434,10,475,1781
MÉXICO,SANTA MARIA TULTEPEC,19,338,3,360,1666
MÉXICO,SANTA MARIA TULTEPEC,32,350,5,387,1665
MÉXICO,SANTA MARIA TULTEPEC,26,367,7,400,1866
MÉXICO,SANTA MARIA TULTEPEC,35,355,7,397,1866
MÉXICO,SANTA MARIA TULTEPEC,33,392,13,438,1865
MÉXICO,SANTA MARIA TULTEPEC,22,269,3,294,1513
MÉXICO,SANTA MARIA TULTEPEC,18,264,6,288,1512
MÉXICO,SANTA MARIA TULTEPEC,21,242,6,269,1030
MÉXICO,SANTA MARIA TULTEPEC,21,245,6,272,1030
MÉXICO,SANTA MARIA TULTEPEC,29,213,1,243,1830
MÉXICO,SANTA MARIA TULTEPEC,32,195,1,228,1830
MÉXICO,SANTA MARIA TULTEPEC,32,202,0,234,1830
MÉXICO,SANTA MARIA TULTEPEC,36,206,3,245,1829
MÉXICO,SANTA MARIA TULTEPEC,36,215,1,252,1829
MÉXICO,SANTA MARIA TULTEPEC,26,208,0,234,1829
MÉXICO,SANTA MARIA TULTEPEC,29,203,1,233,1829
MÉXICO,SANTA MARIA TULTEPEC,16,264,6,286,1286
MÉXICO,SANTA MARIA TULTEPEC,17,261,2,280,1285
MÉXICO,SANTA MARIA TULTEPEC,17,222,1,240,1108
MÉXICO,SANTA MARIA TULTEPEC,14,224,0,238,1108
MÉXICO,SANTA MARIA TULTEPEC,21,284,6,311,1472
MÉXICO,SANTA MARIA TULTEPEC,11,249,2,262,1471
MÉXICO,SANTA MARIA TULTEPEC,28,259,7,294,1471
MÉXICO,SANTA MARIA TULTEPEC,26,314,4,344,1469
MÉXICO,SANTA MARIA TULTEPEC,32,294,3,329,1469
MÉXICO,SANTA MARIA TULTEPEC,16,266,4,286,1832
MÉXICO,SANTA MARIA TULTEPEC,20,254,5,279,1832
MÉXICO,SANTA MARIA TULTEPEC,22,263,2,287,1832
MÉXICO,SANTA MARIA TULTEPEC,23,264,2,289,1831
MÉXICO,SANTA MARIA TULTEPEC,19,236,1,256,1831
MÉXICO,SANTA MARIA TULTEPEC,21,258,4,283,1831
MÉXICO,SANTA MARIA TULTEPEC,11,225,0,236,1831
MÉXICO,SANTA MARIA TULTEPEC,22,248,274,544,1831
MÉXICO,SANTA MARIA TULTEPEC,60,573,2,635,0
MÉXICO,SANTA MARIA TULTEPEC,31,250,2,283,1656
MÉXICO,SANTA MARIA TULTEPEC,28,296,4,328,1656
MÉXICO,SANTA MARIA TULTEPEC,251,31,1,283,1656
MÉXICO,SANTA MARIA TULTEPEC,32,255,2,289,1655
MÉXICO,SANTA MARIA TULTEPEC,25,249,2,276,1388
MÉXICO,SANTA MARIA TULTEPEC,40,245,3,288,1387
MÉXICO,SANTA MARIA TULTEPEC,26,288,2,316,1960
MÉXICO,SANTA MARIA TULTEPEC,41,306,1,348,1960
MÉXICO,SANTA MARIA TULTEPEC,33,330,1,364,1960
MÉXICO,SANTA MARIA TULTEPEC,43,286,0,329,1960
MÉXICO,SANTA MARIA TULTEPEC,31,294,5,330,1960
MÉXICO,SANTA MARIA TULTEPEC,27,337,3,367,1959
MÉXICO,SANTA MARIA TULTEPEC,38,263,6,307,1414
MÉXICO,SANTA MARIA TULTEPEC,13,284,3,300,1414
MÉXICO,SANTA MARIA TULTEPEC,19,397,3,419,1654
MÉXICO,SANTA MARIA TULTEPEC,10,307,6,323,1654
MÉXICO,SANTA MARIA TULTEPEC,9,363,3,375,1653
MÉXICO,SANTA MARIA TULTEPEC,36,240,1,277,1491
MÉXICO,SANTA MARIA TULTEPEC,20,247,2,269,1490
MÉXICO,SANTA MARIA TULTEPEC,9,295,5,309,1659
MÉXICO,SANTA MARIA TULTEPEC,23,309,2,334,1658
MÉXICO,SANTA MARIA TULTEPEC,17,310,3,330,1658
MÉXICO,SANTA MARIA TULTEPEC,32,276,3,311,1658
MÉXICO,SANTA MARIA TULTEPEC,29,340,4,373,1884
MÉXICO,SANTA MARIA TULTEPEC,25,285,3,313,1445
MÉXICO,SANTA MARIA TULTEPEC,14,242,2,258,1445
MÉXICO,SANTA MARIA TULTEPEC,27,235,4,266,1445
MÉXICO,SANTA MARIA TULTEPEC,40,341,3,384,1498
MÉXICO,SANTA MARIA TULTEPEC,28,300,12,340,1498
MÉXICO,SANTA MARIA TULTEPEC,20,288,1,309,1542
MÉXICO,SANTA MARIA TULTEPEC,22,298,8,328,1541
MÉXICO,SANTA MARIA TULTEPEC,24,351,5,380,1876
MÉXICO,SANTA MARIA TULTEPEC,36,311,4,351,1876
MÉXICO,SANTA MARIA TULTEPEC,30,340,2,372,1876
MÉXICO,SANTA MARIA TULTEPEC,28,329,6,363,1876
MÉXICO,SANTA MARIA TULTEPEC,35,288,1,324,1544
MÉXICO,SANTA MARIA TULTEPEC,35,323,2,360,1598
MÉXICO,SANTA MARIA TULTEPEC,15,189,3,207,1077
MÉXICO,SANTA MARIA TULTEPEC,14,193,1,208,1077
MÉXICO,SANTA MARIA TULTEPEC,31,287,4,322,1464
MÉXICO,SANTA MARIA TULTEPEC,24,299,9,332,1464
MÉXICO,SANTA MARIA TULTEPEC,17,281,2,300,1544
MÉXICO,SANTA MARIA TULTEPEC,16,270,1,287,1544
MÉXICO,SANTA MARIA TULTEPEC,22,390,0,412,1963
MÉXICO,SANTA MARIA TULTEPEC,31,358,1,390,1962
MÉXICO,SANTA MARIA TULTEPEC,25,354,1,380,1962
MÉXICO,SANTA MARIA TULTEPEC,34,299,2,335,1864
MÉXICO,SANTA MARIA TULTEPEC,19,300,5,324,1864
MÉXICO,SANTA MARIA TULTEPEC,21,300,3,324,1864
MÉXICO,SANTA MARIA TULTEPEC,22,286,2,310,1863
MÉXICO,SANTA MARIA TULTEPEC,35,271,5,311,1334
MÉXICO,SANTA MARIA TULTEPEC,28,277,4,309,1333
MÉXICO,SANTA MARIA TULTEPEC,23,263,5,291,1333
MÉXICO,SANTA MARIA TULTEPEC,21,299,0,320,1850
MÉXICO,SANTA MARIA TULTEPEC,24,303,0,327,1850
MÉXICO,SANTA MARIA TULTEPEC,21,316,3,340,1850
MÉXICO,SANTA MARIA TULTEPEC,24,261,0,285,1535
MÉXICO,SANTA MARIA TULTEPEC,19,250,5,274,1534
MÉXICO,SANTA MARIA TULTEPEC,32,285,2,319,1826
MÉXICO,SANTA MARIA TULTEPEC,18,274,6,298,1826
MÉXICO,SANTA MARIA TULTEPEC,19,296,0,315,1826
MÉXICO,SANTA MARIA TULTEPEC,28,203,0,231,1755
MÉXICO,SANTA MARIA TULTEPEC,17,231,0,248,1755
MÉXICO,SANTA MARIA TULTEPEC,19,247,4,270,1755
MÉXICO,SANTA MARIA TULTEPEC,28,210,1,239,1755
MÉXICO,SANTA MARIA TULTEPEC,14,240,2,256,1755
MÉXICO,SANTA MARIA TULTEPEC,25,243,3,271,1755
MÉXICO,SANTA MARIA TULTEPEC,21,187,1,209,1528
MÉXICO,SANTA MARIA TULTEPEC,14,174,2,190,1528
MÉXICO,SANTA MARIA TULTEPEC,23,214,3,240,1527
MÉXICO,SANTA MARIA TULTEPEC,23,194,1,218,1527
MÉXICO,SANTA MARIA TULTEPEC,22,248,2,272,1218
MÉXICO,SANTA MARIA TULTEPEC,20,198,6,224,1218
MÉXICO,SANTA MARIA TULTEPEC,24,203,2,229,1111
MÉXICO,SANTA MARIA TULTEPEC,19,234,4,257,1111
MÉXICO,SANTA MARIA TULTEPEC,13,282,3,298,1509
MÉXICO,SANTA MARIA TULTEPEC,10,239,2,251,1230
MÉXICO,SANTA MARIA TULTEPEC,10,219,1,230,1229
MÉXICO,SANTA MARIA TULTEPEC,11,246,3,260,1360
MÉXICO,SANTA MARIA TULTEPEC,18,205,3,226,1360
MÉXICO,SANTA MARIA TULTEPEC,13,274,0,287,1360
MÉXICO,SANTA MARIA TULTEPEC,30,268,2,300,1788
MÉXICO,SANTA MARIA TULTEPEC,20,298,5,323,1787
MÉXICO,SANTA MARIA TULTEPEC,33,263,2,298,1788
MÉXICO,SANTA MARIA TULTEPEC,34,302,5,341,1787
MÉXICO,SANTA MARIA TULTEPEC,21,166,1,188,1221
MÉXICO,SANTA MARIA TULTEPEC,14,177,1,192,1220
MÉXICO,SANTA MARIA TULTEPEC,37,269,4,310,1388
MÉXICO,SANTA MARIA TULTEPEC,24,269,6,299,1388
MÉXICO,SANTA MARIA TULTEPEC,30,283,5,318,1388
MÉXICO,SANTA MARIA TULTEPEC,23,303,5,331,1582
MÉXICO,SANTA MARIA TULTEPEC,28,322,2,352,1581
MÉXICO,SANTA MARIA TULTEPEC,31,311,3,345,1581
MÉXICO,SANTA MARIA TULTEPEC,32,263,2,297,1497
MÉXICO,SANTA MARIA TULTEPEC,31,291,3,325,1709
MÉXICO,SANTA MARIA TULTEPEC,9,239,6,254,1427
MÉXICO,SANTA MARIA TULTEPEC,9,252,2,263,1427
MÉXICO,ATLACOMULCO DE FABELA,17,202,2,221,1528
MÉXICO,ATLACOMULCO DE FABELA,20,189,1,210,1528
MÉXICO,ATLACOMULCO DE FABELA,23,224,1,248,1528
MÉXICO,ATLACOMULCO DE FABELA,24,221,0,245,1528
MÉXICO,ATLACOMULCO DE FABELA,22,175,1,198,1396
MÉXICO,ATLACOMULCO DE FABELA,22,179,1,202,1396
MÉXICO,ATLACOMULCO DE FABELA,21,134,2,157,1395
MÉXICO,ATLACOMULCO DE FABELA,59,774,0,833,0
MÉXICO,ATLACOMULCO DE FABELA,26,170,2,198,1494
MÉXICO,ATLACOMULCO DE FABELA,19,189,0,208,1493
MÉXICO,ATLACOMULCO DE FABELA,15,129,0,144,1773
MÉXICO,ATLACOMULCO DE FABELA,20,234,13,267,1807
MÉXICO,ATLACOMULCO DE FABELA,27,242,2,271,1806
MÉXICO,ATLACOMULCO DE FABELA,22,180,1,203,1358
MÉXICO,ATLACOMULCO DE FABELA,23,158,2,183,1358
MÉXICO,ATLACOMULCO DE FABELA,21,196,6,223,1381
MÉXICO,ATLACOMULCO DE FABELA,22,174,1,197,1380
MÉXICO,ATLACOMULCO DE FABELA,10,264,6,280,1618
MÉXICO,ATLACOMULCO DE FABELA,15,251,7,273,1618
MÉXICO,ATLACOMULCO DE FABELA,12,222,6,240,2021
MÉXICO,ATLACOMULCO DE FABELA,6,170,5,181,2021
MÉXICO,ATLACOMULCO DE FABELA,13,128,2,143,1637
MÉXICO,ATLACOMULCO DE FABELA,17,173,2,192,1606
MÉXICO,ATLACOMULCO DE FABELA,6,191,3,200,1605
MÉXICO,ATLACOMULCO DE FABELA,10,176,8,194,1605
MÉXICO,ATLACOMULCO DE FABELA,14,407,8,429,1575
MÉXICO,ATLACOMULCO DE FABELA,12,185,2,199,1257
MÉXICO,ATLACOMULCO DE FABELA,14,189,0,203,1256
MÉXICO,ATLACOMULCO DE FABELA,23,220,0,243,1267
MÉXICO,ATLACOMULCO DE FABELA,10,203,2,215,1267
MÉXICO,ATLACOMULCO DE FABELA,17,159,3,179,1246
MÉXICO,ATLACOMULCO DE FABELA,11,171,2,184,1246
MÉXICO,ATLACOMULCO DE FABELA,12,144,2,158,1219
MÉXICO,ATLACOMULCO DE FABELA,10,175,1,186,1218
MÉXICO,ATLACOMULCO DE FABELA,15,171,4,190,1421
MÉXICO,ATLACOMULCO DE FABELA,17,170,1,188,1421
MÉXICO,ATLACOMULCO DE FABELA,21,255,2,278,1747
MÉXICO,ATLACOMULCO DE FABELA,21,221,5,247,1813
MÉXICO,ATLACOMULCO DE FABELA,10,188,1,199,1812
MÉXICO,ATLACOMULCO DE FABELA,8,167,1,176,1218
MÉXICO,ATLACOMULCO DE FABELA,13,152,2,167,1218
MÉXICO,ATLACOMULCO DE FABELA,14,119,2,135,1373
MÉXICO,ATLACOMULCO DE FABELA,13,133,8,154,1372
MÉXICO,ATLACOMULCO DE FABELA,19,137,3,159,1372
MÉXICO,ATLACOMULCO DE FABELA,4,168,3,175,1754
MÉXICO,ATLACOMULCO DE FABELA,8,152,4,164,1753
MÉXICO,ATLACOMULCO DE FABELA,8,127,7,142,1679
MÉXICO,ATLACOMULCO DE FABELA,10,124,7,141,1688
MÉXICO,ATLACOMULCO DE FABELA,26,105,5,136,1770
MÉXICO,ATLACOMULCO DE FABELA,21,181,14,216,1705
MÉXICO,ATLACOMULCO DE FABELA,17,183,6,206,1704
MÉXICO,ATLACOMULCO DE FABELA,10,117,3,130,1229
MÉXICO,ATLACOMULCO DE FABELA,15,129,1,145,1229
MÉXICO,ATLACOMULCO DE FABELA,29,363,4,396,2097
MÉXICO,ATLACOMULCO DE FABELA,14,172,5,191,1297
MÉXICO,ATLACOMULCO DE FABELA,20,205,1,226,1296
MÉXICO,ATLACOMULCO DE FABELA,21,268,1,290,1909
MÉXICO,ATLACOMULCO DE FABELA,31,260,2,293,1908
MÉXICO,ATLACOMULCO DE FABELA,18,164,7,189,1429
MÉXICO,ATLACOMULCO DE FABELA,21,182,9,212,1429
MÉXICO,ATLACOMULCO DE FABELA,40,345,8,393,2040
MÉXICO,ATLACOMULCO DE FABELA,28,356,3,387,1766
MÉXICO,ATLACOMULCO DE FABELA,19,345,9,373,1765
MÉXICO,ATLACOMULCO DE FABELA,15,358,6,379,1765
MÉXICO,ATLACOMULCO DE FABELA,15,366,10,391,1544
MÉXICO,ATLACOMULCO DE FABELA,21,385,9,415,1543
MÉXICO,ATLACOMULCO DE FABELA,15,451,10,476,1856
MÉXICO,ATLACOMULCO DE FABELA,28,391,11,430,1855
MÉXICO,ATLACOMULCO DE FABELA,16,380,5,401,1567
MÉXICO,ATLACOMULCO DE FABELA,11,334,6,351,1567
MÉXICO,ATLACOMULCO DE FABELA,29,164,4,197,1274
MÉXICO,ATLACOMULCO DE FABELA,16,141,6,163,1273
MÉXICO,ATLACOMULCO DE FABELA,31,519,13,563,2211
MÉXICO,ATLACOMULCO DE FABELA,20,389,8,417,2034
MÉXICO,ATLACOMULCO DE FABELA,22,415,8,445,2026
MÉXICO,ATLACOMULCO DE FABELA,11,219,9,239,1076
MÉXICO,ATLACOMULCO DE FABELA,15,196,10,221,1076
MÉXICO,ATLACOMULCO DE FABELA,23,172,18,213,1413
MÉXICO,ATLACOMULCO DE FABELA,31,223,24,278,1413
MÉXICO,ATLACOMULCO DE FABELA,11,226,15,252,1275
MÉXICO,ATLACOMULCO DE FABELA,15,220,15,250,1274
MÉXICO,ATLACOMULCO DE FABELA,19,316,6,341,1679
MÉXICO,ATLACOMULCO DE FABELA,28,274,9,311,1679
MÉXICO,ATLACOMULCO DE FABELA,8,258,4,270,1451
MÉXICO,ATLACOMULCO DE FABELA,11,208,8,227,1450
MÉXICO,ATLACOMULCO DE FABELA,11,283,3,297,1634
MÉXICO,ATLACOMULCO DE FABELA,24,252,13,289,1634
MÉXICO,ATLACOMULCO DE FABELA,26,306,10,342,2019
MÉXICO,ATLACOMULCO DE FABELA,23,252,6,281,1445
MÉXICO,ATLACOMULCO DE FABELA,9,271,12,292,1445
MÉXICO,ATLACOMULCO DE FABELA,40,284,7,331,1691
MÉXICO,ATLACOMULCO DE FABELA,27,287,7,321,1690
MÉXICO,ATLACOMULCO DE FABELA,18,298,8,324,2008
MÉXICO,ATLACOMULCO DE FABELA,36,309,5,350,2007
MÉXICO,ATLACOMULCO DE FABELA,13,255,21,289,1923
MÉXICO,ATLACOMULCO DE FABELA,21,200,15,236,1461
MÉXICO,ATLACOMULCO DE FABELA,15,207,5,227,1461
MÉXICO,ATLACOMULCO DE FABELA,21,169,14,204,1461
MÉXICO,ATLACOMULCO DE FABELA,23,179,14,216,1237
MÉXICO,ATLACOMULCO DE FABELA,21,152,11,184,1237
MÉXICO,ATLACOMULCO DE FABELA,37,424,23,484,1907
MÉXICO,ATLACOMULCO DE FABELA,19,285,16,320,1406
MÉXICO,ATLACOMULCO DE FABELA,21,251,10,282,1405
MÉXICO,ATLACOMULCO DE FABELA,25,258,12,295,1405
MÉXICO,ATLACOMULCO DE FABELA,17,241,15,273,1286
MÉXICO,ATLACOMULCO DE FABELA,25,252,8,285,1285
MÉXICO,ATLACOMULCO DE FABELA,19,284,8,311,1605
MÉXICO,ATLACOMULCO DE FABELA,12,217,10,239,1605
MÉXICO,ATLACOMULCO DE FABELA,19,188,3,210,1272
MÉXICO,ATLACOMULCO DE FABELA,14,196,9,219,1271
MÉXICO,ATLACOMULCO DE FABELA,37,355,10,402,1949
MÉXICO,ATLACOMULCO DE FABELA,30,346,10,386,1949
MÉXICO,ATLACOMULCO DE FABELA,21,233,5,259,1631
MÉXICO,ATLACOMULCO DE FABELA,20,217,3,240,1630
MÉXICO,ATLACOMULCO DE FABELA,12,220,3,235,1640
MÉXICO,ATLACOMULCO DE FABELA,21,265,4,290,1640
MÉXICO,ATLACOMULCO DE FABELA,21,238,2,261,1474
MÉXICO,ATLACOMULCO DE FABELA,13,298,3,314,1473
MÉXICO,ATLACOMULCO DE FABELA,18,171,4,193,1314
MÉXICO,ATLACOMULCO DE FABELA,7,142,6,155,1313
MÉXICO,ATLACOMULCO DE FABELA,4,211,5,220,1826
MÉXICO,ATLACOMULCO DE FABELA,7,198,19,224,1826
MÉXICO,ATLACOMULCO DE FABELA,12,125,2,139,1047
MÉXICO,ATLACOMULCO DE FABELA,11,103,3,117,1047
MÉXICO,ATLACOMULCO DE FABELA,10,289,8,307,1785
MÉXICO,ATLACOMULCO DE FABELA,21,283,7,311,1785
MÉXICO,ATLACOMULCO DE FABELA,16,336,4,356,1946
MÉXICO,ATLACOMULCO DE FABELA,10,310,6,326,1945
MÉXICO,ATLACOMULCO DE FABELA,17,233,3,253,1897
MÉXICO,ATLACOMULCO DE FABELA,6,138,9,153,1943
MÉXICO,ATLACOMULCO DE FABELA,24,173,7,204,1628
MÉXICO,ATLACOMULCO DE FABELA,5,126,5,136,1302
MÉXICO,ATLACOMULCO DE FABELA,6,179,6,191,1302
MÉXICO,ATLACOMULCO DE FABELA,13,218,0,231,1490
MÉXICO,ATLACOMULCO DE FABELA,18,210,3,231,1432
MÉXICO,ATLACOMULCO DE FABELA,9,209,6,224,1431
MÉXICO,ATLACOMULCO DE FABELA,36,238,5,279,1577
MÉXICO,ATLACOMULCO DE FABELA,18,235,6,259,1576
MÉXICO,ATLACOMULCO DE FABELA,16,216,3,235,1267
MÉXICO,ATLACOMULCO DE FABELA,7,209,7,223,1266
MÉXICO,ATLACOMULCO DE FABELA,1,204,11,216,1689
MÉXICO,ATLACOMULCO DE FABELA,8,202,7,217,1688
MÉXICO,ATLACOMULCO DE FABELA,15,139,5,159,2202
MÉXICO,ATLACOMULCO DE FABELA,26,171,8,205,1961
MÉXICO,ATLACOMULCO DE FABELA,10,181,5,196,1819
MÉXICO,ATLACOMULCO DE FABELA,8,124,6,138,1944
MÉXICO,ATLACOMULCO DE FABELA,9,129,2,140,1944
MÉXICO,ATLACOMULCO DE FABELA,14,128,5,147,1729
MÉXICO,ATLACOMULCO DE FABELA,11,82,3,96,1048
MÉXICO,ATLACOMULCO DE FABELA,9,82,7,98,1047
MÉXICO,ATLACOMULCO DE FABELA,19,233,4,256,2011
MÉXICO,ATLACOMULCO DE FABELA,8,294,5,307,1523
MÉXICO,ATLACOMULCO DE FABELA,10,228,2,240,1205
MÉXICO,ATLACOMULCO DE FABELA,18,206,1,225,1204
MÉXICO,ATLACOMULCO DE FABELA,13,213,4,230,1245
MÉXICO,ATLACOMULCO DE FABELA,22,209,3,234,1245
MÉXICO,ATLACOMULCO DE FABELA,28,375,7,410,2019
MÉXICO,ATLACOMULCO DE FABELA,31,273,13,317,2059
MÉXICO,ATLACOMULCO DE FABELA,25,245,1,271,2059
MÉXICO,ATLACOMULCO DE FABELA,15,300,6,321,1731
MÉXICO,ATLACOMULCO DE FABELA,6,247,4,257,1455
MÉXICO,ATLACOMULCO DE FABELA,6,287,4,297,1454
MÉXICO,ATLACOMULCO DE FABELA,11,262,4,277,1032
MÉXICO,ATLACOMULCO DE FABELA,19,237,3,259,1032
MÉXICO,ATLACOMULCO DE FABELA,21,360,7,388,1674
MÉXICO,ATLACOMULCO DE FABELA,16,321,8,345,1684
MÉXICO,ATLACOMULCO DE FABELA,15,192,3,210,1175
MÉXICO,ATLACOMULCO DE FABELA,15,166,4,185,1174
MÉXICO,ATLACOMULCO DE FABELA,33,219,11,263,2000
MÉXICO,ATLACOMULCO DE FABELA,6,186,6,198,1200
MÉXICO,ATLACOMULCO DE FABELA,7,182,1,190,1200
MÉXICO,ATLACOMULCO DE FABELA,26,382,13,421,2028
MÉXICO,ATLACOMULCO DE FABELA,8,213,7,228,1578
MÉXICO,ATLACOMULCO DE FABELA,22,196,4,222,1760
MÉXICO,ATLACOMULCO DE FABELA,17,197,5,219,1760
MÉXICO,ATLACOMULCO DE FABELA,20,369,10,399,1830
MÉXICO,ATLACOMULCO DE FABELA,14,269,5,288,1676
MÉXICO,ATLACOMULCO DE FABELA,9,289,0,298,1524
MÉXICO,ATLACOMULCO DE FABELA,19,278,8,305,1523
MÉXICO,ATLACOMULCO DE FABELA,13,300,5,318,1942
MÉXICO,ATLACOMULCO DE FABELA,30,280,7,317,1647
MÉXICO,ATLACOMULCO DE FABELA,18,280,5,303,1646
MÉXICO,ATLACOMULCO DE FABELA,13,282,1,296,1623
MÉXICO,ATLACOMULCO DE FABELA,19,224,1,244,1623
MÉXICO,ATLACOMULCO DE FABELA,8,141,2,151,1088
MÉXICO,ATLACOMULCO DE FABELA,11,167,2,180,1088
MÉXICO,ATLACOMULCO DE FABELA,16,180,1,197,1137
MÉXICO,ATLACOMULCO DE FABELA,12,188,1,201,1136
MÉXICO,ATLACOMULCO DE FABELA,16,331,8,355,2212
MÉXICO,ATLACOMULCO DE FABELA,10,215,4,229,1582
MÉXICO,ATLACOMULCO DE FABELA,7,244,6,257,1582
MÉXICO,ATLACOMULCO DE FABELA,18,424,10,452,2201
MÉXICO,ATLACOMULCO DE FABELA,10,151,9,170,1410
MÉXICO,ATLACOMULCO DE FABELA,13,178,3,194,1410
MÉXICO,ATLACOMULCO DE FABELA,7,152,2,161,1313
MÉXICO,ATLACOMULCO DE FABELA,9,108,7,124,1312
MÉXICO,ATLACOMULCO DE FABELA,22,334,5,361,1576
MÉXICO,ATLACOMULCO DE FABELA,14,240,22,276,1726
MÉXICO,ATLACOMULCO DE FABELA,15,250,9,274,1726
MÉXICO,ATLACOMULCO DE FABELA,14,239,5,258,1927
MÉXICO,ATLACOMULCO DE FABELA,9,138,3,150,1485
MÉXICO,ATLACOMULCO DE FABELA,3,156,6,165,1484
MÉXICO,ATLACOMULCO DE FABELA,24,327,13,364,1717
MÉXICO,ATLACOMULCO DE FABELA,17,253,5,275,1404
MÉXICO,ATLACOMULCO DE FABELA,14,256,13,283,1404
MÉXICO,ATLACOMULCO DE FABELA,16,220,3,239,1311
MÉXICO,ATLACOMULCO DE FABELA,23,222,1,246,1310
MÉXICO,ATLACOMULCO DE FABELA,23,169,4,196,1106
MÉXICO,ATLACOMULCO DE FABELA,14,131,3,148,1105
MÉXICO,NICOLAS ROMERO,8,101,1,110,1104
MÉXICO,NICOLAS ROMERO,8,130,2,140,1103
MÉXICO,NICOLAS ROMERO,10,213,4,227,1374
MÉXICO,NICOLAS ROMERO,10,170,3,183,1373
MÉXICO,NICOLAS ROMERO,9,156,4,169,1733
MÉXICO,NICOLAS ROMERO,15,186,1,202,1733
MÉXICO,NICOLAS ROMERO,23,225,1,249,1728
MÉXICO,NICOLAS ROMERO,20,187,2,209,1728
MÉXICO,NICOLAS ROMERO,15,207,1,223,1727
MÉXICO,NICOLAS ROMERO,21,230,0,251,1445
MÉXICO,NICOLAS ROMERO,19,215,4,238,1444
MÉXICO,NICOLAS ROMERO,9,160,4,173,1185
MÉXICO,NICOLAS ROMERO,15,163,3,181,1184
MÉXICO,NICOLAS ROMERO,23,283,3,309,1783
MÉXICO,NICOLAS ROMERO,21,278,2,301,1782
MÉXICO,NICOLAS ROMERO,25,269,4,298,1769
MÉXICO,NICOLAS ROMERO,24,247,5,276,1769
MÉXICO,NICOLAS ROMERO,14,188,3,205,1761
MÉXICO,NICOLAS ROMERO,9,180,3,192,1761
MÉXICO,NICOLAS ROMERO,3,185,2,190,1761
MÉXICO,NICOLAS ROMERO,14,206,1,221,1761
MÉXICO,NICOLAS ROMERO,22,158,6,186,1761
MÉXICO,NICOLAS ROMERO,15,173,3,191,1761
MÉXICO,NICOLAS ROMERO,11,158,0,169,1760
MÉXICO,NICOLAS ROMERO,6,141,0,147,1339
MÉXICO,NICOLAS ROMERO,16,147,2,165,1339
MÉXICO,NICOLAS ROMERO,21,189,2,212,1496
MÉXICO,NICOLAS ROMERO,19,216,7,242,1495
MÉXICO,NICOLAS ROMERO,13,234,2,249,1398
MÉXICO,NICOLAS ROMERO,17,234,4,255,1398
MÉXICO,NICOLAS ROMERO,16,216,1,233,1398
MÉXICO,NICOLAS ROMERO,17,202,5,224,1539
MÉXICO,NICOLAS ROMERO,15,225,0,240,1658
MÉXICO,NICOLAS ROMERO,16,208,3,227,1658
MÉXICO,NICOLAS ROMERO,22,205,7,234,1388
MÉXICO,NICOLAS ROMERO,11,168,3,182,1388
MÉXICO,NICOLAS ROMERO,12,196,5,213,1387
MÉXICO,NICOLAS ROMERO,21,176,3,200,1403
MÉXICO,NICOLAS ROMERO,18,196,1,215,1402
MÉXICO,NICOLAS ROMERO,20,226,5,251,1717
MÉXICO,NICOLAS ROMERO,13,235,3,251,1717
MÉXICO,NICOLAS ROMERO,29,261,5,295,1696
MÉXICO,NICOLAS ROMERO,38,516,8,562,0
MÉXICO,NICOLAS ROMERO,15,221,0,236,1367
MÉXICO,NICOLAS ROMERO,19,214,3,236,1367
MÉXICO,NICOLAS ROMERO,19,224,1,244,1669
MÉXICO,NICOLAS ROMERO,22,208,0,230,1668
MÉXICO,NICOLAS ROMERO,15,200,1,216,1668
MÉXICO,NICOLAS ROMERO,22,188,2,212,1600
MÉXICO,NICOLAS ROMERO,17,179,2,198,1600
MÉXICO,NICOLAS ROMERO,10,193,3,206,1599
MÉXICO,NICOLAS ROMERO,13,168,2,183,1599
MÉXICO,NICOLAS ROMERO,33,285,6,324,1865
MÉXICO,NICOLAS ROMERO,11,303,3,317,1864
MÉXICO,NICOLAS ROMERO,11,238,1,250,1730
MÉXICO,NICOLAS ROMERO,14,238,2,254,1729
MÉXICO,NICOLAS ROMERO,11,206,2,219,1254
MÉXICO,NICOLAS ROMERO,12,223,3,238,1253
MÉXICO,NICOLAS ROMERO,22,212,5,239,1675
MÉXICO,NICOLAS ROMERO,0,233,1,234,1675
MÉXICO,NICOLAS ROMERO,6,226,7,239,1338
MÉXICO,NICOLAS ROMERO,9,225,7,241,1337
MÉXICO,NICOLAS ROMERO,13,175,5,193,1173
MÉXICO,NICOLAS ROMERO,9,165,4,178,1172
MÉXICO,NICOLAS ROMERO,19,196,3,218,1101
MÉXICO,NICOLAS ROMERO,15,225,2,242,1100
MÉXICO,NICOLAS ROMERO,31,227,5,263,1948
MÉXICO,NICOLAS ROMERO,29,223,4,256,1948
MÉXICO,NICOLAS ROMERO,23,209,2,234,1948
MÉXICO,NICOLAS ROMERO,16,238,1,255,1947
MÉXICO,NICOLAS ROMERO,23,292,5,320,1514
MÉXICO,NICOLAS ROMERO,27,286,2,315,1513
MÉXICO,NICOLAS ROMERO,22,303,0,325,1632
MÉXICO,NICOLAS ROMERO,19,308,2,329,1632
MÉXICO,NICOLAS ROMERO,17,257,2,276,1898
MÉXICO,NICOLAS ROMERO,33,281,4,318,1897
MÉXICO,NICOLAS ROMERO,24,234,5,263,1111
MÉXICO,NICOLAS ROMERO,19,233,2,254,1110
MÉXICO,NICOLAS ROMERO,9,198,4,211,1465
MÉXICO,NICOLAS ROMERO,11,203,5,219,1464
MÉXICO,NICOLAS ROMERO,11,137,2,150,1104
MÉXICO,NICOLAS ROMERO,15,165,4,184,1103
MÉXICO,NICOLAS ROMERO,27,265,6,298,1568
MÉXICO,NICOLAS ROMERO,15,272,3,290,1567
MÉXICO,NICOLAS ROMERO,26,300,5,331,1685
MÉXICO,NICOLAS ROMERO,26,297,5,328,1684
MÉXICO,NICOLAS ROMERO,21,230,2,253,1734
MÉXICO,NICOLAS ROMERO,25,198,0,223,1734
MÉXICO,NICOLAS ROMERO,11,215,2,228,1733
MÉXICO,NICOLAS ROMERO,31,302,4,337,1513
MÉXICO,NICOLAS ROMERO,25,307,5,337,1513
MÉXICO,NICOLAS ROMERO,19,312,1,332,1854
MÉXICO,NICOLAS ROMERO,12,175,1,188,1002
MÉXICO,NICOLAS ROMERO,9,147,3,159,1002
MÉXICO,NICOLAS ROMERO,8,189,4,201,1773
MÉXICO,NICOLAS ROMERO,20,216,5,241,1772
MÉXICO,NICOLAS ROMERO,22,315,2,339,1765
MÉXICO,NICOLAS ROMERO,10,238,5,253,1782
MÉXICO,NICOLAS ROMERO,17,318,1,336,1938
MÉXICO,NICOLAS ROMERO,13,269,0,282,1938
MÉXICO,NICOLAS ROMERO,14,232,4,250,1579
MÉXICO,NICOLAS ROMERO,20,260,6,286,1579
MÉXICO,NICOLAS ROMERO,14,244,8,266,1578
MÉXICO,NICOLAS ROMERO,14,277,7,298,1779
MÉXICO,NICOLAS ROMERO,24,260,6,290,1867
MÉXICO,NICOLAS ROMERO,19,265,9,293,1867
MÉXICO,NICOLAS ROMERO,18,274,4,296,1866
MÉXICO,NICOLAS ROMERO,5,146,5,156,1324
MÉXICO,NICOLAS ROMERO,12,154,1,167,1324
MÉXICO,NICOLAS ROMERO,9,147,1,157,1324
MÉXICO,NICOLAS ROMERO,19,179,8,206,1807
MÉXICO,NICOLAS ROMERO,10,197,7,214,1807
MÉXICO,NICOLAS ROMERO,19,176,3,198,1807
MÉXICO,NICOLAS ROMERO,16,197,3,216,1806
MÉXICO,NICOLAS ROMERO,19,327,5,351,1874
MÉXICO,NICOLAS ROMERO,18,238,3,259,1607
MÉXICO,NICOLAS ROMERO,34,170,4,208,1471
MÉXICO,NICOLAS ROMERO,31,161,2,194,1470
MÉXICO,NICOLAS ROMERO,29,144,2,175,1470
MÉXICO,NICOLAS ROMERO,15,218,1,234,1633
MÉXICO,NICOLAS ROMERO,30,206,2,238,1633
MÉXICO,NICOLAS ROMERO,24,200,2,226,1633
MÉXICO,NICOLAS ROMERO,27,327,2,356,1697
MÉXICO,NICOLAS ROMERO,30,289,7,326,1675
MÉXICO,NICOLAS ROMERO,18,189,4,211,1027
MÉXICO,NICOLAS ROMERO,18,182,5,205,1027
MÉXICO,NICOLAS ROMERO,57,317,2,376,1534
MÉXICO,NICOLAS ROMERO,24,238,2,264,1921
MÉXICO,NICOLAS ROMERO,9,228,3,240,1921
MÉXICO,NICOLAS ROMERO,20,247,3,270,1911
MÉXICO,NICOLAS ROMERO,26,248,1,275,1911
MÉXICO,NICOLAS ROMERO,30,205,0,235,1427
MÉXICO,NICOLAS ROMERO,16,193,0,209,1427
MÉXICO,NICOLAS ROMERO,23,191,0,214,1426
MÉXICO,NICOLAS ROMERO,22,259,0,281,1593
MÉXICO,NICOLAS ROMERO,22,266,4,292,1593
MÉXICO,NICOLAS ROMERO,32,190,1,223,1930
MÉXICO,NICOLAS ROMERO,18,179,2,199,1929
MÉXICO,NICOLAS ROMERO,17,192,1,210,1929
MÉXICO,NICOLAS ROMERO,28,190,1,219,1929
MÉXICO,NICOLAS ROMERO,18,212,2,232,1929
MÉXICO,NICOLAS ROMERO,29,211,3,243,1929
MÉXICO,NICOLAS ROMERO,33,199,1,233,1929
MÉXICO,NICOLAS ROMERO,13,214,7,234,1830
MÉXICO,NICOLAS ROMERO,11,212,6,229,1830
MÉXICO,NICOLAS ROMERO,17,240,5,262,1883
MÉXICO,NICOLAS ROMERO,19,202,8,229,1883
MÉXICO,NICOLAS ROMERO,7,167,9,183,1462
MÉXICO,NICOLAS ROMERO,15,148,7,170,1461
MÉXICO,NICOLAS ROMERO,16,123,4,143,1194
MÉXICO,NICOLAS ROMERO,12,144,4,160,1194
MÉXICO,NICOLAS ROMERO,13,222,1,236,1889
MÉXICO,NICOLAS ROMERO,17,242,4,263,1888
MÉXICO,NICOLAS ROMERO,23,205,5,233,1948
MÉXICO,NICOLAS ROMERO,24,219,4,247,1948
MÉXICO,NICOLAS ROMERO,25,175,4,204,1948
MÉXICO,NICOLAS ROMERO,19,246,6,271,1700
MÉXICO,NICOLAS ROMERO,21,171,5,197,1810
MÉXICO,NICOLAS ROMERO,22,175,6,203,1810
MÉXICO,NICOLAS ROMERO,21,186,3,210,1810
MÉXICO,NICOLAS ROMERO,20,186,4,210,1809
MÉXICO,NICOLAS ROMERO,12,179,3,194,1809
MÉXICO,NICOLAS ROMERO,27,267,2,296,1788
MÉXICO,NICOLAS ROMERO,18,256,9,283,1797
MÉXICO,NICOLAS ROMERO,21,268,3,292,1797
MÉXICO,NICOLAS ROMERO,21,259,3,283,1797
MÉXICO,NICOLAS ROMERO,16,173,3,192,1563
MÉXICO,NICOLAS ROMERO,7,183,4,194,1563
MÉXICO,NICOLAS ROMERO,16,117,6,139,1163
MÉXICO,NICOLAS ROMERO,5,134,9,148,1163
MÉXICO,NICOLAS ROMERO,13,197,4,214,1581
MÉXICO,NICOLAS ROMERO,14,176,0,190,1711
MÉXICO,NICOLAS ROMERO,16,199,2,217,1710
MÉXICO,NICOLAS ROMERO,8,140,1,149,1710
MÉXICO,NICOLAS ROMERO,8,165,0,173,1038
MÉXICO,NICOLAS ROMERO,10,189,2,201,1037
MÉXICO,NICOLAS ROMERO,17,351,5,373,1813
MÉXICO,NICOLAS ROMERO,13,162,4,179,1822
MÉXICO,NICOLAS ROMERO,12,185,6,203,1821
MÉXICO,NICOLAS ROMERO,14,304,2,320,1655
MÉXICO,NICOLAS ROMERO,22,289,4,315,1654
MÉXICO,NICOLAS ROMERO,19,231,9,259,1894
MÉXICO,NICOLAS ROMERO,23,152,5,180,1344
MÉXICO,NICOLAS ROMERO,18,156,4,178,1344
MÉXICO,NICOLAS ROMERO,9,150,0,159,1562
MÉXICO,NICOLAS ROMERO,13,158,5,176,1562
MÉXICO,NICOLAS ROMERO,6,169,1,176,1562
MÉXICO,NICOLAS ROMERO,24,167,4,195,1120
MÉXICO,NICOLAS ROMERO,15,155,4,174,1119
MÉXICO,TEOTIHUACAN DE ARISTA,18,294,10,322,1439
MÉXICO,TEOTIHUACAN DE ARISTA,25,306,5,336,1439
MÉXICO,TEOTIHUACAN DE ARISTA,25,272,5,302,1240
MÉXICO,TEOTIHUACAN DE ARISTA,18,281,2,301,1239
MÉXICO,TEOTIHUACAN DE ARISTA,33,355,7,395,2063
MÉXICO,TEOTIHUACAN DE ARISTA,33,349,9,391,2062
MÉXICO,TEOTIHUACAN DE ARISTA,18,224,2,244,1449
MÉXICO,TEOTIHUACAN DE ARISTA,15,291,4,310,1449
MÉXICO,TEOTIHUACAN DE ARISTA,18,276,3,297,1449
MÉXICO,TEOTIHUACAN DE ARISTA,11,253,3,267,1244
MÉXICO,TEOTIHUACAN DE ARISTA,14,267,2,283,1243
MÉXICO,TEOTIHUACAN DE ARISTA,22,214,3,239,1251
MÉXICO,TEOTIHUACAN DE ARISTA,12,207,2,221,1250
MÉXICO,TEOTIHUACAN DE ARISTA,18,212,4,234,1571
MÉXICO,TEOTIHUACAN DE ARISTA,35,209,4,248,1570
MÉXICO,TEOTIHUACAN DE ARISTA,34,201,3,238,1570
MÉXICO,TEOTIHUACAN DE ARISTA,15,264,5,284,1399
MÉXICO,TEOTIHUACAN DE ARISTA,17,258,3,278,1399
MÉXICO,TEOTIHUACAN DE ARISTA,250,24,3,277,1398
MÉXICO,TEOTIHUACAN DE ARISTA,24,261,3,288,1356
MÉXICO,TEOTIHUACAN DE ARISTA,20,276,4,300,1356
MÉXICO,TEOTIHUACAN DE ARISTA,22,355,4,381,1877
MÉXICO,TEOTIHUACAN DE ARISTA,30,377,7,414,1877
MÉXICO,TEOTIHUACAN DE ARISTA,24,242,1,267,1302
MÉXICO,TEOTIHUACAN DE ARISTA,11,260,7,278,1301
MÉXICO,TEOTIHUACAN DE ARISTA,26,346,10,382,1583
MÉXICO,TEOTIHUACAN DE ARISTA,13,294,7,314,1583
MÉXICO,TEOTIHUACAN DE ARISTA,21,286,1,308,1341
MÉXICO,TEOTIHUACAN DE ARISTA,19,237,7,263,1340
MÉXICO,TEOTIHUACAN DE ARISTA,39,277,4,320,1619
MÉXICO,TEOTIHUACAN DE ARISTA,33,243,3,279,1618
MÉXICO,TEOTIHUACAN DE ARISTA,39,269,4,312,1613
MÉXICO,TEOTIHUACAN DE ARISTA,26,247,4,277,1613
MÉXICO,TEOTIHUACAN DE ARISTA,42,236,6,284,1393
MÉXICO,TEOTIHUACAN DE ARISTA,21,213,3,237,1393
MÉXICO,TEOTIHUACAN DE ARISTA,22,209,1,232,1392
MÉXICO,TEOTIHUACAN DE ARISTA,15,229,2,246,1437
MÉXICO,TEOTIHUACAN DE ARISTA,21,283,4,308,1436
MÉXICO,TEOTIHUACAN DE ARISTA,41,245,3,289,1742
MÉXICO,TEOTIHUACAN DE ARISTA,32,224,2,258,1742
MÉXICO,TEOTIHUACAN DE ARISTA,16,174,2,192,1720
MÉXICO,TEOTIHUACAN DE ARISTA,34,208,0,242,1720
MÉXICO,TEOTIHUACAN DE ARISTA,13,175,3,191,1720
MÉXICO,TEOTIHUACAN DE ARISTA,20,168,7,195,1719
MÉXICO,TEOTIHUACAN DE ARISTA,20,209,2,231,1719
MÉXICO,TEOTIHUACAN DE ARISTA,28,190,1,219,1719
MÉXICO,TEOTIHUACAN DE ARISTA,17,211,2,230,1804
MÉXICO,TEOTIHUACAN DE ARISTA,15,262,5,282,1803
MÉXICO,TEOTIHUACAN DE ARISTA,10,182,4,196,1422
MÉXICO,TEOTIHUACAN DE ARISTA,11,210,3,224,1422
MÉXICO,TEOTIHUACAN DE ARISTA,17,242,13,272,1825
MÉXICO,TEOTIHUACAN DE ARISTA,17,300,16,333,1824
MÉXICO,TEOTIHUACAN DE ARISTA,12,272,8,292,1965
MÉXICO,TEOTIHUACAN DE ARISTA,15,245,5,265,1406
MÉXICO,TEOTIHUACAN DE ARISTA,5,257,4,266,1405
MÉXICO,TEOTIHUACAN DE ARISTA,19,291,11,321,1778
MÉXICO,TEOTIHUACAN DE ARISTA,13,423,11,447,1836
MÉXICO,TEOTIHUACAN DE ARISTA,10,379,9,398,1835
MÉXICO,TEOTIHUACAN DE ARISTA,23,318,0,341,1755
MÉXICO,TEOTIHUACAN DE ARISTA,18,326,4,348,1754
MÉXICO,TEOTIHUACAN DE ARISTA,21,257,7,285,1868
MÉXICO,TEOTIHUACAN DE ARISTA,21,286,0,307,1868
MÉXICO,TEOTIHUACAN DE ARISTA,28,321,2,351,1867
MÉXICO,TEOTIHUACAN DE ARISTA,32,409,4,445,1939
MÉXICO,TEOTIHUACAN DE ARISTA,31,385,4,420,1938
MÉXICO,TEOTIHUACAN DE ARISTA,9,215,4,228,1640
MÉXICO,TEOTIHUACAN DE ARISTA,9,213,1,223,1639
MÉXICO,TEOTIHUACAN DE ARISTA,30,354,2,386,1551
MÉXICO,TEOTIHUACAN DE ARISTA,23,358,3,384,1551
MÉXICO,TEOTIHUACAN DE ARISTA,22,266,2,290,1387
MÉXICO,TEOTIHUACAN DE ARISTA,16,290,0,306,1387
MÉXICO,TEOTIHUACAN DE ARISTA,13,214,6,233,1471
MÉXICO,TEOTIHUACAN DE ARISTA,21,253,3,277,1470
MÉXICO,TEOTIHUACAN DE ARISTA,24,232,4,260,1470
MÉXICO,TEOTIHUACAN DE ARISTA,25,315,10,350,1716
MÉXICO,TEOTIHUACAN DE ARISTA,23,317,9,349,1715
MÉXICO,TEOTIHUACAN DE ARISTA,12,144,1,157,1390
MÉXICO,TEOTIHUACAN DE ARISTA,15,141,0,156,1390
MÉXICO,TEOTIHUACAN DE ARISTA,23,314,4,341,1899
MÉXICO,TEOTIHUACAN DE ARISTA,23,277,3,303,1898
MÉXICO,TEOTIHUACAN DE ARISTA,6,112,2,120,1946
MÉXICO,TEOTIHUACAN DE ARISTA,5,107,3,115,1388
MÉXICO,TEOTIHUACAN DE ARISTA,6,131,2,139,1388
MÉXICO,TEOTIHUACAN DE ARISTA,8,220,8,236,2161
MÉXICO,TEOTIHUACAN DE ARISTA,14,224,3,241,2161
MÉXICO,TEOTIHUACAN DE ARISTA,18,279,2,299,1642
MÉXICO,TEOTIHUACAN DE ARISTA,10,261,2,273,1642
MÉXICO,TEOTIHUACAN DE ARISTA,6,89,1,96,1010
MÉXICO,TEOTIHUACAN DE ARISTA,6,78,2,86,1010
MÉXICO,TEOTIHUACAN DE ARISTA,14,220,10,244,1594
MÉXICO,TEOTIHUACAN DE ARISTA,13,249,6,268,1593
MÉXICO,TEOTIHUACAN DE ARISTA,18,240,4,262,1610
MÉXICO,TEOTIHUACAN DE ARISTA,43,295,9,347,1365
MÉXICO,TEOTIHUACAN DE ARISTA,49,339,4,392,1365
MÉXICO,TEOTIHUACAN DE ARISTA,24,320,5,349,1365
MÉXICO,TEOTIHUACAN DE ARISTA,19,269,1,289,1962
MÉXICO,TEOTIHUACAN DE ARISTA,30,271,1,302,1962
MÉXICO,TEOTIHUACAN DE ARISTA,8,246,3,257,1388
MÉXICO,TEOTIHUACAN DE ARISTA,9,213,0,222,1387
MÉXICO,TEOTIHUACAN DE ARISTA,16,316,3,335,2048
MÉXICO,TEOTIHUACAN DE ARISTA,13,302,5,320,2048
MÉXICO,TEOTIHUACAN DE ARISTA,15,214,2,231,1278
MÉXICO,TEOTIHUACAN DE ARISTA,9,210,3,222,1277
MÉXICO,TEOTIHUACAN DE ARISTA,9,177,4,190,1938
MÉXICO,TEOTIHUACAN DE ARISTA,11,215,1,227,1937
MÉXICO,TEOTIHUACAN DE ARISTA,16,224,2,242,1850
MÉXICO,TEOTIHUACAN DE ARISTA,8,248,0,256,1850
MÉXICO,TEOTIHUACAN DE ARISTA,12,237,2,251,1650
MÉXICO,TEOTIHUACAN DE ARISTA,18,251,4,273,1650
MÉXICO,TEOTIHUACAN DE ARISTA,7,226,1,234,1859
MÉXICO,TEOTIHUACAN DE ARISTA,10,172,3,185,1858
MÉXICO,TEOTIHUACAN DE ARISTA,18,285,3,306,1609
MÉXICO,TEOTIHUACAN DE ARISTA,11,308,2,321,1608
MÉXICO,TEOTIHUACAN DE ARISTA,8,367,6,381,1732
MÉXICO,TEOTIHUACAN DE ARISTA,8,380,6,394,1732
MÉXICO,TEOTIHUACAN DE ARISTA,22,250,8,280,2114
MÉXICO,TEOTIHUACAN DE ARISTA,6,302,1,309,1816
MÉXICO,TEOTIHUACAN DE ARISTA,19,320,5,344,1815
MÉXICO,TEOTIHUACAN DE ARISTA,21,264,2,287,1664
MÉXICO,TEOTIHUACAN DE ARISTA,10,245,4,259,1664
MÉXICO,TEOTIHUACAN DE ARISTA,15,232,8,255,1663
MÉXICO,TEOTIHUACAN DE ARISTA,12,300,7,319,1278
MÉXICO,TEOTIHUACAN DE ARISTA,8,313,1,322,1277
MÉXICO,TEOTIHUACAN DE ARISTA,9,274,5,288,1552
MÉXICO,TEOTIHUACAN DE ARISTA,7,268,2,277,1551
MÉXICO,TEOTIHUACAN DE ARISTA,15,216,1,232,1283
MÉXICO,TEOTIHUACAN DE ARISTA,12,239,1,252,1282
MÉXICO,TEOTIHUACAN DE ARISTA,19,321,0,340,1806
MÉXICO,TEOTIHUACAN DE ARISTA,14,333,4,351,1805
MÉXICO,TEOTIHUACAN DE ARISTA,18,179,2,199,1288
MÉXICO,TEOTIHUACAN DE ARISTA,11,159,0,170,1288
MÉXICO,TEOTIHUACAN DE ARISTA,7,219,1,227,1375
MÉXICO,TEOTIHUACAN DE ARISTA,11,222,1,234,1375
MÉXICO,TEOTIHUACAN DE ARISTA,9,233,4,246,1522
MÉXICO,TEOTIHUACAN DE ARISTA,12,223,7,242,1521
MÉXICO,TEOTIHUACAN DE ARISTA,13,226,1,240,1521
MÉXICO,TEOTIHUACAN DE ARISTA,13,323,3,339,1665
MÉXICO,TEOTIHUACAN DE ARISTA,31,316,4,351,1664
MÉXICO,TEOTIHUACAN DE ARISTA,17,201,4,222,1698
MÉXICO,TEOTIHUACAN DE ARISTA,8,144,6,158,1118
MÉXICO,TEOTIHUACAN DE ARISTA,7,174,3,184,1118
MÉXICO,TEOTIHUACAN DE ARISTA,24,279,2,305,1567
MÉXICO,TEOTIHUACAN DE ARISTA,18,338,1,357,1566
MÉXICO,TEOTIHUACAN DE ARISTA,72,545,5,622,0
MÉXICO,TEOTIHUACAN DE ARISTA,15,384,4,403,1840
MÉXICO,TEOTIHUACAN DE ARISTA,14,384,2,400,1565
MÉXICO,TEOTIHUACAN DE ARISTA,10,399,4,413,1565
MÉXICO,TEOTIHUACAN DE ARISTA,15,345,3,363,2018
MÉXICO,TEOTIHUACAN DE ARISTA,11,211,4,226,1840
MÉXICO,TEOTIHUACAN DE ARISTA,9,257,3,269,1840
MÉXICO,TEOTIHUACAN DE ARISTA,13,249,3,265,1697
MÉXICO,TEOTIHUACAN DE ARISTA,20,229,3,252,1456
MÉXICO,TEOTIHUACAN DE ARISTA,21,225,3,249,1456
MÉXICO,TEOTIHUACAN DE ARISTA,22,359,3,384,2074
MÉXICO,TEOTIHUACAN DE ARISTA,13,233,2,248,1344
MÉXICO,TEOTIHUACAN DE ARISTA,12,224,4,240,1344
MÉXICO,TEOTIHUACAN DE ARISTA,11,161,2,174,1159
MÉXICO,TEOTIHUACAN DE ARISTA,14,174,3,191,1159
MÉXICO,TEOTIHUACAN DE ARISTA,17,236,5,258,1341
MÉXICO,TEOTIHUACAN DE ARISTA,17,232,1,250,1341
MÉXICO,TEOTIHUACAN DE ARISTA,14,315,0,329,1861
MÉXICO,TEOTIHUACAN DE ARISTA,18,247,5,270,1861
MÉXICO,TEOTIHUACAN DE ARISTA,20,207,7,234,1645
MÉXICO,TEOTIHUACAN DE ARISTA,21,163,2,186,1644
MÉXICO,TEOTIHUACAN DE ARISTA,22,261,2,285,1193
MÉXICO,TEOTIHUACAN DE ARISTA,13,268,1,282,1192
MÉXICO,TEOTIHUACAN DE ARISTA,19,305,7,331,2029
MÉXICO,TEOTIHUACAN DE ARISTA,20,384,8,412,2011
MÉXICO,TEOTIHUACAN DE ARISTA,18,290,6,314,2010
MÉXICO,TEOTIHUACAN DE ARISTA,28,199,3,230,1304
MÉXICO,TEOTIHUACAN DE ARISTA,12,185,2,199,1304
MÉXICO,TEOTIHUACAN DE ARISTA,27,144,1,172,1531
MÉXICO,TEOTIHUACAN DE ARISTA,15,162,0,177,1531
MÉXICO,TEOTIHUACAN DE ARISTA,23,162,2,187,1531
MÉXICO,TEOTIHUACAN DE ARISTA,39,242,5,286,1584
MÉXICO,TEOTIHUACAN DE ARISTA,20,204,5,229,1584
MÉXICO,TEOTIHUACAN DE ARISTA,23,167,3,193,1376
MÉXICO,TEOTIHUACAN DE ARISTA,24,157,3,184,1376
MÉXICO,TEOTIHUACAN DE ARISTA,16,144,1,161,1368
MÉXICO,TEOTIHUACAN DE ARISTA,9,151,1,161,1368
MÉXICO,TEOTIHUACAN DE ARISTA,14,124,3,141,1368
MÉXICO,TEOTIHUACAN DE ARISTA,23,279,6,308,2049
MÉXICO,COACALCO DE BERRIOZABAL,26,220,0,246,1552
MÉXICO,COACALCO DE BERRIOZABAL,23,181,2,206,1552
MÉXICO,COACALCO DE BERRIOZABAL,28,223,0,251,1552
MÉXICO,COACALCO DE BERRIOZABAL,29,216,0,245,1552
MÉXICO,COACALCO DE BERRIOZABAL,29,259,9,297,1487
MÉXICO,COACALCO DE BERRIOZABAL,13,253,2,268,1487
MÉXICO,COACALCO DE BERRIOZABAL,32,258,2,292,1487
MÉXICO,COACALCO DE BERRIOZABAL,16,274,4,294,1771
MÉXICO,COACALCO DE BERRIOZABAL,17,293,5,315,1771
MÉXICO,COACALCO DE BERRIOZABAL,38,268,8,314,1942
MÉXICO,COACALCO DE BERRIOZABAL,25,324,3,352,1941
MÉXICO,COACALCO DE BERRIOZABAL,34,264,3,301,1533
MÉXICO,COACALCO DE BERRIOZABAL,25,294,1,320,1533
MÉXICO,COACALCO DE BERRIOZABAL,26,225,1,252,1920
MÉXICO,COACALCO DE BERRIOZABAL,38,221,0,259,1920
MÉXICO,COACALCO DE BERRIOZABAL,22,244,0,266,1919
MÉXICO,COACALCO DE BERRIOZABAL,29,252,1,282,1919
MÉXICO,COACALCO DE BERRIOZABAL,14,182,2,198,1542
MÉXICO,COACALCO DE BERRIOZABAL,18,190,0,208,1541
MÉXICO,COACALCO DE BERRIOZABAL,11,192,0,203,1541
MÉXICO,COACALCO DE BERRIOZABAL,32,224,5,261,1367
MÉXICO,COACALCO DE BERRIOZABAL,20,249,0,269,1366
MÉXICO,COACALCO DE BERRIOZABAL,39,308,3,350,1635
MÉXICO,COACALCO DE BERRIOZABAL,22,318,7,347,1635
MÉXICO,COACALCO DE BERRIOZABAL,27,192,3,222,1613
MÉXICO,COACALCO DE BERRIOZABAL,25,185,1,211,1613
MÉXICO,COACALCO DE BERRIOZABAL,29,198,1,228,1612
MÉXICO,COACALCO DE BERRIOZABAL,15,336,6,357,1605
MÉXICO,COACALCO DE BERRIOZABAL,14,247,6,267,1604
MÉXICO,COACALCO DE BERRIOZABAL,23,254,4,281,1408
MÉXICO,COACALCO DE BERRIOZABAL,20,226,3,249,1408
MÉXICO,COACALCO DE BERRIOZABAL,23,230,3,256,1535
MÉXICO,COACALCO DE BERRIOZABAL,40,255,2,297,1534
MÉXICO,COACALCO DE BERRIOZABAL,25,253,2,280,1534
MÉXICO,COACALCO DE BERRIOZABAL,33,241,2,276,1576
MÉXICO,COACALCO DE BERRIOZABAL,22,214,2,238,1575
MÉXICO,COACALCO DE BERRIOZABAL,36,240,2,278,1575
MÉXICO,COACALCO DE BERRIOZABAL,17,196,2,215,1443
MÉXICO,COACALCO DE BERRIOZABAL,22,193,0,215,1443
MÉXICO,COACALCO DE BERRIOZABAL,20,207,1,228,1443
MÉXICO,COACALCO DE BERRIOZABAL,20,265,6,291,1684
MÉXICO,COACALCO DE BERRIOZABAL,17,241,4,262,1684
MÉXICO,COACALCO DE BERRIOZABAL,29,291,2,322,1916
MÉXICO,COACALCO DE BERRIOZABAL,27,328,0,355,1916
MÉXICO,COACALCO DE BERRIOZABAL,15,197,0,212,1430
MÉXICO,COACALCO DE BERRIOZABAL,21,205,4,230,1430
MÉXICO,COACALCO DE BERRIOZABAL,13,180,0,193,1430
MÉXICO,COACALCO DE BERRIOZABAL,29,264,3,296,1790
MÉXICO,COACALCO DE BERRIOZABAL,16,220,2,238,1789
MÉXICO,COACALCO DE BERRIOZABAL,18,233,2,253,1418
MÉXICO,COACALCO DE BERRIOZABAL,12,238,0,250,1418
MÉXICO,COACALCO DE BERRIOZABAL,19,259,1,279,1418
MÉXICO,COACALCO DE BERRIOZABAL,13,157,1,171,1072
MÉXICO,COACALCO DE BERRIOZABAL,18,172,3,193,1072
MÉXICO,COACALCO DE BERRIOZABAL,18,210,5,233,1626
MÉXICO,COACALCO DE BERRIOZABAL,24,231,2,257,1626
MÉXICO,COACALCO DE BERRIOZABAL,18,225,4,247,1626
MÉXICO,COACALCO DE BERRIOZABAL,17,247,2,266,1703
MÉXICO,COACALCO DE BERRIOZABAL,23,244,0,267,1702
MÉXICO,COACALCO DE BERRIOZABAL,33,240,1,274,1702
MÉXICO,COACALCO DE BERRIOZABAL,27,242,1,270,1702
MÉXICO,COACALCO DE BERRIOZABAL,27,226,1,254,1702
MÉXICO,COACALCO DE BERRIOZABAL,27,246,3,276,1702
MÉXICO,COACALCO DE BERRIOZABAL,32,172,0,204,1399
MÉXICO,COACALCO DE BERRIOZABAL,26,175,1,202,1398
MÉXICO,COACALCO DE BERRIOZABAL,20,211,0,231,1398
MÉXICO,COACALCO DE BERRIOZABAL,45,300,0,345,1973
MÉXICO,COACALCO DE BERRIOZABAL,28,307,0,335,1972
MÉXICO,COACALCO DE BERRIOZABAL,25,225,4,254,1385
MÉXICO,COACALCO DE BERRIOZABAL,25,196,0,221,1384
MÉXICO,COACALCO DE BERRIOZABAL,30,204,1,235,1384
MÉXICO,COACALCO DE BERRIOZABAL,29,253,0,282,1487
MÉXICO,COACALCO DE BERRIOZABAL,36,229,0,265,1487
MÉXICO,COACALCO DE BERRIOZABAL,27,200,1,228,1738
MÉXICO,COACALCO DE BERRIOZABAL,25,178,1,204,1738
MÉXICO,COACALCO DE BERRIOZABAL,31,210,1,242,1737
MÉXICO,COACALCO DE BERRIOZABAL,25,233,1,259,1737
MÉXICO,COACALCO DE BERRIOZABAL,31,222,2,255,1737
MÉXICO,COACALCO DE BERRIOZABAL,22,233,1,256,1737
MÉXICO,COACALCO DE BERRIOZABAL,42,322,3,367,1927
MÉXICO,COACALCO DE BERRIOZABAL,35,334,1,370,1926
MÉXICO,COACALCO DE BERRIOZABAL,33,266,4,303,1750
MÉXICO,COACALCO DE BERRIOZABAL,25,261,4,290,1749
MÉXICO,COACALCO DE BERRIOZABAL,16,221,1,238,1685
MÉXICO,COACALCO DE BERRIOZABAL,26,239,2,267,1684
MÉXICO,COACALCO DE BERRIOZABAL,36,297,3,336,1703
MÉXICO,COACALCO DE BERRIOZABAL,29,264,2,295,1702
MÉXICO,COACALCO DE BERRIOZABAL,32,216,1,249,1397
MÉXICO,COACALCO DE BERRIOZABAL,31,208,2,241,1396
MÉXICO,COACALCO DE BERRIOZABAL,14,185,4,203,1396
MÉXICO,COACALCO DE BERRIOZABAL,36,272,3,311,1937
MÉXICO,COACALCO DE BERRIOZABAL,31,266,1,298,1937
MÉXICO,COACALCO DE BERRIOZABAL,14,150,2,166,1328
MÉXICO,COACALCO DE BERRIOZABAL,22,194,3,219,1328
MÉXICO,COACALCO DE BERRIOZABAL,15,182,2,199,1328
MÉXICO,COACALCO DE BERRIOZABAL,28,287,1,316,1790
MÉXICO,COACALCO DE BERRIOZABAL,20,228,2,250,1790
MÉXICO,COACALCO DE BERRIOZABAL,14,294,1,309,1790
MÉXICO,COACALCO DE BERRIOZABAL,27,350,4,381,1813
MÉXICO,COACALCO DE BERRIOZABAL,34,342,3,379,1812
MÉXICO,COACALCO DE BERRIOZABAL,28,348,3,379,1642
MÉXICO,COACALCO DE BERRIOZABAL,15,318,2,335,1641
MÉXICO,COACALCO DE BERRIOZABAL,34,261,0,295,1675
MÉXICO,COACALCO DE BERRIOZABAL,35,283,4,322,1675
MÉXICO,COACALCO DE BERRIOZABAL,27,188,0,215,1714
MÉXICO,COACALCO DE BERRIOZABAL,20,221,5,246,1713
MÉXICO,COACALCO DE BERRIOZABAL,10,228,2,240,1713
MÉXICO,COACALCO DE BERRIOZABAL,69,749,7,825,0
MÉXICO,COACALCO DE BERRIOZABAL,18,187,2,207,1074
MÉXICO,COACALCO DE BERRIOZABAL,27,158,3,188,1073
MÉXICO,COACALCO DE BERRIOZABAL,12,174,3,189,1023
MÉXICO,COACALCO DE BERRIOZABAL,10,185,1,196,1022
MÉXICO,COACALCO DE BERRIOZABAL,23,232,4,259,1417
MÉXICO,COACALCO DE BERRIOZABAL,21,231,10,262,1416
MÉXICO,COACALCO DE BERRIOZABAL,25,204,1,230,1416
MÉXICO,COACALCO DE BERRIOZABAL,21,275,2,298,1677
MÉXICO,COACALCO DE BERRIOZABAL,31,273,1,305,1676
MÉXICO,COACALCO DE BERRIOZABAL,27,230,3,260,1848
MÉXICO,COACALCO DE BERRIOZABAL,28,246,0,274,1848
MÉXICO,COACALCO DE BERRIOZABAL,21,247,3,271,1848
MÉXICO,COACALCO DE BERRIOZABAL,27,216,7,250,1737
MÉXICO,COACALCO DE BERRIOZABAL,26,247,4,277,1737
MÉXICO,COACALCO DE BERRIOZABAL,27,251,3,281,1737
MÉXICO,COACALCO DE BERRIOZABAL,21,262,7,290,1633
MÉXICO,COACALCO DE BERRIOZABAL,16,243,3,262,1632
MÉXICO,COACALCO DE BERRIOZABAL,19,233,4,256,1632
MÉXICO,COACALCO DE BERRIOZABAL,17,221,2,240,1435
MÉXICO,COACALCO DE BERRIOZABAL,11,241,2,254,1434
MÉXICO,COACALCO DE BERRIOZABAL,25,218,1,244,1428
MÉXICO,COACALCO DE BERRIOZABAL,19,232,6,257,1428
MÉXICO,COACALCO DE BERRIOZABAL,14,220,0,234,1428
MÉXICO,COACALCO DE BERRIOZABAL,36,226,2,264,1638
MÉXICO,COACALCO DE BERRIOZABAL,27,240,1,268,1637
MÉXICO,COACALCO DE BERRIOZABAL,27,266,2,295,1676
MÉXICO,COACALCO DE BERRIOZABAL,23,269,3,295,1675
MÉXICO,COACALCO DE BERRIOZABAL,27,205,1,233,1647
MÉXICO,COACALCO DE BERRIOZABAL,25,193,1,219,1647
MÉXICO,COACALCO DE BERRIOZABAL,24,210,4,238,1646
MÉXICO,COACALCO DE BERRIOZABAL,29,341,0,370,1825
MÉXICO,COACALCO DE BERRIOZABAL,25,290,7,322,1825
MÉXICO,COACALCO DE BERRIOZABAL,32,290,1,323,1824
MÉXICO,COACALCO DE BERRIOZABAL,27,255,1,283,1532
MÉXICO,COACALCO DE BERRIOZABAL,21,260,4,285,1531
MÉXICO,COACALCO DE BERRIOZABAL,30,357,4,391,1698
MÉXICO,COACALCO DE BERRIOZABAL,31,337,3,371,1698
MÉXICO,COACALCO DE BERRIOZABAL,36,357,6,399,1770
MÉXICO,COACALCO DE BERRIOZABAL,31,372,5,408,1770
MÉXICO,COACALCO DE BERRIOZABAL,45,373,7,425,1962
MÉXICO,COACALCO DE BERRIOZABAL,37,400,10,447,1962
MÉXICO,COACALCO DE BERRIOZABAL,14,139,2,155,1143
MÉXICO,COACALCO DE BERRIOZABAL,12,118,0,130,1143
MÉXICO,COACALCO DE BERRIOZABAL,26,206,13,245,1703
MÉXICO,COACALCO DE BERRIOZABAL,11,220,2,233,1702
MÉXICO,COACALCO DE BERRIOZABAL,10,194,3,207,1518
MÉXICO,COACALCO DE BERRIOZABAL,15,189,5,209,1517
MÉXICO,COACALCO DE BERRIOZABAL,15,192,4,211,1517
MÉXICO,COACALCO DE BERRIOZABAL,14,200,1,215,1586
MÉXICO,COACALCO DE BERRIOZABAL,12,170,4,186,1586
MÉXICO,COACALCO DE BERRIOZABAL,12,184,3,199,1585
MÉXICO,COACALCO DE BERRIOZABAL,26,238,2,266,1889
MÉXICO,COACALCO DE BERRIOZABAL,9,274,0,283,1888
MÉXICO,COACALCO DE BERRIOZABAL,9,157,1,167,1570
MÉXICO,COACALCO DE BERRIOZABAL,9,169,5,183,1570
MÉXICO,COACALCO DE BERRIOZABAL,7,175,1,183,1569
MÉXICO,COACALCO DE BERRIOZABAL,18,228,8,254,1954
MÉXICO,COACALCO DE BERRIOZABAL,33,242,0,275,1953
MÉXICO,COACALCO DE BERRIOZABAL,19,197,3,219,1459
MÉXICO,COACALCO DE BERRIOZABAL,27,157,2,186,1458
MÉXICO,COACALCO DE BERRIOZABAL,16,162,3,181,1458
MÉXICO,COACALCO DE BERRIOZABAL,20,186,3,209,1552
MÉXICO,COACALCO DE BERRIOZABAL,20,175,2,197,1551
MÉXICO,COACALCO DE BERRIOZABAL,26,176,6,208,1551
MÉXICO,COACALCO DE BERRIOZABAL,24,206,1,231,1784
MÉXICO,COACALCO DE BERRIOZABAL,15,200,2,217,1784
MÉXICO,COACALCO DE BERRIOZABAL,15,222,0,237,1784
MÉXICO,COACALCO DE BERRIOZABAL,14,215,6,235,1823
MÉXICO,COACALCO DE BERRIOZABAL,17,219,9,245,1823
MÉXICO,COACALCO DE BERRIOZABAL,12,228,1,241,1822
MÉXICO,COACALCO DE BERRIOZABAL,18,268,1,287,1765
MÉXICO,COACALCO DE BERRIOZABAL,16,256,1,273,1764
MÉXICO,CUAUTITLAN IZCALLI,21,228,4,253,1578
MÉXICO,CUAUTITLAN IZCALLI,18,218,1,237,1578
MÉXICO,CUAUTITLAN IZCALLI,15,209,2,226,1578
MÉXICO,CUAUTITLAN IZCALLI,29,248,5,282,1466
MÉXICO,CUAUTITLAN IZCALLI,31,234,0,265,1466
MÉXICO,CUAUTITLAN IZCALLI,22,269,1,292,1566
MÉXICO,CUAUTITLAN IZCALLI,13,208,2,223,1566
MÉXICO,CUAUTITLAN IZCALLI,22,333,2,357,1828
MÉXICO,CUAUTITLAN IZCALLI,14,158,1,173,1154
MÉXICO,CUAUTITLAN IZCALLI,14,169,2,185,1153
MÉXICO,CUAUTITLAN IZCALLI,24,209,2,235,1085
MÉXICO,CUAUTITLAN IZCALLI,18,227,3,248,1084
MÉXICO,CUAUTITLAN IZCALLI,28,300,3,331,1963
MÉXICO,CUAUTITLAN IZCALLI,20,270,1,291,1962
MÉXICO,CUAUTITLAN IZCALLI,33,227,4,264,1977
MÉXICO,CUAUTITLAN IZCALLI,50,228,3,281,1977
MÉXICO,CUAUTITLAN IZCALLI,37,257,2,296,1977
MÉXICO,CUAUTITLAN IZCALLI,18,243,0,261,1316
MÉXICO,CUAUTITLAN IZCALLI,16,203,6,225,1316
MÉXICO,CUAUTITLAN IZCALLI,12,180,1,193,1282
MÉXICO,CUAUTITLAN IZCALLI,10,152,0,162,1282
MÉXICO,CUAUTITLAN IZCALLI,36,376,3,415,1908
MÉXICO,CUAUTITLAN IZCALLI,24,370,5,399,1907
MÉXICO,CUAUTITLAN IZCALLI,49,241,1,291,1536
MÉXICO,CUAUTITLAN IZCALLI,42,230,2,274,1535
MÉXICO,CUAUTITLAN IZCALLI,16,243,1,260,1309
MÉXICO,CUAUTITLAN IZCALLI,25,230,1,256,1308
MÉXICO,CUAUTITLAN IZCALLI,27,264,5,296,1590
MÉXICO,CUAUTITLAN IZCALLI,29,233,1,263,1590
MÉXICO,CUAUTITLAN IZCALLI,26,256,4,286,1589
MÉXICO,CUAUTITLAN IZCALLI,29,167,1,197,1118
MÉXICO,CUAUTITLAN IZCALLI,39,144,4,187,1118
MÉXICO,CUAUTITLAN IZCALLI,23,265,2,290,1377
MÉXICO,CUAUTITLAN IZCALLI,26,279,1,306,1377
MÉXICO,CUAUTITLAN IZCALLI,24,293,3,320,1377
MÉXICO,CUAUTITLAN IZCALLI,12,205,0,217,1032
MÉXICO,CUAUTITLAN IZCALLI,14,188,3,205,1032
MÉXICO,CUAUTITLAN IZCALLI,18,361,3,382,1979
MÉXICO,CUAUTITLAN IZCALLI,24,320,2,346,1978
MÉXICO,CUAUTITLAN IZCALLI,27,332,2,361,1978
MÉXICO,CUAUTITLAN IZCALLI,39,334,1,374,1585
MÉXICO,CUAUTITLAN IZCALLI,18,214,2,234,1561
MÉXICO,CUAUTITLAN IZCALLI,14,270,2,286,1400
MÉXICO,CUAUTITLAN IZCALLI,18,271,3,292,1400
MÉXICO,CUAUTITLAN IZCALLI,19,258,2,279,1400
MÉXICO,CUAUTITLAN IZCALLI,13,216,3,232,1429
MÉXICO,CUAUTITLAN IZCALLI,16,242,2,260,1429
MÉXICO,CUAUTITLAN IZCALLI,11,223,3,237,1428
MÉXICO,CUAUTITLAN IZCALLI,22,224,0,246,1342
MÉXICO,CUAUTITLAN IZCALLI,17,229,2,248,1342
MÉXICO,CUAUTITLAN IZCALLI,34,308,6,348,1882
MÉXICO,CUAUTITLAN IZCALLI,24,300,0,324,1882
MÉXICO,CUAUTITLAN IZCALLI,12,287,2,301,1545
MÉXICO,CUAUTITLAN IZCALLI,21,266,1,288,1544
MÉXICO,CUAUTITLAN IZCALLI,21,297,1,319,1914
MÉXICO,CUAUTITLAN IZCALLI,26,287,6,319,1914
MÉXICO,CUAUTITLAN IZCALLI,34,260,2,296,1647
MÉXICO,CUAUTITLAN IZCALLI,29,309,6,344,1647
MÉXICO,CUAUTITLAN IZCALLI,19,325,1,345,1903
MÉXICO,CUAUTITLAN IZCALLI,33,282,5,320,1903
MÉXICO,CUAUTITLAN IZCALLI,24,287,3,314,1937
MÉXICO,CUAUTITLAN IZCALLI,26,284,2,312,1936
MÉXICO,CUAUTITLAN IZCALLI,36,445,9,490,2042
MÉXICO,CUAUTITLAN IZCALLI,13,269,3,285,1687
MÉXICO,CUAUTITLAN IZCALLI,25,250,0,275,1687
MÉXICO,CUAUTITLAN IZCALLI,13,229,1,243,1686
MÉXICO,CUAUTITLAN IZCALLI,13,247,0,260,1686
MÉXICO,CUAUTITLAN IZCALLI,24,223,2,249,1686
MÉXICO,CUAUTITLAN IZCALLI,26,343,4,373,1954
MÉXICO,CUAUTITLAN IZCALLI,15,181,3,199,1556
MÉXICO,CUAUTITLAN IZCALLI,27,184,1,212,1556
MÉXICO,CUAUTITLAN IZCALLI,20,220,2,242,1555
MÉXICO,CUAUTITLAN IZCALLI,35,211,0,246,1391
MÉXICO,CUAUTITLAN IZCALLI,27,264,1,292,1391
MÉXICO,CUAUTITLAN IZCALLI,28,214,2,244,1390
MÉXICO,CUAUTITLAN IZCALLI,44,318,4,366,1929
MÉXICO,CUAUTITLAN IZCALLI,37,341,5,383,1929
MÉXICO,CUAUTITLAN IZCALLI,28,291,5,324,1854
MÉXICO,CUAUTITLAN IZCALLI,28,278,3,309,1854
MÉXICO,CUAUTITLAN IZCALLI,28,264,1,293,1854
MÉXICO,CUAUTITLAN IZCALLI,8,282,33,323,1608
MÉXICO,CUAUTITLAN IZCALLI,44,250,5,299,1608
MÉXICO,CUAUTITLAN IZCALLI,26,223,3,252,1422
MÉXICO,CUAUTITLAN IZCALLI,33,189,1,223,1422
MÉXICO,CUAUTITLAN IZCALLI,36,224,2,262,1421
MÉXICO,CUAUTITLAN IZCALLI,26,226,2,254,1530
MÉXICO,CUAUTITLAN IZCALLI,22,222,0,244,1529
MÉXICO,CUAUTITLAN IZCALLI,18,235,1,254,1529
MÉXICO,CUAUTITLAN IZCALLI,17,202,3,222,1529
MÉXICO,CUAUTITLAN IZCALLI,41,281,1,323,1578
MÉXICO,CUAUTITLAN IZCALLI,41,251,3,295,1635
MÉXICO,CUAUTITLAN IZCALLI,24,243,2,269,1634
MÉXICO,CUAUTITLAN IZCALLI,33,325,0,358,2021
MÉXICO,CUAUTITLAN IZCALLI,39,346,0,385,2020
MÉXICO,CUAUTITLAN IZCALLI,21,209,0,230,1502
MÉXICO,CUAUTITLAN IZCALLI,18,231,1,250,1501
MÉXICO,CUAUTITLAN IZCALLI,15,258,2,275,1548
MÉXICO,CUAUTITLAN IZCALLI,23,263,6,292,1555
MÉXICO,CUAUTITLAN IZCALLI,41,311,1,353,1699
MÉXICO,CUAUTITLAN IZCALLI,38,275,5,318,1698
MÉXICO,CUAUTITLAN IZCALLI,27,241,1,269,1944
MÉXICO,CUAUTITLAN IZCALLI,34,251,0,285,1943
MÉXICO,CUAUTITLAN IZCALLI,31,190,3,224,1943
MÉXICO,CUAUTITLAN IZCALLI,117,1042,15,1174,0
MÉXICO,CUAUTITLAN IZCALLI,23,171,1,195,1098
MÉXICO,CUAUTITLAN IZCALLI,28,160,3,191,1097
MÉXICO,CUAUTITLAN IZCALLI,25,209,0,234,1409
MÉXICO,CUAUTITLAN IZCALLI,25,221,1,247,1408
MÉXICO,CUAUTITLAN IZCALLI,31,186,0,217,1408
MÉXICO,CUAUTITLAN IZCALLI,29,268,0,297,1787
MÉXICO,CUAUTITLAN IZCALLI,31,236,5,272,1787
MÉXICO,CUAUTITLAN IZCALLI,38,166,1,205,1505
MÉXICO,CUAUTITLAN IZCALLI,42,177,1,220,1505
MÉXICO,CUAUTITLAN IZCALLI,38,282,7,327,1579
MÉXICO,CUAUTITLAN IZCALLI,27,234,1,262,1843
MÉXICO,CUAUTITLAN IZCALLI,38,276,2,316,1843
MÉXICO,CUAUTITLAN IZCALLI,32,218,2,252,1843
MÉXICO,CUAUTITLAN IZCALLI,22,258,0,280,1843
MÉXICO,CUAUTITLAN IZCALLI,44,296,3,343,1878
MÉXICO,CUAUTITLAN IZCALLI,37,235,3,275,1878
MÉXICO,CUAUTITLAN IZCALLI,37,226,2,265,1665
MÉXICO,CUAUTITLAN IZCALLI,40,234,5,279,1665
MÉXICO,CUAUTITLAN IZCALLI,50,239,0,289,1558
MÉXICO,CUAUTITLAN IZCALLI,22,171,6,199,1435
MÉXICO,CUAUTITLAN IZCALLI,19,156,1,176,1435
MÉXICO,CUAUTITLAN IZCALLI,23,195,2,220,1435
MÉXICO,CUAUTITLAN IZCALLI,30,124,0,154,1224
MÉXICO,CUAUTITLAN IZCALLI,21,144,0,165,1224
MÉXICO,CUAUTITLAN IZCALLI,20,321,7,348,1805
MÉXICO,CUAUTITLAN IZCALLI,32,256,6,294,1809
MÉXICO,CUAUTITLAN IZCALLI,19,266,5,290,1809
MÉXICO,CUAUTITLAN IZCALLI,30,265,4,299,1809
MÉXICO,CUAUTITLAN IZCALLI,21,246,1,268,1676
MÉXICO,CUAUTITLAN IZCALLI,27,194,1,222,1167
MÉXICO,CUAUTITLAN IZCALLI,23,169,2,194,1166
MÉXICO,CUAUTITLAN IZCALLI,39,159,0,198,1398
MÉXICO,CUAUTITLAN IZCALLI,35,147,0,182,1398
MÉXICO,CUAUTITLAN IZCALLI,29,178,1,208,1398
MÉXICO,CUAUTITLAN IZCALLI,28,251,2,281,1752
MÉXICO,CUAUTITLAN IZCALLI,29,218,2,249,1872
MÉXICO,CUAUTITLAN IZCALLI,28,267,1,296,1872
MÉXICO,CUAUTITLAN IZCALLI,39,253,0,292,1872
MÉXICO,CUAUTITLAN IZCALLI,35,240,8,283,1872
MÉXICO,CUAUTITLAN IZCALLI,28,123,0,151,1187
MÉXICO,CUAUTITLAN IZCALLI,37,134,2,173,1187
MÉXICO,CUAUTITLAN IZCALLI,28,182,1,211,1489
MÉXICO,CUAUTITLAN IZCALLI,55,184,2,241,1900
MÉXICO,CUAUTITLAN IZCALLI,9,194,1,204,1979
MÉXICO,CUAUTITLAN IZCALLI,14,194,2,210,1979
MÉXICO,CUAUTITLAN IZCALLI,14,183,1,198,1979
MÉXICO,CUAUTITLAN IZCALLI,11,203,2,216,1979
MÉXICO,CUAUTITLAN IZCALLI,23,294,3,320,1716
MÉXICO,CUAUTITLAN IZCALLI,17,316,2,335,1715
MÉXICO,CUAUTITLAN IZCALLI,24,375,9,408,2010
MÉXICO,CUAUTITLAN IZCALLI,16,229,5,250,1237
MÉXICO,CUAUTITLAN IZCALLI,11,239,0,250,1236
MÉXICO,CUAUTITLAN IZCALLI,16,259,6,281,1617
MÉXICO,CUAUTITLAN IZCALLI,15,245,4,264,1616
MÉXICO,CUAUTITLAN IZCALLI,10,257,0,267,1616
MÉXICO,CUAUTITLAN IZCALLI,36,209,3,248,1574
MÉXICO,CUAUTITLAN IZCALLI,32,190,3,225,1573
MÉXICO,CUAUTITLAN IZCALLI,23,182,3,208,1573
MÉXICO,CUAUTITLAN IZCALLI,34,188,0,222,1784
MÉXICO,CUAUTITLAN IZCALLI,19,285,4,308,1341
MÉXICO,CUAUTITLAN IZCALLI,15,250,1,266,1341
MÉXICO,CUAUTITLAN IZCALLI,24,175,3,202,1527
MÉXICO,CUAUTITLAN IZCALLI,22,158,0,180,1527
MÉXICO,CUAUTITLAN IZCALLI,18,172,1,191,1526
MÉXICO,CUAUTITLAN IZCALLI,28,220,3,251,1839
MÉXICO,CUAUTITLAN IZCALLI,42,186,4,232,1839
MÉXICO,CUAUTITLAN IZCALLI,21,126,1,148,1059
MÉXICO,CUAUTITLAN IZCALLI,18,121,0,139,1058
MÉXICO,CUAUTITLAN IZCALLI,43,222,2,267,1500
MÉXICO,CUAUTITLAN IZCALLI,24,191,2,217,1464
MÉXICO,CUAUTITLAN IZCALLI,20,191,3,214,1464
MÉXICO,CUAUTITLAN IZCALLI,40,185,2,227,1463
MÉXICO,CUAUTITLAN IZCALLI,71,225,0,296,1737
MÉXICO,CUAUTITLAN IZCALLI,15,190,2,207,1993
MÉXICO,CUAUTITLAN IZCALLI,8,231,0,239,1992
MÉXICO,CUAUTITLAN IZCALLI,42,282,0,324,2062
MÉXICO,CUAUTITLAN IZCALLI,25,210,4,239,1936
MÉXICO,CUAUTITLAN IZCALLI,22,175,1,198,1945
MÉXICO,CUAUTITLAN IZCALLI,24,231,3,258,1944
MÉXICO,CUAUTITLAN IZCALLI,21,149,1,171,1188
MÉXICO,CUAUTITLAN IZCALLI,28,159,0,187,1187
MÉXICO,CUAUTITLAN IZCALLI,7,145,2,154,1321
MÉXICO,CUAUTITLAN IZCALLI,11,105,1,117,1321
MÉXICO,CUAUTITLAN IZCALLI,24,163,1,188,1529
MÉXICO,CUAUTITLAN IZCALLI,10,169,1,180,1080
MÉXICO,CUAUTITLAN IZCALLI,13,130,3,146,1080
MÉXICO,CUAUTITLAN IZCALLI,18,244,2,264,1942
MÉXICO,TULTITLAN DE MARIANO ESCOBEDO,25,213,1,239,1430
MÉXICO,TULTITLAN DE MARIANO ESCOBEDO,36,223,4,263,1429
MÉXICO,TULTITLAN DE MARIANO ESCOBEDO,32,269,6,307,1979
MÉXICO,TULTITLAN DE MARIANO ESCOBEDO,43,349,5,397,1978
MÉXICO,TULTITLAN DE MARIANO ESCOBEDO,45,287,3,335,1879
MÉXICO,TULTITLAN DE MARIANO ESCOBEDO,38,275,4,317,1878
MÉXICO,TULTITLAN DE MARIANO ESCOBEDO,22,270,5,297,1735
MÉXICO,TULTITLAN DE MARIANO ESCOBEDO,35,273,2,310,1734
MÉXICO,TULTITLAN DE MARIANO ESCOBEDO,17,152,3,172,1387
MÉXICO,TULTITLAN DE MARIANO ESCOBEDO,16,186,0,202,1387
MÉXICO,TULTITLAN DE MARIANO ESCOBEDO,15,236,5,256,1471
MÉXICO,TULTITLAN DE MARIANO ESCOBEDO,28,236,3,267,1471
MÉXICO,TULTITLAN DE MARIANO ESCOBEDO,26,219,1,246,1558
MÉXICO,TULTITLAN DE MARIANO ESCOBEDO,30,177,1,208,1558
MÉXICO,TULTITLAN DE MARIANO ESCOBEDO,40,320,1,361,1976
MÉXICO,TULTITLAN DE MARIANO ESCOBEDO,30,326,3,359,1975
MÉXICO,TULTITLAN DE MARIANO ESCOBEDO,24,285,4,313,1541
MÉXICO,TULTITLAN DE MARIANO ESCOBEDO,41,377,3,421,1967
MÉXICO,TULTITLAN DE MARIANO ESCOBEDO,26,383,8,417,1966
MÉXICO,TULTITLAN DE MARIANO ESCOBEDO,36,211,4,251,1333
MÉXICO,TULTITLAN DE MARIANO ESCOBEDO,31,199,3,233,1333
MÉXICO,TULTITLAN DE MARIANO ESCOBEDO,27,212,1,240,1333
MÉXICO,TULTITLAN DE MARIANO ESCOBEDO,23,257,6,286,1494
MÉXICO,TULTITLAN DE MARIANO ESCOBEDO,24,248,4,276,1493
MÉXICO,TULTITLAN DE MARIANO ESCOBEDO,15,214,1,230,1198
MÉXICO,TULTITLAN DE MARIANO ESCOBEDO,26,165,2,193,1197
MÉXICO,TULTITLAN DE MARIANO ESCOBEDO,41,300,9,350,1921
MÉXICO,TULTITLAN DE MARIANO ESCOBEDO,33,318,4,355,1920
MÉXICO,TULTITLAN DE MARIANO ESCOBEDO,15,194,1,210,1172
MÉXICO,TULTITLAN DE MARIANO ESCOBEDO,8,172,1,181,1172
MÉXICO,TULTITLAN DE MARIANO ESCOBEDO,26,334,8,368,1637
MÉXICO,TULTITLAN DE MARIANO ESCOBEDO,14,325,4,343,1637
MÉXICO,TULTITLAN DE MARIANO ESCOBEDO,30,290,2,322,1804
MÉXICO,TULTITLAN DE MARIANO ESCOBEDO,28,313,2,343,1804
MÉXICO,TULTITLAN DE MARIANO ESCOBEDO,17,330,7,354,1427
MÉXICO,TULTITLAN DE MARIANO ESCOBEDO,27,344,5,376,1426
MÉXICO,TULTITLAN DE MARIANO ESCOBEDO,22,228,6,256,1118
MÉXICO,TULTITLAN DE MARIANO ESCOBEDO,19,204,1,224,1118
MÉXICO,TULTITLAN DE MARIANO ESCOBEDO,18,247,3,268,1302
MÉXICO,TULTITLAN DE MARIANO ESCOBEDO,21,210,1,232,1302
MÉXICO,TULTITLAN DE MARIANO ESCOBEDO,36,368,3,407,1919
MÉXICO,TULTITLAN DE MARIANO ESCOBEDO,45,433,6,484,1930
MÉXICO,TULTITLAN DE MARIANO ESCOBEDO,30,346,6,382,1608
MÉXICO,TULTITLAN DE MARIANO ESCOBEDO,29,337,10,376,1856
MÉXICO,TULTITLAN DE MARIANO ESCOBEDO,20,323,6,349,1731
MÉXICO,TULTITLAN DE MARIANO ESCOBEDO,18,206,2,226,1319
MÉXICO,TULTITLAN DE MARIANO ESCOBEDO,9,226,1,236,1319
MÉXICO,TULTITLAN DE MARIANO ESCOBEDO,29,295,4,328,1799
MÉXICO,TULTITLAN DE MARIANO ESCOBEDO,26,290,5,321,1798
MÉXICO,TULTITLAN DE MARIANO ESCOBEDO,17,176,3,196,1116
MÉXICO,TULTITLAN DE MARIANO ESCOBEDO,26,196,2,224,1115
MÉXICO,TULTITLAN DE MARIANO ESCOBEDO,26,252,2,280,1916
MÉXICO,TULTITLAN DE MARIANO ESCOBEDO,22,255,4,281,1915
MÉXICO,TULTITLAN DE MARIANO ESCOBEDO,20,226,1,247,1915
MÉXICO,TULTITLAN DE MARIANO ESCOBEDO,25,309,2,336,1915
MÉXICO,TULTITLAN DE MARIANO ESCOBEDO,22,216,3,241,1269
MÉXICO,TULTITLAN DE MARIANO ESCOBEDO,21,242,6,269,1268
MÉXICO,TULTITLAN DE MARIANO ESCOBEDO,25,366,7,398,1702
MÉXICO,TULTITLAN DE MARIANO ESCOBEDO,31,366,6,403,1898
MÉXICO,TULTITLAN DE MARIANO ESCOBEDO,25,360,10,395,1897
MÉXICO,TULTITLAN DE MARIANO ESCOBEDO,13,232,6,251,1566
MÉXICO,TULTITLAN DE MARIANO ESCOBEDO,15,216,3,234,1566
MÉXICO,TULTITLAN DE MARIANO ESCOBEDO,25,251,4,280,1565
MÉXICO,TULTITLAN DE MARIANO ESCOBEDO,43,341,11,395,1606
MÉXICO,TULTITLAN DE MARIANO ESCOBEDO,53,415,9,477,1915
MÉXICO,TULTITLAN DE MARIANO ESCOBEDO,31,281,8,320,1779
MÉXICO,TULTITLAN DE MARIANO ESCOBEDO,36,272,0,308,1778
MÉXICO,TULTITLAN DE MARIANO ESCOBEDO,22,299,3,324,1648
MÉXICO,TULTITLAN DE MARIANO ESCOBEDO,16,252,5,273,1872
MÉXICO,TULTITLAN DE MARIANO ESCOBEDO,23,239,4,266,1871
MÉXICO,TULTITLAN DE MARIANO ESCOBEDO,20,247,6,273,1871
MÉXICO,TULTITLAN DE MARIANO ESCOBEDO,18,232,2,252,1871
MÉXICO,TULTITLAN DE MARIANO ESCOBEDO,15,222,7,244,1225
MÉXICO,TULTITLAN DE MARIANO ESCOBEDO,18,242,2,262,1225
MÉXICO,TULTITLAN DE MARIANO ESCOBEDO,18,209,0,227,1200
MÉXICO,TULTITLAN DE MARIANO ESCOBEDO,11,176,6,193,1199
MÉXICO,TULTITLAN DE MARIANO ESCOBEDO,29,273,3,305,1597
MÉXICO,TULTITLAN DE MARIANO ESCOBEDO,37,286,0,323,1597
MÉXICO,TULTITLAN DE MARIANO ESCOBEDO,20,262,2,284,1904
MÉXICO,TULTITLAN DE MARIANO ESCOBEDO,26,295,3,324,1903
MÉXICO,TULTITLAN DE MARIANO ESCOBEDO,20,196,6,222,1175
MÉXICO,TULTITLAN DE MARIANO ESCOBEDO,6,248,3,257,1174
MÉXICO,TULTITLAN DE MARIANO ESCOBEDO,11,263,3,277,1369
MÉXICO,TULTITLAN DE MARIANO ESCOBEDO,13,225,3,241,1368
MÉXICO,TULTITLAN DE MARIANO ESCOBEDO,14,263,3,280,1560
MÉXICO,TULTITLAN DE MARIANO ESCOBEDO,26,219,3,248,1560
MÉXICO,TULTITLAN DE MARIANO ESCOBEDO,21,187,7,215,1198
MÉXICO,TULTITLAN DE MARIANO ESCOBEDO,10,193,3,206,1197
MÉXICO,TULTITLAN DE MARIANO ESCOBEDO,17,244,2,263,1623
MÉXICO,TULTITLAN DE MARIANO ESCOBEDO,26,240,3,269,1623
MÉXICO,TULTITLAN DE MARIANO ESCOBEDO,17,277,5,299,1622
MÉXICO,TULTITLAN DE MARIANO ESCOBEDO,14,239,6,259,1622
MÉXICO,TULTITLAN DE MARIANO ESCOBEDO,10,293,7,310,1872
MÉXICO,TULTITLAN DE MARIANO ESCOBEDO,24,321,2,347,1872
MÉXICO,TULTITLAN DE MARIANO ESCOBEDO,32,275,1,308,1872
MÉXICO,TULTITLAN DE MARIANO ESCOBEDO,20,245,5,270,1819
MÉXICO,TULTITLAN DE MARIANO ESCOBEDO,19,249,4,272,1818
MÉXICO,TULTITLAN DE MARIANO ESCOBEDO,34,322,7,363,1921
MÉXICO,TULTITLAN DE MARIANO ESCOBEDO,43,339,7,389,1920
MÉXICO,TULTITLAN DE MARIANO ESCOBEDO,16,330,4,350,1645
MÉXICO,TULTITLAN DE MARIANO ESCOBEDO,17,232,2,251,1606
MÉXICO,TULTITLAN DE MARIANO ESCOBEDO,13,193,5,211,1606
MÉXICO,TULTITLAN DE MARIANO ESCOBEDO,9,214,1,224,1605
MÉXICO,TULTITLAN DE MARIANO ESCOBEDO,14,217,2,233,1605
MÉXICO,TULTITLAN DE MARIANO ESCOBEDO,8,202,2,212,1605
MÉXICO,TULTITLAN DE MARIANO ESCOBEDO,17,284,2,303,1722
MÉXICO,TULTITLAN DE MARIANO ESCOBEDO,19,280,7,306,1721
MÉXICO,TULTITLAN DE MARIANO ESCOBEDO,25,273,7,305,1949
MÉXICO,TULTITLAN DE MARIANO ESCOBEDO,15,317,13,345,1948
MÉXICO,TULTITLAN DE MARIANO ESCOBEDO,11,218,3,232,1109
MÉXICO,TULTITLAN DE MARIANO ESCOBEDO,10,220,6,236,1109
MÉXICO,TULTITLAN DE MARIANO ESCOBEDO,30,230,5,265,1257
MÉXICO,TULTITLAN DE MARIANO ESCOBEDO,35,193,2,230,1256
MÉXICO,TULTITLAN DE MARIANO ESCOBEDO,22,222,10,254,1620
MÉXICO,TULTITLAN DE MARIANO ESCOBEDO,17,235,9,261,1620
MÉXICO,TULTITLAN DE MARIANO ESCOBEDO,26,302,5,333,1687
MÉXICO,TULTITLAN DE MARIANO ESCOBEDO,30,274,8,312,1897
MÉXICO,TULTITLAN DE MARIANO ESCOBEDO,40,325,3,368,1896
MÉXICO,TULTITLAN DE MARIANO ESCOBEDO,36,184,2,222,1549
MÉXICO,TULTITLAN DE MARIANO ESCOBEDO,37,192,0,229,1549
MÉXICO,TULTITLAN DE MARIANO ESCOBEDO,35,210,0,245,1549
MÉXICO,TULTITLAN DE MARIANO ESCOBEDO,32,319,8,359,1765
MÉXICO,TULTITLAN DE MARIANO ESCOBEDO,43,350,6,399,1918
MÉXICO,TULTITLAN DE MARIANO ESCOBEDO,32,307,3,342,1592
MÉXICO,TULTITLAN DE MARIANO ESCOBEDO,31,266,6,303,1592
MÉXICO,TULTITLAN DE MARIANO ESCOBEDO,32,294,2,328,1739
MÉXICO,TULTITLAN DE MARIANO ESCOBEDO,38,277,3,318,1739
MÉXICO,TULTITLAN DE MARIANO ESCOBEDO,12,213,3,228,1490
MÉXICO,TULTITLAN DE MARIANO ESCOBEDO,12,186,8,206,1490
MÉXICO,TULTITLAN DE MARIANO ESCOBEDO,15,219,1,235,1489
MÉXICO,TULTITLAN DE MARIANO ESCOBEDO,34,255,3,292,1968
MÉXICO,TULTITLAN DE MARIANO ESCOBEDO,29,231,6,266,1968
MÉXICO,TULTITLAN DE MARIANO ESCOBEDO,27,239,2,268,1968
MÉXICO,TULTITLAN DE MARIANO ESCOBEDO,26,210,3,239,1968
MÉXICO,TULTITLAN DE MARIANO ESCOBEDO,38,224,3,265,1968
MÉXICO,TULTITLAN DE MARIANO ESCOBEDO,25,303,7,335,1955
MÉXICO,TULTITLAN DE MARIANO ESCOBEDO,16,343,4,363,1955
MÉXICO,TULTITLAN DE MARIANO ESCOBEDO,21,337,4,362,1891
MÉXICO,TULTITLAN DE MARIANO ESCOBEDO,21,274,2,297,1891
MÉXICO,TULTITLAN DE MARIANO ESCOBEDO,21,303,2,326,1891
MÉXICO,TULTITLAN DE MARIANO ESCOBEDO,31,268,2,301,1891
MÉXICO,TULTITLAN DE MARIANO ESCOBEDO,10,250,4,264,1891
MÉXICO,TULTITLAN DE MARIANO ESCOBEDO,26,264,4,294,1891
MÉXICO,TULTITLAN DE MARIANO ESCOBEDO,17,260,8,285,1890
MÉXICO,TULTITLAN DE MARIANO ESCOBEDO,17,270,5,292,1719
MÉXICO,TULTITLAN DE MARIANO ESCOBEDO,55,665,6,726,0
MÉXICO,TULTITLAN DE MARIANO ESCOBEDO,31,279,5,315,1883
MÉXICO,TULTITLAN DE MARIANO ESCOBEDO,54,244,5,303,1863
MÉXICO,TULTITLAN DE MARIANO ESCOBEDO,216,28,2,246,1598
MÉXICO,TULTITLAN DE MARIANO ESCOBEDO,30,243,3,276,1759
MÉXICO,TULTITLAN DE MARIANO ESCOBEDO,36,281,3,320,1774
MÉXICO,TULTITLAN DE MARIANO ESCOBEDO,54,293,2,349,1774
MÉXICO,TULTITLAN DE MARIANO ESCOBEDO,39,280,5,324,1829
MÉXICO,TULTITLAN DE MARIANO ESCOBEDO,41,257,2,300,1829
MÉXICO,TULTITLAN DE MARIANO ESCOBEDO,20,212,2,234,1444
MÉXICO,TULTITLAN DE MARIANO ESCOBEDO,21,248,2,271,1443
MÉXICO,SAN FELIPE DEL PROGRESO,34,175,16,225,2066
MÉXICO,SAN FELIPE DEL PROGRESO,10,118,8,136,1392
MÉXICO,SAN FELIPE DEL PROGRESO,13,152,3,168,1391
MÉXICO,SAN FELIPE DEL PROGRESO,25,186,1,212,1878
MÉXICO,SAN FELIPE DEL PROGRESO,22,248,3,273,1890
MÉXICO,SAN FELIPE DEL PROGRESO,0,335,14,349,1964
MÉXICO,SAN FELIPE DEL PROGRESO,10,165,8,183,1351
MÉXICO,SAN FELIPE DEL PROGRESO,6,232,3,241,1350
MÉXICO,SAN FELIPE DEL PROGRESO,7,126,8,141,1687
MÉXICO,SAN FELIPE DEL PROGRESO,10,164,8,182,1687
MÉXICO,SAN FELIPE DEL PROGRESO,9,129,3,141,1687
MÉXICO,SAN FELIPE DEL PROGRESO,32,263,33,328,1895
MÉXICO,SAN FELIPE DEL PROGRESO,31,300,22,353,1894
MÉXICO,SAN FELIPE DEL PROGRESO,14,212,2,228,1544
MÉXICO,SAN FELIPE DEL PROGRESO,14,226,5,245,1544
MÉXICO,SAN FELIPE DEL PROGRESO,7,163,2,172,1439
MÉXICO,SAN FELIPE DEL PROGRESO,19,184,4,207,1438
MÉXICO,SAN FELIPE DEL PROGRESO,15,176,6,197,1438
MÉXICO,SAN FELIPE DEL PROGRESO,30,461,6,497,0
MÉXICO,SAN FELIPE DEL PROGRESO,13,40,0,53,1414
MÉXICO,SAN FELIPE DEL PROGRESO,8,41,0,49,1414
MÉXICO,SAN FELIPE DEL PROGRESO,17,59,6,82,1785
MÉXICO,SAN FELIPE DEL PROGRESO,37,174,9,220,1759
MÉXICO,SAN FELIPE DEL PROGRESO,35,181,10,226,1758
MÉXICO,SAN FELIPE DEL PROGRESO,6,58,1,65,1085
MÉXICO,SAN FELIPE DEL PROGRESO,7,37,2,46,1085
MÉXICO,SAN FELIPE DEL PROGRESO,30,233,6,269,1946
MÉXICO,SAN FELIPE DEL PROGRESO,22,290,7,319,2012
MÉXICO,SAN FELIPE DEL PROGRESO,12,264,5,281,1855
MÉXICO,SAN FELIPE DEL PROGRESO,14,149,3,166,2065
MÉXICO,SAN FELIPE DEL PROGRESO,8,66,5,79,1805
MÉXICO,SAN FELIPE DEL PROGRESO,9,111,4,124,1805
MÉXICO,SAN FELIPE DEL PROGRESO,4,89,1,94,1804
MÉXICO,SAN FELIPE DEL PROGRESO,12,75,9,96,2017
MÉXICO,SAN FELIPE DEL PROGRESO,13,69,2,84,2016
MÉXICO,SAN FELIPE DEL PROGRESO,11,107,7,125,2016
MÉXICO,SAN FELIPE DEL PROGRESO,19,106,9,134,1658
MÉXICO,SAN FELIPE DEL PROGRESO,19,101,6,126,1657
MÉXICO,SAN FELIPE DEL PROGRESO,16,52,5,73,1186
MÉXICO,SAN FELIPE DEL PROGRESO,15,62,3,80,1186
MÉXICO,SAN FELIPE DEL PROGRESO,31,100,6,137,1538
MÉXICO,SAN FELIPE DEL PROGRESO,9,104,2,115,1538
MÉXICO,SAN FELIPE DEL PROGRESO,15,104,4,123,1537
MÉXICO,SAN FELIPE DEL PROGRESO,17,79,4,100,1888
MÉXICO,SAN FELIPE DEL PROGRESO,7,54,0,61,1130
MÉXICO,SAN FELIPE DEL PROGRESO,7,37,3,47,1130
MÉXICO,SAN FELIPE DEL PROGRESO,19,75,6,100,1080
MÉXICO,SAN FELIPE DEL PROGRESO,10,61,5,76,1079
MÉXICO,SAN FELIPE DEL PROGRESO,19,136,3,158,1090
MÉXICO,SAN FELIPE DEL PROGRESO,4,128,0,132,1089
MÉXICO,SAN FELIPE DEL PROGRESO,20,163,13,196,1719
MÉXICO,SAN FELIPE DEL PROGRESO,12,110,14,136,1808
MÉXICO,SAN FELIPE DEL PROGRESO,12,107,12,131,1807
MÉXICO,SAN FELIPE DEL PROGRESO,12,326,4,342,1665
MÉXICO,SAN FELIPE DEL PROGRESO,12,272,3,287,1665
MÉXICO,SAN FELIPE DEL PROGRESO,34,121,11,166,1629
MÉXICO,SAN FELIPE DEL PROGRESO,8,80,8,96,1114
MÉXICO,SAN FELIPE DEL PROGRESO,19,73,12,104,1114
MÉXICO,SAN FELIPE DEL PROGRESO,13,96,8,117,1374
MÉXICO,SAN FELIPE DEL PROGRESO,11,95,6,112,1373
MÉXICO,SAN FELIPE DEL PROGRESO,37,186,17,240,2068
MÉXICO,SAN FELIPE DEL PROGRESO,40,184,7,231,2067
MÉXICO,SAN FELIPE DEL PROGRESO,18,68,10,96,1211
MÉXICO,SAN FELIPE DEL PROGRESO,20,77,10,107,1210
MÉXICO,SAN FELIPE DEL PROGRESO,32,71,17,120,1132
MÉXICO,SAN FELIPE DEL PROGRESO,17,77,22,116,1132
MÉXICO,SAN FELIPE DEL PROGRESO,19,66,7,92,1571
MÉXICO,SAN FELIPE DEL PROGRESO,13,62,7,82,1571
MÉXICO,SAN FELIPE DEL PROGRESO,19,77,7,103,1571
MÉXICO,SAN FELIPE DEL PROGRESO,18,96,10,124,2052
MÉXICO,SAN FELIPE DEL PROGRESO,22,132,11,165,2052
MÉXICO,SAN FELIPE DEL PROGRESO,23,103,4,130,2051
MÉXICO,SAN FELIPE DEL PROGRESO,17,146,5,168,1859
MÉXICO,SAN FELIPE DEL PROGRESO,4,168,8,180,1788
MÉXICO,SAN FELIPE DEL PROGRESO,7,157,12,176,1787
MÉXICO,SAN FELIPE DEL PROGRESO,12,128,6,146,1932
MÉXICO,SAN FELIPE DEL PROGRESO,5,140,1,146,1931
MÉXICO,SAN FELIPE DEL PROGRESO,10,186,8,204,1646
MÉXICO,SAN FELIPE DEL PROGRESO,5,164,1,170,1645
MÉXICO,SAN FELIPE DEL PROGRESO,17,192,3,212,1645
MÉXICO,SAN FELIPE DEL PROGRESO,10,80,1,91,2064
MÉXICO,SAN FELIPE DEL PROGRESO,6,34,3,43,1484
MÉXICO,SAN FELIPE DEL PROGRESO,11,45,1,57,1483
MÉXICO,SAN FELIPE DEL PROGRESO,17,79,5,101,1379
MÉXICO,SAN FELIPE DEL PROGRESO,12,81,7,100,1379
MÉXICO,SAN FELIPE DEL PROGRESO,6,94,3,103,1378
MÉXICO,SAN FELIPE DEL PROGRESO,6,92,5,103,1424
MÉXICO,SAN FELIPE DEL PROGRESO,11,89,7,107,1424
MÉXICO,SAN FELIPE DEL PROGRESO,17,119,14,150,1366
MÉXICO,SAN FELIPE DEL PROGRESO,13,102,18,133,1366
MÉXICO,SAN FELIPE DEL PROGRESO,20,107,8,135,1365
MÉXICO,SAN FELIPE DEL PROGRESO,36,116,18,170,1729
MÉXICO,SAN FELIPE DEL PROGRESO,24,122,12,158,1728
MÉXICO,SAN FELIPE DEL PROGRESO,18,109,7,134,2052
MÉXICO,SAN FELIPE DEL PROGRESO,42,304,12,358,1390
MÉXICO,SAN FELIPE DEL PROGRESO,32,261,24,317,1389
MÉXICO,SAN FELIPE DEL PROGRESO,54,364,35,453,1993
MÉXICO,SAN FELIPE DEL PROGRESO,17,187,1,205,1989
MÉXICO,SAN FELIPE DEL PROGRESO,30,144,7,181,1615
MÉXICO,SAN FELIPE DEL PROGRESO,3,112,2,117,1709
MÉXICO,SAN FELIPE DEL PROGRESO,7,107,3,117,1709
MÉXICO,SAN FELIPE DEL PROGRESO,7,134,2,143,1708
MÉXICO,SAN FELIPE DEL PROGRESO,30,426,15,471,1946
MÉXICO,SAN FELIPE DEL PROGRESO,37,249,13,299,1946
MÉXICO,SAN FELIPE DEL PROGRESO,44,97,3,144,1741
MÉXICO,SAN FELIPE DEL PROGRESO,33,148,4,185,1781
MÉXICO,SAN FELIPE DEL PROGRESO,15,57,4,76,1370
MÉXICO,SAN FELIPE DEL PROGRESO,10,30,1,41,1370
MÉXICO,SAN FELIPE DEL PROGRESO,10,46,2,58,1369
MÉXICO,SAN FELIPE DEL PROGRESO,30,73,1,104,1212
MÉXICO,SAN FELIPE DEL PROGRESO,11,81,1,93,1212
MÉXICO,SAN FELIPE DEL PROGRESO,11,163,7,181,2084
MÉXICO,SAN FELIPE DEL PROGRESO,25,201,6,232,1818
MÉXICO,SAN FELIPE DEL PROGRESO,15,91,8,114,1456
MÉXICO,SAN FELIPE DEL PROGRESO,7,72,5,84,1456
MÉXICO,SAN FELIPE DEL PROGRESO,23,193,12,228,1876
MÉXICO,SAN FELIPE DEL PROGRESO,29,180,17,226,1876
MÉXICO,SAN FELIPE DEL PROGRESO,16,129,5,150,1701
MÉXICO,SAN FELIPE DEL PROGRESO,19,181,8,208,1701
MÉXICO,SAN FELIPE DEL PROGRESO,7,135,4,146,1713
MÉXICO,SAN FELIPE DEL PROGRESO,7,185,9,201,1712
MÉXICO,SAN FELIPE DEL PROGRESO,8,120,8,136,1712
MÉXICO,SAN FELIPE DEL PROGRESO,12,119,2,133,1611
MÉXICO,SAN FELIPE DEL PROGRESO,10,159,4,173,1767
MÉXICO,SAN FELIPE DEL PROGRESO,17,147,4,168,1766
MÉXICO,SAN FELIPE DEL PROGRESO,14,175,10,199,1842
MÉXICO,SAN FELIPE DEL PROGRESO,18,206,7,231,1842
MÉXICO,SAN FELIPE DEL PROGRESO,13,168,6,187,1842
MÉXICO,SAN FELIPE DEL PROGRESO,10,75,2,87,1289
MÉXICO,SAN FELIPE DEL PROGRESO,4,47,3,54,1289
MÉXICO,SAN FELIPE DEL PROGRESO,24,130,12,166,1591
MÉXICO,SAN FELIPE DEL PROGRESO,29,90,10,129,1591
MÉXICO,SAN FELIPE DEL PROGRESO,29,130,9,168,1590
MÉXICO,SAN FELIPE DEL PROGRESO,13,117,3,133,1716
MÉXICO,SAN FELIPE DEL PROGRESO,9,155,4,168,1983
MÉXICO,SAN FELIPE DEL PROGRESO,11,139,2,152,1982
MÉXICO,SAN FELIPE DEL PROGRESO,12,174,9,195,1309
MÉXICO,SAN FELIPE DEL PROGRESO,9,176,8,193,1308
MÉXICO,SAN FELIPE DEL PROGRESO,18,123,7,148,1539
MÉXICO,SAN FELIPE DEL PROGRESO,7,121,8,136,1539
MÉXICO,SAN FELIPE DEL PROGRESO,7,132,7,146,1538
MÉXICO,SAN FELIPE DEL PROGRESO,13,154,0,167,1549
MÉXICO,SAN FELIPE DEL PROGRESO,9,106,3,118,1548
MÉXICO,SAN FELIPE DEL PROGRESO,30,361,26,417,1911
MÉXICO,SAN FELIPE DEL PROGRESO,14,205,18,237,1925
MÉXICO,SAN FELIPE DEL PROGRESO,12,185,12,209,1924
MÉXICO,SAN FELIPE DEL PROGRESO,14,226,11,251,1924
MÉXICO,SAN FELIPE DEL PROGRESO,6,62,2,70,1123
MÉXICO,SAN FELIPE DEL PROGRESO,7,80,0,87,1122
MÉXICO,SAN FELIPE DEL PROGRESO,4,54,4,62,1095
MÉXICO,SAN FELIPE DEL PROGRESO,12,59,2,73,1095
MÉXICO,SAN FELIPE DEL PROGRESO,4,67,1,72,1909
MÉXICO,SAN FELIPE DEL PROGRESO,7,79,2,88,1909
MÉXICO,SAN FELIPE DEL PROGRESO,17,139,4,160,1333
MÉXICO,SAN FELIPE DEL PROGRESO,16,145,4,165,1333
MÉXICO,SAN FELIPE DEL PROGRESO,19,171,10,200,1919
MÉXICO,SAN FELIPE DEL PROGRESO,7,120,9,136,1661
MÉXICO,SAN FELIPE DEL PROGRESO,18,63,3,84,1539
MÉXICO,SAN FELIPE DEL PROGRESO,12,52,0,64,1233
MÉXICO,SAN FELIPE DEL PROGRESO,5,57,1,63,1233
MÉXICO,SAN FELIPE DEL PROGRESO,8,75,2,85,1449
MÉXICO,SAN FELIPE DEL PROGRESO,7,54,2,63,1449
MÉXICO,SAN FELIPE DEL PROGRESO,23,39,4,66,1831
MÉXICO,SAN FELIPE DEL PROGRESO,9,75,1,85,1508
MÉXICO,SAN FELIPE DEL PROGRESO,6,61,4,71,1507
MÉXICO,SAN FELIPE DEL PROGRESO,15,163,1,179,1776
MÉXICO,SAN FELIPE DEL PROGRESO,24,259,9,292,1923
MÉXICO,SAN FELIPE DEL PROGRESO,21,109,8,138,2059
MÉXICO,SAN FELIPE DEL PROGRESO,23,110,5,138,1558
MÉXICO,SAN FELIPE DEL PROGRESO,11,168,6,185,1510
MÉXICO,SAN FELIPE DEL PROGRESO,17,113,7,137,1510
MÉXICO,SAN FELIPE DEL PROGRESO,20,164,3,187,1997
MÉXICO,SAN FELIPE DEL PROGRESO,18,172,3,193,1997
MÉXICO,SAN FELIPE DEL PROGRESO,17,223,2,242,1996
MÉXICO,SAN FELIPE DEL PROGRESO,15,346,10,371,1426
MÉXICO,SAN FELIPE DEL PROGRESO,9,291,5,305,1426
MÉXICO,SAN FELIPE DEL PROGRESO,38,160,7,205,1758
MÉXICO,SAN FELIPE DEL PROGRESO,10,160,6,176,1629
MÉXICO,SAN FELIPE DEL PROGRESO,12,163,4,179,1629
MÉXICO,SAN FELIPE DEL PROGRESO,22,76,4,102,1212
MÉXICO,SAN FELIPE DEL PROGRESO,20,80,6,106,1211
MÉXICO,SAN FELIPE DEL PROGRESO,13,86,4,103,1590
MÉXICO,SAN FELIPE DEL PROGRESO,12,66,3,81,1589
MÉXICO,SAN FELIPE DEL PROGRESO,9,59,1,69,1589
MÉXICO,ECATEPEC DE MORELOS,26,194,3,223,1323
MÉXICO,ECATEPEC DE MORELOS,13,208,4,225,1323
MÉXICO,ECATEPEC DE MORELOS,24,191,7,222,1344
MÉXICO,ECATEPEC DE MORELOS,15,207,7,229,1344
MÉXICO,ECATEPEC DE MORELOS,27,376,8,411,2034
MÉXICO,ECATEPEC DE MORELOS,22,357,5,384,2033
MÉXICO,ECATEPEC DE MORELOS,23,236,2,261,1526
MÉXICO,ECATEPEC DE MORELOS,22,227,7,256,1525
MÉXICO,ECATEPEC DE MORELOS,17,215,4,236,1450
MÉXICO,ECATEPEC DE MORELOS,19,247,5,271,1450
MÉXICO,ECATEPEC DE MORELOS,32,303,8,343,1788
MÉXICO,ECATEPEC DE MORELOS,28,318,4,350,1787
MÉXICO,ECATEPEC DE MORELOS,26,238,2,266,1614
MÉXICO,ECATEPEC DE MORELOS,12,332,6,350,1658
MÉXICO,ECATEPEC DE MORELOS,16,322,3,341,1572
MÉXICO,ECATEPEC DE MORELOS,21,319,14,354,2028
MÉXICO,ECATEPEC DE MORELOS,30,325,4,359,2028
MÉXICO,ECATEPEC DE MORELOS,37,294,4,335,1872
MÉXICO,ECATEPEC DE MORELOS,18,181,6,205,1631
MÉXICO,ECATEPEC DE MORELOS,15,170,2,187,1630
MÉXICO,ECATEPEC DE MORELOS,15,187,4,206,1630
MÉXICO,ECATEPEC DE MORELOS,26,216,5,247,1899
MÉXICO,ECATEPEC DE MORELOS,22,241,11,274,1898
MÉXICO,ECATEPEC DE MORELOS,8,194,5,207,1397
MÉXICO,ECATEPEC DE MORELOS,7,205,3,215,1396
MÉXICO,ECATEPEC DE MORELOS,31,224,6,261,1939
MÉXICO,ECATEPEC DE MORELOS,18,210,6,234,1938
MÉXICO,ECATEPEC DE MORELOS,16,203,7,226,1102
MÉXICO,ECATEPEC DE MORELOS,13,172,8,193,1101
MÉXICO,ECATEPEC DE MORELOS,24,301,6,331,2016
MÉXICO,ECATEPEC DE MORELOS,29,212,2,243,1186
MÉXICO,ECATEPEC DE MORELOS,17,195,4,216,1186
MÉXICO,ECATEPEC DE MORELOS,20,375,4,399,1803
MÉXICO,ECATEPEC DE MORELOS,23,165,2,190,1133
MÉXICO,ECATEPEC DE MORELOS,14,160,3,177,1132
MÉXICO,ECATEPEC DE MORELOS,10,187,4,201,1937
MÉXICO,ECATEPEC DE MORELOS,12,186,5,203,1937
MÉXICO,ECATEPEC DE MORELOS,15,184,3,202,1328
MÉXICO,ECATEPEC DE MORELOS,15,200,4,219,1328
MÉXICO,ECATEPEC DE MORELOS,19,153,3,175,1238
MÉXICO,ECATEPEC DE MORELOS,15,193,2,210,1238
MÉXICO,ECATEPEC DE MORELOS,20,177,0,197,1239
MÉXICO,ECATEPEC DE MORELOS,26,154,3,183,1238
MÉXICO,ECATEPEC DE MORELOS,22,182,1,205,1575
MÉXICO,ECATEPEC DE MORELOS,17,191,4,212,1575
MÉXICO,ECATEPEC DE MORELOS,24,197,5,226,1574
MÉXICO,ECATEPEC DE MORELOS,13,185,0,198,1303
MÉXICO,ECATEPEC DE MORELOS,9,166,1,176,1303
MÉXICO,ECATEPEC DE MORELOS,21,231,1,253,2083
MÉXICO,ECATEPEC DE MORELOS,29,246,3,278,2082
MÉXICO,ECATEPEC DE MORELOS,29,250,3,282,2082
MÉXICO,ECATEPEC DE MORELOS,20,239,1,260,2082
MÉXICO,ECATEPEC DE MORELOS,32,226,3,261,2082
MÉXICO,ECATEPEC DE MORELOS,22,210,2,234,2082
MÉXICO,ECATEPEC DE MORELOS,20,233,5,258,2082
MÉXICO,ECATEPEC DE MORELOS,26,264,7,297,1862
MÉXICO,ECATEPEC DE MORELOS,31,245,8,284,1861
MÉXICO,ECATEPEC DE MORELOS,19,228,0,247,1821
MÉXICO,ECATEPEC DE MORELOS,14,194,2,210,1392
MÉXICO,ECATEPEC DE MORELOS,21,217,3,241,1391
MÉXICO,ECATEPEC DE MORELOS,22,191,5,218,1391
MÉXICO,ECATEPEC DE MORELOS,28,248,6,282,2031
MÉXICO,ECATEPEC DE MORELOS,13,277,2,292,2030
MÉXICO,ECATEPEC DE MORELOS,35,245,9,289,2030
MÉXICO,ECATEPEC DE MORELOS,14,159,3,176,1321
MÉXICO,ECATEPEC DE MORELOS,18,173,2,193,1320
MÉXICO,ECATEPEC DE MORELOS,24,215,2,241,1543
MÉXICO,ECATEPEC DE MORELOS,18,173,3,194,1543
MÉXICO,ECATEPEC DE MORELOS,20,172,1,193,1542
MÉXICO,ECATEPEC DE MORELOS,33,315,6,354,1919
MÉXICO,ECATEPEC DE MORELOS,44,325,5,374,1918
MÉXICO,ECATEPEC DE MORELOS,27,212,2,241,1596
MÉXICO,ECATEPEC DE MORELOS,18,246,6,270,1595
MÉXICO,ECATEPEC DE MORELOS,26,247,6,279,1593
MÉXICO,ECATEPEC DE MORELOS,31,273,4,308,1592
MÉXICO,ECATEPEC DE MORELOS,42,255,6,303,1592
MÉXICO,ECATEPEC DE MORELOS,26,239,4,269,1337
MÉXICO,ECATEPEC DE MORELOS,26,232,7,265,1337
MÉXICO,ECATEPEC DE MORELOS,31,309,2,342,1455
MÉXICO,ECATEPEC DE MORELOS,29,293,4,326,1455
MÉXICO,ECATEPEC DE MORELOS,34,287,3,324,1674
MÉXICO,ECATEPEC DE MORELOS,22,276,33,331,1673
MÉXICO,ECATEPEC DE MORELOS,29,229,3,261,1341
MÉXICO,ECATEPEC DE MORELOS,29,255,3,287,1341
MÉXICO,ECATEPEC DE MORELOS,28,330,1,359,1567
MÉXICO,ECATEPEC DE MORELOS,36,271,2,309,1566
MÉXICO,ECATEPEC DE MORELOS,28,247,9,284,1534
MÉXICO,ECATEPEC DE MORELOS,20,204,6,230,1534
MÉXICO,ECATEPEC DE MORELOS,47,362,0,409,2027
MÉXICO,ECATEPEC DE MORELOS,26,319,6,351,1782
MÉXICO,ECATEPEC DE MORELOS,25,318,11,354,1782
MÉXICO,ECATEPEC DE MORELOS,23,293,4,320,1782
MÉXICO,ECATEPEC DE MORELOS,28,240,4,272,1482
MÉXICO,ECATEPEC DE MORELOS,32,242,5,279,1481
MÉXICO,ECATEPEC DE MORELOS,32,310,3,345,1781
MÉXICO,ECATEPEC DE MORELOS,26,334,7,367,1781
MÉXICO,ECATEPEC DE MORELOS,65,782,19,866,0
MÉXICO,ECATEPEC DE MORELOS,41,352,1,394,1775
MÉXICO,ECATEPEC DE MORELOS,23,272,2,297,1418
MÉXICO,ECATEPEC DE MORELOS,27,267,3,297,1417
MÉXICO,ECATEPEC DE MORELOS,14,281,3,298,1417
MÉXICO,ECATEPEC DE MORELOS,28,342,4,374,1757
MÉXICO,ECATEPEC DE MORELOS,27,317,5,349,1757
MÉXICO,ECATEPEC DE MORELOS,21,296,6,323,1757
MÉXICO,ECATEPEC DE MORELOS,19,240,1,260,1277
MÉXICO,ECATEPEC DE MORELOS,16,242,5,263,1276
MÉXICO,ECATEPEC DE MORELOS,43,397,6,446,1896
MÉXICO,ECATEPEC DE MORELOS,30,325,4,359,1856
MÉXICO,ECATEPEC DE MORELOS,31,308,4,343,1855
MÉXICO,ECATEPEC DE MORELOS,26,422,4,452,1836
MÉXICO,ECATEPEC DE MORELOS,34,245,7,286,1594
MÉXICO,ECATEPEC DE MORELOS,33,255,5,293,1593
MÉXICO,ECATEPEC DE MORELOS,29,248,3,280,1690
MÉXICO,ECATEPEC DE MORELOS,35,238,3,276,1690
MÉXICO,ECATEPEC DE MORELOS,39,223,4,266,1688
MÉXICO,ECATEPEC DE MORELOS,32,261,3,296,1687
MÉXICO,ECATEPEC DE MORELOS,34,261,8,303,1459
MÉXICO,ECATEPEC DE MORELOS,33,258,1,292,1458
MÉXICO,ECATEPEC DE MORELOS,34,269,3,306,1509
MÉXICO,ECATEPEC DE MORELOS,54,447,6,507,1954
MÉXICO,ECATEPEC DE MORELOS,31,170,2,203,1248
MÉXICO,ECATEPEC DE MORELOS,29,179,2,210,1247
MÉXICO,ECATEPEC DE MORELOS,21,213,3,237,1088
MÉXICO,ECATEPEC DE MORELOS,18,213,3,234,1088
MÉXICO,ECATEPEC DE MORELOS,46,318,2,366,1575
MÉXICO,ECATEPEC DE MORELOS,23,254,2,279,1234
MÉXICO,ECATEPEC DE MORELOS,32,246,1,279,1233
MÉXICO,ECATEPEC DE MORELOS,31,313,7,351,1888
MÉXICO,ECATEPEC DE MORELOS,17,273,5,295,1887
MÉXICO,ECATEPEC DE MORELOS,24,311,4,339,1887
MÉXICO,ECATEPEC DE MORELOS,13,220,7,240,1515
MÉXICO,ECATEPEC DE MORELOS,17,221,5,243,1514
MÉXICO,ECATEPEC DE MORELOS,24,253,3,280,1514
MÉXICO,ECATEPEC DE MORELOS,30,233,4,267,1050
MÉXICO,ECATEPEC DE MORELOS,30,227,3,260,1049
MÉXICO,ECATEPEC DE MORELOS,26,226,6,258,1569
MÉXICO,ECATEPEC DE MORELOS,31,215,1,247,1569
MÉXICO,ECATEPEC DE MORELOS,42,271,4,317,1905
MÉXICO,ECATEPEC DE MORELOS,28,274,2,304,1904
MÉXICO,ECATEPEC DE MORELOS,19,160,0,179,1131
MÉXICO,ECATEPEC DE MORELOS,9,143,1,153,1131
MÉXICO,ECATEPEC DE MORELOS,25,155,4,184,1708
MÉXICO,ECATEPEC DE MORELOS,19,147,5,171,1707
MÉXICO,ECATEPEC DE MORELOS,19,276,7,302,1581
MÉXICO,ECATEPEC DE MORELOS,23,177,2,202,1250
MÉXICO,ECATEPEC DE MORELOS,29,192,1,222,1250
MÉXICO,ECATEPEC DE MORELOS,32,286,4,322,2032
MÉXICO,ECATEPEC DE MORELOS,21,260,0,281,1899
MÉXICO,ECATEPEC DE MORELOS,26,256,3,285,1899
MÉXICO,ECATEPEC DE MORELOS,19,232,1,252,1682
MÉXICO,ECATEPEC DE MORELOS,30,235,5,270,1681
MÉXICO,ECATEPEC DE MORELOS,35,347,3,385,1972
MÉXICO,ECATEPEC DE MORELOS,35,345,8,388,1972
MÉXICO,ECATEPEC DE MORELOS,34,218,2,254,1856
MÉXICO,ECATEPEC DE MORELOS,34,178,3,215,1553
MÉXICO,ECATEPEC DE MORELOS,31,237,1,269,1770
MÉXICO,ECATEPEC DE MORELOS,24,186,3,213,1769
MÉXICO,ECATEPEC DE MORELOS,32,141,1,174,1269
MÉXICO,ECATEPEC DE MORELOS,22,132,0,154,1268
MÉXICO,ECATEPEC DE MORELOS,25,218,2,245,1717
MÉXICO,ECATEPEC DE MORELOS,32,225,2,259,1716
MÉXICO,ECATEPEC DE MORELOS,39,210,0,249,1805
MÉXICO,ECATEPEC DE MORELOS,26,196,2,224,1385
MÉXICO,ECATEPEC DE MORELOS,18,220,0,238,1384
MÉXICO,ECATEPEC DE MORELOS,26,183,2,211,1619
MÉXICO,ECATEPEC DE MORELOS,38,173,3,214,1618
MÉXICO,ECATEPEC DE MORELOS,27,223,5,255,1247
MÉXICO,ECATEPEC DE MORELOS,34,204,0,238,1247
MÉXICO,ECATEPEC DE MORELOS,89,1018,14,1121,0
MÉXICO,ECATEPEC DE MORELOS,19,196,4,219,1466
MÉXICO,ECATEPEC DE MORELOS,26,188,0,214,1466
MÉXICO,ECATEPEC DE MORELOS,16,207,2,225,1466
MÉXICO,ECATEPEC DE MORELOS,26,232,4,262,1778
MÉXICO,ECATEPEC DE MORELOS,24,277,3,304,1778
MÉXICO,ECATEPEC DE MORELOS,34,292,3,329,1875
MÉXICO,ECATEPEC DE MORELOS,40,298,4,342,1874
MÉXICO,ECATEPEC DE MORELOS,19,149,1,169,1048
MÉXICO,ECATEPEC DE MORELOS,18,139,1,158,1047
MÉXICO,ECATEPEC DE MORELOS,33,264,3,300,1533
MÉXICO,ECATEPEC DE MORELOS,25,294,6,325,1666
MÉXICO,ECATEPEC DE MORELOS,27,193,4,224,1650
MÉXICO,ECATEPEC DE MORELOS,21,220,3,244,1650
MÉXICO,ECATEPEC DE MORELOS,23,237,1,261,1855
MÉXICO,ECATEPEC DE MORELOS,18,250,4,272,1854
MÉXICO,ECATEPEC DE MORELOS,9,232,4,245,1890
MÉXICO,ECATEPEC DE MORELOS,25,233,5,263,1889
MÉXICO,ECATEPEC DE MORELOS,26,361,6,393,1939
MÉXICO,ECATEPEC DE MORELOS,17,177,2,196,1143
MÉXICO,ECATEPEC DE MORELOS,10,162,2,174,1142
MÉXICO,ECATEPEC DE MORELOS,20,258,1,279,1902
MÉXICO,ECATEPEC DE MORELOS,29,266,2,297,1901
MÉXICO,ECATEPEC DE MORELOS,26,276,2,304,1901
MÉXICO,ECATEPEC DE MORELOS,24,223,6,253,1901
MÉXICO,ECATEPEC DE MORELOS,15,246,2,263,1901
MÉXICO,ECATEPEC DE MORELOS,17,230,6,253,1901
MÉXICO,ECATEPEC DE MORELOS,32,314,0,346,1892
MÉXICO,ECATEPEC DE MORELOS,32,355,4,391,2022
MÉXICO,ECATEPEC DE MORELOS,33,224,4,261,1546
MÉXICO,ECATEPEC DE MORELOS,22,220,7,249,1546
MÉXICO,ECATEPEC DE MORELOS,16,190,4,210,1688
MÉXICO,ECATEPEC DE MORELOS,24,219,4,247,1687
MÉXICO,ECATEPEC DE MORELOS,17,222,6,245,1394
MÉXICO,ECATEPEC DE MORELOS,20,197,6,223,1394
MÉXICO,ECATEPEC DE MORELOS,35,189,2,226,1122
MÉXICO,ECATEPEC DE MORELOS,21,154,4,179,1121
MÉXICO,ECATEPEC DE MORELOS,35,263,3,301,1753
MÉXICO,ECATEPEC DE MORELOS,28,247,5,280,1752
MÉXICO,ECATEPEC DE MORELOS,35,247,2,284,2059
MÉXICO,ECATEPEC DE MORELOS,24,198,2,224,1582
MÉXICO,ECATEPEC DE MORELOS,33,216,2,251,1581
MÉXICO,ECATEPEC DE MORELOS,28,255,6,289,1917
MÉXICO,ECATEPEC DE MORELOS,32,281,4,317,1917
MÉXICO,ECATEPEC DE MORELOS,27,307,7,341,1964
MÉXICO,ECATEPEC DE MORELOS,25,290,9,324,1931
MÉXICO,ECATEPEC DE MORELOS,36,291,9,336,2045
MÉXICO,ECATEPEC DE MORELOS,17,220,3,240,1605
MÉXICO,ECATEPEC DE MORELOS,21,232,6,259,1604
MÉXICO,ECATEPEC DE MORELOS,21,150,2,173,1086
MÉXICO,ECATEPEC DE MORELOS,8,121,151,280,1086
MÉXICO,ECATEPEC DE MORELOS,39,295,1,335,1787
MÉXICO,ECATEPEC DE MORELOS,21,271,6,298,1786
MÉXICO,ECATEPEC DE MORELOS,33,226,3,262,1608
MÉXICO,ECATEPEC DE MORELOS,35,230,4,269,1608
MÉXICO,ECATEPEC DE MORELOS,30,279,2,311,1608
MÉXICO,ECATEPEC DE MORELOS,25,191,3,219,1302
MÉXICO,ECATEPEC DE MORELOS,14,192,2,208,1301
MÉXICO,ECATEPEC DE MORELOS,29,274,1,304,1596
MÉXICO,ECATEPEC DE MORELOS,35,265,2,302,1595
MÉXICO,ECATEPEC DE MORELOS,23,195,7,225,1287
MÉXICO,ECATEPEC DE MORELOS,15,189,5,209,1287
MÉXICO,ECATEPEC DE MORELOS,45,312,5,362,2004
MÉXICO,ECATEPEC DE MORELOS,24,247,6,277,1675
MÉXICO,ECATEPEC DE MORELOS,31,245,1,277,1675
MÉXICO,ECATEPEC DE MORELOS,27,300,6,333,1988
MÉXICO,ECATEPEC DE MORELOS,31,197,6,234,1731
MÉXICO,ECATEPEC DE MORELOS,26,176,3,205,1533
MÉXICO,ECATEPEC DE MORELOS,17,168,12,197,1533
MÉXICO,ECATEPEC DE MORELOS,29,246,1,276,1650
MÉXICO,ECATEPEC DE MORELOS,10,205,6,221,1650
MÉXICO,ECATEPEC DE MORELOS,14,174,2,190,1130
MÉXICO,ECATEPEC DE MORELOS,13,191,2,206,1129
MÉXICO,ECATEPEC DE MORELOS,10,143,2,155,1588
MÉXICO,ECATEPEC DE MORELOS,11,167,9,187,1588
MÉXICO,ECATEPEC DE MORELOS,12,143,4,159,1588
MÉXICO,ECATEPEC DE MORELOS,16,176,3,195,1382
MÉXICO,ECATEPEC DE MORELOS,9,165,11,185,1381
MÉXICO,ECATEPEC DE MORELOS,17,217,9,243,1510
MÉXICO,ECATEPEC DE MORELOS,21,231,6,258,1509
MÉXICO,ECATEPEC DE MORELOS,19,260,12,291,1976
MÉXICO,ECATEPEC DE MORELOS,21,252,4,277,1976
MÉXICO,ECATEPEC DE MORELOS,26,250,4,280,1821
MÉXICO,ECATEPEC DE MORELOS,31,237,6,274,1821
MÉXICO,ECATEPEC DE MORELOS,22,219,6,247,1820
MÉXICO,ECATEPEC DE MORELOS,28,249,7,284,1820
MÉXICO,ECATEPEC DE MORELOS,25,232,2,259,1967
MÉXICO,ECATEPEC DE MORELOS,27,232,6,265,1966
MÉXICO,ECATEPEC DE MORELOS,23,224,5,252,1966
MÉXICO,ECATEPEC DE MORELOS,31,221,2,254,1483
MÉXICO,ECATEPEC DE MORELOS,38,258,6,302,1482
MÉXICO,ECATEPEC DE MORELOS,14,220,3,237,1530
MÉXICO,ECATEPEC DE MORELOS,15,227,2,244,1529
MÉXICO,ECATEPEC DE MORELOS,42,337,7,386,1899
MÉXICO,ECATEPEC DE MORELOS,39,311,12,362,1898
MÉXICO,ECATEPEC DE MORELOS,26,255,2,283,1736
MÉXICO,ECATEPEC DE MORELOS,25,254,3,282,1736
MÉXICO,ECATEPEC DE MORELOS,28,249,1,278,1735
MÉXICO,ECATEPEC DE MORELOS,14,252,14,280,2042
MÉXICO,ECATEPEC DE MORELOS,19,252,8,279,2042
MÉXICO,ECATEPEC DE MORELOS,13,234,7,254,1446
MÉXICO,ECATEPEC DE MORELOS,9,237,2,248,1445
MÉXICO,ECATEPEC DE MORELOS,11,256,2,269,1591
MÉXICO,ECATEPEC DE MORELOS,22,228,4,254,1591
MÉXICO,ECATEPEC DE MORELOS,33,277,4,314,1590
MÉXICO,ECATEPEC DE MORELOS,15,248,1,264,1842
MÉXICO,ECATEPEC DE MORELOS,17,307,6,330,1841
MÉXICO,ECATEPEC DE MORELOS,29,246,7,282,1613
MÉXICO,ECATEPEC DE MORELOS,20,258,3,281,1613
MÉXICO,ECATEPEC DE MORELOS,16,287,5,308,1612
MÉXICO,ECATEPEC DE MORELOS,13,251,3,267,1536
MÉXICO,ECATEPEC DE MORELOS,16,226,4,246,1535
MÉXICO,ECATEPEC DE MORELOS,8,164,0,172,1063
MÉXICO,ECATEPEC DE MORELOS,10,146,4,160,1063
MÉXICO,ECATEPEC DE MORELOS,14,228,3,245,1388
MÉXICO,ECATEPEC DE MORELOS,19,201,8,228,1388
MÉXICO,ECATEPEC DE MORELOS,28,317,5,350,1827
MÉXICO,ECATEPEC DE MORELOS,23,313,6,342,1827
MÉXICO,ECATEPEC DE MORELOS,26,238,2,266,1944
MÉXICO,ECATEPEC DE MORELOS,36,231,5,272,1943
MÉXICO,ECATEPEC DE MORELOS,18,223,1,242,1943
MÉXICO,ECATEPEC DE MORELOS,19,260,3,282,1943
MÉXICO,ECATEPEC DE MORELOS,22,257,7,286,1943
MÉXICO,ECATEPEC DE MORELOS,11,193,4,208,1594
MÉXICO,ECATEPEC DE MORELOS,9,175,0,184,1594
MÉXICO,ECATEPEC DE MORELOS,15,216,3,234,1593
MÉXICO,ECATEPEC DE MORELOS,13,158,8,179,1593
MÉXICO,ECATEPEC DE MORELOS,19,181,3,203,1466
MÉXICO,ECATEPEC DE MORELOS,19,167,4,190,1466
MÉXICO,ECATEPEC DE MORELOS,14,182,1,197,1466
MÉXICO,ECATEPEC DE MORELOS,20,188,1,209,1339
MÉXICO,ECATEPEC DE MORELOS,16,159,0,175,1339
MÉXICO,ECATEPEC DE MORELOS,17,204,5,226,1832
MÉXICO,ECATEPEC DE MORELOS,21,196,4,221,1832
MÉXICO,ECATEPEC DE MORELOS,40,318,5,363,1941
MÉXICO,ECATEPEC DE MORELOS,30,325,5,360,1940
MÉXICO,ECATEPEC DE MORELOS,30,232,1,263,1351
MÉXICO,ECATEPEC DE MORELOS,33,235,4,272,1351
MÉXICO,ECATEPEC DE MORELOS,31,287,5,323,1781
MÉXICO,ECATEPEC DE MORELOS,22,284,1,307,1781
MÉXICO,ECATEPEC DE MORELOS,68,451,4,523,2042
MÉXICO,ECATEPEC DE MORELOS,41,372,4,417,1883
MÉXICO,ECATEPEC DE MORELOS,49,344,2,395,1882
MÉXICO,ECATEPEC DE MORELOS,19,124,1,144,1116
MÉXICO,ECATEPEC DE MORELOS,12,148,1,161,1115
MÉXICO,ECATEPEC DE MORELOS,39,209,3,251,1727
MÉXICO,ECATEPEC DE MORELOS,41,214,3,258,1727
MÉXICO,ECATEPEC DE MORELOS,44,255,4,303,1585
MÉXICO,ECATEPEC DE MORELOS,38,277,4,319,1585
MÉXICO,ECATEPEC DE MORELOS,33,241,1,275,1584
MÉXICO,ECATEPEC DE MORELOS,13,223,5,241,1335
MÉXICO,ECATEPEC DE MORELOS,11,220,5,236,1334
MÉXICO,ECATEPEC DE MORELOS,24,183,6,213,1427
MÉXICO,ECATEPEC DE MORELOS,33,197,2,232,1426
MÉXICO,ECATEPEC DE MORELOS,27,184,3,214,1107
MÉXICO,ECATEPEC DE MORELOS,34,170,1,205,1107
MÉXICO,ECATEPEC DE MORELOS,25,271,4,300,1929
MÉXICO,ECATEPEC DE MORELOS,38,307,6,351,1867
MÉXICO,ECATEPEC DE MORELOS,25,255,7,287,1867
MÉXICO,ECATEPEC DE MORELOS,35,205,0,240,1501
MÉXICO,ECATEPEC DE MORELOS,33,185,0,218,1460
MÉXICO,ECATEPEC DE MORELOS,22,221,6,249,1460
MÉXICO,ECATEPEC DE MORELOS,35,253,2,290,1681
MÉXICO,ECATEPEC DE MORELOS,52,241,4,297,1680
MÉXICO,ECATEPEC DE MORELOS,29,276,3,308,1680
MÉXICO,ECATEPEC DE MORELOS,40,241,6,287,1365
MÉXICO,ECATEPEC DE MORELOS,33,256,1,290,1365
MÉXICO,ECATEPEC DE MORELOS,30,265,3,298,1364
MÉXICO,ECATEPEC DE MORELOS,43,203,1,247,1441
MÉXICO,ECATEPEC DE MORELOS,29,185,0,214,1441
MÉXICO,ECATEPEC DE MORELOS,32,177,5,214,1418
MÉXICO,ECATEPEC DE MORELOS,28,205,2,235,1417
MÉXICO,IXTAPALUCA,18,213,1,232,1874
MÉXICO,IXTAPALUCA,14,199,4,217,1874
MÉXICO,IXTAPALUCA,10,205,2,217,1873
MÉXICO,IXTAPALUCA,13,227,6,246,1873
MÉXICO,IXTAPALUCA,20,207,1,228,1873
MÉXICO,IXTAPALUCA,25,216,3,244,1873
MÉXICO,IXTAPALUCA,25,273,2,300,1825
MÉXICO,IXTAPALUCA,15,262,4,281,1824
MÉXICO,IXTAPALUCA,19,211,1,231,1006
MÉXICO,IXTAPALUCA,11,229,3,243,1006
MÉXICO,IXTAPALUCA,15,183,1,199,1482
MÉXICO,IXTAPALUCA,15,195,3,213,1482
MÉXICO,IXTAPALUCA,39,277,1,317,1672
MÉXICO,IXTAPALUCA,15,265,2,282,1672
MÉXICO,IXTAPALUCA,11,213,3,227,1672
MÉXICO,IXTAPALUCA,17,218,3,238,1514
MÉXICO,IXTAPALUCA,9,200,4,213,1514
MÉXICO,IXTAPALUCA,18,204,2,224,1514
MÉXICO,IXTAPALUCA,7,274,1,282,1889
MÉXICO,IXTAPALUCA,17,241,9,267,1889
MÉXICO,IXTAPALUCA,13,184,3,200,1197
MÉXICO,IXTAPALUCA,13,224,2,239,1197
MÉXICO,IXTAPALUCA,18,170,4,192,1922
MÉXICO,IXTAPALUCA,12,188,3,203,1922
MÉXICO,IXTAPALUCA,21,195,1,217,1922
MÉXICO,IXTAPALUCA,13,159,4,176,1922
MÉXICO,IXTAPALUCA,16,192,4,212,1921
MÉXICO,IXTAPALUCA,22,202,2,226,1921
MÉXICO,IXTAPALUCA,20,201,2,223,1921
MÉXICO,IXTAPALUCA,11,169,1,181,1764
MÉXICO,IXTAPALUCA,11,194,4,209,1764
MÉXICO,IXTAPALUCA,11,156,1,168,1764
MÉXICO,IXTAPALUCA,8,200,5,213,1764
MÉXICO,IXTAPALUCA,14,163,2,179,1763
MÉXICO,IXTAPALUCA,23,174,8,205,1227
MÉXICO,IXTAPALUCA,9,172,2,183,1227
MÉXICO,IXTAPALUCA,21,197,2,220,1354
MÉXICO,IXTAPALUCA,27,182,1,210,1353
MÉXICO,IXTAPALUCA,23,180,3,206,1013
MÉXICO,IXTAPALUCA,19,161,4,184,1012
MÉXICO,IXTAPALUCA,81,1105,12,1198,0
MÉXICO,IXTAPALUCA,33,207,0,240,1835
MÉXICO,IXTAPALUCA,28,223,3,254,1834
MÉXICO,IXTAPALUCA,34,245,1,280,1834
MÉXICO,IXTAPALUCA,44,370,2,416,1850
MÉXICO,IXTAPALUCA,43,359,2,404,1849
MÉXICO,IXTAPALUCA,30,239,0,269,1709
MÉXICO,IXTAPALUCA,27,239,3,269,1709
MÉXICO,IXTAPALUCA,28,232,2,262,1708
MÉXICO,IXTAPALUCA,30,378,5,413,1686
MÉXICO,IXTAPALUCA,19,221,8,248,1946
MÉXICO,IXTAPALUCA,24,273,4,301,1945
MÉXICO,IXTAPALUCA,26,234,2,262,1534
MÉXICO,IXTAPALUCA,22,244,0,266,1533
MÉXICO,IXTAPALUCA,29,276,0,305,1513
MÉXICO,IXTAPALUCA,30,344,1,375,1822
MÉXICO,IXTAPALUCA,18,272,1,291,1608
MÉXICO,IXTAPALUCA,25,314,1,340,1607
MÉXICO,IXTAPALUCA,29,260,3,292,1607
MÉXICO,IXTAPALUCA,29,344,5,378,1896
MÉXICO,IXTAPALUCA,25,323,4,352,1895
MÉXICO,IXTAPALUCA,25,277,8,310,1523
MÉXICO,IXTAPALUCA,45,267,3,315,1522
MÉXICO,IXTAPALUCA,7,129,3,139,1087
MÉXICO,IXTAPALUCA,20,158,1,179,1086
MÉXICO,IXTAPALUCA,21,323,0,344,1859
MÉXICO,IXTAPALUCA,23,274,5,302,1858
MÉXICO,IXTAPALUCA,35,308,5,348,1807
MÉXICO,IXTAPALUCA,28,247,3,278,1806
MÉXICO,IXTAPALUCA,28,284,4,316,1720
MÉXICO,IXTAPALUCA,33,305,2,340,1720
MÉXICO,IXTAPALUCA,26,318,2,346,1612
MÉXICO,IXTAPALUCA,17,336,4,357,1611
MÉXICO,IXTAPALUCA,25,327,3,355,1840
MÉXICO,IXTAPALUCA,22,329,2,353,1840
MÉXICO,IXTAPALUCA,18,259,6,283,1936
MÉXICO,IXTAPALUCA,24,267,1,292,1936
MÉXICO,IXTAPALUCA,28,249,3,280,1945
MÉXICO,IXTAPALUCA,24,257,4,285,1945
MÉXICO,IXTAPALUCA,19,294,4,317,1861
MÉXICO,IXTAPALUCA,17,334,4,355,1860
MÉXICO,IXTAPALUCA,9,334,33,376,1769
MÉXICO,IXTAPALUCA,24,365,5,394,1769
MÉXICO,IXTAPALUCA,14,269,2,285,1609
MÉXICO,IXTAPALUCA,13,252,5,270,1609
MÉXICO,IXTAPALUCA,11,167,0,178,1004
MÉXICO,IXTAPALUCA,13,189,2,204,1003
MÉXICO,IXTAPALUCA,22,246,1,269,1931
MÉXICO,IXTAPALUCA,21,272,6,299,1930
MÉXICO,IXTAPALUCA,27,250,2,279,1290
MÉXICO,IXTAPALUCA,21,227,2,250,1289
MÉXICO,IXTAPALUCA,21,317,3,341,1726
MÉXICO,IXTAPALUCA,14,273,6,293,1726
MÉXICO,IXTAPALUCA,31,256,3,290,1788
MÉXICO,IXTAPALUCA,20,259,1,280,1788
MÉXICO,IXTAPALUCA,15,245,4,264,1830
MÉXICO,IXTAPALUCA,31,218,3,252,1830
MÉXICO,IXTAPALUCA,17,232,5,254,1364
MÉXICO,IXTAPALUCA,21,234,7,262,1363
MÉXICO,IXTAPALUCA,18,226,1,245,1726
MÉXICO,IXTAPALUCA,26,227,1,254,1725
MÉXICO,IXTAPALUCA,20,209,0,229,1725
MÉXICO,IXTAPALUCA,28,225,1,254,1725
MÉXICO,IXTAPALUCA,26,220,3,249,1725
MÉXICO,IXTAPALUCA,12,108,10,130,1587
MÉXICO,IXTAPALUCA,6,118,3,127,1587
MÉXICO,IXTAPALUCA,19,120,3,142,1587
MÉXICO,IXTAPALUCA,14,177,4,195,1949
MÉXICO,IXTAPALUCA,23,169,4,196,1949
MÉXICO,IXTAPALUCA,16,171,2,189,1796
MÉXICO,IXTAPALUCA,9,152,4,165,1795
MÉXICO,IXTAPALUCA,13,162,4,179,1557
MÉXICO,IXTAPALUCA,8,172,1,181,1556
MÉXICO,IXTAPALUCA,13,189,5,207,1556
MÉXICO,IXTAPALUCA,14,159,4,177,1311
MÉXICO,IXTAPALUCA,10,178,1,189,1310
MÉXICO,IXTAPALUCA,8,140,3,151,1310
MÉXICO,IXTAPALUCA,32,294,1,327,1692
MÉXICO,IXTAPALUCA,21,165,0,186,1296
MÉXICO,IXTAPALUCA,16,171,1,188,1296
MÉXICO,IXTAPALUCA,26,183,1,210,1204
MÉXICO,IXTAPALUCA,33,164,4,201,1203
MÉXICO,IXTAPALUCA,25,324,2,351,1763
MÉXICO,IXTAPALUCA,18,225,0,243,1324
MÉXICO,IXTAPALUCA,25,213,1,239,1323
MÉXICO,IXTAPALUCA,26,217,3,246,1388
MÉXICO,IXTAPALUCA,34,205,3,242,1388
MÉXICO,IXTAPALUCA,19,176,0,195,1139
MÉXICO,IXTAPALUCA,18,187,0,205,1139
MÉXICO,IXTAPALUCA,30,234,3,267,1631
MÉXICO,IXTAPALUCA,20,203,1,224,1630
MÉXICO,IXTAPALUCA,29,258,0,287,1752
MÉXICO,IXTAPALUCA,26,275,5,306,1539
MÉXICO,IXTAPALUCA,19,272,3,294,1539
MÉXICO,IXTAPALUCA,26,309,2,337,1904
MÉXICO,IXTAPALUCA,34,259,1,294,1904
MÉXICO,IXTAPALUCA,41,273,1,315,1566
MÉXICO,IXTAPALUCA,15,173,2,190,1637
MÉXICO,IXTAPALUCA,16,151,3,170,1637
MÉXICO,IXTAPALUCA,13,224,0,237,1648
MÉXICO,IXTAPALUCA,18,207,1,226,1647
MÉXICO,IXTAPALUCA,10,217,3,230,1664
MÉXICO,IXTAPALUCA,22,214,2,238,1664
MÉXICO,IXTAPALUCA,20,220,0,240,1664
MÉXICO,IXTAPALUCA,28,238,0,266,1341
MÉXICO,IXTAPALUCA,26,228,1,255,1340
MÉXICO,IXTAPALUCA,16,152,0,168,1009
MÉXICO,IXTAPALUCA,17,154,1,172,1009
MÉXICO,IXTAPALUCA,58,271,4,333,1795
MÉXICO,IXTAPALUCA,39,265,4,308,1795
MÉXICO,IXTAPALUCA,23,216,1,240,1716
MÉXICO,IXTAPALUCA,38,221,3,262,1864
MÉXICO,IXTAPALUCA,25,200,2,227,1548
MÉXICO,IXTAPALUCA,16,224,4,244,1548
MÉXICO,IXTAPALUCA,27,233,2,262,1709
MÉXICO,IXTAPALUCA,24,228,2,254,1708
MÉXICO,IXTAPALUCA,29,268,0,297,1789
MÉXICO,IXTAPALUCA,21,246,2,269,1789
MÉXICO,IXTAPALUCA,18,156,3,177,1148
MÉXICO,IXTAPALUCA,23,191,2,216,1147
MÉXICO,IXTAPALUCA,47,287,2,336,1907
MÉXICO,IXTAPALUCA,17,183,3,203,1452
MÉXICO,IXTAPALUCA,19,197,1,217,1451
MÉXICO,IXTAPALUCA,28,243,2,273,1755
MÉXICO,IXTAPALUCA,21,248,2,271,1755
MÉXICO,ECATEPEC DE MORELOS,31,205,1,237,1269
MÉXICO,ECATEPEC DE MORELOS,28,187,4,219,1268
MÉXICO,ECATEPEC DE MORELOS,21,206,2,229,1222
MÉXICO,ECATEPEC DE MORELOS,36,204,8,248,1222
MÉXICO,ECATEPEC DE MORELOS,28,324,2,354,1967
MÉXICO,ECATEPEC DE MORELOS,23,283,2,308,1444
MÉXICO,ECATEPEC DE MORELOS,35,258,4,297,1444
MÉXICO,ECATEPEC DE MORELOS,25,264,4,293,1513
MÉXICO,ECATEPEC DE MORELOS,53,317,8,378,1633
MÉXICO,ECATEPEC DE MORELOS,28,242,8,278,1401
MÉXICO,ECATEPEC DE MORELOS,33,246,1,280,1400
MÉXICO,ECATEPEC DE MORELOS,32,192,4,228,1216
MÉXICO,ECATEPEC DE MORELOS,26,190,4,220,1216
MÉXICO,ECATEPEC DE MORELOS,42,264,5,311,1745
MÉXICO,ECATEPEC DE MORELOS,33,243,2,278,1744
MÉXICO,ECATEPEC DE MORELOS,24,258,5,287,1842
MÉXICO,ECATEPEC DE MORELOS,26,271,3,300,1842
MÉXICO,ECATEPEC DE MORELOS,26,206,4,236,1346
MÉXICO,ECATEPEC DE MORELOS,32,218,4,254,1346
MÉXICO,ECATEPEC DE MORELOS,24,236,3,263,1444
MÉXICO,ECATEPEC DE MORELOS,20,205,4,229,1444
MÉXICO,ECATEPEC DE MORELOS,15,215,6,236,1444
MÉXICO,ECATEPEC DE MORELOS,19,214,5,238,1218
MÉXICO,ECATEPEC DE MORELOS,21,192,3,216,1217
MÉXICO,ECATEPEC DE MORELOS,43,290,4,337,1950
MÉXICO,ECATEPEC DE MORELOS,33,334,3,370,1838
MÉXICO,ECATEPEC DE MORELOS,48,314,10,372,1838
MÉXICO,ECATEPEC DE MORELOS,19,326,2,347,1804
MÉXICO,ECATEPEC DE MORELOS,24,227,8,259,1724
MÉXICO,ECATEPEC DE MORELOS,22,237,3,262,1724
MÉXICO,ECATEPEC DE MORELOS,44,231,1,276,1471
MÉXICO,ECATEPEC DE MORELOS,38,314,3,355,1903
MÉXICO,ECATEPEC DE MORELOS,25,263,2,290,1903
MÉXICO,ECATEPEC DE MORELOS,38,267,3,308,1599
MÉXICO,ECATEPEC DE MORELOS,23,228,2,253,1599
MÉXICO,ECATEPEC DE MORELOS,29,201,4,234,1337
MÉXICO,ECATEPEC DE MORELOS,22,204,2,228,1336
MÉXICO,ECATEPEC DE MORELOS,22,236,5,263,1903
MÉXICO,ECATEPEC DE MORELOS,25,299,3,327,1902
MÉXICO,ECATEPEC DE MORELOS,24,254,4,282,1579
MÉXICO,ECATEPEC DE MORELOS,26,280,4,310,1578
MÉXICO,ECATEPEC DE MORELOS,24,214,6,244,1385
MÉXICO,ECATEPEC DE MORELOS,16,225,3,244,1385
MÉXICO,ECATEPEC DE MORELOS,29,242,3,274,1715
MÉXICO,ECATEPEC DE MORELOS,43,291,5,339,1935
MÉXICO,ECATEPEC DE MORELOS,41,297,6,344,1934
MÉXICO,ECATEPEC DE MORELOS,23,298,2,323,1832
MÉXICO,ECATEPEC DE MORELOS,20,269,3,292,1832
MÉXICO,ECATEPEC DE MORELOS,19,240,2,261,1217
MÉXICO,ECATEPEC DE MORELOS,18,221,1,240,1217
MÉXICO,ECATEPEC DE MORELOS,38,290,3,331,1873
MÉXICO,ECATEPEC DE MORELOS,33,297,4,334,1873
MÉXICO,ECATEPEC DE MORELOS,27,213,2,242,1424
MÉXICO,ECATEPEC DE MORELOS,32,246,3,281,1423
MÉXICO,ECATEPEC DE MORELOS,16,252,5,273,1398
MÉXICO,ECATEPEC DE MORELOS,22,248,1,271,1397
MÉXICO,ECATEPEC DE MORELOS,22,210,2,234,1385
MÉXICO,ECATEPEC DE MORELOS,13,173,2,188,1384
MÉXICO,ECATEPEC DE MORELOS,18,277,3,298,1746
MÉXICO,ECATEPEC DE MORELOS,24,254,2,280,1938
MÉXICO,ECATEPEC DE MORELOS,31,269,3,303,1801
MÉXICO,ECATEPEC DE MORELOS,11,165,1,177,1043
MÉXICO,ECATEPEC DE MORELOS,11,152,3,166,1042
MÉXICO,ECATEPEC DE MORELOS,9,248,2,259,1368
MÉXICO,ECATEPEC DE MORELOS,21,185,0,206,1368
MÉXICO,ECATEPEC DE MORELOS,41,314,5,360,1834
MÉXICO,ECATEPEC DE MORELOS,26,201,3,230,1316
MÉXICO,ECATEPEC DE MORELOS,26,186,2,214,1316
MÉXICO,ECATEPEC DE MORELOS,24,217,5,246,1503
MÉXICO,ECATEPEC DE MORELOS,26,201,8,235,1503
MÉXICO,ECATEPEC DE MORELOS,30,341,4,375,1874
MÉXICO,ECATEPEC DE MORELOS,16,259,0,275,1851
MÉXICO,ECATEPEC DE MORELOS,32,271,1,304,1851
MÉXICO,ECATEPEC DE MORELOS,19,219,3,241,1062
MÉXICO,ECATEPEC DE MORELOS,19,181,1,201,1061
MÉXICO,ECATEPEC DE MORELOS,28,226,5,259,1438
MÉXICO,ECATEPEC DE MORELOS,27,239,5,271,1438
MÉXICO,ECATEPEC DE MORELOS,31,223,8,262,1438
MÉXICO,ECATEPEC DE MORELOS,17,254,4,275,1616
MÉXICO,ECATEPEC DE MORELOS,22,238,5,265,1615
MÉXICO,ECATEPEC DE MORELOS,23,165,5,193,1059
MÉXICO,ECATEPEC DE MORELOS,17,158,2,177,1059
MÉXICO,ECATEPEC DE MORELOS,24,266,3,293,1424
MÉXICO,ECATEPEC DE MORELOS,29,246,8,283,1423
MÉXICO,ECATEPEC DE MORELOS,30,303,2,335,1861
MÉXICO,ECATEPEC DE MORELOS,22,271,3,296,1861
MÉXICO,ECATEPEC DE MORELOS,27,254,4,285,1861
MÉXICO,ECATEPEC DE MORELOS,14,232,0,246,1602
MÉXICO,ECATEPEC DE MORELOS,32,235,9,276,1625
MÉXICO,ECATEPEC DE MORELOS,27,239,6,272,1625
MÉXICO,ECATEPEC DE MORELOS,22,163,1,186,1109
MÉXICO,ECATEPEC DE MORELOS,12,167,1,180,1108
MÉXICO,ECATEPEC DE MORELOS,25,284,1,310,1692
MÉXICO,ECATEPEC DE MORELOS,27,311,5,343,1692
MÉXICO,ECATEPEC DE MORELOS,34,267,1,302,1692
MÉXICO,ECATEPEC DE MORELOS,28,240,1,269,1308
MÉXICO,ECATEPEC DE MORELOS,44,218,4,266,1308
MÉXICO,ECATEPEC DE MORELOS,27,267,5,299,1376
MÉXICO,ECATEPEC DE MORELOS,25,244,2,271,1375
MÉXICO,ECATEPEC DE MORELOS,24,362,5,391,1765
MÉXICO,ECATEPEC DE MORELOS,24,360,9,393,1865
MÉXICO,ECATEPEC DE MORELOS,29,226,3,258,1304
MÉXICO,ECATEPEC DE MORELOS,21,214,1,236,1304
MÉXICO,ECATEPEC DE MORELOS,35,323,5,363,1677
MÉXICO,ECATEPEC DE MORELOS,46,359,1,406,1987
MÉXICO,ECATEPEC DE MORELOS,21,293,6,320,1469
MÉXICO,ECATEPEC DE MORELOS,36,298,3,337,1469
MÉXICO,ECATEPEC DE MORELOS,35,223,5,263,1202
MÉXICO,ECATEPEC DE MORELOS,24,262,2,288,1202
MÉXICO,ECATEPEC DE MORELOS,45,414,3,462,1738
MÉXICO,ECATEPEC DE MORELOS,30,284,10,324,1408
MÉXICO,ECATEPEC DE MORELOS,27,301,6,334,1407
MÉXICO,ECATEPEC DE MORELOS,25,239,2,266,1192
MÉXICO,ECATEPEC DE MORELOS,21,234,2,257,1191
MÉXICO,ECATEPEC DE MORELOS,58,355,5,418,1929
MÉXICO,ECATEPEC DE MORELOS,41,366,6,413,1929
MÉXICO,ECATEPEC DE MORELOS,29,374,3,406,1928
MÉXICO,ECATEPEC DE MORELOS,35,234,5,274,1394
MÉXICO,ECATEPEC DE MORELOS,32,252,1,285,1393
MÉXICO,ECATEPEC DE MORELOS,23,244,1,268,1404
MÉXICO,ECATEPEC DE MORELOS,38,243,1,282,1403
MÉXICO,ECATEPEC DE MORELOS,27,237,2,266,1403
MÉXICO,ECATEPEC DE MORELOS,60,335,2,397,1887
MÉXICO,ECATEPEC DE MORELOS,41,282,1,324,1630
MÉXICO,ECATEPEC DE MORELOS,26,271,3,300,1630
MÉXICO,ECATEPEC DE MORELOS,27,231,1,259,1610
MÉXICO,ECATEPEC DE MORELOS,18,233,4,255,1609
MÉXICO,ECATEPEC DE MORELOS,20,270,3,293,1361
MÉXICO,ECATEPEC DE MORELOS,26,225,3,254,1360
MÉXICO,ECATEPEC DE MORELOS,32,309,3,344,1914
MÉXICO,ECATEPEC DE MORELOS,45,331,0,376,1913
MÉXICO,ECATEPEC DE MORELOS,35,329,11,375,1934
MÉXICO,ECATEPEC DE MORELOS,39,313,4,356,1934
MÉXICO,ECATEPEC DE MORELOS,28,317,4,349,1933
MÉXICO,ECATEPEC DE MORELOS,35,267,9,311,1655
MÉXICO,ECATEPEC DE MORELOS,27,314,4,345,1654
MÉXICO,ECATEPEC DE MORELOS,37,290,2,329,1721
MÉXICO,ECATEPEC DE MORELOS,45,300,2,347,1720
MÉXICO,ECATEPEC DE MORELOS,49,350,8,407,1980
MÉXICO,ECATEPEC DE MORELOS,48,328,3,379,1979
MÉXICO,ECATEPEC DE MORELOS,24,209,1,234,1385
MÉXICO,ECATEPEC DE MORELOS,42,228,1,271,1384
MÉXICO,ECATEPEC DE MORELOS,37,214,4,255,1384
MÉXICO,ECATEPEC DE MORELOS,23,242,1,266,1601
MÉXICO,ECATEPEC DE MORELOS,15,232,1,248,1601
MÉXICO,ECATEPEC DE MORELOS,33,263,0,296,1790
MÉXICO,ECATEPEC DE MORELOS,33,282,4,319,1789
MÉXICO,ECATEPEC DE MORELOS,35,351,6,392,1931
MÉXICO,ECATEPEC DE MORELOS,43,328,6,377,1931
MÉXICO,ECATEPEC DE MORELOS,15,226,3,244,1413
MÉXICO,ECATEPEC DE MORELOS,27,188,1,216,1413
MÉXICO,ECATEPEC DE MORELOS,27,266,1,294,1499
MÉXICO,ECATEPEC DE MORELOS,39,224,3,266,1499
MÉXICO,ECATEPEC DE MORELOS,35,258,1,294,1498
MÉXICO,ECATEPEC DE MORELOS,25,288,4,317,1642
MÉXICO,ECATEPEC DE MORELOS,34,267,7,308,1641
MÉXICO,ECATEPEC DE MORELOS,118,1070,10,1198,0
MÉXICO,ECATEPEC DE MORELOS,54,306,3,363,1503
MÉXICO,ECATEPEC DE MORELOS,32,305,5,342,1892
MÉXICO,ECATEPEC DE MORELOS,28,287,0,315,1572
MÉXICO,ECATEPEC DE MORELOS,26,231,3,260,1476
MÉXICO,ECATEPEC DE MORELOS,25,208,6,239,1476
MÉXICO,ECATEPEC DE MORELOS,23,213,11,247,1655
MÉXICO,ECATEPEC DE MORELOS,18,191,1,210,1655
MÉXICO,ECATEPEC DE MORELOS,31,314,3,348,1546
MÉXICO,ECATEPEC DE MORELOS,27,240,3,270,1816
MÉXICO,ECATEPEC DE MORELOS,29,292,7,328,1816
MÉXICO,CIUDAD ADOLFO LOPEZ MATEOS,35,158,0,193,1747
MÉXICO,CIUDAD ADOLFO LOPEZ MATEOS,28,190,0,218,1747
MÉXICO,CIUDAD ADOLFO LOPEZ MATEOS,90,571,4,665,0
MÉXICO,CIUDAD ADOLFO LOPEZ MATEOS,28,221,5,254,1608
MÉXICO,CIUDAD ADOLFO LOPEZ MATEOS,20,231,0,251,1607
MÉXICO,CIUDAD ADOLFO LOPEZ MATEOS,29,230,1,260,1607
MÉXICO,CIUDAD ADOLFO LOPEZ MATEOS,22,244,3,269,1929
MÉXICO,CIUDAD ADOLFO LOPEZ MATEOS,23,210,1,234,1929
MÉXICO,CIUDAD ADOLFO LOPEZ MATEOS,14,224,1,239,1929
MÉXICO,CIUDAD ADOLFO LOPEZ MATEOS,26,253,2,281,1929
MÉXICO,CIUDAD ADOLFO LOPEZ MATEOS,16,189,1,206,1541
MÉXICO,CIUDAD ADOLFO LOPEZ MATEOS,15,208,3,226,1540
MÉXICO,CIUDAD ADOLFO LOPEZ MATEOS,14,196,3,213,1540
MÉXICO,CIUDAD ADOLFO LOPEZ MATEOS,35,160,1,196,1552
MÉXICO,CIUDAD ADOLFO LOPEZ MATEOS,22,174,0,196,1551
MÉXICO,CIUDAD ADOLFO LOPEZ MATEOS,25,130,2,157,1084
MÉXICO,CIUDAD ADOLFO LOPEZ MATEOS,15,140,4,159,1084
MÉXICO,CIUDAD ADOLFO LOPEZ MATEOS,17,197,2,216,1947
MÉXICO,CIUDAD ADOLFO LOPEZ MATEOS,24,196,1,221,1946
MÉXICO,CIUDAD ADOLFO LOPEZ MATEOS,27,121,0,148,1200
MÉXICO,CIUDAD ADOLFO LOPEZ MATEOS,18,100,3,121,1200
MÉXICO,CIUDAD ADOLFO LOPEZ MATEOS,20,222,1,243,1881
MÉXICO,CIUDAD ADOLFO LOPEZ MATEOS,14,240,6,260,1881
MÉXICO,CIUDAD ADOLFO LOPEZ MATEOS,12,151,0,163,1437
MÉXICO,CIUDAD ADOLFO LOPEZ MATEOS,14,152,1,167,1437
MÉXICO,CIUDAD ADOLFO LOPEZ MATEOS,10,161,2,173,1436
MÉXICO,CIUDAD ADOLFO LOPEZ MATEOS,13,168,0,181,1142
MÉXICO,CIUDAD ADOLFO LOPEZ MATEOS,11,123,1,135,1142
MÉXICO,CIUDAD ADOLFO LOPEZ MATEOS,35,175,7,217,1319
MÉXICO,CIUDAD ADOLFO LOPEZ MATEOS,19,166,2,187,1318
MÉXICO,CIUDAD ADOLFO LOPEZ MATEOS,14,199,1,214,1633
MÉXICO,CIUDAD ADOLFO LOPEZ MATEOS,28,193,3,224,1632
MÉXICO,CIUDAD ADOLFO LOPEZ MATEOS,15,162,0,177,1347
MÉXICO,CIUDAD ADOLFO LOPEZ MATEOS,17,144,2,163,1346
MÉXICO,CIUDAD ADOLFO LOPEZ MATEOS,20,166,2,188,1285
MÉXICO,CIUDAD ADOLFO LOPEZ MATEOS,14,183,4,201,1284
MÉXICO,CIUDAD ADOLFO LOPEZ MATEOS,12,197,2,211,1428
MÉXICO,CIUDAD ADOLFO LOPEZ MATEOS,21,171,1,193,1427
MÉXICO,CIUDAD ADOLFO LOPEZ MATEOS,18,236,1,255,1916
MÉXICO,CIUDAD ADOLFO LOPEZ MATEOS,7,247,3,257,1916
MÉXICO,CIUDAD ADOLFO LOPEZ MATEOS,28,129,1,158,1426
MÉXICO,CIUDAD ADOLFO LOPEZ MATEOS,18,127,0,145,1425
MÉXICO,CIUDAD ADOLFO LOPEZ MATEOS,22,129,3,154,1204
MÉXICO,CIUDAD ADOLFO LOPEZ MATEOS,27,130,2,159,1204
MÉXICO,CIUDAD ADOLFO LOPEZ MATEOS,24,255,3,282,1932
MÉXICO,CIUDAD ADOLFO LOPEZ MATEOS,37,261,9,307,1932
MÉXICO,CIUDAD ADOLFO LOPEZ MATEOS,24,107,3,134,1572
MÉXICO,CIUDAD ADOLFO LOPEZ MATEOS,20,116,0,136,1571
MÉXICO,CIUDAD ADOLFO LOPEZ MATEOS,18,159,1,178,1482
MÉXICO,CIUDAD ADOLFO LOPEZ MATEOS,20,120,1,141,1482
MÉXICO,CIUDAD ADOLFO LOPEZ MATEOS,23,134,1,158,1482
MÉXICO,CIUDAD ADOLFO LOPEZ MATEOS,35,96,2,133,1491
MÉXICO,CIUDAD ADOLFO LOPEZ MATEOS,25,98,0,123,1491
MÉXICO,CIUDAD ADOLFO LOPEZ MATEOS,33,79,2,114,1281
MÉXICO,CIUDAD ADOLFO LOPEZ MATEOS,17,78,0,95,1281
MÉXICO,CIUDAD ADOLFO LOPEZ MATEOS,23,152,7,182,1621
MÉXICO,CIUDAD ADOLFO LOPEZ MATEOS,27,177,2,206,1621
MÉXICO,CIUDAD ADOLFO LOPEZ MATEOS,18,136,2,156,1621
MÉXICO,CIUDAD ADOLFO LOPEZ MATEOS,12,162,0,174,1172
MÉXICO,CIUDAD ADOLFO LOPEZ MATEOS,20,151,1,172,1172
MÉXICO,CIUDAD ADOLFO LOPEZ MATEOS,22,164,2,188,1811
MÉXICO,CIUDAD ADOLFO LOPEZ MATEOS,24,180,2,206,1810
MÉXICO,CIUDAD ADOLFO LOPEZ MATEOS,18,145,3,166,1124
MÉXICO,CIUDAD ADOLFO LOPEZ MATEOS,19,152,2,173,1123
MÉXICO,CIUDAD ADOLFO LOPEZ MATEOS,30,260,1,291,1838
MÉXICO,CIUDAD ADOLFO LOPEZ MATEOS,27,264,4,295,1837
MÉXICO,CIUDAD ADOLFO LOPEZ MATEOS,28,222,3,253,1629
MÉXICO,CIUDAD ADOLFO LOPEZ MATEOS,16,218,1,235,1629
MÉXICO,CIUDAD ADOLFO LOPEZ MATEOS,40,209,2,251,1629
MÉXICO,CIUDAD ADOLFO LOPEZ MATEOS,9,248,3,260,1631
MÉXICO,CIUDAD ADOLFO LOPEZ MATEOS,17,218,3,238,1630
MÉXICO,CIUDAD ADOLFO LOPEZ MATEOS,25,288,2,315,1814
MÉXICO,CIUDAD ADOLFO LOPEZ MATEOS,26,277,2,305,1814
MÉXICO,CIUDAD ADOLFO LOPEZ MATEOS,19,237,3,259,1633
MÉXICO,CIUDAD ADOLFO LOPEZ MATEOS,32,229,3,264,1633
MÉXICO,CIUDAD ADOLFO LOPEZ MATEOS,20,229,7,256,1553
MÉXICO,CIUDAD ADOLFO LOPEZ MATEOS,21,234,0,255,1553
MÉXICO,CIUDAD ADOLFO LOPEZ MATEOS,13,235,4,252,1553
MÉXICO,CIUDAD ADOLFO LOPEZ MATEOS,12,185,6,203,1451
MÉXICO,CIUDAD ADOLFO LOPEZ MATEOS,12,187,6,205,1450
MÉXICO,CIUDAD ADOLFO LOPEZ MATEOS,12,208,1,221,1450
MÉXICO,CIUDAD ADOLFO LOPEZ MATEOS,11,172,2,185,1453
MÉXICO,CIUDAD ADOLFO LOPEZ MATEOS,20,154,2,176,1453
MÉXICO,CIUDAD ADOLFO LOPEZ MATEOS,19,169,2,190,1453
MÉXICO,CIUDAD ADOLFO LOPEZ MATEOS,8,189,5,202,1309
MÉXICO,CIUDAD ADOLFO LOPEZ MATEOS,14,187,3,204,1308
MÉXICO,CIUDAD ADOLFO LOPEZ MATEOS,21,262,3,286,1881
MÉXICO,CIUDAD ADOLFO LOPEZ MATEOS,15,260,6,281,1880
MÉXICO,CIUDAD ADOLFO LOPEZ MATEOS,17,255,1,273,1467
MÉXICO,CIUDAD ADOLFO LOPEZ MATEOS,13,221,2,236,1466
MÉXICO,CIUDAD ADOLFO LOPEZ MATEOS,12,201,3,216,1466
MÉXICO,CIUDAD ADOLFO LOPEZ MATEOS,38,284,1,323,1905
MÉXICO,CIUDAD ADOLFO LOPEZ MATEOS,34,258,3,295,1904
MÉXICO,CIUDAD ADOLFO LOPEZ MATEOS,23,237,2,262,1394
MÉXICO,CIUDAD ADOLFO LOPEZ MATEOS,20,223,3,246,1393
MÉXICO,CIUDAD ADOLFO LOPEZ MATEOS,28,218,0,246,1393
MÉXICO,CIUDAD ADOLFO LOPEZ MATEOS,16,219,1,236,1477
MÉXICO,CIUDAD ADOLFO LOPEZ MATEOS,17,214,0,231,1477
MÉXICO,CIUDAD ADOLFO LOPEZ MATEOS,17,213,2,232,1476
MÉXICO,CIUDAD ADOLFO LOPEZ MATEOS,23,279,4,306,1814
MÉXICO,CIUDAD ADOLFO LOPEZ MATEOS,20,309,5,334,1814
MÉXICO,CIUDAD ADOLFO LOPEZ MATEOS,18,213,3,234,1568
MÉXICO,CIUDAD ADOLFO LOPEZ MATEOS,27,210,1,238,1567
MÉXICO,CIUDAD ADOLFO LOPEZ MATEOS,22,269,4,295,1666
MÉXICO,CIUDAD ADOLFO LOPEZ MATEOS,25,235,4,264,1666
MÉXICO,CIUDAD ADOLFO LOPEZ MATEOS,15,154,1,170,1313
MÉXICO,CIUDAD ADOLFO LOPEZ MATEOS,24,167,1,192,1312
MÉXICO,CIUDAD ADOLFO LOPEZ MATEOS,38,302,1,341,1778
MÉXICO,CIUDAD ADOLFO LOPEZ MATEOS,18,290,2,310,1778
MÉXICO,CIUDAD ADOLFO LOPEZ MATEOS,44,306,3,353,1816
MÉXICO,CIUDAD ADOLFO LOPEZ MATEOS,37,325,4,366,1816
MÉXICO,CIUDAD ADOLFO LOPEZ MATEOS,21,260,3,284,1543
MÉXICO,CIUDAD ADOLFO LOPEZ MATEOS,19,232,4,255,1543
MÉXICO,CIUDAD ADOLFO LOPEZ MATEOS,20,237,1,258,1542
MÉXICO,CIUDAD ADOLFO LOPEZ MATEOS,221,25,2,248,1395
MÉXICO,CIUDAD ADOLFO LOPEZ MATEOS,11,268,3,282,1394
MÉXICO,CIUDAD ADOLFO LOPEZ MATEOS,24,255,2,281,1229
MÉXICO,CIUDAD ADOLFO LOPEZ MATEOS,20,233,2,255,1228
MÉXICO,CIUDAD ADOLFO LOPEZ MATEOS,28,196,1,225,1565
MÉXICO,CIUDAD ADOLFO LOPEZ MATEOS,32,227,4,263,1565
MÉXICO,CIUDAD ADOLFO LOPEZ MATEOS,48,119,1,168,1777
MÉXICO,CIUDAD ADOLFO LOPEZ MATEOS,49,137,0,186,1777
MÉXICO,CIUDAD ADOLFO LOPEZ MATEOS,24,259,2,285,1376
MÉXICO,CIUDAD ADOLFO LOPEZ MATEOS,28,230,1,259,1376
MÉXICO,CIUDAD ADOLFO LOPEZ MATEOS,31,250,3,284,1376
MÉXICO,CIUDAD ADOLFO LOPEZ MATEOS,27,273,1,301,1820
MÉXICO,CIUDAD ADOLFO LOPEZ MATEOS,48,294,4,346,1820
MÉXICO,CIUDAD ADOLFO LOPEZ MATEOS,23,237,0,260,1770
MÉXICO,CIUDAD ADOLFO LOPEZ MATEOS,22,237,3,262,1770
MÉXICO,CIUDAD ADOLFO LOPEZ MATEOS,27,261,11,299,1835
MÉXICO,CIUDAD ADOLFO LOPEZ MATEOS,40,245,6,291,1835
MÉXICO,CIUDAD ADOLFO LOPEZ MATEOS,32,128,4,164,1479
MÉXICO,CIUDAD ADOLFO LOPEZ MATEOS,43,92,1,136,1478
MÉXICO,CIUDAD ADOLFO LOPEZ MATEOS,25,125,2,152,1510
MÉXICO,CIUDAD ADOLFO LOPEZ MATEOS,44,115,2,161,1509
MÉXICO,CIUDAD ADOLFO LOPEZ MATEOS,34,142,0,176,1646
MÉXICO,CIUDAD ADOLFO LOPEZ MATEOS,25,146,3,174,1646
MÉXICO,CIUDAD ADOLFO LOPEZ MATEOS,33,68,4,105,1117
MÉXICO,CIUDAD ADOLFO LOPEZ MATEOS,42,60,3,105,1117
MÉXICO,CIUDAD ADOLFO LOPEZ MATEOS,33,123,2,158,1911
MÉXICO,CIUDAD ADOLFO LOPEZ MATEOS,44,102,1,147,1911
MÉXICO,CIUDAD ADOLFO LOPEZ MATEOS,30,118,1,149,1454
MÉXICO,CIUDAD ADOLFO LOPEZ MATEOS,34,150,5,189,1453
MÉXICO,CIUDAD ADOLFO LOPEZ MATEOS,25,135,2,162,1453
MÉXICO,CIUDAD ADOLFO LOPEZ MATEOS,44,136,0,180,1605
MÉXICO,CIUDAD ADOLFO LOPEZ MATEOS,40,155,1,196,1605
MÉXICO,CIUDAD ADOLFO LOPEZ MATEOS,39,158,1,198,1627
MÉXICO,CIUDAD ADOLFO LOPEZ MATEOS,33,163,1,197,1627
MÉXICO,CIUDAD ADOLFO LOPEZ MATEOS,31,152,2,185,1570
MÉXICO,CIUDAD ADOLFO LOPEZ MATEOS,30,146,1,177,1570
MÉXICO,CIUDAD ADOLFO LOPEZ MATEOS,41,158,3,202,1684
MÉXICO,CIUDAD ADOLFO LOPEZ MATEOS,43,159,3,205,1683
MÉXICO,CIUDAD ADOLFO LOPEZ MATEOS,38,148,4,190,1828
MÉXICO,CIUDAD ADOLFO LOPEZ MATEOS,60,176,2,238,1827
MÉXICO,CIUDAD ADOLFO LOPEZ MATEOS,39,154,3,196,1731
MÉXICO,CIUDAD ADOLFO LOPEZ MATEOS,44,143,1,188,1730
MÉXICO,CIUDAD ADOLFO LOPEZ MATEOS,34,171,0,205,1371
MÉXICO,CIUDAD ADOLFO LOPEZ MATEOS,36,174,3,213,1371
MÉXICO,CIUDAD ADOLFO LOPEZ MATEOS,23,177,0,200,1121
MÉXICO,CIUDAD ADOLFO LOPEZ MATEOS,17,188,4,209,1121
MÉXICO,CIUDAD ADOLFO LOPEZ MATEOS,17,123,1,141,1061
MÉXICO,CIUDAD ADOLFO LOPEZ MATEOS,16,144,1,161,1060
MÉXICO,CIUDAD ADOLFO LOPEZ MATEOS,13,139,2,154,1076
MÉXICO,CIUDAD ADOLFO LOPEZ MATEOS,13,152,4,169,1076
MÉXICO,CIUDAD ADOLFO LOPEZ MATEOS,18,166,7,191,1020
MÉXICO,CIUDAD ADOLFO LOPEZ MATEOS,27,176,1,204,1019
MÉXICO,CIUDAD ADOLFO LOPEZ MATEOS,17,166,1,184,1049
MÉXICO,CIUDAD ADOLFO LOPEZ MATEOS,16,140,2,158,1048
MÉXICO,CIUDAD ADOLFO LOPEZ MATEOS,48,195,3,246,1909
MÉXICO,CIUDAD ADOLFO LOPEZ MATEOS,45,237,5,287,1908
MÉXICO,CIUDAD ADOLFO LOPEZ MATEOS,28,179,1,208,1936
MÉXICO,CIUDAD ADOLFO LOPEZ MATEOS,37,205,6,248,1936
MÉXICO,CIUDAD ADOLFO LOPEZ MATEOS,25,133,4,162,1351
MÉXICO,CIUDAD ADOLFO LOPEZ MATEOS,23,115,3,141,1351
MÉXICO,CIUDAD ADOLFO LOPEZ MATEOS,14,13,0,27,1350
MÉXICO,CIUDAD ADOLFO LOPEZ MATEOS,18,199,5,222,1416
MÉXICO,CIUDAD ADOLFO LOPEZ MATEOS,15,229,3,247,1416
MÉXICO,CIUDAD ADOLFO LOPEZ MATEOS,20,200,7,227,1388
MÉXICO,CIUDAD ADOLFO LOPEZ MATEOS,19,203,4,226,1388
MÉXICO,CIUDAD ADOLFO LOPEZ MATEOS,7,173,0,180,1754
MÉXICO,CIUDAD ADOLFO LOPEZ MATEOS,12,176,2,190,1753
MÉXICO,CIUDAD ADOLFO LOPEZ MATEOS,27,205,3,235,1554
MÉXICO,CIUDAD ADOLFO LOPEZ MATEOS,13,181,5,199,1554
MÉXICO,CIUDAD ADOLFO LOPEZ MATEOS,25,174,1,200,1657
MÉXICO,CIUDAD ADOLFO LOPEZ MATEOS,26,143,1,170,1656
MÉXICO,CIUDAD ADOLFO LOPEZ MATEOS,22,316,11,349,1962
MÉXICO,CIUDAD ADOLFO LOPEZ MATEOS,27,283,8,318,1929
MÉXICO,CIUDAD ADOLFO LOPEZ MATEOS,25,235,4,264,1929
MÉXICO,CIUDAD ADOLFO LOPEZ MATEOS,24,148,1,173,1341
MÉXICO,CIUDAD ADOLFO LOPEZ MATEOS,23,193,3,219,1341
MÉXICO,CIUDAD ADOLFO LOPEZ MATEOS,27,168,4,199,1396
MÉXICO,CIUDAD ADOLFO LOPEZ MATEOS,14,180,1,195,1395
MÉXICO,CIUDAD ADOLFO LOPEZ MATEOS,16,139,1,156,1345
MÉXICO,CIUDAD ADOLFO LOPEZ MATEOS,20,147,2,169,1344
MÉXICO,CIUDAD ADOLFO LOPEZ MATEOS,28,146,0,174,1344
MÉXICO,CIUDAD ADOLFO LOPEZ MATEOS,36,167,4,207,1898
MÉXICO,CIUDAD ADOLFO LOPEZ MATEOS,30,227,7,264,1898
MÉXICO,CIUDAD ADOLFO LOPEZ MATEOS,24,179,0,203,1510
MÉXICO,CIUDAD ADOLFO LOPEZ MATEOS,19,192,2,213,1509
MÉXICO,CIUDAD ADOLFO LOPEZ MATEOS,20,190,3,213,1377
MÉXICO,CIUDAD ADOLFO LOPEZ MATEOS,20,183,4,207,1377
MÉXICO,CIUDAD ADOLFO LOPEZ MATEOS,17,197,5,219,1338
MÉXICO,CIUDAD ADOLFO LOPEZ MATEOS,21,170,1,192,1337
MÉXICO,CIUDAD ADOLFO LOPEZ MATEOS,14,185,6,205,1581
MÉXICO,CIUDAD ADOLFO LOPEZ MATEOS,15,222,8,245,1581
MÉXICO,CIUDAD ADOLFO LOPEZ MATEOS,26,225,1,252,1512
MÉXICO,CIUDAD ADOLFO LOPEZ MATEOS,27,226,8,261,1511
MÉXICO,CIUDAD ADOLFO LOPEZ MATEOS,32,245,4,281,1659
MÉXICO,CIUDAD ADOLFO LOPEZ MATEOS,23,262,2,287,1658
MÉXICO,CIUDAD ADOLFO LOPEZ MATEOS,26,256,8,290,1786
MÉXICO,CIUDAD ADOLFO LOPEZ MATEOS,22,287,2,311,1786
MÉXICO,CIUDAD ADOLFO LOPEZ MATEOS,21,249,3,273,1932
MÉXICO,CIUDAD ADOLFO LOPEZ MATEOS,32,244,1,277,1931
MÉXICO,CIUDAD ADOLFO LOPEZ MATEOS,24,258,2,284,1931
MÉXICO,CIUDAD ADOLFO LOPEZ MATEOS,15,174,1,190,1277
MÉXICO,CIUDAD ADOLFO LOPEZ MATEOS,9,195,2,206,1276
MÉXICO,CIUDAD ADOLFO LOPEZ MATEOS,20,182,2,204,1441
MÉXICO,CIUDAD ADOLFO LOPEZ MATEOS,28,174,2,204,1440
MÉXICO,CIUDAD ADOLFO LOPEZ MATEOS,19,166,5,190,1440
MÉXICO,CIUDAD ADOLFO LOPEZ MATEOS,13,200,0,213,1906
MÉXICO,CIUDAD ADOLFO LOPEZ MATEOS,9,183,2,194,1906
MÉXICO,CIUDAD ADOLFO LOPEZ MATEOS,15,220,2,237,1905
MÉXICO,CIUDAD ADOLFO LOPEZ MATEOS,20,210,8,238,1905
MÉXICO,CIUDAD ADOLFO LOPEZ MATEOS,24,217,4,245,1905
MÉXICO,CIUDAD ADOLFO LOPEZ MATEOS,18,208,3,229,1905
MÉXICO,CIUDAD ADOLFO LOPEZ MATEOS,13,165,7,185,1559
MÉXICO,CIUDAD ADOLFO LOPEZ MATEOS,21,192,2,215,1559
MÉXICO,CIUDAD ADOLFO LOPEZ MATEOS,26,227,10,263,1833
MÉXICO,CIUDAD ADOLFO LOPEZ MATEOS,18,204,3,225,1832
MÉXICO,CIUDAD ADOLFO LOPEZ MATEOS,17,188,6,211,1489
MÉXICO,CIUDAD ADOLFO LOPEZ MATEOS,18,227,4,249,1488
MÉXICO,CIUDAD ADOLFO LOPEZ MATEOS,22,203,2,227,1894
MÉXICO,CIUDAD ADOLFO LOPEZ MATEOS,22,245,2,269,1894
MÉXICO,CIUDAD ADOLFO LOPEZ MATEOS,35,231,5,271,1893
MÉXICO,CIUDAD ADOLFO LOPEZ MATEOS,20,161,5,186,1224
MÉXICO,CIUDAD ADOLFO LOPEZ MATEOS,11,158,6,175,1223
MÉXICO,CIUDAD ADOLFO LOPEZ MATEOS,39,303,3,345,1972
MÉXICO,CIUDAD ADOLFO LOPEZ MATEOS,25,284,7,316,1972
MÉXICO,CIUDAD ADOLFO LOPEZ MATEOS,40,51,1,92,1724
MÉXICO,CIUDAD ADOLFO LOPEZ MATEOS,30,61,1,92,1724
MÉXICO,CIUDAD ADOLFO LOPEZ MATEOS,21,81,0,102,1723
MÉXICO,CIUDAD ADOLFO LOPEZ MATEOS,29,48,1,78,1925
MÉXICO,CIUDAD ADOLFO LOPEZ MATEOS,23,48,1,72,1924
MÉXICO,CIUDAD ADOLFO LOPEZ MATEOS,18,53,2,73,1924
MÉXICO,CIUDAD ADOLFO LOPEZ MATEOS,22,198,5,225,1374
MÉXICO,CIUDAD ADOLFO LOPEZ MATEOS,16,184,4,204,1374
MÉXICO,CIUDAD ADOLFO LOPEZ MATEOS,9,178,4,191,1373
MÉXICO,CIUDAD ADOLFO LOPEZ MATEOS,21,233,5,259,1846
MÉXICO,CIUDAD ADOLFO LOPEZ MATEOS,21,233,3,257,1846
MÉXICO,CIUDAD ADOLFO LOPEZ MATEOS,19,206,4,229,1377
MÉXICO,CIUDAD ADOLFO LOPEZ MATEOS,13,167,4,184,1377
MÉXICO,CIUDAD ADOLFO LOPEZ MATEOS,17,161,5,183,1377
MÉXICO,CIUDAD ADOLFO LOPEZ MATEOS,12,193,2,207,1889
MÉXICO,CIUDAD ADOLFO LOPEZ MATEOS,13,197,6,216,1888
MÉXICO,CIUDAD ADOLFO LOPEZ MATEOS,21,161,0,182,1888
MÉXICO,CIUDAD ADOLFO LOPEZ MATEOS,14,232,2,248,1723
MÉXICO,CIUDAD ADOLFO LOPEZ MATEOS,14,265,1,280,1723
MÉXICO,CIUDAD ADOLFO LOPEZ MATEOS,18,245,5,268,1366
MÉXICO,CIUDAD ADOLFO LOPEZ MATEOS,24,262,6,292,1366
MÉXICO,CIUDAD ADOLFO LOPEZ MATEOS,22,219,1,242,1394
MÉXICO,CIUDAD ADOLFO LOPEZ MATEOS,20,193,5,218,1393
MÉXICO,CIUDAD ADOLFO LOPEZ MATEOS,14,189,1,204,1321
MÉXICO,CIUDAD ADOLFO LOPEZ MATEOS,28,200,4,232,1321
MÉXICO,CIUDAD ADOLFO LOPEZ MATEOS,19,233,4,256,1652
MÉXICO,CIUDAD ADOLFO LOPEZ MATEOS,35,228,2,265,1651
MÉXICO,CIUDAD ADOLFO LOPEZ MATEOS,15,181,4,200,1596
MÉXICO,CIUDAD ADOLFO LOPEZ MATEOS,20,206,3,229,1595
MÉXICO,CIUDAD ADOLFO LOPEZ MATEOS,15,199,2,216,1595
MÉXICO,CIUDAD ADOLFO LOPEZ MATEOS,23,278,4,305,1887
MÉXICO,CIUDAD ADOLFO LOPEZ MATEOS,21,271,5,297,1886
MÉXICO,CIUDAD ADOLFO LOPEZ MATEOS,20,186,2,208,1514
MÉXICO,CIUDAD ADOLFO LOPEZ MATEOS,13,195,3,211,1514
MÉXICO,CIUDAD ADOLFO LOPEZ MATEOS,25,261,2,288,1866
MÉXICO,CIUDAD ADOLFO LOPEZ MATEOS,26,266,5,297,1865
MÉXICO,CIUDAD ADOLFO LOPEZ MATEOS,19,131,0,150,1216
MÉXICO,CIUDAD ADOLFO LOPEZ MATEOS,13,134,0,147,1216
MÉXICO,CIUDAD ADOLFO LOPEZ MATEOS,19,156,2,177,1650
MÉXICO,CIUDAD ADOLFO LOPEZ MATEOS,16,160,0,176,1650
MÉXICO,CIUDAD ADOLFO LOPEZ MATEOS,19,188,4,211,1650
MÉXICO,CIUDAD ADOLFO LOPEZ MATEOS,11,179,7,197,1649
MÉXICO,CIUDAD ADOLFO LOPEZ MATEOS,15,165,4,184,1430
MÉXICO,CIUDAD ADOLFO LOPEZ MATEOS,18,162,0,180,1429
MÉXICO,CIUDAD ADOLFO LOPEZ MATEOS,18,137,1,156,1429
MÉXICO,CIUDAD ADOLFO LOPEZ MATEOS,25,206,0,231,1623
MÉXICO,CIUDAD ADOLFO LOPEZ MATEOS,9,192,0,201,1622
MÉXICO,CIUDAD ADOLFO LOPEZ MATEOS,24,115,0,139,1110
MÉXICO,CIUDAD ADOLFO LOPEZ MATEOS,12,116,2,130,1109
MÉXICO,CIUDAD ADOLFO LOPEZ MATEOS,12,99,3,114,1016
MÉXICO,CIUDAD ADOLFO LOPEZ MATEOS,14,118,2,134,1016
MÉXICO,CIUDAD ADOLFO LOPEZ MATEOS,27,229,4,260,1551
MÉXICO,CIUDAD ADOLFO LOPEZ MATEOS,16,190,0,206,1551
MÉXICO,CIUDAD ADOLFO LOPEZ MATEOS,20,233,6,259,1551
MÉXICO,CIUDAD ADOLFO LOPEZ MATEOS,33,286,2,321,1899
MÉXICO,CIUDAD ADOLFO LOPEZ MATEOS,25,256,1,282,1898
MÉXICO,CIUDAD ADOLFO LOPEZ MATEOS,45,212,3,260,1785
MÉXICO,CIUDAD ADOLFO LOPEZ MATEOS,47,193,3,243,1784
MÉXICO,CIUDAD ADOLFO LOPEZ MATEOS,9,113,1,123,1101
MÉXICO,CIUDAD ADOLFO LOPEZ MATEOS,12,125,9,146,1101
MÉXICO,CIUDAD ADOLFO LOPEZ MATEOS,22,202,3,227,1605
MÉXICO,CIUDAD ADOLFO LOPEZ MATEOS,19,170,3,192,1604
MÉXICO,CIUDAD ADOLFO LOPEZ MATEOS,13,122,3,138,1139
MÉXICO,CIUDAD ADOLFO LOPEZ MATEOS,22,139,3,164,1138
MÉXICO,CIUDAD ADOLFO LOPEZ MATEOS,24,218,2,244,1631
MÉXICO,CIUDAD ADOLFO LOPEZ MATEOS,34,179,3,216,1630
MÉXICO,CIUDAD ADOLFO LOPEZ MATEOS,29,212,3,244,1963
MÉXICO,CIUDAD ADOLFO LOPEZ MATEOS,26,220,4,250,1962
MÉXICO,CIUDAD ADOLFO LOPEZ MATEOS,7,55,0,62,998
MÉXICO,CIUDAD ADOLFO LOPEZ MATEOS,14,89,0,103,997
MÉXICO,CIUDAD ADOLFO LOPEZ MATEOS,22,187,2,211,1701
MÉXICO,CIUDAD ADOLFO LOPEZ MATEOS,33,148,8,189,1701
MÉXICO,CIUDAD ADOLFO LOPEZ MATEOS,52,588,3,643,0
MÉXICO,CIUDAD ADOLFO LOPEZ MATEOS,36,244,2,282,1748
MÉXICO,CIUDAD ADOLFO LOPEZ MATEOS,11,167,0,178,1124
MÉXICO,CIUDAD ADOLFO LOPEZ MATEOS,21,141,2,164,1123
MÉXICO,CIUDAD ADOLFO LOPEZ MATEOS,15,114,3,132,995
MÉXICO,CIUDAD ADOLFO LOPEZ MATEOS,16,118,4,138,994
MÉXICO,CIUDAD ADOLFO LOPEZ MATEOS,22,154,1,177,1235
MÉXICO,CIUDAD ADOLFO LOPEZ MATEOS,22,137,0,159,1235
MÉXICO,CIUDAD ADOLFO LOPEZ MATEOS,23,168,6,197,1845
MÉXICO,CIUDAD ADOLFO LOPEZ MATEOS,13,211,3,227,1844
MÉXICO,CIUDAD ADOLFO LOPEZ MATEOS,9,238,3,250,1940
MÉXICO,CIUDAD ADOLFO LOPEZ MATEOS,11,198,0,209,1373
MÉXICO,CIUDAD ADOLFO LOPEZ MATEOS,16,221,3,240,1373
MÉXICO,CIUDAD ADOLFO LOPEZ MATEOS,17,174,3,194,1273
MÉXICO,CIUDAD ADOLFO LOPEZ MATEOS,22,165,3,190,1273
MÉXICO,CIUDAD ADOLFO LOPEZ MATEOS,21,138,1,160,1204
MÉXICO,CIUDAD ADOLFO LOPEZ MATEOS,21,170,1,192,1204
MÉXICO,CIUDAD ADOLFO LOPEZ MATEOS,12,200,1,213,1403
MÉXICO,CIUDAD ADOLFO LOPEZ MATEOS,22,207,3,232,1402
MÉXICO,CIUDAD ADOLFO LOPEZ MATEOS,38,388,1,427,1621
MÉXICO,CIUDAD ADOLFO LOPEZ MATEOS,25,385,7,417,1620
MÉXICO,CIUDAD ADOLFO LOPEZ MATEOS,35,338,3,376,1672
MÉXICO,CIUDAD ADOLFO LOPEZ MATEOS,12,352,2,366,1672
MÉXICO,CIUDAD ADOLFO LOPEZ MATEOS,42,195,0,237,1664
MÉXICO,CIUDAD ADOLFO LOPEZ MATEOS,48,198,2,248,1664
MÉXICO,CIUDAD ADOLFO LOPEZ MATEOS,18,204,6,228,1827
MÉXICO,CIUDAD ADOLFO LOPEZ MATEOS,28,235,3,266,1827
MÉXICO,CIUDAD ADOLFO LOPEZ MATEOS,25,156,3,184,1109
MÉXICO,CIUDAD ADOLFO LOPEZ MATEOS,20,150,3,173,1108
MÉXICO,CIUDAD ADOLFO LOPEZ MATEOS,18,108,3,129,1295
MÉXICO,CIUDAD ADOLFO LOPEZ MATEOS,28,103,0,131,1294
MÉXICO,CIUDAD ADOLFO LOPEZ MATEOS,39,172,0,211,1729
MÉXICO,CIUDAD ADOLFO LOPEZ MATEOS,20,342,2,364,1527
MÉXICO,CIUDAD ADOLFO LOPEZ MATEOS,16,299,0,315,1526
MÉXICO,CIUDAD ADOLFO LOPEZ MATEOS,19,313,0,332,1526
MÉXICO,CIUDAD ADOLFO LOPEZ MATEOS,25,213,3,241,1896
MÉXICO,CIUDAD ADOLFO LOPEZ MATEOS,33,180,0,213,1895
MÉXICO,CIUDAD ADOLFO LOPEZ MATEOS,41,174,3,218,1958
MÉXICO,CIUDAD ADOLFO LOPEZ MATEOS,36,202,5,243,1958
MÉXICO,CIUDAD ADOLFO LOPEZ MATEOS,53,151,1,205,1732
MÉXICO,CIUDAD ADOLFO LOPEZ MATEOS,40,161,3,204,1731
MÉXICO,CIUDAD ADOLFO LOPEZ MATEOS,33,185,3,221,1623
MÉXICO,CIUDAD ADOLFO LOPEZ MATEOS,26,159,1,186,1623
MÉXICO,CIUDAD ADOLFO LOPEZ MATEOS,18,113,0,131,1197
MÉXICO,CIUDAD ADOLFO LOPEZ MATEOS,21,117,0,138,1196
MÉXICO,CIUDAD ADOLFO LOPEZ MATEOS,48,230,5,283,1836
MÉXICO,CIUDAD ADOLFO LOPEZ MATEOS,20,159,1,180,1495
MÉXICO,CIUDAD ADOLFO LOPEZ MATEOS,27,157,4,188,1495
MÉXICO,CIUDAD ADOLFO LOPEZ MATEOS,30,150,2,182,1316
MÉXICO,CIUDAD ADOLFO LOPEZ MATEOS,24,159,1,184,1316
MÉXICO,CIUDAD ADOLFO LOPEZ MATEOS,13,130,1,144,1374
MÉXICO,CIUDAD ADOLFO LOPEZ MATEOS,16,164,2,182,1374
MÉXICO,CIUDAD ADOLFO LOPEZ MATEOS,14,138,2,154,1373
MÉXICO,CIUDAD ADOLFO LOPEZ MATEOS,21,67,0,88,1386
MÉXICO,CIUDAD ADOLFO LOPEZ MATEOS,28,93,4,125,1385
MÉXICO,CIUDAD ADOLFO LOPEZ MATEOS,28,158,0,186,1353
MÉXICO,CIUDAD ADOLFO LOPEZ MATEOS,19,191,4,214,1352
MÉXICO,CIUDAD ADOLFO LOPEZ MATEOS,23,150,3,176,1922
MÉXICO,CIUDAD ADOLFO LOPEZ MATEOS,18,145,4,167,1921
MÉXICO,CIUDAD ADOLFO LOPEZ MATEOS,19,139,2,160,1921
MÉXICO,CIUDAD ADOLFO LOPEZ MATEOS,25,169,0,194,1619
MÉXICO,CIUDAD ADOLFO LOPEZ MATEOS,23,114,6,143,1648
MÉXICO,CIUDAD ADOLFO LOPEZ MATEOS,23,113,1,137,1648
MÉXICO,CIUDAD ADOLFO LOPEZ MATEOS,36,161,4,201,1720
MÉXICO,CIUDAD ADOLFO LOPEZ MATEOS,22,194,4,220,1720
MÉXICO,CIUDAD ADOLFO LOPEZ MATEOS,18,147,1,166,1593
MÉXICO,CIUDAD ADOLFO LOPEZ MATEOS,19,157,1,177,1593
MÉXICO,CIUDAD ADOLFO LOPEZ MATEOS,20,138,0,158,1526
MÉXICO,CIUDAD ADOLFO LOPEZ MATEOS,27,124,1,152,1525
MÉXICO,CIUDAD ADOLFO LOPEZ MATEOS,29,68,2,99,1901
MÉXICO,CIUDAD ADOLFO LOPEZ MATEOS,31,77,0,108,1901
MÉXICO,CIUDAD ADOLFO LOPEZ MATEOS,23,117,2,142,1120
MÉXICO,CIUDAD ADOLFO LOPEZ MATEOS,23,123,1,147,1119
MÉXICO,CIUDAD ADOLFO LOPEZ MATEOS,26,34,2,62,1686
MÉXICO,CIUDAD ADOLFO LOPEZ MATEOS,20,46,1,67,1686
MÉXICO,CIUDAD ADOLFO LOPEZ MATEOS,18,68,1,87,1686
MÉXICO,CIUDAD ADOLFO LOPEZ MATEOS,21,44,0,65,1685
MÉXICO,CIUDAD ADOLFO LOPEZ MATEOS,21,222,4,247,1797
MÉXICO,CIUDAD ADOLFO LOPEZ MATEOS,16,228,4,248,1797
MÉXICO,CIUDAD ADOLFO LOPEZ MATEOS,7,177,1,185,989
MÉXICO,CIUDAD ADOLFO LOPEZ MATEOS,10,135,0,145,988
MÉXICO,ECATEPEC DE MORELOS,28,232,5,265,1384
MÉXICO,ECATEPEC DE MORELOS,19,215,4,238,1384
MÉXICO,ECATEPEC DE MORELOS,12,247,5,264,1419
MÉXICO,ECATEPEC DE MORELOS,14,232,1,247,1419
MÉXICO,ECATEPEC DE MORELOS,242,17,3,262,1419
MÉXICO,ECATEPEC DE MORELOS,19,194,8,221,1349
MÉXICO,ECATEPEC DE MORELOS,19,220,2,241,1348
MÉXICO,ECATEPEC DE MORELOS,35,236,5,276,1348
MÉXICO,ECATEPEC DE MORELOS,15,179,8,202,1217
MÉXICO,ECATEPEC DE MORELOS,15,159,0,174,1216
MÉXICO,ECATEPEC DE MORELOS,18,195,3,216,1449
MÉXICO,ECATEPEC DE MORELOS,16,165,6,187,1448
MÉXICO,ECATEPEC DE MORELOS,26,208,3,237,1099
MÉXICO,ECATEPEC DE MORELOS,16,181,0,197,1098
MÉXICO,ECATEPEC DE MORELOS,18,212,8,238,1520
MÉXICO,ECATEPEC DE MORELOS,28,203,6,237,1519
MÉXICO,ECATEPEC DE MORELOS,24,274,5,303,1843
MÉXICO,ECATEPEC DE MORELOS,17,223,7,247,1842
MÉXICO,ECATEPEC DE MORELOS,25,267,4,296,1371
MÉXICO,ECATEPEC DE MORELOS,27,229,1,257,1371
MÉXICO,ECATEPEC DE MORELOS,26,221,6,253,1370
MÉXICO,ECATEPEC DE MORELOS,18,190,12,220,1478
MÉXICO,ECATEPEC DE MORELOS,8,191,5,204,1477
MÉXICO,ECATEPEC DE MORELOS,12,210,6,228,1364
MÉXICO,ECATEPEC DE MORELOS,15,216,8,239,1364
MÉXICO,ECATEPEC DE MORELOS,14,178,1,193,1027
MÉXICO,ECATEPEC DE MORELOS,14,169,0,183,1027
MÉXICO,ECATEPEC DE MORELOS,22,169,2,193,1009
MÉXICO,ECATEPEC DE MORELOS,19,160,2,181,1009
MÉXICO,ECATEPEC DE MORELOS,12,150,4,166,1238
MÉXICO,ECATEPEC DE MORELOS,10,173,1,184,1238
MÉXICO,ECATEPEC DE MORELOS,20,205,4,229,1608
MÉXICO,ECATEPEC DE MORELOS,16,183,4,203,1608
MÉXICO,ECATEPEC DE MORELOS,7,158,3,168,1608
MÉXICO,ECATEPEC DE MORELOS,23,191,3,217,1608
MÉXICO,ECATEPEC DE MORELOS,24,209,3,236,1365
MÉXICO,ECATEPEC DE MORELOS,19,188,4,211,1364
MÉXICO,ECATEPEC DE MORELOS,17,224,7,248,1677
MÉXICO,ECATEPEC DE MORELOS,17,230,4,251,1677
MÉXICO,ECATEPEC DE MORELOS,10,162,2,174,1081
MÉXICO,ECATEPEC DE MORELOS,13,171,0,184,1080
MÉXICO,ECATEPEC DE MORELOS,18,163,2,183,1009
MÉXICO,ECATEPEC DE MORELOS,15,158,6,179,1008
MÉXICO,ECATEPEC DE MORELOS,15,158,0,173,1068
MÉXICO,ECATEPEC DE MORELOS,14,183,3,200,1068
MÉXICO,ECATEPEC DE MORELOS,27,202,2,231,1304
MÉXICO,ECATEPEC DE MORELOS,21,174,1,196,1303
MÉXICO,ECATEPEC DE MORELOS,14,181,0,195,1062
MÉXICO,ECATEPEC DE MORELOS,12,196,2,210,1062
MÉXICO,ECATEPEC DE MORELOS,30,298,8,336,1972
MÉXICO,ECATEPEC DE MORELOS,7,185,2,194,1094
MÉXICO,ECATEPEC DE MORELOS,11,176,2,189,1093
MÉXICO,ECATEPEC DE MORELOS,10,122,4,136,1188
MÉXICO,ECATEPEC DE MORELOS,13,135,4,152,1187
MÉXICO,ECATEPEC DE MORELOS,17,235,5,257,1968
MÉXICO,ECATEPEC DE MORELOS,17,257,2,276,1968
MÉXICO,ECATEPEC DE MORELOS,11,289,4,304,1967
MÉXICO,ECATEPEC DE MORELOS,9,173,2,184,1437
MÉXICO,ECATEPEC DE MORELOS,11,195,2,208,1436
MÉXICO,ECATEPEC DE MORELOS,23,303,1,327,1920
MÉXICO,ECATEPEC DE MORELOS,23,324,6,353,1919
MÉXICO,ECATEPEC DE MORELOS,27,333,2,362,1964
MÉXICO,ECATEPEC DE MORELOS,32,319,4,355,1964
MÉXICO,ECATEPEC DE MORELOS,28,197,1,226,1322
MÉXICO,ECATEPEC DE MORELOS,15,264,4,283,1321
MÉXICO,ECATEPEC DE MORELOS,27,206,3,236,1321
MÉXICO,ECATEPEC DE MORELOS,20,269,3,292,1816
MÉXICO,ECATEPEC DE MORELOS,17,279,4,300,1815
MÉXICO,ECATEPEC DE MORELOS,14,156,6,176,1011
MÉXICO,ECATEPEC DE MORELOS,19,157,2,178,1010
MÉXICO,ECATEPEC DE MORELOS,27,227,1,255,1575
MÉXICO,ECATEPEC DE MORELOS,38,261,6,305,1575
MÉXICO,ECATEPEC DE MORELOS,11,260,2,273,1626
MÉXICO,ECATEPEC DE MORELOS,15,231,1,247,1626
MÉXICO,ECATEPEC DE MORELOS,24,225,1,250,1625
MÉXICO,ECATEPEC DE MORELOS,13,161,0,174,1232
MÉXICO,ECATEPEC DE MORELOS,18,180,2,200,1232
MÉXICO,ECATEPEC DE MORELOS,32,219,12,263,1778
MÉXICO,ECATEPEC DE MORELOS,35,237,6,278,1778
MÉXICO,ECATEPEC DE MORELOS,20,235,5,260,1778
MÉXICO,ECATEPEC DE MORELOS,11,221,4,236,1751
MÉXICO,ECATEPEC DE MORELOS,34,247,2,283,1751
MÉXICO,ECATEPEC DE MORELOS,29,231,7,267,1751
MÉXICO,ECATEPEC DE MORELOS,14,158,6,178,1213
MÉXICO,ECATEPEC DE MORELOS,22,182,4,208,1213
MÉXICO,ECATEPEC DE MORELOS,26,253,4,283,1857
MÉXICO,ECATEPEC DE MORELOS,24,267,10,301,1856
MÉXICO,ECATEPEC DE MORELOS,29,196,5,230,1691
MÉXICO,ECATEPEC DE MORELOS,21,215,7,243,1691
MÉXICO,ECATEPEC DE MORELOS,19,242,5,266,1691
MÉXICO,ECATEPEC DE MORELOS,20,173,1,194,1302
MÉXICO,ECATEPEC DE MORELOS,16,185,4,205,1302
MÉXICO,ECATEPEC DE MORELOS,28,195,5,228,1332
MÉXICO,ECATEPEC DE MORELOS,27,174,2,203,1332
MÉXICO,ECATEPEC DE MORELOS,25,179,6,210,1331
MÉXICO,ECATEPEC DE MORELOS,13,228,8,249,1679
MÉXICO,ECATEPEC DE MORELOS,13,232,7,252,1679
MÉXICO,ECATEPEC DE MORELOS,32,260,4,296,1679
MÉXICO,ECATEPEC DE MORELOS,13,227,9,249,1679
MÉXICO,ECATEPEC DE MORELOS,20,245,4,269,1678
MÉXICO,ECATEPEC DE MORELOS,13,151,4,168,1021
MÉXICO,ECATEPEC DE MORELOS,16,120,0,136,1021
MÉXICO,ECATEPEC DE MORELOS,22,183,0,205,1853
MÉXICO,ECATEPEC DE MORELOS,22,189,3,214,1853
MÉXICO,ECATEPEC DE MORELOS,12,219,4,235,1593
MÉXICO,ECATEPEC DE MORELOS,27,257,4,288,1592
MÉXICO,ECATEPEC DE MORELOS,18,203,2,223,1305
MÉXICO,ECATEPEC DE MORELOS,9,158,1,168,1305
MÉXICO,ECATEPEC DE MORELOS,16,216,3,235,1609
MÉXICO,ECATEPEC DE MORELOS,16,209,3,228,1609
MÉXICO,ECATEPEC DE MORELOS,14,209,8,231,1583
MÉXICO,ECATEPEC DE MORELOS,15,208,8,231,1583
MÉXICO,ECATEPEC DE MORELOS,27,223,4,254,1242
MÉXICO,ECATEPEC DE MORELOS,13,202,1,216,1242
MÉXICO,ECATEPEC DE MORELOS,19,139,3,161,1214
MÉXICO,ECATEPEC DE MORELOS,13,150,6,169,1213
MÉXICO,ECATEPEC DE MORELOS,24,265,13,302,1905
MÉXICO,ECATEPEC DE MORELOS,8,221,1,230,1382
MÉXICO,ECATEPEC DE MORELOS,17,183,9,209,1381
MÉXICO,ECATEPEC DE MORELOS,14,235,3,252,1841
MÉXICO,ECATEPEC DE MORELOS,14,212,4,230,1841
MÉXICO,ECATEPEC DE MORELOS,8,234,6,248,1840
MÉXICO,ECATEPEC DE MORELOS,30,266,1,297,1933
MÉXICO,ECATEPEC DE MORELOS,24,213,5,242,1553
MÉXICO,ECATEPEC DE MORELOS,17,224,7,248,1552
MÉXICO,ECATEPEC DE MORELOS,28,449,5,482,1552
MÉXICO,ECATEPEC DE MORELOS,22,269,3,294,1958
MÉXICO,ECATEPEC DE MORELOS,12,223,0,235,1806
MÉXICO,ECATEPEC DE MORELOS,13,223,1,237,1806
MÉXICO,ECATEPEC DE MORELOS,16,211,1,228,1355
MÉXICO,ECATEPEC DE MORELOS,20,197,5,222,1355
MÉXICO,ECATEPEC DE MORELOS,12,193,2,207,1354
MÉXICO,ECATEPEC DE MORELOS,29,236,4,269,1947
MÉXICO,ECATEPEC DE MORELOS,27,263,4,294,1947
MÉXICO,ECATEPEC DE MORELOS,11,184,3,198,1169
MÉXICO,ECATEPEC DE MORELOS,8,166,5,179,1168
MÉXICO,ECATEPEC DE MORELOS,14,235,5,254,1940
MÉXICO,ECATEPEC DE MORELOS,19,206,3,228,1940
MÉXICO,ECATEPEC DE MORELOS,13,200,5,218,1507
MÉXICO,ECATEPEC DE MORELOS,14,200,5,219,1507
MÉXICO,ECATEPEC DE MORELOS,20,203,3,226,1507
MÉXICO,ECATEPEC DE MORELOS,16,151,1,168,1537
MÉXICO,ECATEPEC DE MORELOS,16,174,6,196,1537
MÉXICO,ECATEPEC DE MORELOS,16,215,5,236,1362
MÉXICO,ECATEPEC DE MORELOS,9,190,2,201,1361
MÉXICO,ECATEPEC DE MORELOS,19,212,3,234,1738
MÉXICO,ECATEPEC DE MORELOS,18,176,6,200,1738
MÉXICO,ECATEPEC DE MORELOS,19,142,2,163,1286
MÉXICO,ECATEPEC DE MORELOS,9,151,1,161,1286
MÉXICO,ECATEPEC DE MORELOS,25,204,3,232,1828
MÉXICO,ECATEPEC DE MORELOS,13,209,4,226,1828
MÉXICO,ECATEPEC DE MORELOS,29,194,5,228,1555
MÉXICO,ECATEPEC DE MORELOS,18,164,7,189,1554
MÉXICO,ECATEPEC DE MORELOS,25,167,4,196,1106
MÉXICO,ECATEPEC DE MORELOS,18,218,5,241,1106
MÉXICO,ECATEPEC DE MORELOS,21,185,4,210,1658
MÉXICO,ECATEPEC DE MORELOS,28,228,5,261,1658
MÉXICO,ECATEPEC DE MORELOS,25,420,9,454,0
MÉXICO,ECATEPEC DE MORELOS,16,293,4,313,1617
MÉXICO,ECATEPEC DE MORELOS,23,252,6,281,1904
MÉXICO,ECATEPEC DE MORELOS,26,235,5,266,1903
MÉXICO,ECATEPEC DE MORELOS,18,260,4,282,1903
MÉXICO,ECATEPEC DE MORELOS,27,262,8,297,1913
MÉXICO,ECATEPEC DE MORELOS,31,220,6,257,1913
MÉXICO,ECATEPEC DE MORELOS,25,238,1,264,1912
MÉXICO,ECATEPEC DE MORELOS,20,185,2,207,1375
MÉXICO,ECATEPEC DE MORELOS,26,179,12,217,1375
MÉXICO,ECATEPEC DE MORELOS,29,314,5,348,1899
MÉXICO,ECATEPEC DE MORELOS,33,282,0,315,1898
MÉXICO,ECATEPEC DE MORELOS,22,235,2,259,1791
MÉXICO,ECATEPEC DE MORELOS,21,250,2,273,1791
MÉXICO,ECATEPEC DE MORELOS,18,273,5,296,1725
MÉXICO,ECATEPEC DE MORELOS,27,246,1,274,1725
MÉXICO,ECATEPEC DE MORELOS,46,269,3,318,1658
MÉXICO,ECATEPEC DE MORELOS,21,209,10,240,1658
MÉXICO,ECATEPEC DE MORELOS,19,222,6,247,1657
MÉXICO,ECATEPEC DE MORELOS,31,285,2,318,1719
MÉXICO,ECATEPEC DE MORELOS,16,258,3,277,1719
MÉXICO,ECATEPEC DE MORELOS,15,214,6,235,1675
MÉXICO,ECATEPEC DE MORELOS,18,205,1,224,1675
MÉXICO,ECATEPEC DE MORELOS,22,215,4,241,1654
MÉXICO,ECATEPEC DE MORELOS,17,234,0,251,1653
MÉXICO,ECATEPEC DE MORELOS,11,270,2,283,1818
MÉXICO,ECATEPEC DE MORELOS,25,307,5,337,1818
MÉXICO,ECATEPEC DE MORELOS,9,228,10,247,1922
MÉXICO,ECATEPEC DE MORELOS,25,242,2,269,1922
MÉXICO,ECATEPEC DE MORELOS,6,148,5,159,1038
MÉXICO,ECATEPEC DE MORELOS,10,155,2,167,1038
MÉXICO,ECATEPEC DE MORELOS,9,183,5,197,1483
MÉXICO,ECATEPEC DE MORELOS,8,128,4,140,1482
MÉXICO,ECATEPEC DE MORELOS,8,146,1,155,1482
MÉXICO,ECATEPEC DE MORELOS,28,355,2,385,2027
MÉXICO,ECATEPEC DE MORELOS,24,320,7,351,2027
MÉXICO,ECATEPEC DE MORELOS,14,237,2,253,1489
MÉXICO,ECATEPEC DE MORELOS,27,181,2,210,1092
MÉXICO,ECATEPEC DE MORELOS,17,200,8,225,1091
MÉXICO,ECATEPEC DE MORELOS,43,325,5,373,1784
MÉXICO,ECATEPEC DE MORELOS,38,340,9,387,1851
MÉXICO,ECATEPEC DE MORELOS,22,276,7,305,1711
MÉXICO,ECATEPEC DE MORELOS,26,248,2,276,1710
MÉXICO,ECATEPEC DE MORELOS,25,371,4,400,2072
MÉXICO,ECATEPEC DE MORELOS,27,329,3,359,2072
MÉXICO,ECATEPEC DE MORELOS,32,274,2,308,1494
MÉXICO,ECATEPEC DE MORELOS,31,178,1,210,1270
MÉXICO,ECATEPEC DE MORELOS,29,201,2,232,1270
MÉXICO,ECATEPEC DE MORELOS,49,321,10,380,1826
MÉXICO,ECATEPEC DE MORELOS,30,271,3,304,1424
MÉXICO,ECATEPEC DE MORELOS,26,244,4,274,1423
MÉXICO,ECATEPEC DE MORELOS,24,215,1,240,1588
MÉXICO,ECATEPEC DE MORELOS,19,217,5,241,1555
MÉXICO,ECATEPEC DE MORELOS,15,268,2,285,1500
MÉXICO,ECATEPEC DE MORELOS,37,279,2,318,2067
MÉXICO,ECATEPEC DE MORELOS,27,276,8,311,2066
MÉXICO,ECATEPEC DE MORELOS,34,300,1,335,1525
MÉXICO,ECATEPEC DE MORELOS,21,214,4,239,1431
MÉXICO,ECATEPEC DE MORELOS,22,217,5,244,1430
MÉXICO,ECATEPEC DE MORELOS,25,231,1,257,1648
MÉXICO,ECATEPEC DE MORELOS,40,298,3,341,1845
MÉXICO,ECATEPEC DE MORELOS,42,291,7,340,1844
MÉXICO,ECATEPEC DE MORELOS,19,259,4,282,1696
MÉXICO,ECATEPEC DE MORELOS,22,257,1,280,1643
MÉXICO,ECATEPEC DE MORELOS,30,278,2,310,1713
MÉXICO,ECATEPEC DE MORELOS,31,254,1,286,1712
MÉXICO,ECATEPEC DE MORELOS,54,294,4,352,1689
MÉXICO,ECATEPEC DE MORELOS,39,330,4,373,1973
MÉXICO,ECATEPEC DE MORELOS,22,179,0,201,1105
MÉXICO,ECATEPEC DE MORELOS,23,187,3,213,1104
MÉXICO,ECATEPEC DE MORELOS,26,182,3,211,1420
MÉXICO,ECATEPEC DE MORELOS,24,202,4,230,1419
MÉXICO,ECATEPEC DE MORELOS,33,203,4,240,1550
MÉXICO,ECATEPEC DE MORELOS,22,215,3,240,1393
MÉXICO,ECATEPEC DE MORELOS,26,198,5,229,1392
MÉXICO,ECATEPEC DE MORELOS,25,281,1,307,1501
MÉXICO,ECATEPEC DE MORELOS,26,272,0,298,1831
MÉXICO,ECATEPEC DE MORELOS,39,303,6,348,1966
MÉXICO,ECATEPEC DE MORELOS,36,310,1,347,1965
MÉXICO,ECATEPEC DE MORELOS,31,304,1,336,1622
MÉXICO,ECATEPEC DE MORELOS,30,346,2,378,1840
MÉXICO,ECATEPEC DE MORELOS,50,279,3,332,1605
MÉXICO,ECATEPEC DE MORELOS,38,289,1,328,1886
MÉXICO,ECATEPEC DE MORELOS,41,236,5,282,1808
MÉXICO,ECATEPEC DE MORELOS,23,189,5,217,1233
MÉXICO,ECATEPEC DE MORELOS,35,184,1,220,1233
MÉXICO,ECATEPEC DE MORELOS,27,168,2,197,1162
MÉXICO,ECATEPEC DE MORELOS,20,169,0,189,1162
MÉXICO,ECATEPEC DE MORELOS,8,168,1,177,1274
MÉXICO,ECATEPEC DE MORELOS,9,134,3,146,1273
MÉXICO,ECATEPEC DE MORELOS,24,235,2,261,1296
MÉXICO,ECATEPEC DE MORELOS,16,213,4,233,1296
MÉXICO,ECATEPEC DE MORELOS,33,285,2,320,1523
MÉXICO,ECATEPEC DE MORELOS,39,237,4,280,1523
MÉXICO,ECATEPEC DE MORELOS,17,221,8,246,1550
MÉXICO,ECATEPEC DE MORELOS,36,324,5,365,2059
MÉXICO,ECATEPEC DE MORELOS,37,271,3,311,1615
MÉXICO,ECATEPEC DE MORELOS,32,229,7,268,1515
MÉXICO,ECATEPEC DE MORELOS,27,351,4,382,1806
MÉXICO,ECATEPEC DE MORELOS,32,360,5,397,2054
MÉXICO,ECATEPEC DE MORELOS,30,289,9,328,1762
MÉXICO,ECATEPEC DE MORELOS,26,224,1,251,1228
MÉXICO,ECATEPEC DE MORELOS,23,216,8,247,1228
MÉXICO,ECATEPEC DE MORELOS,16,260,1,277,1558
MÉXICO,ECATEPEC DE MORELOS,19,265,3,287,1557
MÉXICO,ECATEPEC DE MORELOS,43,236,6,285,1641
MÉXICO,ECATEPEC DE MORELOS,45,282,14,341,1763
MÉXICO,ECATEPEC DE MORELOS,32,273,11,316,1763
MÉXICO,ECATEPEC DE MORELOS,65,326,6,397,1876
MÉXICO,ECATEPEC DE MORELOS,17,197,4,218,1197
MÉXICO,ECATEPEC DE MORELOS,28,193,3,224,1196
MÉXICO,ECATEPEC DE MORELOS,21,211,3,235,1289
MÉXICO,ECATEPEC DE MORELOS,22,173,1,196,1288
MÉXICO,ECATEPEC DE MORELOS,31,233,10,274,1727
MÉXICO,ECATEPEC DE MORELOS,13,207,8,228,1267
MÉXICO,ECATEPEC DE MORELOS,21,194,0,215,1266
MÉXICO,ECATEPEC DE MORELOS,26,308,2,336,1672
MÉXICO,ECATEPEC DE MORELOS,26,235,5,266,1554
MÉXICO,ECATEPEC DE MORELOS,27,194,0,221,1265
MÉXICO,ECATEPEC DE MORELOS,20,201,4,225,1264
MÉXICO,ECATEPEC DE MORELOS,30,274,0,304,1544
MÉXICO,ECATEPEC DE MORELOS,44,274,8,326,1990
MÉXICO,ECATEPEC DE MORELOS,26,139,1,166,1360
MÉXICO,ECATEPEC DE MORELOS,19,168,2,189,1359
MÉXICO,ECATEPEC DE MORELOS,18,184,1,203,1386
MÉXICO,ECATEPEC DE MORELOS,17,215,2,234,1385
MÉXICO,ECATEPEC DE MORELOS,34,269,4,307,1834
MÉXICO,ECATEPEC DE MORELOS,33,289,6,328,1833
MÉXICO,ECATEPEC DE MORELOS,28,205,2,235,1265
MÉXICO,ECATEPEC DE MORELOS,23,202,2,227,1264
MÉXICO,ECATEPEC DE MORELOS,22,320,3,345,1965
MÉXICO,ECATEPEC DE MORELOS,13,154,0,167,1080
MÉXICO,ECATEPEC DE MORELOS,16,155,3,174,1080
MÉXICO,ECATEPEC DE MORELOS,33,308,7,348,1657
MÉXICO,ECATEPEC DE MORELOS,29,293,3,325,1656
MÉXICO,ECATEPEC DE MORELOS,38,294,6,338,1903
MÉXICO,ECATEPEC DE MORELOS,25,188,3,216,1113
MÉXICO,ECATEPEC DE MORELOS,13,205,6,224,1112
MÉXICO,ECATEPEC DE MORELOS,46,303,4,353,1911
MÉXICO,ECATEPEC DE MORELOS,25,281,4,310,1527
MÉXICO,ECATEPEC DE MORELOS,25,213,5,243,1151
MÉXICO,ECATEPEC DE MORELOS,21,207,1,229,1151
MÉXICO,ECATEPEC DE MORELOS,51,322,2,375,1820
MÉXICO,ECATEPEC DE MORELOS,53,377,3,433,1961
MÉXICO,ECATEPEC DE MORELOS,21,232,5,258,1237
MÉXICO,ECATEPEC DE MORELOS,43,213,1,257,1236
MÉXICO,ECATEPEC DE MORELOS,34,245,3,282,1556
MÉXICO,ECATEPEC DE MORELOS,70,609,6,685,0
MÉXICO,ECATEPEC DE MORELOS,39,332,4,375,2005
MÉXICO,ECATEPEC DE MORELOS,29,272,3,304,1901
MÉXICO,ECATEPEC DE MORELOS,15,189,0,204,1206
MÉXICO,ECATEPEC DE MORELOS,17,153,4,174,1205
MÉXICO,ECATEPEC DE MORELOS,28,331,4,363,1708
MÉXICO,ECATEPEC DE MORELOS,39,303,3,345,1561
MÉXICO,ECATEPEC DE MORELOS,24,267,4,295,1665
MÉXICO,ECATEPEC DE MORELOS,29,272,4,305,1675
MÉXICO,ECATEPEC DE MORELOS,38,276,4,318,1520
MÉXICO,ECATEPEC DE MORELOS,36,262,3,301,1520
MÉXICO,ECATEPEC DE MORELOS,34,302,0,336,1908
MÉXICO,ECATEPEC DE MORELOS,25,293,5,323,1907
MÉXICO,ECATEPEC DE MORELOS,26,321,5,352,1940
MÉXICO,ECATEPEC DE MORELOS,28,307,3,338,1791
MÉXICO,ECATEPEC DE MORELOS,33,329,1,363,2079
MÉXICO,ECATEPEC DE MORELOS,24,273,9,306,1581
MÉXICO,ECATEPEC DE MORELOS,44,284,3,331,1662
MÉXICO,ECATEPEC DE MORELOS,36,325,0,361,1723
MÉXICO,ECATEPEC DE MORELOS,25,259,3,287,1692
MÉXICO,ECATEPEC DE MORELOS,19,189,4,212,1167
MÉXICO,ECATEPEC DE MORELOS,22,187,1,210,1166
MÉXICO,ECATEPEC DE MORELOS,17,222,2,241,1410
MÉXICO,ECATEPEC DE MORELOS,22,248,2,272,1409
MÉXICO,ECATEPEC DE MORELOS,22,309,3,334,1740
MÉXICO,ECATEPEC DE MORELOS,25,224,7,256,1658
MÉXICO,ECATEPEC DE MORELOS,14,229,1,244,1658
MÉXICO,ECATEPEC DE MORELOS,41,283,5,329,2081
MÉXICO,ECATEPEC DE MORELOS,36,291,3,330,2080
MÉXICO,ECATEPEC DE MORELOS,27,328,6,361,2039
MÉXICO,ECATEPEC DE MORELOS,32,290,3,325,1866
MÉXICO,ECATEPEC DE MORELOS,31,323,4,358,1865
MÉXICO,ECATEPEC DE MORELOS,29,281,7,317,1614
MÉXICO,ECATEPEC DE MORELOS,43,287,2,332,1613
MÉXICO,ECATEPEC DE MORELOS,38,281,4,323,1552
MÉXICO,ECATEPEC DE MORELOS,30,312,3,345,1745
MÉXICO,ECATEPEC DE MORELOS,35,279,7,321,1702
MÉXICO,ECATEPEC DE MORELOS,38,376,8,422,2042
MÉXICO,ECATEPEC DE MORELOS,44,324,7,375,1941
MÉXICO,ECATEPEC DE MORELOS,31,273,5,309,1940
MÉXICO,ECATEPEC DE MORELOS,35,226,9,270,1638
MÉXICO,ECATEPEC DE MORELOS,17,214,2,233,1637
MÉXICO,ECATEPEC DE MORELOS,21,227,6,254,1637
MÉXICO,ECATEPEC DE MORELOS,53,332,3,388,1836
MÉXICO,HUIXQUILUCAN DE DEGOLLADO,29,162,6,197,1737
MÉXICO,HUIXQUILUCAN DE DEGOLLADO,16,156,4,176,1737
MÉXICO,HUIXQUILUCAN DE DEGOLLADO,22,138,0,160,1390
MÉXICO,HUIXQUILUCAN DE DEGOLLADO,10,124,1,135,1390
MÉXICO,HUIXQUILUCAN DE DEGOLLADO,20,180,0,200,1794
MÉXICO,HUIXQUILUCAN DE DEGOLLADO,12,151,0,163,1794
MÉXICO,HUIXQUILUCAN DE DEGOLLADO,20,218,6,244,1886
MÉXICO,HUIXQUILUCAN DE DEGOLLADO,14,175,7,196,1885
MÉXICO,HUIXQUILUCAN DE DEGOLLADO,33,233,6,272,0
MÉXICO,HUIXQUILUCAN DE DEGOLLADO,19,179,0,198,1772
MÉXICO,HUIXQUILUCAN DE DEGOLLADO,28,210,2,240,1771
MÉXICO,HUIXQUILUCAN DE DEGOLLADO,20,206,5,231,1771
MÉXICO,HUIXQUILUCAN DE DEGOLLADO,18,154,2,174,1231
MÉXICO,HUIXQUILUCAN DE DEGOLLADO,22,146,2,170,1230
MÉXICO,HUIXQUILUCAN DE DEGOLLADO,5,110,2,117,1708
MÉXICO,HUIXQUILUCAN DE DEGOLLADO,16,140,6,162,1708
MÉXICO,HUIXQUILUCAN DE DEGOLLADO,13,102,3,118,1707
MÉXICO,HUIXQUILUCAN DE DEGOLLADO,26,253,4,283,1784
MÉXICO,HUIXQUILUCAN DE DEGOLLADO,1,259,3,263,1784
MÉXICO,HUIXQUILUCAN DE DEGOLLADO,22,139,0,161,1126
MÉXICO,HUIXQUILUCAN DE DEGOLLADO,10,122,1,133,1126
MÉXICO,HUIXQUILUCAN DE DEGOLLADO,12,25,0,37,1622
MÉXICO,HUIXQUILUCAN DE DEGOLLADO,22,27,0,49,1622
MÉXICO,HUIXQUILUCAN DE DEGOLLADO,16,22,0,38,1622
MÉXICO,HUIXQUILUCAN DE DEGOLLADO,21,191,2,214,1859
MÉXICO,HUIXQUILUCAN DE DEGOLLADO,31,208,4,243,1858
MÉXICO,HUIXQUILUCAN DE DEGOLLADO,18,243,2,263,1901
MÉXICO,HUIXQUILUCAN DE DEGOLLADO,18,277,6,301,1901
MÉXICO,HUIXQUILUCAN DE DEGOLLADO,24,141,7,172,1900
MÉXICO,HUIXQUILUCAN DE DEGOLLADO,27,164,1,192,1745
MÉXICO,HUIXQUILUCAN DE DEGOLLADO,35,156,2,193,1744
MÉXICO,HUIXQUILUCAN DE DEGOLLADO,13,22,0,35,1734
MÉXICO,HUIXQUILUCAN DE DEGOLLADO,17,20,0,37,1733
MÉXICO,HUIXQUILUCAN DE DEGOLLADO,7,12,0,19,1337
MÉXICO,HUIXQUILUCAN DE DEGOLLADO,8,8,0,16,1337
MÉXICO,HUIXQUILUCAN DE DEGOLLADO,14,17,0,31,1336
MÉXICO,HUIXQUILUCAN DE DEGOLLADO,21,19,1,41,1488
MÉXICO,HUIXQUILUCAN DE DEGOLLADO,15,25,0,40,1488
MÉXICO,HUIXQUILUCAN DE DEGOLLADO,23,124,1,148,1663
MÉXICO,HUIXQUILUCAN DE DEGOLLADO,21,123,0,144,1662
MÉXICO,HUIXQUILUCAN DE DEGOLLADO,15,113,1,129,1507
MÉXICO,HUIXQUILUCAN DE DEGOLLADO,15,97,1,113,1507
MÉXICO,HUIXQUILUCAN DE DEGOLLADO,9,116,1,126,1507
MÉXICO,HUIXQUILUCAN DE DEGOLLADO,14,198,0,212,1729
MÉXICO,HUIXQUILUCAN DE DEGOLLADO,22,210,5,237,1728
MÉXICO,HUIXQUILUCAN DE DEGOLLADO,14,117,2,133,1588
MÉXICO,HUIXQUILUCAN DE DEGOLLADO,19,130,1,150,1588
MÉXICO,HUIXQUILUCAN DE DEGOLLADO,10,120,1,131,1587
MÉXICO,HUIXQUILUCAN DE DEGOLLADO,18,153,0,171,1263
MÉXICO,HUIXQUILUCAN DE DEGOLLADO,15,134,0,149,1262
MÉXICO,HUIXQUILUCAN DE DEGOLLADO,19,71,0,90,1659
MÉXICO,HUIXQUILUCAN DE DEGOLLADO,17,80,1,98,1659
MÉXICO,HUIXQUILUCAN DE DEGOLLADO,11,88,2,101,1659
MÉXICO,HUIXQUILUCAN DE DEGOLLADO,16,106,1,123,1658
MÉXICO,HUIXQUILUCAN DE DEGOLLADO,7,78,0,85,1658
MÉXICO,HUIXQUILUCAN DE DEGOLLADO,10,119,3,132,1783
MÉXICO,HUIXQUILUCAN DE DEGOLLADO,20,143,3,166,1783
MÉXICO,HUIXQUILUCAN DE DEGOLLADO,19,131,2,152,1782
MÉXICO,HUIXQUILUCAN DE DEGOLLADO,12,109,0,121,1782
MÉXICO,HUIXQUILUCAN DE DEGOLLADO,10,151,4,165,1279
MÉXICO,HUIXQUILUCAN DE DEGOLLADO,13,168,3,184,1279
MÉXICO,HUIXQUILUCAN DE DEGOLLADO,8,139,9,156,1080
MÉXICO,HUIXQUILUCAN DE DEGOLLADO,7,134,2,143,1080
MÉXICO,HUIXQUILUCAN DE DEGOLLADO,14,133,3,150,1772
MÉXICO,HUIXQUILUCAN DE DEGOLLADO,6,116,0,122,1771
MÉXICO,HUIXQUILUCAN DE DEGOLLADO,9,114,0,123,1771
MÉXICO,HUIXQUILUCAN DE DEGOLLADO,17,78,5,100,1480
MÉXICO,HUIXQUILUCAN DE DEGOLLADO,22,127,2,151,1480
MÉXICO,HUIXQUILUCAN DE DEGOLLADO,19,132,5,156,1479
MÉXICO,HUIXQUILUCAN DE DEGOLLADO,31,233,4,268,1924
MÉXICO,HUIXQUILUCAN DE DEGOLLADO,30,223,4,257,1923
MÉXICO,HUIXQUILUCAN DE DEGOLLADO,43,279,5,327,1923
MÉXICO,HUIXQUILUCAN DE DEGOLLADO,22,14,0,36,1944
MÉXICO,HUIXQUILUCAN DE DEGOLLADO,21,13,0,34,1944
MÉXICO,HUIXQUILUCAN DE DEGOLLADO,16,18,0,34,1944
MÉXICO,HUIXQUILUCAN DE DEGOLLADO,25,23,0,48,1943
MÉXICO,HUIXQUILUCAN DE DEGOLLADO,12,13,0,25,1943
MÉXICO,HUIXQUILUCAN DE DEGOLLADO,12,19,0,31,1785
MÉXICO,HUIXQUILUCAN DE DEGOLLADO,8,23,0,31,1784
MÉXICO,HUIXQUILUCAN DE DEGOLLADO,20,151,1,172,1370
MÉXICO,HUIXQUILUCAN DE DEGOLLADO,33,129,2,164,1369
MÉXICO,HUIXQUILUCAN DE DEGOLLADO,32,166,0,198,1369
MÉXICO,HUIXQUILUCAN DE DEGOLLADO,20,104,3,127,1700
MÉXICO,HUIXQUILUCAN DE DEGOLLADO,12,84,2,98,1699
MÉXICO,HUIXQUILUCAN DE DEGOLLADO,15,114,2,131,1913
MÉXICO,HUIXQUILUCAN DE DEGOLLADO,9,171,2,182,1912
MÉXICO,HUIXQUILUCAN DE DEGOLLADO,24,159,1,184,1795
MÉXICO,HUIXQUILUCAN DE DEGOLLADO,30,212,5,247,1795
MÉXICO,HUIXQUILUCAN DE DEGOLLADO,28,213,6,247,1753
MÉXICO,HUIXQUILUCAN DE DEGOLLADO,42,192,0,234,1753
MÉXICO,HUIXQUILUCAN DE DEGOLLADO,24,170,0,194,1336
MÉXICO,HUIXQUILUCAN DE DEGOLLADO,7,152,1,160,1335
MÉXICO,HUIXQUILUCAN DE DEGOLLADO,9,134,2,145,1502
MÉXICO,HUIXQUILUCAN DE DEGOLLADO,16,164,3,183,1501
MÉXICO,HUIXQUILUCAN DE DEGOLLADO,14,183,1,198,1501
MÉXICO,HUIXQUILUCAN DE DEGOLLADO,19,67,2,88,1861
MÉXICO,HUIXQUILUCAN DE DEGOLLADO,16,95,1,112,1861
MÉXICO,HUIXQUILUCAN DE DEGOLLADO,26,158,1,185,1334
MÉXICO,HUIXQUILUCAN DE DEGOLLADO,18,140,0,158,1334
MÉXICO,HUIXQUILUCAN DE DEGOLLADO,11,163,6,180,1462
MÉXICO,HUIXQUILUCAN DE DEGOLLADO,7,186,1,194,1462
MÉXICO,HUIXQUILUCAN DE DEGOLLADO,9,207,1,217,1825
MÉXICO,HUIXQUILUCAN DE DEGOLLADO,20,231,4,255,1824
MÉXICO,HUIXQUILUCAN DE DEGOLLADO,15,198,12,225,1467
MÉXICO,HUIXQUILUCAN DE DEGOLLADO,18,178,0,196,1466
MÉXICO,HUIXQUILUCAN DE DEGOLLADO,14,181,0,195,1466
MÉXICO,HUIXQUILUCAN DE DEGOLLADO,12,157,4,173,1768
MÉXICO,HUIXQUILUCAN DE DEGOLLADO,10,214,7,231,1767
MÉXICO,HUIXQUILUCAN DE DEGOLLADO,10,122,2,134,1241
MÉXICO,HUIXQUILUCAN DE DEGOLLADO,16,167,4,187,1241
MÉXICO,HUIXQUILUCAN DE DEGOLLADO,11,121,0,132,1138
MÉXICO,HUIXQUILUCAN DE DEGOLLADO,12,134,2,148,1137
MÉXICO,HUIXQUILUCAN DE DEGOLLADO,17,122,4,143,1348
MÉXICO,HUIXQUILUCAN DE DEGOLLADO,9,172,10,191,1347
MÉXICO,HUIXQUILUCAN DE DEGOLLADO,21,125,2,148,1347
MÉXICO,HUIXQUILUCAN DE DEGOLLADO,25,198,8,231,1521
MÉXICO,HUIXQUILUCAN DE DEGOLLADO,22,192,0,214,1520
MÉXICO,HUIXQUILUCAN DE DEGOLLADO,27,186,2,215,1696
MÉXICO,HUIXQUILUCAN DE DEGOLLADO,23,158,1,182,1696
MÉXICO,HUIXQUILUCAN DE DEGOLLADO,16,121,1,138,1276
MÉXICO,HUIXQUILUCAN DE DEGOLLADO,10,93,1,104,1275
MÉXICO,HUIXQUILUCAN DE DEGOLLADO,14,95,0,109,1302
MÉXICO,HUIXQUILUCAN DE DEGOLLADO,14,100,2,116,1301
MÉXICO,HUIXQUILUCAN DE DEGOLLADO,22,197,2,221,1889
MÉXICO,HUIXQUILUCAN DE DEGOLLADO,24,200,4,228,1889
MÉXICO,HUIXQUILUCAN DE DEGOLLADO,33,232,7,272,1877
MÉXICO,HUIXQUILUCAN DE DEGOLLADO,29,219,2,250,1877
MÉXICO,HUIXQUILUCAN DE DEGOLLADO,14,179,6,199,1572
MÉXICO,HUIXQUILUCAN DE DEGOLLADO,21,155,3,179,1571
MÉXICO,HUIXQUILUCAN DE DEGOLLADO,14,195,3,212,1369
MÉXICO,HUIXQUILUCAN DE DEGOLLADO,18,215,4,237,1368
MÉXICO,HUIXQUILUCAN DE DEGOLLADO,10,217,1,228,1368
MÉXICO,HUIXQUILUCAN DE DEGOLLADO,10,222,2,234,1528
MÉXICO,HUIXQUILUCAN DE DEGOLLADO,6,226,2,234,1528
MÉXICO,HUIXQUILUCAN DE DEGOLLADO,10,206,1,217,1528
MÉXICO,HUIXQUILUCAN DE DEGOLLADO,14,226,7,247,1740
MÉXICO,HUIXQUILUCAN DE DEGOLLADO,19,243,6,268,1739
MÉXICO,HUIXQUILUCAN DE DEGOLLADO,14,217,2,233,1859
MÉXICO,HUIXQUILUCAN DE DEGOLLADO,17,200,2,219,1858
MÉXICO,HUIXQUILUCAN DE DEGOLLADO,17,147,1,165,1645
MÉXICO,HUIXQUILUCAN DE DEGOLLADO,6,137,0,143,1644
MÉXICO,HUIXQUILUCAN DE DEGOLLADO,14,120,2,136,1447
MÉXICO,HUIXQUILUCAN DE DEGOLLADO,13,100,1,114,1447
MÉXICO,HUIXQUILUCAN DE DEGOLLADO,14,74,4,92,1380
MÉXICO,HUIXQUILUCAN DE DEGOLLADO,10,65,0,75,1379
MÉXICO,HUIXQUILUCAN DE DEGOLLADO,9,87,2,98,1379
MÉXICO,HUIXQUILUCAN DE DEGOLLADO,14,90,2,106,1775
MÉXICO,HUIXQUILUCAN DE DEGOLLADO,8,105,2,115,1775
MÉXICO,HUIXQUILUCAN DE DEGOLLADO,3,190,8,201,1553
MÉXICO,HUIXQUILUCAN DE DEGOLLADO,11,128,7,146,1553
MÉXICO,HUIXQUILUCAN DE DEGOLLADO,5,162,4,171,1466
MÉXICO,HUIXQUILUCAN DE DEGOLLADO,5,106,6,117,1466
MÉXICO,HUIXQUILUCAN DE DEGOLLADO,4,96,5,105,1466
MÉXICO,HUIXQUILUCAN DE DEGOLLADO,13,130,1,144,1107
MÉXICO,HUIXQUILUCAN DE DEGOLLADO,28,124,1,153,1106
MÉXICO,HUIXQUILUCAN DE DEGOLLADO,16,206,3,225,1919
MÉXICO,HUIXQUILUCAN DE DEGOLLADO,8,196,4,208,1918
MÉXICO,HUIXQUILUCAN DE DEGOLLADO,7,195,3,205,1559
MÉXICO,HUIXQUILUCAN DE DEGOLLADO,9,141,3,153,1559
MÉXICO,HUIXQUILUCAN DE DEGOLLADO,23,175,7,205,1490
MÉXICO,HUIXQUILUCAN DE DEGOLLADO,16,190,4,210,1489
MÉXICO,HUIXQUILUCAN DE DEGOLLADO,12,167,1,180,1489
MÉXICO,HUIXQUILUCAN DE DEGOLLADO,10,173,2,185,1584
MÉXICO,HUIXQUILUCAN DE DEGOLLADO,15,179,4,198,1583
MÉXICO,HUIXQUILUCAN DE DEGOLLADO,10,153,8,171,1686
MÉXICO,HUIXQUILUCAN DE DEGOLLADO,17,192,7,216,1685
MÉXICO,HUIXQUILUCAN DE DEGOLLADO,8,141,7,156,1463
MÉXICO,HUIXQUILUCAN DE DEGOLLADO,10,114,4,128,1463
MÉXICO,HUIXQUILUCAN DE DEGOLLADO,14,150,1,165,1275
MÉXICO,HUIXQUILUCAN DE DEGOLLADO,9,178,1,188,1275
MÉXICO,HUIXQUILUCAN DE DEGOLLADO,13,197,1,211,1461
MÉXICO,HUIXQUILUCAN DE DEGOLLADO,13,163,3,179,1461
MÉXICO,HUIXQUILUCAN DE DEGOLLADO,6,195,1,202,1461
MÉXICO,HUIXQUILUCAN DE DEGOLLADO,21,283,4,308,1769
MÉXICO,HUIXQUILUCAN DE DEGOLLADO,23,233,2,258,1769
MÉXICO,HUIXQUILUCAN DE DEGOLLADO,15,199,0,214,1394
MÉXICO,HUIXQUILUCAN DE DEGOLLADO,15,222,3,240,1394
MÉXICO,HUIXQUILUCAN DE DEGOLLADO,16,210,2,228,1394
MÉXICO,HUIXQUILUCAN DE DEGOLLADO,16,178,1,195,1557
MÉXICO,HUIXQUILUCAN DE DEGOLLADO,11,199,0,210,1557
MÉXICO,HUIXQUILUCAN DE DEGOLLADO,10,165,2,177,1556
MÉXICO,HUIXQUILUCAN DE DEGOLLADO,9,171,1,181,1556
MÉXICO,HUIXQUILUCAN DE DEGOLLADO,15,106,0,121,1402
MÉXICO,HUIXQUILUCAN DE DEGOLLADO,9,128,2,139,1402
MÉXICO,HUIXQUILUCAN DE DEGOLLADO,4,66,1,71,1481
MÉXICO,HUIXQUILUCAN DE DEGOLLADO,9,68,0,77,1481
MÉXICO,HUIXQUILUCAN DE DEGOLLADO,10,131,5,146,1384
MÉXICO,HUIXQUILUCAN DE DEGOLLADO,6,127,4,137,1383
MÉXICO,HUIXQUILUCAN DE DEGOLLADO,13,180,2,195,1512
MÉXICO,HUIXQUILUCAN DE DEGOLLADO,9,202,2,213,1512
MÉXICO,HUIXQUILUCAN DE DEGOLLADO,9,199,6,214,1512
MÉXICO,HUIXQUILUCAN DE DEGOLLADO,12,254,1,267,1496
MÉXICO,HUIXQUILUCAN DE DEGOLLADO,10,223,4,237,1495
MÉXICO,HUIXQUILUCAN DE DEGOLLADO,15,237,2,254,1859
MÉXICO,HUIXQUILUCAN DE DEGOLLADO,17,212,3,232,1858
MÉXICO,HUIXQUILUCAN DE DEGOLLADO,18,139,1,158,1167
MÉXICO,HUIXQUILUCAN DE DEGOLLADO,9,168,4,181,1167
MÉXICO,HUIXQUILUCAN DE DEGOLLADO,8,87,2,97,1349
MÉXICO,HUIXQUILUCAN DE DEGOLLADO,15,148,3,166,1349
MÉXICO,HUIXQUILUCAN DE DEGOLLADO,4,117,1,122,1348
MÉXICO,HUIXQUILUCAN DE DEGOLLADO,11,121,1,133,2030
MÉXICO,HUIXQUILUCAN DE DEGOLLADO,16,156,5,177,2030
MÉXICO,HUIXQUILUCAN DE DEGOLLADO,17,130,1,148,2029
MÉXICO,HUIXQUILUCAN DE DEGOLLADO,13,149,0,162,2029
MÉXICO,HUIXQUILUCAN DE DEGOLLADO,10,123,1,134,1844
MÉXICO,HUIXQUILUCAN DE DEGOLLADO,22,121,5,148,1844
MÉXICO,HUIXQUILUCAN DE DEGOLLADO,9,121,5,135,1844
MÉXICO,TLALNEPANTLA DE BAZ,16,149,1,166,1427
MÉXICO,TLALNEPANTLA DE BAZ,39,145,3,187,1427
MÉXICO,TLALNEPANTLA DE BAZ,42,162,2,206,1607
MÉXICO,TLALNEPANTLA DE BAZ,36,130,1,167,1492
MÉXICO,TLALNEPANTLA DE BAZ,43,125,0,168,1592
MÉXICO,TLALNEPANTLA DE BAZ,36,217,1,254,1940
MÉXICO,TLALNEPANTLA DE BAZ,38,217,4,259,1940
MÉXICO,TLALNEPANTLA DE BAZ,26,150,6,182,1274
MÉXICO,TLALNEPANTLA DE BAZ,17,154,1,172,1274
MÉXICO,TLALNEPANTLA DE BAZ,40,256,5,301,2005
MÉXICO,TLALNEPANTLA DE BAZ,36,284,3,323,2005
MÉXICO,TLALNEPANTLA DE BAZ,46,211,3,260,2066
MÉXICO,TLALNEPANTLA DE BAZ,32,249,2,283,2066
MÉXICO,TLALNEPANTLA DE BAZ,52,206,1,259,1833
MÉXICO,TLALNEPANTLA DE BAZ,25,259,11,295,1920
MÉXICO,TLALNEPANTLA DE BAZ,19,296,6,321,1765
MÉXICO,TLALNEPANTLA DE BAZ,17,274,1,292,1764
MÉXICO,TLALNEPANTLA DE BAZ,35,300,6,341,2059
MÉXICO,TLALNEPANTLA DE BAZ,48,300,3,351,2059
MÉXICO,TLALNEPANTLA DE BAZ,33,198,2,233,1134
MÉXICO,TLALNEPANTLA DE BAZ,23,191,4,218,1133
MÉXICO,TLALNEPANTLA DE BAZ,27,236,0,263,1583
MÉXICO,TLALNEPANTLA DE BAZ,19,252,6,277,1670
MÉXICO,TLALNEPANTLA DE BAZ,16,202,8,226,1293
MÉXICO,TLALNEPANTLA DE BAZ,18,214,5,237,1293
MÉXICO,TLALNEPANTLA DE BAZ,20,237,2,259,1537
MÉXICO,TLALNEPANTLA DE BAZ,10,224,2,236,1507
MÉXICO,TLALNEPANTLA DE BAZ,18,169,2,189,1298
MÉXICO,TLALNEPANTLA DE BAZ,20,160,1,181,1298
MÉXICO,TLALNEPANTLA DE BAZ,24,271,6,301,1559
MÉXICO,TLALNEPANTLA DE BAZ,25,281,8,314,1780
MÉXICO,TLALNEPANTLA DE BAZ,22,245,6,273,1779
MÉXICO,TLALNEPANTLA DE BAZ,22,193,1,216,1297
MÉXICO,TLALNEPANTLA DE BAZ,27,178,2,207,1297
MÉXICO,TLALNEPANTLA DE BAZ,29,207,6,242,1482
MÉXICO,TLALNEPANTLA DE BAZ,26,242,2,270,1482
MÉXICO,TLALNEPANTLA DE BAZ,33,277,4,314,2043
MÉXICO,TLALNEPANTLA DE BAZ,24,215,11,250,1598
MÉXICO,TLALNEPANTLA DE BAZ,12,201,0,213,1105
MÉXICO,TLALNEPANTLA DE BAZ,13,180,1,194,1105
MÉXICO,TLALNEPANTLA DE BAZ,21,287,2,310,1731
MÉXICO,TLALNEPANTLA DE BAZ,31,259,5,295,1984
MÉXICO,TLALNEPANTLA DE BAZ,24,202,1,227,1385
MÉXICO,TLALNEPANTLA DE BAZ,34,194,2,230,1384
MÉXICO,TLALNEPANTLA DE BAZ,36,286,0,322,1605
MÉXICO,TLALNEPANTLA DE BAZ,38,236,6,280,1604
MÉXICO,TLALNEPANTLA DE BAZ,49,177,0,226,1621
MÉXICO,TLALNEPANTLA DE BAZ,38,179,3,220,1621
MÉXICO,TLALNEPANTLA DE BAZ,31,195,0,226,1620
MÉXICO,TLALNEPANTLA DE BAZ,45,306,5,356,2004
MÉXICO,TLALNEPANTLA DE BAZ,44,340,2,386,2003
MÉXICO,TLALNEPANTLA DE BAZ,39,288,4,331,1747
MÉXICO,TLALNEPANTLA DE BAZ,30,333,2,365,1669
MÉXICO,TLALNEPANTLA DE BAZ,57,264,2,323,1581
MÉXICO,TLALNEPANTLA DE BAZ,22,171,1,194,1660
MÉXICO,TLALNEPANTLA DE BAZ,38,190,3,231,1838
MÉXICO,TLALNEPANTLA DE BAZ,36,148,2,186,1270
MÉXICO,TLALNEPANTLA DE BAZ,29,136,4,169,1270
MÉXICO,TLALNEPANTLA DE BAZ,40,212,6,258,2007
MÉXICO,TLALNEPANTLA DE BAZ,22,218,1,241,1805
MÉXICO,TLALNEPANTLA DE BAZ,26,204,3,233,1805
MÉXICO,TLALNEPANTLA DE BAZ,21,176,1,198,1841
MÉXICO,TLALNEPANTLA DE BAZ,38,217,2,257,2019
MÉXICO,TLALNEPANTLA DE BAZ,34,217,5,256,1494
MÉXICO,TLALNEPANTLA DE BAZ,44,248,2,294,1615
MÉXICO,TLALNEPANTLA DE BAZ,18,154,4,176,1235
MÉXICO,TLALNEPANTLA DE BAZ,26,158,1,185,1234
MÉXICO,TLALNEPANTLA DE BAZ,44,340,3,387,1966
MÉXICO,TLALNEPANTLA DE BAZ,25,217,2,244,1533
MÉXICO,TLALNEPANTLA DE BAZ,22,292,1,315,1872
MÉXICO,TLALNEPANTLA DE BAZ,31,284,3,318,1872
MÉXICO,TLALNEPANTLA DE BAZ,24,305,1,330,1919
MÉXICO,TLALNEPANTLA DE BAZ,18,312,4,334,2000
MÉXICO,TLALNEPANTLA DE BAZ,22,218,0,240,1597
MÉXICO,TLALNEPANTLA DE BAZ,31,256,4,291,1597
MÉXICO,TLALNEPANTLA DE BAZ,24,273,3,300,1601
MÉXICO,TLALNEPANTLA DE BAZ,29,272,6,307,1855
MÉXICO,TLALNEPANTLA DE BAZ,22,271,7,300,1854
MÉXICO,TLALNEPANTLA DE BAZ,24,298,0,322,1325
MÉXICO,TLALNEPANTLA DE BAZ,20,303,2,325,1325
MÉXICO,TLALNEPANTLA DE BAZ,13,206,2,221,1189
MÉXICO,TLALNEPANTLA DE BAZ,19,202,1,222,1189
MÉXICO,TLALNEPANTLA DE BAZ,49,247,2,298,1592
MÉXICO,TLALNEPANTLA DE BAZ,68,500,6,574,0
MÉXICO,TLALNEPANTLA DE BAZ,26,235,3,264,1574
MÉXICO,TLALNEPANTLA DE BAZ,17,114,6,137,1306
MÉXICO,TLALNEPANTLA DE BAZ,10,130,3,143,1306
MÉXICO,TLALNEPANTLA DE BAZ,20,197,5,222,1282
MÉXICO,TLALNEPANTLA DE BAZ,25,197,2,224,1281
MÉXICO,TLALNEPANTLA DE BAZ,16,220,2,238,1240
MÉXICO,TLALNEPANTLA DE BAZ,28,205,4,237,1239
MÉXICO,TLALNEPANTLA DE BAZ,15,234,1,250,1199
MÉXICO,TLALNEPANTLA DE BAZ,19,220,2,241,1198
MÉXICO,TLALNEPANTLA DE BAZ,29,185,2,216,1223
MÉXICO,TLALNEPANTLA DE BAZ,26,179,1,206,1222
MÉXICO,TLALNEPANTLA DE BAZ,25,258,4,287,1832
MÉXICO,TLALNEPANTLA DE BAZ,44,269,4,317,1831
MÉXICO,TLALNEPANTLA DE BAZ,25,308,2,335,1831
MÉXICO,TLALNEPANTLA DE BAZ,25,127,1,153,1428
MÉXICO,TLALNEPANTLA DE BAZ,24,117,4,145,1428
MÉXICO,TLALNEPANTLA DE BAZ,35,122,1,158,1229
MÉXICO,TLALNEPANTLA DE BAZ,24,111,2,137,1228
MÉXICO,TLALNEPANTLA DE BAZ,47,310,4,361,1854
MÉXICO,TLALNEPANTLA DE BAZ,43,310,1,354,1853
MÉXICO,TLALNEPANTLA DE BAZ,30,249,2,281,1829
MÉXICO,TLALNEPANTLA DE BAZ,54,290,4,348,1828
MÉXICO,TLALNEPANTLA DE BAZ,24,195,2,221,1593
MÉXICO,TLALNEPANTLA DE BAZ,18,157,1,176,1592
MÉXICO,TLALNEPANTLA DE BAZ,27,171,3,201,1509
MÉXICO,TLALNEPANTLA DE BAZ,27,205,2,234,1508
MÉXICO,TLALNEPANTLA DE BAZ,28,172,1,201,1924
MÉXICO,TLALNEPANTLA DE BAZ,35,196,0,231,1924
MÉXICO,TLALNEPANTLA DE BAZ,28,155,1,184,1944
MÉXICO,TLALNEPANTLA DE BAZ,41,177,1,219,1944
MÉXICO,TLALNEPANTLA DE BAZ,32,218,0,250,1824
MÉXICO,TLALNEPANTLA DE BAZ,29,177,0,206,1823
MÉXICO,TLALNEPANTLA DE BAZ,33,282,5,320,1570
MÉXICO,TLALNEPANTLA DE BAZ,38,259,2,299,1570
MÉXICO,TLALNEPANTLA DE BAZ,28,229,1,258,1391
MÉXICO,TLALNEPANTLA DE BAZ,30,213,3,246,1390
MÉXICO,TLALNEPANTLA DE BAZ,31,246,1,278,1663
MÉXICO,TLALNEPANTLA DE BAZ,21,246,4,271,1663
MÉXICO,TLALNEPANTLA DE BAZ,23,211,0,234,1126
MÉXICO,TLALNEPANTLA DE BAZ,21,181,4,206,1126
MÉXICO,TLALNEPANTLA DE BAZ,33,258,1,292,1348
MÉXICO,TLALNEPANTLA DE BAZ,37,200,0,237,1348
MÉXICO,TLALNEPANTLA DE BAZ,26,326,5,357,1572
MÉXICO,TLALNEPANTLA DE BAZ,43,250,2,295,1692
MÉXICO,TLALNEPANTLA DE BAZ,25,246,2,273,1692
MÉXICO,TLALNEPANTLA DE BAZ,14,153,1,168,1593
MÉXICO,TLALNEPANTLA DE BAZ,18,160,3,181,1593
MÉXICO,TLALNEPANTLA DE BAZ,40,162,3,205,1580
MÉXICO,TLALNEPANTLA DE BAZ,22,202,3,227,1579
MÉXICO,TLALNEPANTLA DE BAZ,30,347,9,386,1709
MÉXICO,TLALNEPANTLA DE BAZ,30,291,2,323,1709
MÉXICO,TLALNEPANTLA DE BAZ,52,347,11,410,1911
MÉXICO,TLALNEPANTLA DE BAZ,44,311,8,363,1911
MÉXICO,TLALNEPANTLA DE BAZ,30,338,1,369,1734
MÉXICO,TLALNEPANTLA DE BAZ,30,303,2,335,1733
MÉXICO,TLALNEPANTLA DE BAZ,24,163,0,187,1076
MÉXICO,TLALNEPANTLA DE BAZ,23,156,3,182,1076
MÉXICO,TLALNEPANTLA DE BAZ,45,352,7,404,1820
MÉXICO,TLALNEPANTLA DE BAZ,40,254,5,299,1236
MÉXICO,TLALNEPANTLA DE BAZ,35,220,2,257,1235
MÉXICO,TLALNEPANTLA DE BAZ,34,257,7,298,1370
MÉXICO,TLALNEPANTLA DE BAZ,41,213,4,258,1370
MÉXICO,TLALNEPANTLA DE BAZ,30,340,7,377,1715
MÉXICO,TLALNEPANTLA DE BAZ,33,316,1,350,1714
MÉXICO,TLALNEPANTLA DE BAZ,28,340,7,375,1843
MÉXICO,TLALNEPANTLA DE BAZ,29,365,8,402,1843
MÉXICO,TLALNEPANTLA DE BAZ,21,214,3,238,1251
MÉXICO,TLALNEPANTLA DE BAZ,27,190,3,220,1250
MÉXICO,TLALNEPANTLA DE BAZ,29,224,4,257,1556
MÉXICO,TLALNEPANTLA DE BAZ,22,212,1,235,1556
MÉXICO,TLALNEPANTLA DE BAZ,37,236,2,275,1581
MÉXICO,TLALNEPANTLA DE BAZ,40,243,2,285,1718
MÉXICO,TLALNEPANTLA DE BAZ,53,278,4,335,2057
MÉXICO,TLALNEPANTLA DE BAZ,54,289,5,348,2056
MÉXICO,TLALNEPANTLA DE BAZ,35,190,3,228,1691
MÉXICO,TLALNEPANTLA DE BAZ,30,203,0,233,1691
MÉXICO,TLALNEPANTLA DE BAZ,28,252,4,284,1726
MÉXICO,TLALNEPANTLA DE BAZ,33,279,6,318,1909
MÉXICO,TLALNEPANTLA DE BAZ,29,258,1,288,1908
MÉXICO,TLALNEPANTLA DE BAZ,44,259,2,305,1528
MÉXICO,TLALNEPANTLA DE BAZ,27,282,3,312,1508
MÉXICO,TLALNEPANTLA DE BAZ,22,276,6,304,1507
MÉXICO,TLALNEPANTLA DE BAZ,12,219,0,231,1353
MÉXICO,TLALNEPANTLA DE BAZ,18,205,1,224,1352
MÉXICO,TLALNEPANTLA DE BAZ,31,340,11,382,1952
MÉXICO,TLALNEPANTLA DE BAZ,30,278,3,311,1717
MÉXICO,TLALNEPANTLA DE BAZ,24,250,1,275,1815
MÉXICO,TLALNEPANTLA DE BAZ,26,236,2,264,1814
MÉXICO,TLALNEPANTLA DE BAZ,10,157,3,170,1193
MÉXICO,TLALNEPANTLA DE BAZ,24,187,1,212,1192
MÉXICO,TLALNEPANTLA DE BAZ,16,189,6,211,1445
MÉXICO,TLALNEPANTLA DE BAZ,13,185,2,200,1445
MÉXICO,TLALNEPANTLA DE BAZ,16,293,8,317,1850
MÉXICO,TLALNEPANTLA DE BAZ,17,230,4,251,1515
MÉXICO,TLALNEPANTLA DE BAZ,11,185,3,199,1211
MÉXICO,TLALNEPANTLA DE BAZ,13,180,2,195,1211
MÉXICO,TLALNEPANTLA DE BAZ,11,168,5,184,1490
MÉXICO,TLALNEPANTLA DE BAZ,15,175,4,194,1489
MÉXICO,TLALNEPANTLA DE BAZ,10,155,0,165,1114
MÉXICO,TLALNEPANTLA DE BAZ,8,153,3,164,1114
MÉXICO,TLALNEPANTLA DE BAZ,15,156,3,174,1429
MÉXICO,TLALNEPANTLA DE BAZ,18,137,1,156,1428
MÉXICO,TLALNEPANTLA DE BAZ,16,147,3,166,1123
MÉXICO,TLALNEPANTLA DE BAZ,4,175,4,183,1122
MÉXICO,TLALNEPANTLA DE BAZ,18,198,2,218,1207
MÉXICO,TLALNEPANTLA DE BAZ,9,206,6,221,1207
MÉXICO,TLALNEPANTLA DE BAZ,12,172,7,191,1134
MÉXICO,TLALNEPANTLA DE BAZ,8,167,4,179,1133
MÉXICO,TLALNEPANTLA DE BAZ,40,345,4,389,1861
MÉXICO,TLALNEPANTLA DE BAZ,22,356,5,383,1819
MÉXICO,TLALNEPANTLA DE BAZ,29,348,5,382,1923
MÉXICO,TLALNEPANTLA DE BAZ,15,165,3,183,1103
MÉXICO,TLALNEPANTLA DE BAZ,17,170,5,192,1103
MÉXICO,CD. NEZAHUALCOYOTL,32,237,3,272,1182
MÉXICO,CD. NEZAHUALCOYOTL,30,234,4,268,1182
MÉXICO,CD. NEZAHUALCOYOTL,60,316,4,380,1929
MÉXICO,CD. NEZAHUALCOYOTL,42,320,6,368,1929
MÉXICO,CD. NEZAHUALCOYOTL,39,262,5,306,1599
MÉXICO,CD. NEZAHUALCOYOTL,45,260,0,305,1598
MÉXICO,CD. NEZAHUALCOYOTL,28,278,4,310,1728
MÉXICO,CD. NEZAHUALCOYOTL,39,290,5,334,1728
MÉXICO,CD. NEZAHUALCOYOTL,38,293,5,336,1784
MÉXICO,CD. NEZAHUALCOYOTL,23,318,3,344,1784
MÉXICO,CD. NEZAHUALCOYOTL,30,308,0,338,1784
MÉXICO,CD. NEZAHUALCOYOTL,24,211,3,238,1140
MÉXICO,CD. NEZAHUALCOYOTL,15,207,5,227,1139
MÉXICO,CD. NEZAHUALCOYOTL,42,379,2,423,1838
MÉXICO,CD. NEZAHUALCOYOTL,49,332,8,389,1838
MÉXICO,CD. NEZAHUALCOYOTL,32,191,2,225,1029
MÉXICO,CD. NEZAHUALCOYOTL,26,182,2,210,1028
MÉXICO,CD. NEZAHUALCOYOTL,40,311,7,358,1786
MÉXICO,CD. NEZAHUALCOYOTL,43,308,5,356,1786
MÉXICO,CD. NEZAHUALCOYOTL,31,272,2,305,1466
MÉXICO,CD. NEZAHUALCOYOTL,34,242,7,283,1466
MÉXICO,CD. NEZAHUALCOYOTL,22,209,3,234,1263
MÉXICO,CD. NEZAHUALCOYOTL,21,185,4,210,1263
MÉXICO,CD. NEZAHUALCOYOTL,29,265,1,295,1593
MÉXICO,CD. NEZAHUALCOYOTL,35,276,2,313,1593
MÉXICO,CD. NEZAHUALCOYOTL,33,294,7,334,1889
MÉXICO,CD. NEZAHUALCOYOTL,37,302,3,342,1888
MÉXICO,CD. NEZAHUALCOYOTL,39,244,6,289,1570
MÉXICO,CD. NEZAHUALCOYOTL,30,241,3,274,1570
MÉXICO,CD. NEZAHUALCOYOTL,41,284,9,334,1491
MÉXICO,CD. NEZAHUALCOYOTL,33,271,8,312,1491
MÉXICO,CD. NEZAHUALCOYOTL,30,277,2,309,1501
MÉXICO,CD. NEZAHUALCOYOTL,43,249,3,295,1501
MÉXICO,CD. NEZAHUALCOYOTL,21,316,3,340,1836
MÉXICO,CD. NEZAHUALCOYOTL,26,345,6,377,1835
MÉXICO,CD. NEZAHUALCOYOTL,36,243,3,282,1408
MÉXICO,CD. NEZAHUALCOYOTL,34,228,5,267,1408
MÉXICO,CD. NEZAHUALCOYOTL,28,234,3,265,1408
MÉXICO,CD. NEZAHUALCOYOTL,37,357,5,399,1928
MÉXICO,CD. NEZAHUALCOYOTL,27,360,12,399,1927
MÉXICO,CD. NEZAHUALCOYOTL,70,696,13,779,0
MÉXICO,CD. NEZAHUALCOYOTL,21,213,1,235,1579
MÉXICO,CD. NEZAHUALCOYOTL,24,251,7,282,1578
MÉXICO,CD. NEZAHUALCOYOTL,42,231,0,273,1395
MÉXICO,CD. NEZAHUALCOYOTL,25,204,5,234,1395
MÉXICO,CD. NEZAHUALCOYOTL,31,226,3,260,1395
MÉXICO,CD. NEZAHUALCOYOTL,39,296,7,342,1752
MÉXICO,CD. NEZAHUALCOYOTL,34,332,6,372,1751
MÉXICO,CD. NEZAHUALCOYOTL,22,176,3,201,1112
MÉXICO,CD. NEZAHUALCOYOTL,20,201,1,222,1111
MÉXICO,CD. NEZAHUALCOYOTL,44,306,3,353,1586
MÉXICO,CD. NEZAHUALCOYOTL,43,266,4,313,1585
MÉXICO,CD. NEZAHUALCOYOTL,35,322,6,363,1679
MÉXICO,CD. NEZAHUALCOYOTL,32,287,6,325,1678
MÉXICO,CD. NEZAHUALCOYOTL,37,299,4,340,1939
MÉXICO,CD. NEZAHUALCOYOTL,42,306,8,356,1938
MÉXICO,CD. NEZAHUALCOYOTL,33,334,0,367,1742
MÉXICO,CD. NEZAHUALCOYOTL,46,335,3,384,1741
MÉXICO,CD. NEZAHUALCOYOTL,17,249,8,274,1180
MÉXICO,CD. NEZAHUALCOYOTL,28,210,5,243,1179
MÉXICO,CD. NEZAHUALCOYOTL,30,328,7,365,1688
MÉXICO,CD. NEZAHUALCOYOTL,53,275,4,332,1687
MÉXICO,CD. NEZAHUALCOYOTL,30,313,4,347,1835
MÉXICO,CD. NEZAHUALCOYOTL,34,283,2,319,1835
MÉXICO,CD. NEZAHUALCOYOTL,55,335,7,397,1923
MÉXICO,CD. NEZAHUALCOYOTL,61,311,8,380,1922
MÉXICO,CD. NEZAHUALCOYOTL,31,311,3,345,1733
MÉXICO,CD. NEZAHUALCOYOTL,29,288,11,328,1733
MÉXICO,CD. NEZAHUALCOYOTL,20,297,6,323,1733
MÉXICO,CD. NEZAHUALCOYOTL,33,254,10,297,1389
MÉXICO,CD. NEZAHUALCOYOTL,25,260,7,292,1389
MÉXICO,CD. NEZAHUALCOYOTL,27,222,3,252,1389
MÉXICO,CD. NEZAHUALCOYOTL,34,237,1,272,1814
MÉXICO,CD. NEZAHUALCOYOTL,24,201,2,227,1813
MÉXICO,CD. NEZAHUALCOYOTL,47,280,1,328,1882
MÉXICO,CD. NEZAHUALCOYOTL,59,246,4,309,1881
MÉXICO,CD. NEZAHUALCOYOTL,41,290,1,332,1773
MÉXICO,CD. NEZAHUALCOYOTL,48,314,4,366,1772
MÉXICO,CD. NEZAHUALCOYOTL,39,293,4,336,1739
MÉXICO,CD. NEZAHUALCOYOTL,36,275,2,313,1738
MÉXICO,CD. NEZAHUALCOYOTL,52,264,6,322,1638
MÉXICO,CD. NEZAHUALCOYOTL,41,278,3,322,1638
MÉXICO,CD. NEZAHUALCOYOTL,32,207,7,246,1356
MÉXICO,CD. NEZAHUALCOYOTL,45,176,2,223,1355
MÉXICO,CD. NEZAHUALCOYOTL,32,177,0,209,1378
MÉXICO,CD. NEZAHUALCOYOTL,23,223,0,246,1378
MÉXICO,CD. NEZAHUALCOYOTL,33,299,12,344,1667
MÉXICO,CD. NEZAHUALCOYOTL,34,280,5,319,1667
MÉXICO,CD. NEZAHUALCOYOTL,42,312,5,359,1666
MÉXICO,CD. NEZAHUALCOYOTL,35,331,5,371,1901
MÉXICO,CD. NEZAHUALCOYOTL,37,348,2,387,1901
MÉXICO,CD. NEZAHUALCOYOTL,31,326,8,365,1848
MÉXICO,CD. NEZAHUALCOYOTL,35,314,7,356,1847
MÉXICO,CD. NEZAHUALCOYOTL,37,319,3,359,1716
MÉXICO,CD. NEZAHUALCOYOTL,23,291,2,316,1716
MÉXICO,CD. NEZAHUALCOYOTL,30,276,5,311,1715
MÉXICO,CD. NEZAHUALCOYOTL,34,233,4,271,1374
MÉXICO,CD. NEZAHUALCOYOTL,20,251,3,274,1373
MÉXICO,CD. NEZAHUALCOYOTL,21,285,4,310,1373
MÉXICO,CD. NEZAHUALCOYOTL,24,244,6,274,1276
MÉXICO,CD. NEZAHUALCOYOTL,32,227,6,265,1276
MÉXICO,CD. NEZAHUALCOYOTL,33,357,5,395,1856
MÉXICO,CD. NEZAHUALCOYOTL,47,325,7,379,1855
MÉXICO,CD. NEZAHUALCOYOTL,24,338,7,369,1599
MÉXICO,CD. NEZAHUALCOYOTL,28,283,2,313,1599
MÉXICO,CD. NEZAHUALCOYOTL,41,310,3,354,1666
MÉXICO,CD. NEZAHUALCOYOTL,34,346,7,387,1665
MÉXICO,CD. NEZAHUALCOYOTL,36,352,5,393,1764
MÉXICO,CD. NEZAHUALCOYOTL,35,360,3,398,1763
MÉXICO,CD. NEZAHUALCOYOTL,20,243,6,269,1295
MÉXICO,CD. NEZAHUALCOYOTL,21,231,0,252,1294
MÉXICO,CD. NEZAHUALCOYOTL,52,328,11,391,1725
MÉXICO,CD. NEZAHUALCOYOTL,42,337,5,384,1724
MÉXICO,CD. NEZAHUALCOYOTL,59,324,8,391,1716
MÉXICO,CD. NEZAHUALCOYOTL,59,341,11,411,1715
MÉXICO,CD. NEZAHUALCOYOTL,42,267,7,316,1441
MÉXICO,CD. NEZAHUALCOYOTL,38,276,5,319,1440
MÉXICO,CD. NEZAHUALCOYOTL,34,305,6,345,1838
MÉXICO,CD. NEZAHUALCOYOTL,32,300,2,334,1838
MÉXICO,CD. NEZAHUALCOYOTL,46,341,4,391,1760
MÉXICO,CD. NEZAHUALCOYOTL,55,323,5,383,1759
MÉXICO,CD. NEZAHUALCOYOTL,46,337,0,383,1845
MÉXICO,CD. NEZAHUALCOYOTL,41,292,5,338,1845
MÉXICO,CD. NEZAHUALCOYOTL,50,350,5,405,1927
MÉXICO,CD. NEZAHUALCOYOTL,51,321,1,373,1926
MÉXICO,CD. NEZAHUALCOYOTL,20,301,5,326,1504
MÉXICO,CD. NEZAHUALCOYOTL,29,299,8,336,1503
MÉXICO,CD. NEZAHUALCOYOTL,31,297,13,341,1518
MÉXICO,CD. NEZAHUALCOYOTL,30,282,1,313,1517
MÉXICO,CD. NEZAHUALCOYOTL,43,372,11,426,1922
MÉXICO,CD. NEZAHUALCOYOTL,39,344,5,388,1921
MÉXICO,CD. NEZAHUALCOYOTL,15,199,2,216,1228
MÉXICO,CD. NEZAHUALCOYOTL,20,214,2,236,1228
MÉXICO,CD. NEZAHUALCOYOTL,40,246,6,292,1338
MÉXICO,CD. NEZAHUALCOYOTL,33,222,6,261,1338
MÉXICO,CD. NEZAHUALCOYOTL,19,223,7,249,1338
MÉXICO,CD. NEZAHUALCOYOTL,26,315,4,345,1694
MÉXICO,CD. NEZAHUALCOYOTL,34,357,5,396,1693
MÉXICO,CD. NEZAHUALCOYOTL,39,261,7,307,1354
MÉXICO,CD. NEZAHUALCOYOTL,33,207,4,244,1354
MÉXICO,CD. NEZAHUALCOYOTL,28,237,5,270,1353
MÉXICO,CD. NEZAHUALCOYOTL,16,351,9,376,1806
MÉXICO,CD. NEZAHUALCOYOTL,25,332,4,361,1805
MÉXICO,CD. NEZAHUALCOYOTL,24,289,4,317,1414
MÉXICO,CD. NEZAHUALCOYOTL,33,264,2,299,1413
MÉXICO,CD. NEZAHUALCOYOTL,25,274,6,305,1413
MÉXICO,CD. NEZAHUALCOYOTL,29,301,7,337,1554
MÉXICO,CD. NEZAHUALCOYOTL,29,352,5,386,1553
MÉXICO,CD. NEZAHUALCOYOTL,20,210,3,233,1168
MÉXICO,CD. NEZAHUALCOYOTL,34,259,5,298,1168
MÉXICO,CD. NEZAHUALCOYOTL,30,367,10,407,1739
MÉXICO,CD. NEZAHUALCOYOTL,32,354,6,392,1738
MÉXICO,CD. NEZAHUALCOYOTL,31,265,4,300,1679
MÉXICO,CD. NEZAHUALCOYOTL,23,310,0,333,1679
MÉXICO,CD. NEZAHUALCOYOTL,16,186,0,202,1175
MÉXICO,CD. NEZAHUALCOYOTL,23,196,3,222,1175
MÉXICO,CD. NEZAHUALCOYOTL,40,304,7,351,1655
MÉXICO,CD. NEZAHUALCOYOTL,30,313,3,346,1654
MÉXICO,CD. NEZAHUALCOYOTL,30,302,3,335,1785
MÉXICO,CD. NEZAHUALCOYOTL,20,249,7,276,1784
MÉXICO,CD. NEZAHUALCOYOTL,30,328,3,361,1848
MÉXICO,CD. NEZAHUALCOYOTL,33,311,1,345,1847
MÉXICO,CD. NEZAHUALCOYOTL,32,358,3,393,1893
MÉXICO,CD. NEZAHUALCOYOTL,44,353,2,399,1893
MÉXICO,CD. NEZAHUALCOYOTL,28,321,5,354,1686
MÉXICO,CD. NEZAHUALCOYOTL,32,305,8,345,1686
MÉXICO,CD. NEZAHUALCOYOTL,32,276,8,316,1459
MÉXICO,CD. NEZAHUALCOYOTL,20,287,3,310,1458
MÉXICO,CD. NEZAHUALCOYOTL,26,251,6,283,1458
MÉXICO,CD. NEZAHUALCOYOTL,17,314,3,334,1822
MÉXICO,CD. NEZAHUALCOYOTL,23,295,5,323,1821
MÉXICO,CD. NEZAHUALCOYOTL,34,214,5,253,1409
MÉXICO,CD. NEZAHUALCOYOTL,31,202,2,235,1409
MÉXICO,CD. NEZAHUALCOYOTL,18,200,2,220,1408
MÉXICO,AMECAMECA DE JUAREZ,15,298,3,316,2106
MÉXICO,AMECAMECA DE JUAREZ,15,343,2,360,1752
MÉXICO,AMECAMECA DE JUAREZ,27,282,3,312,1942
MÉXICO,AMECAMECA DE JUAREZ,20,264,1,285,1942
MÉXICO,AMECAMECA DE JUAREZ,19,316,5,340,2071
MÉXICO,AMECAMECA DE JUAREZ,83,813,9,905,0
MÉXICO,AMECAMECA DE JUAREZ,12,344,2,358,1497
MÉXICO,AMECAMECA DE JUAREZ,15,152,0,167,1101
MÉXICO,AMECAMECA DE JUAREZ,10,166,2,178,1101
MÉXICO,AMECAMECA DE JUAREZ,14,252,4,270,1608
MÉXICO,AMECAMECA DE JUAREZ,12,264,3,279,1607
MÉXICO,AMECAMECA DE JUAREZ,19,294,3,316,1816
MÉXICO,AMECAMECA DE JUAREZ,26,295,0,321,1816
MÉXICO,AMECAMECA DE JUAREZ,23,313,3,339,1816
MÉXICO,AMECAMECA DE JUAREZ,12,191,2,205,1096
MÉXICO,AMECAMECA DE JUAREZ,6,189,1,196,1096
MÉXICO,AMECAMECA DE JUAREZ,11,185,0,196,1057
MÉXICO,AMECAMECA DE JUAREZ,13,152,2,167,1056
MÉXICO,AMECAMECA DE JUAREZ,26,370,5,401,1825
MÉXICO,AMECAMECA DE JUAREZ,6,312,0,318,1413
MÉXICO,AMECAMECA DE JUAREZ,13,311,7,331,1413
MÉXICO,AMECAMECA DE JUAREZ,13,286,8,307,1982
MÉXICO,AMECAMECA DE JUAREZ,10,272,4,286,1492
MÉXICO,AMECAMECA DE JUAREZ,13,244,1,258,1198
MÉXICO,AMECAMECA DE JUAREZ,13,235,2,250,1198
MÉXICO,AMECAMECA DE JUAREZ,14,323,2,339,1556
MÉXICO,AMECAMECA DE JUAREZ,13,223,11,247,1959
MÉXICO,AMECAMECA DE JUAREZ,8,79,4,91,1097
MÉXICO,AMECAMECA DE JUAREZ,3,85,5,93,1097
MÉXICO,AMECAMECA DE JUAREZ,13,257,7,277,1149
MÉXICO,AMECAMECA DE JUAREZ,20,221,8,249,1148
MÉXICO,AMECAMECA DE JUAREZ,13,279,6,298,1540
MÉXICO,AMECAMECA DE JUAREZ,14,331,10,355,1539
MÉXICO,AMECAMECA DE JUAREZ,16,285,6,307,1539
MÉXICO,AMECAMECA DE JUAREZ,16,338,8,362,1868
MÉXICO,AMECAMECA DE JUAREZ,21,281,3,305,1535
MÉXICO,AMECAMECA DE JUAREZ,15,280,5,300,1535
MÉXICO,AMECAMECA DE JUAREZ,21,366,12,399,1991
MÉXICO,AMECAMECA DE JUAREZ,36,399,5,440,1991
MÉXICO,AMECAMECA DE JUAREZ,6,372,15,393,1531
MÉXICO,AMECAMECA DE JUAREZ,8,324,10,342,1530
MÉXICO,AMECAMECA DE JUAREZ,6,306,7,319,1684
MÉXICO,AMECAMECA DE JUAREZ,5,309,6,320,1684
MÉXICO,AMECAMECA DE JUAREZ,15,264,6,285,1672
MÉXICO,AMECAMECA DE JUAREZ,14,296,3,313,1672
MÉXICO,AMECAMECA DE JUAREZ,20,197,2,219,1434
MÉXICO,AMECAMECA DE JUAREZ,16,202,3,221,1434
MÉXICO,AMECAMECA DE JUAREZ,14,157,5,176,1957
MÉXICO,AMECAMECA DE JUAREZ,17,177,4,198,1956
MÉXICO,AMECAMECA DE JUAREZ,14,170,6,190,1748
MÉXICO,AMECAMECA DE JUAREZ,13,206,7,226,1747
MÉXICO,AMECAMECA DE JUAREZ,35,291,3,329,1461
MÉXICO,AMECAMECA DE JUAREZ,26,250,4,280,1460
MÉXICO,AMECAMECA DE JUAREZ,32,256,2,290,1460
MÉXICO,AMECAMECA DE JUAREZ,36,331,6,373,1507
MÉXICO,AMECAMECA DE JUAREZ,33,268,4,305,1506
MÉXICO,AMECAMECA DE JUAREZ,29,295,1,325,1506
MÉXICO,AMECAMECA DE JUAREZ,19,123,9,151,1244
MÉXICO,AMECAMECA DE JUAREZ,21,120,7,148,1244
MÉXICO,AMECAMECA DE JUAREZ,34,165,6,205,1895
MÉXICO,AMECAMECA DE JUAREZ,9,122,2,133,1185
MÉXICO,AMECAMECA DE JUAREZ,8,137,4,149,1185
MÉXICO,AMECAMECA DE JUAREZ,23,251,4,278,1731
MÉXICO,AMECAMECA DE JUAREZ,25,218,2,245,1731
MÉXICO,AMECAMECA DE JUAREZ,17,261,3,281,1731
MÉXICO,AMECAMECA DE JUAREZ,23,292,1,316,1826
MÉXICO,AMECAMECA DE JUAREZ,27,285,3,315,1826
MÉXICO,AMECAMECA DE JUAREZ,15,268,4,287,1826
MÉXICO,AMECAMECA DE JUAREZ,19,268,7,294,1826
MÉXICO,AMECAMECA DE JUAREZ,20,268,5,293,1777
MÉXICO,AMECAMECA DE JUAREZ,18,270,7,295,1776
MÉXICO,AMECAMECA DE JUAREZ,39,287,3,329,1776
MÉXICO,AMECAMECA DE JUAREZ,9,209,3,221,2003
MÉXICO,AMECAMECA DE JUAREZ,34,261,5,300,1905
MÉXICO,AMECAMECA DE JUAREZ,38,258,3,299,1905
MÉXICO,AMECAMECA DE JUAREZ,18,173,5,196,1574
MÉXICO,AMECAMECA DE JUAREZ,19,187,5,211,1574
MÉXICO,AMECAMECA DE JUAREZ,20,175,10,205,1574
MÉXICO,AMECAMECA DE JUAREZ,16,187,1,204,1574
MÉXICO,AMECAMECA DE JUAREZ,27,294,2,323,1719
MÉXICO,AMECAMECA DE JUAREZ,17,328,7,352,1601
MÉXICO,AMECAMECA DE JUAREZ,16,246,4,266,1537
MÉXICO,AMECAMECA DE JUAREZ,12,259,5,276,1537
MÉXICO,AMECAMECA DE JUAREZ,16,301,9,326,1599
MÉXICO,AMECAMECA DE JUAREZ,9,207,2,218,1186
MÉXICO,AMECAMECA DE JUAREZ,4,197,6,207,1186
MÉXICO,AMECAMECA DE JUAREZ,11,371,9,391,1974
MÉXICO,AMECAMECA DE JUAREZ,13,344,9,366,1974
MÉXICO,AMECAMECA DE JUAREZ,11,365,5,381,1973
MÉXICO,AMECAMECA DE JUAREZ,15,213,6,234,1127
MÉXICO,AMECAMECA DE JUAREZ,5,256,9,270,1126
MÉXICO,AMECAMECA DE JUAREZ,12,267,4,283,1639
MÉXICO,AMECAMECA DE JUAREZ,7,304,1,312,1638
MÉXICO,AMECAMECA DE JUAREZ,10,336,1,347,1638
MÉXICO,AMECAMECA DE JUAREZ,20,398,7,425,1965
MÉXICO,AMECAMECA DE JUAREZ,24,354,3,381,1970
MÉXICO,AMECAMECA DE JUAREZ,16,331,7,354,1970
MÉXICO,AMECAMECA DE JUAREZ,25,261,5,291,1813
MÉXICO,AMECAMECA DE JUAREZ,15,251,3,269,1539
MÉXICO,AMECAMECA DE JUAREZ,18,249,2,269,1538
MÉXICO,AMECAMECA DE JUAREZ,21,470,6,497,2052
MÉXICO,AMECAMECA DE JUAREZ,10,254,5,269,1603
MÉXICO,AMECAMECA DE JUAREZ,3,289,8,300,1603
MÉXICO,AMECAMECA DE JUAREZ,16,277,4,297,1767
MÉXICO,AMECAMECA DE JUAREZ,24,225,3,252,1558
MÉXICO,AMECAMECA DE JUAREZ,14,143,0,157,1152
MÉXICO,AMECAMECA DE JUAREZ,16,169,3,188,1151
MÉXICO,AMECAMECA DE JUAREZ,29,249,2,280,1620
MÉXICO,AMECAMECA DE JUAREZ,22,277,6,305,1619
MÉXICO,AMECAMECA DE JUAREZ,27,396,11,434,1895
MÉXICO,AMECAMECA DE JUAREZ,20,348,8,376,1894
MÉXICO,AMECAMECA DE JUAREZ,14,443,5,462,1914
MÉXICO,AMECAMECA DE JUAREZ,12,252,0,264,1369
MÉXICO,AMECAMECA DE JUAREZ,13,262,1,276,1369
MÉXICO,AMECAMECA DE JUAREZ,11,234,3,248,1317
MÉXICO,AMECAMECA DE JUAREZ,10,216,1,227,1316
MÉXICO,AMECAMECA DE JUAREZ,18,342,3,363,1579
MÉXICO,AMECAMECA DE JUAREZ,10,370,5,385,1961
MÉXICO,AMECAMECA DE JUAREZ,27,260,5,292,1624
MÉXICO,AMECAMECA DE JUAREZ,22,182,8,212,1141
MÉXICO,AMECAMECA DE JUAREZ,11,246,5,262,1140
MÉXICO,AMECAMECA DE JUAREZ,19,189,2,210,1138
MÉXICO,AMECAMECA DE JUAREZ,12,214,0,226,1137
MÉXICO,AMECAMECA DE JUAREZ,26,295,2,323,1753
MÉXICO,AMECAMECA DE JUAREZ,25,263,5,293,1747
MÉXICO,AMECAMECA DE JUAREZ,22,301,5,328,1747
MÉXICO,AMECAMECA DE JUAREZ,30,269,5,304,1747
MÉXICO,AMECAMECA DE JUAREZ,17,206,4,227,1141
MÉXICO,AMECAMECA DE JUAREZ,15,219,1,235,1141
MÉXICO,AMECAMECA DE JUAREZ,12,200,5,217,1202
MÉXICO,AMECAMECA DE JUAREZ,24,211,2,237,1202
MÉXICO,AMECAMECA DE JUAREZ,17,185,2,204,1058
MÉXICO,AMECAMECA DE JUAREZ,19,207,3,229,1058
MÉXICO,AMECAMECA DE JUAREZ,13,231,5,249,1197
MÉXICO,AMECAMECA DE JUAREZ,11,234,0,245,1197
MÉXICO,AMECAMECA DE JUAREZ,20,327,6,353,1857
MÉXICO,AMECAMECA DE JUAREZ,16,320,4,340,1857
MÉXICO,AMECAMECA DE JUAREZ,26,282,2,310,1857
MÉXICO,AMECAMECA DE JUAREZ,13,236,4,253,1548
MÉXICO,AMECAMECA DE JUAREZ,23,260,1,284,1619
MÉXICO,AMECAMECA DE JUAREZ,34,390,1,425,1804
MÉXICO,AMECAMECA DE JUAREZ,31,289,0,320,1799
MÉXICO,AMECAMECA DE JUAREZ,18,282,8,308,1537
MÉXICO,AMECAMECA DE JUAREZ,19,294,4,317,1537
MÉXICO,AMECAMECA DE JUAREZ,36,243,1,280,1896
MÉXICO,AMECAMECA DE JUAREZ,47,238,1,286,1896
MÉXICO,AMECAMECA DE JUAREZ,25,203,3,231,1475
MÉXICO,AMECAMECA DE JUAREZ,26,182,4,212,1475
MÉXICO,AMECAMECA DE JUAREZ,18,254,2,274,1621
MÉXICO,AMECAMECA DE JUAREZ,37,255,3,295,1621
MÉXICO,AMECAMECA DE JUAREZ,41,274,3,318,1911
MÉXICO,AMECAMECA DE JUAREZ,30,235,2,267,1910
MÉXICO,AMECAMECA DE JUAREZ,18,212,0,230,1532
MÉXICO,AMECAMECA DE JUAREZ,27,184,2,213,1532
MÉXICO,AMECAMECA DE JUAREZ,38,199,5,242,1656
MÉXICO,AMECAMECA DE JUAREZ,28,193,4,225,1656
MÉXICO,AMECAMECA DE JUAREZ,22,134,1,157,1544
MÉXICO,AMECAMECA DE JUAREZ,18,157,2,177,1544
MÉXICO,AMECAMECA DE JUAREZ,17,207,2,226,1712
MÉXICO,AMECAMECA DE JUAREZ,28,232,3,263,1711
MÉXICO,AMECAMECA DE JUAREZ,9,180,1,190,1449
MÉXICO,AMECAMECA DE JUAREZ,15,171,1,187,1448
MÉXICO,AMECAMECA DE JUAREZ,18,215,3,236,1826
MÉXICO,AMECAMECA DE JUAREZ,17,215,2,234,1826
MÉXICO,AMECAMECA DE JUAREZ,16,190,3,209,1825
MÉXICO,AMECAMECA DE JUAREZ,19,138,1,158,1065
MÉXICO,AMECAMECA DE JUAREZ,17,173,1,191,1065
MÉXICO,AMECAMECA DE JUAREZ,23,201,1,225,1546
MÉXICO,AMECAMECA DE JUAREZ,22,305,1,328,1943
MÉXICO,AMECAMECA DE JUAREZ,19,285,1,305,1942
MÉXICO,AMECAMECA DE JUAREZ,16,183,1,200,1170
MÉXICO,AMECAMECA DE JUAREZ,13,168,2,183,1170
MÉXICO,NAUCALPAN DE JUAREZ,24,175,3,202,1593
MÉXICO,NAUCALPAN DE JUAREZ,21,150,1,172,1572
MÉXICO,NAUCALPAN DE JUAREZ,31,154,2,187,1572
MÉXICO,NAUCALPAN DE JUAREZ,25,185,2,212,1751
MÉXICO,NAUCALPAN DE JUAREZ,41,205,2,248,1751
MÉXICO,NAUCALPAN DE JUAREZ,23,184,4,211,1761
MÉXICO,NAUCALPAN DE JUAREZ,20,187,4,211,1789
MÉXICO,NAUCALPAN DE JUAREZ,28,234,4,266,1788
MÉXICO,NAUCALPAN DE JUAREZ,16,187,3,206,1575
MÉXICO,NAUCALPAN DE JUAREZ,30,58,4,92,1627
MÉXICO,NAUCALPAN DE JUAREZ,18,75,2,95,1627
MÉXICO,NAUCALPAN DE JUAREZ,36,68,1,105,1532
MÉXICO,NAUCALPAN DE JUAREZ,34,109,0,143,1918
MÉXICO,NAUCALPAN DE JUAREZ,27,106,2,135,1711
MÉXICO,NAUCALPAN DE JUAREZ,16,112,2,130,1711
MÉXICO,NAUCALPAN DE JUAREZ,30,90,0,120,1513
MÉXICO,NAUCALPAN DE JUAREZ,46,102,2,150,1690
MÉXICO,NAUCALPAN DE JUAREZ,52,110,21,183,2008
MÉXICO,NAUCALPAN DE JUAREZ,34,79,1,114,1580
MÉXICO,NAUCALPAN DE JUAREZ,26,82,0,108,1579
MÉXICO,NAUCALPAN DE JUAREZ,38,50,3,91,1555
MÉXICO,NAUCALPAN DE JUAREZ,36,61,1,98,1555
MÉXICO,NAUCALPAN DE JUAREZ,33,65,0,98,1756
MÉXICO,NAUCALPAN DE JUAREZ,40,71,2,113,1755
MÉXICO,NAUCALPAN DE JUAREZ,30,79,0,109,1886
MÉXICO,NAUCALPAN DE JUAREZ,31,84,2,117,1886
MÉXICO,NAUCALPAN DE JUAREZ,16,119,4,139,1654
MÉXICO,NAUCALPAN DE JUAREZ,33,88,0,121,1691
MÉXICO,NAUCALPAN DE JUAREZ,28,75,0,103,1691
MÉXICO,NAUCALPAN DE JUAREZ,34,129,1,164,1819
MÉXICO,NAUCALPAN DE JUAREZ,44,107,2,153,1821
MÉXICO,NAUCALPAN DE JUAREZ,43,99,0,142,1559
MÉXICO,NAUCALPAN DE JUAREZ,44,89,0,133,1788
MÉXICO,NAUCALPAN DE JUAREZ,35,91,1,127,1787
MÉXICO,NAUCALPAN DE JUAREZ,37,108,1,146,1892
MÉXICO,NAUCALPAN DE JUAREZ,12,150,1,163,1393
MÉXICO,NAUCALPAN DE JUAREZ,20,143,5,168,1392
MÉXICO,NAUCALPAN DE JUAREZ,25,139,1,165,1122
MÉXICO,NAUCALPAN DE JUAREZ,16,152,3,171,1121
MÉXICO,NAUCALPAN DE JUAREZ,13,139,2,154,1204
MÉXICO,NAUCALPAN DE JUAREZ,14,149,4,167,1204
MÉXICO,NAUCALPAN DE JUAREZ,16,117,3,136,1163
MÉXICO,NAUCALPAN DE JUAREZ,11,126,2,139,1163
MÉXICO,NAUCALPAN DE JUAREZ,50,187,7,244,1814
MÉXICO,NAUCALPAN DE JUAREZ,15,252,5,272,1978
MÉXICO,NAUCALPAN DE JUAREZ,25,264,4,293,1977
MÉXICO,NAUCALPAN DE JUAREZ,20,136,2,158,1504
MÉXICO,NAUCALPAN DE JUAREZ,14,134,3,151,1504
MÉXICO,NAUCALPAN DE JUAREZ,13,140,2,155,1504
MÉXICO,NAUCALPAN DE JUAREZ,7,152,5,164,1504
MÉXICO,NAUCALPAN DE JUAREZ,16,183,3,202,1364
MÉXICO,NAUCALPAN DE JUAREZ,20,177,0,197,1363
MÉXICO,NAUCALPAN DE JUAREZ,12,99,2,113,1053
MÉXICO,NAUCALPAN DE JUAREZ,11,131,2,144,1053
MÉXICO,NAUCALPAN DE JUAREZ,16,132,5,153,2082
MÉXICO,NAUCALPAN DE JUAREZ,17,172,2,191,2082
MÉXICO,NAUCALPAN DE JUAREZ,38,260,16,314,1947
MÉXICO,NAUCALPAN DE JUAREZ,21,235,8,264,1946
MÉXICO,NAUCALPAN DE JUAREZ,15,143,4,162,1636
MÉXICO,NAUCALPAN DE JUAREZ,14,152,5,171,1635
MÉXICO,NAUCALPAN DE JUAREZ,14,136,4,154,1294
MÉXICO,NAUCALPAN DE JUAREZ,17,146,2,165,1294
MÉXICO,NAUCALPAN DE JUAREZ,15,154,3,172,1394
MÉXICO,NAUCALPAN DE JUAREZ,15,155,1,171,1394
MÉXICO,NAUCALPAN DE JUAREZ,42,172,5,219,1813
MÉXICO,NAUCALPAN DE JUAREZ,35,208,6,249,1796
MÉXICO,NAUCALPAN DE JUAREZ,27,150,1,178,1990
MÉXICO,NAUCALPAN DE JUAREZ,32,109,2,143,1981
MÉXICO,NAUCALPAN DE JUAREZ,33,124,2,159,1980
MÉXICO,NAUCALPAN DE JUAREZ,38,79,1,118,1999
MÉXICO,NAUCALPAN DE JUAREZ,26,95,1,122,1514
MÉXICO,NAUCALPAN DE JUAREZ,27,110,0,137,1513
MÉXICO,NAUCALPAN DE JUAREZ,29,131,2,162,1513
MÉXICO,NAUCALPAN DE JUAREZ,39,117,0,156,2012
MÉXICO,NAUCALPAN DE JUAREZ,17,130,1,148,1553
MÉXICO,NAUCALPAN DE JUAREZ,17,47,0,64,1035
MÉXICO,NAUCALPAN DE JUAREZ,14,66,1,81,1034
MÉXICO,NAUCALPAN DE JUAREZ,36,120,1,157,1742
MÉXICO,NAUCALPAN DE JUAREZ,30,135,0,165,1741
MÉXICO,NAUCALPAN DE JUAREZ,11,125,0,136,1683
MÉXICO,NAUCALPAN DE JUAREZ,9,158,4,171,1683
MÉXICO,NAUCALPAN DE JUAREZ,25,187,5,217,1826
MÉXICO,NAUCALPAN DE JUAREZ,12,134,4,150,1145
MÉXICO,NAUCALPAN DE JUAREZ,16,106,5,127,1145
MÉXICO,NAUCALPAN DE JUAREZ,19,190,5,214,1907
MÉXICO,NAUCALPAN DE JUAREZ,16,155,3,174,1907
MÉXICO,NAUCALPAN DE JUAREZ,18,132,3,153,1906
MÉXICO,NAUCALPAN DE JUAREZ,31,220,3,254,1983
MÉXICO,NAUCALPAN DE JUAREZ,30,246,2,278,1983
MÉXICO,NAUCALPAN DE JUAREZ,21,112,1,134,1658
MÉXICO,NAUCALPAN DE JUAREZ,28,134,1,163,1658
MÉXICO,NAUCALPAN DE JUAREZ,35,84,1,120,1591
MÉXICO,NAUCALPAN DE JUAREZ,31,80,2,113,1591
MÉXICO,NAUCALPAN DE JUAREZ,13,97,3,113,1523
MÉXICO,NAUCALPAN DE JUAREZ,136,777,10,923,0
MÉXICO,NAUCALPAN DE JUAREZ,26,75,3,104,1550
MÉXICO,NAUCALPAN DE JUAREZ,27,91,0,118,1549
MÉXICO,NAUCALPAN DE JUAREZ,28,87,1,116,1487
MÉXICO,NAUCALPAN DE JUAREZ,43,92,1,136,1486
MÉXICO,NAUCALPAN DE JUAREZ,37,289,1,327,1908
MÉXICO,NAUCALPAN DE JUAREZ,36,321,1,358,1907
MÉXICO,NAUCALPAN DE JUAREZ,21,277,1,299,1809
MÉXICO,NAUCALPAN DE JUAREZ,32,104,0,136,1970
MÉXICO,NAUCALPAN DE JUAREZ,38,120,3,161,1970
MÉXICO,NAUCALPAN DE JUAREZ,37,157,1,195,1508
MÉXICO,NAUCALPAN DE JUAREZ,29,170,1,200,1488
MÉXICO,NAUCALPAN DE JUAREZ,35,168,2,205,1487
MÉXICO,NAUCALPAN DE JUAREZ,42,256,6,304,2000
MÉXICO,NAUCALPAN DE JUAREZ,43,158,2,203,1853
MÉXICO,NAUCALPAN DE JUAREZ,23,123,4,150,1498
MÉXICO,NAUCALPAN DE JUAREZ,30,103,1,134,1498
MÉXICO,NAUCALPAN DE JUAREZ,27,137,0,164,1497
MÉXICO,NAUCALPAN DE JUAREZ,30,98,1,129,1316
MÉXICO,NAUCALPAN DE JUAREZ,29,84,0,113,1315
MÉXICO,NAUCALPAN DE JUAREZ,25,121,3,149,1610
MÉXICO,NAUCALPAN DE JUAREZ,33,129,2,164,1610
MÉXICO,NAUCALPAN DE JUAREZ,46,221,6,273,1775
MÉXICO,NAUCALPAN DE JUAREZ,48,87,1,136,1804
MÉXICO,NAUCALPAN DE JUAREZ,50,156,5,211,1763
MÉXICO,NAUCALPAN DE JUAREZ,54,232,3,289,1955
MÉXICO,NAUCALPAN DE JUAREZ,31,295,8,334,1965
MÉXICO,NAUCALPAN DE JUAREZ,25,245,2,272,1952
MÉXICO,NAUCALPAN DE JUAREZ,30,224,7,261,1703
MÉXICO,NAUCALPAN DE JUAREZ,27,285,3,315,2060
MÉXICO,NAUCALPAN DE JUAREZ,17,203,1,221,1984
MÉXICO,NAUCALPAN DE JUAREZ,20,150,0,170,1009
MÉXICO,NAUCALPAN DE JUAREZ,12,128,0,140,1009
MÉXICO,NAUCALPAN DE JUAREZ,34,207,3,244,1952
MÉXICO,NAUCALPAN DE JUAREZ,34,233,2,269,1951
MÉXICO,NAUCALPAN DE JUAREZ,31,126,2,159,1787
MÉXICO,NAUCALPAN DE JUAREZ,27,145,1,173,1786
MÉXICO,NAUCALPAN DE JUAREZ,37,152,6,195,1790
MÉXICO,NAUCALPAN DE JUAREZ,24,80,1,105,1386
MÉXICO,NAUCALPAN DE JUAREZ,22,81,1,104,1386
MÉXICO,NAUCALPAN DE JUAREZ,33,63,3,99,1386
MÉXICO,NAUCALPAN DE JUAREZ,17,207,0,224,1842
MÉXICO,NAUCALPAN DE JUAREZ,17,175,1,193,1720
MÉXICO,NAUCALPAN DE JUAREZ,26,166,3,195,1720
MÉXICO,NAUCALPAN DE JUAREZ,13,149,2,164,1285
MÉXICO,NAUCALPAN DE JUAREZ,19,158,3,180,1285
MÉXICO,NAUCALPAN DE JUAREZ,29,171,3,203,1564
MÉXICO,NAUCALPAN DE JUAREZ,25,169,6,200,1563
MÉXICO,NAUCALPAN DE JUAREZ,14,175,0,189,1172
MÉXICO,NAUCALPAN DE JUAREZ,10,140,4,154,1171
MÉXICO,NAUCALPAN DE JUAREZ,22,210,4,236,1679
MÉXICO,NAUCALPAN DE JUAREZ,18,203,5,226,1678
MÉXICO,NAUCALPAN DE JUAREZ,13,232,7,252,1468
MÉXICO,NAUCALPAN DE JUAREZ,12,171,3,186,1468
MÉXICO,NAUCALPAN DE JUAREZ,17,211,1,229,1492
MÉXICO,NAUCALPAN DE JUAREZ,19,228,6,253,1491
MÉXICO,NAUCALPAN DE JUAREZ,13,158,1,172,1240
MÉXICO,NAUCALPAN DE JUAREZ,14,154,7,175,1239
MÉXICO,NAUCALPAN DE JUAREZ,8,122,1,131,1089
MÉXICO,NAUCALPAN DE JUAREZ,10,129,0,139,1088
MÉXICO,NAUCALPAN DE JUAREZ,20,172,3,195,1597
MÉXICO,NAUCALPAN DE JUAREZ,24,187,5,216,1596
MÉXICO,NAUCALPAN DE JUAREZ,12,127,2,141,1067
MÉXICO,NAUCALPAN DE JUAREZ,11,145,2,158,1067
MÉXICO,NAUCALPAN DE JUAREZ,17,183,4,204,1445
MÉXICO,NAUCALPAN DE JUAREZ,17,188,4,209,1445
MÉXICO,NAUCALPAN DE JUAREZ,19,193,2,214,1301
MÉXICO,NAUCALPAN DE JUAREZ,34,181,2,217,1301
MÉXICO,NAUCALPAN DE JUAREZ,36,211,1,248,1788
MÉXICO,NAUCALPAN DE JUAREZ,22,205,3,230,1787
MÉXICO,NAUCALPAN DE JUAREZ,26,186,5,217,1787
MÉXICO,NAUCALPAN DE JUAREZ,21,189,1,211,1427
MÉXICO,NAUCALPAN DE JUAREZ,13,212,6,231,1426
MÉXICO,NAUCALPAN DE JUAREZ,14,182,4,200,1526
MÉXICO,NAUCALPAN DE JUAREZ,21,209,0,230,1526
MÉXICO,NAUCALPAN DE JUAREZ,27,242,4,273,1521
MÉXICO,NAUCALPAN DE JUAREZ,25,266,2,293,1521
MÉXICO,NAUCALPAN DE JUAREZ,14,247,3,264,1521
MÉXICO,NAUCALPAN DE JUAREZ,20,139,0,159,1121
MÉXICO,NAUCALPAN DE JUAREZ,18,133,3,154,1120
MÉXICO,NAUCALPAN DE JUAREZ,20,250,4,274,1910
MÉXICO,NAUCALPAN DE JUAREZ,32,265,12,309,1878
MÉXICO,NAUCALPAN DE JUAREZ,22,175,6,203,1795
MÉXICO,NAUCALPAN DE JUAREZ,23,211,7,241,1795
MÉXICO,NAUCALPAN DE JUAREZ,25,191,6,222,1795
MÉXICO,NAUCALPAN DE JUAREZ,20,218,2,240,1795
MÉXICO,NAUCALPAN DE JUAREZ,29,265,6,300,1675
MÉXICO,NAUCALPAN DE JUAREZ,16,223,2,241,1577
MÉXICO,NAUCALPAN DE JUAREZ,27,264,6,297,1577
MÉXICO,NAUCALPAN DE JUAREZ,26,320,8,354,1892
MÉXICO,NAUCALPAN DE JUAREZ,45,278,8,331,1650
MÉXICO,NAUCALPAN DE JUAREZ,30,265,2,297,1650
MÉXICO,NAUCALPAN DE JUAREZ,35,221,6,262,1443
MÉXICO,NAUCALPAN DE JUAREZ,25,239,6,270,1443
MÉXICO,NAUCALPAN DE JUAREZ,21,238,6,265,1694
MÉXICO,NAUCALPAN DE JUAREZ,22,216,2,240,1694
MÉXICO,NAUCALPAN DE JUAREZ,17,203,4,224,1490
MÉXICO,NAUCALPAN DE JUAREZ,27,228,4,259,1490
MÉXICO,NAUCALPAN DE JUAREZ,24,165,3,192,1505
MÉXICO,NAUCALPAN DE JUAREZ,21,153,2,176,1505
MÉXICO,NAUCALPAN DE JUAREZ,24,157,3,184,1504
MÉXICO,NAUCALPAN DE JUAREZ,25,203,4,232,1592
MÉXICO,NAUCALPAN DE JUAREZ,19,182,5,206,1709
MÉXICO,NAUCALPAN DE JUAREZ,14,174,2,190,1708
MÉXICO,NAUCALPAN DE JUAREZ,13,130,2,145,1197
MÉXICO,NAUCALPAN DE JUAREZ,12,141,3,156,1196
MÉXICO,NAUCALPAN DE JUAREZ,16,186,5,207,1388
MÉXICO,NAUCALPAN DE JUAREZ,19,186,3,208,1388
MÉXICO,NAUCALPAN DE JUAREZ,18,153,3,174,1162
MÉXICO,NAUCALPAN DE JUAREZ,10,160,1,171,1162
MÉXICO,NAUCALPAN DE JUAREZ,56,264,5,325,1561
MÉXICO,NAUCALPAN DE JUAREZ,19,211,4,234,1530
MÉXICO,NAUCALPAN DE JUAREZ,16,192,12,220,1530
MÉXICO,NAUCALPAN DE JUAREZ,29,254,8,291,1647
MÉXICO,NAUCALPAN DE JUAREZ,10,149,2,161,1844
MÉXICO,NAUCALPAN DE JUAREZ,21,126,2,149,1844
MÉXICO,NAUCALPAN DE JUAREZ,28,209,4,241,1898
MÉXICO,NAUCALPAN DE JUAREZ,25,203,4,232,1897
MÉXICO,NAUCALPAN DE JUAREZ,8,158,1,167,1816
MÉXICO,NAUCALPAN DE JUAREZ,18,156,5,179,1816
MÉXICO,NAUCALPAN DE JUAREZ,14,129,2,145,1816
MÉXICO,NAUCALPAN DE JUAREZ,8,144,4,156,1816
MÉXICO,NAUCALPAN DE JUAREZ,13,158,1,172,1816
MÉXICO,NAUCALPAN DE JUAREZ,14,160,0,174,1816
MÉXICO,NAUCALPAN DE JUAREZ,17,181,4,202,1815
MÉXICO,NAUCALPAN DE JUAREZ,12,180,0,192,1815
MÉXICO,LERMA DE VILLADA,32,346,4,382,1563
MÉXICO,LERMA DE VILLADA,24,319,1,344,1562
MÉXICO,LERMA DE VILLADA,18,232,2,252,1189
MÉXICO,LERMA DE VILLADA,4,201,1,206,1189
MÉXICO,LERMA DE VILLADA,20,323,6,349,1670
MÉXICO,LERMA DE VILLADA,18,297,1,316,1670
MÉXICO,LERMA DE VILLADA,181,11,3,195,1259
MÉXICO,LERMA DE VILLADA,8,222,2,232,1258
MÉXICO,LERMA DE VILLADA,16,230,3,249,1408
MÉXICO,LERMA DE VILLADA,15,218,5,238,1407
MÉXICO,LERMA DE VILLADA,8,103,1,112,1400
MÉXICO,LERMA DE VILLADA,10,90,0,100,1399
MÉXICO,LERMA DE VILLADA,12,160,0,172,1570
MÉXICO,LERMA DE VILLADA,11,150,0,161,1569
MÉXICO,LERMA DE VILLADA,16,185,1,202,1400
MÉXICO,LERMA DE VILLADA,17,161,2,180,1400
MÉXICO,LERMA DE VILLADA,18,202,2,222,1921
MÉXICO,LERMA DE VILLADA,22,189,2,213,1921
MÉXICO,LERMA DE VILLADA,18,149,1,168,1554
MÉXICO,LERMA DE VILLADA,20,138,5,163,1554
MÉXICO,LERMA DE VILLADA,22,155,1,178,1553
MÉXICO,LERMA DE VILLADA,33,214,4,251,1889
MÉXICO,LERMA DE VILLADA,30,192,1,223,1888
MÉXICO,LERMA DE VILLADA,4,139,2,145,1320
MÉXICO,LERMA DE VILLADA,5,139,0,144,1320
MÉXICO,LERMA DE VILLADA,23,343,6,372,1648
MÉXICO,LERMA DE VILLADA,19,289,15,323,1647
MÉXICO,LERMA DE VILLADA,14,201,1,216,1532
MÉXICO,LERMA DE VILLADA,14,194,5,213,1532
MÉXICO,LERMA DE VILLADA,10,194,2,206,1531
MÉXICO,LERMA DE VILLADA,13,257,4,274,1917
MÉXICO,LERMA DE VILLADA,23,260,1,284,1917
MÉXICO,LERMA DE VILLADA,10,271,4,285,1836
MÉXICO,LERMA DE VILLADA,16,293,1,310,1836
MÉXICO,LERMA DE VILLADA,25,292,5,322,2022
MÉXICO,LERMA DE VILLADA,31,313,5,349,2021
MÉXICO,LERMA DE VILLADA,26,203,4,233,1349
MÉXICO,LERMA DE VILLADA,25,152,1,178,1349
MÉXICO,LERMA DE VILLADA,19,213,7,239,1727
MÉXICO,LERMA DE VILLADA,30,253,6,289,1726
MÉXICO,LERMA DE VILLADA,26,260,0,286,1775
MÉXICO,LERMA DE VILLADA,49,243,2,294,1774
MÉXICO,LERMA DE VILLADA,39,236,4,279,1774
MÉXICO,LERMA DE VILLADA,32,247,3,282,1774
MÉXICO,LERMA DE VILLADA,17,192,0,209,1644
MÉXICO,LERMA DE VILLADA,21,187,1,209,1643
MÉXICO,LERMA DE VILLADA,30,186,0,216,1643
MÉXICO,LERMA DE VILLADA,42,255,3,300,1961
MÉXICO,LERMA DE VILLADA,16,174,2,192,1138
MÉXICO,LERMA DE VILLADA,25,129,2,156,1137
MÉXICO,LERMA DE VILLADA,15,212,5,232,1541
MÉXICO,LERMA DE VILLADA,20,203,9,232,1540
MÉXICO,LERMA DE VILLADA,12,133,6,151,1053
MÉXICO,LERMA DE VILLADA,12,165,4,181,1053
MÉXICO,LERMA DE VILLADA,13,226,3,242,1858
MÉXICO,LERMA DE VILLADA,7,169,2,178,1857
MÉXICO,LERMA DE VILLADA,14,286,0,300,1728
MÉXICO,LERMA DE VILLADA,17,232,2,251,1727
MÉXICO,LERMA DE VILLADA,21,366,5,392,1913
MÉXICO,LERMA DE VILLADA,18,382,4,404,1912
MÉXICO,LERMA DE VILLADA,12,156,2,170,1309
MÉXICO,LERMA DE VILLADA,15,127,1,143,1309
MÉXICO,LERMA DE VILLADA,6,251,3,260,1333
MÉXICO,LERMA DE VILLADA,7,159,3,169,1332
MÉXICO,LERMA DE VILLADA,11,359,1,371,1976
MÉXICO,LERMA DE VILLADA,10,384,4,398,1976
MÉXICO,LERMA DE VILLADA,17,347,5,369,1880
MÉXICO,LERMA DE VILLADA,18,344,4,366,1879
MÉXICO,LERMA DE VILLADA,18,261,2,281,1890
MÉXICO,LERMA DE VILLADA,17,254,3,274,1890
MÉXICO,LERMA DE VILLADA,27,259,5,291,1889
MÉXICO,LERMA DE VILLADA,8,203,5,216,1650
MÉXICO,LERMA DE VILLADA,8,213,4,225,1650
MÉXICO,LERMA DE VILLADA,16,180,3,199,1853
MÉXICO,LERMA DE VILLADA,17,199,2,218,1852
MÉXICO,LERMA DE VILLADA,17,173,0,190,1437
MÉXICO,LERMA DE VILLADA,18,175,4,197,1437
MÉXICO,LERMA DE VILLADA,8,199,2,209,1814
MÉXICO,LERMA DE VILLADA,15,188,2,205,1814
MÉXICO,LERMA DE VILLADA,14,174,0,188,1366
MÉXICO,LERMA DE VILLADA,24,141,2,167,1365
MÉXICO,LERMA DE VILLADA,16,161,1,178,1365
MÉXICO,LERMA DE VILLADA,16,222,3,241,1629
MÉXICO,LERMA DE VILLADA,16,221,6,243,1628
MÉXICO,LERMA DE VILLADA,12,144,2,158,1190
MÉXICO,LERMA DE VILLADA,11,130,3,144,1189
MÉXICO,LERMA DE VILLADA,24,215,5,244,1294
MÉXICO,LERMA DE VILLADA,10,124,3,137,1294
MÉXICO,LERMA DE VILLADA,28,275,4,307,1516
MÉXICO,LERMA DE VILLADA,22,309,4,335,1648
MÉXICO,LERMA DE VILLADA,15,308,0,323,1647
MÉXICO,LERMA DE VILLADA,25,225,7,257,1627
MÉXICO,LERMA DE VILLADA,210,28,5,243,1626
MÉXICO,LERMA DE VILLADA,20,162,2,184,1048
MÉXICO,LERMA DE VILLADA,6,185,0,191,1047
MÉXICO,LERMA DE VILLADA,16,325,4,345,1901
MÉXICO,LERMA DE VILLADA,10,272,0,282,1901
MÉXICO,LERMA DE VILLADA,11,227,1,239,1636
MÉXICO,LERMA DE VILLADA,11,249,0,260,1635
MÉXICO,LERMA DE VILLADA,10,59,1,70,1474
MÉXICO,LERMA DE VILLADA,10,67,1,78,1473
MÉXICO,LERMA DE VILLADA,33,210,4,247,1500
MÉXICO,LERMA DE VILLADA,28,185,3,216,1500
MÉXICO,LERMA DE VILLADA,25,233,2,260,1499
MÉXICO,LERMA DE VILLADA,26,271,4,301,1740
MÉXICO,LERMA DE VILLADA,32,299,4,335,1740
MÉXICO,LERMA DE VILLADA,33,296,0,329,1739
MÉXICO,LERMA DE VILLADA,17,178,5,200,1130
MÉXICO,LERMA DE VILLADA,24,196,4,224,1129
MÉXICO,LERMA DE VILLADA,21,198,2,221,1539
MÉXICO,LERMA DE VILLADA,13,187,3,203,1538
MÉXICO,LERMA DE VILLADA,13,223,0,236,1538
MÉXICO,LERMA DE VILLADA,34,312,4,350,1957
MÉXICO,LERMA DE VILLADA,40,347,2,389,1957
MÉXICO,LERMA DE VILLADA,27,266,4,297,1721
MÉXICO,LERMA DE VILLADA,41,270,2,313,1721
MÉXICO,LERMA DE VILLADA,29,169,0,198,1991
MÉXICO,LERMA DE VILLADA,39,158,1,198,1990
MÉXICO,LERMA DE VILLADA,30,329,1,360,1780
MÉXICO,LERMA DE VILLADA,28,305,1,334,1779
MÉXICO,LERMA DE VILLADA,24,232,1,257,1477
MÉXICO,LERMA DE VILLADA,21,232,7,260,1477
MÉXICO,LERMA DE VILLADA,24,245,4,273,1476
MÉXICO,LERMA DE VILLADA,12,290,3,305,1960
MÉXICO,LERMA DE VILLADA,20,228,2,250,1960
MÉXICO,LERMA DE VILLADA,17,297,2,316,1959
MÉXICO,LERMA DE VILLADA,19,260,1,280,1959
MÉXICO,LERMA DE VILLADA,13,195,1,209,1380
MÉXICO,LERMA DE VILLADA,10,179,3,192,1380
MÉXICO,LERMA DE VILLADA,9,185,3,197,1380
MÉXICO,LERMA DE VILLADA,19,274,2,295,1742
MÉXICO,LERMA DE VILLADA,13,303,3,319,1741
MÉXICO,LERMA DE VILLADA,20,190,5,215,1352
MÉXICO,LERMA DE VILLADA,7,208,4,219,1352
MÉXICO,LERMA DE VILLADA,12,155,7,174,1474
MÉXICO,LERMA DE VILLADA,16,186,6,208,1474
MÉXICO,LERMA DE VILLADA,16,215,7,238,1474
MÉXICO,LERMA DE VILLADA,12,332,9,353,1952
MÉXICO,LERMA DE VILLADA,15,300,5,320,1951
MÉXICO,LERMA DE VILLADA,17,252,9,278,1981
MÉXICO,LERMA DE VILLADA,17,279,10,306,1981
MÉXICO,LERMA DE VILLADA,8,96,6,110,1587
MÉXICO,LERMA DE VILLADA,9,92,2,103,1586
MÉXICO,LERMA DE VILLADA,7,220,3,230,1827
MÉXICO,LERMA DE VILLADA,10,195,2,207,1827
MÉXICO,LERMA DE VILLADA,31,197,2,230,1983
MÉXICO,LERMA DE VILLADA,26,194,1,221,1983
MÉXICO,LERMA DE VILLADA,16,103,1,120,1630
MÉXICO,LERMA DE VILLADA,22,107,2,131,1630
MÉXICO,LERMA DE VILLADA,20,99,1,120,1630
MÉXICO,LERMA DE VILLADA,7,118,1,126,1630
MÉXICO,LERMA DE VILLADA,19,207,6,232,1049
MÉXICO,LERMA DE VILLADA,9,264,4,277,1049
MÉXICO,LERMA DE VILLADA,8,251,4,263,1087
MÉXICO,LERMA DE VILLADA,7,255,2,264,1086
MÉXICO,LERMA DE VILLADA,33,213,1,247,1680
MÉXICO,LERMA DE VILLADA,21,224,3,248,1680
MÉXICO,LERMA DE VILLADA,25,192,1,218,1671
MÉXICO,LERMA DE VILLADA,23,180,1,204,1671
MÉXICO,LERMA DE VILLADA,23,191,2,216,1496
MÉXICO,LERMA DE VILLADA,31,198,5,234,1496
MÉXICO,LERMA DE VILLADA,10,218,0,228,1536
MÉXICO,LERMA DE VILLADA,8,198,0,206,1535
MÉXICO,LERMA DE VILLADA,20,201,0,221,1535
MÉXICO,LERMA DE VILLADA,13,218,1,232,1216
MÉXICO,LERMA DE VILLADA,25,214,4,243,1216
MÉXICO,LERMA DE VILLADA,12,103,1,116,1372
MÉXICO,LERMA DE VILLADA,15,133,1,149,1372
MÉXICO,LERMA DE VILLADA,19,101,2,122,1371
MÉXICO,LERMA DE VILLADA,9,289,5,303,1985
MÉXICO,LERMA DE VILLADA,9,289,2,300,1985
MÉXICO,LERMA DE VILLADA,17,198,2,217,1149
MÉXICO,LERMA DE VILLADA,12,221,2,235,1148
MÉXICO,LERMA DE VILLADA,14,196,0,210,1817
MÉXICO,LERMA DE VILLADA,15,228,2,245,1816
MÉXICO,LERMA DE VILLADA,9,136,3,148,1262
MÉXICO,LERMA DE VILLADA,4,141,7,152,1261
MÉXICO,LERMA DE VILLADA,12,236,5,253,1694
MÉXICO,LERMA DE VILLADA,12,259,5,276,1694
MÉXICO,LERMA DE VILLADA,21,225,2,248,1174
MÉXICO,LERMA DE VILLADA,16,226,3,245,1174
MÉXICO,LERMA DE VILLADA,10,253,3,266,1848
MÉXICO,LERMA DE VILLADA,16,259,4,279,1848
MÉXICO,LERMA DE VILLADA,10,172,5,187,1420
MÉXICO,LERMA DE VILLADA,19,137,1,157,1420
MÉXICO,LERMA DE VILLADA,7,177,3,187,1419
MÉXICO,LERMA DE VILLADA,2,151,3,156,1457
MÉXICO,LERMA DE VILLADA,11,114,2,127,1456
MÉXICO,LERMA DE VILLADA,163,24,2,189,1954
MÉXICO,LERMA DE VILLADA,9,188,5,202,1953
MÉXICO,LERMA DE VILLADA,30,243,4,277,1743
MÉXICO,LERMA DE VILLADA,11,277,3,291,1743
MÉXICO,LERMA DE VILLADA,20,237,1,258,1445
MÉXICO,LERMA DE VILLADA,14,242,3,259,1444
MÉXICO,LERMA DE VILLADA,22,255,8,285,1905
MÉXICO,LERMA DE VILLADA,28,311,4,343,1905
MÉXICO,LERMA DE VILLADA,22,306,5,333,0
MÉXICO,NAUCALPAN DE JUAREZ,28,203,5,236,1722
MÉXICO,NAUCALPAN DE JUAREZ,32,248,0,280,1721
MÉXICO,NAUCALPAN DE JUAREZ,23,250,4,277,1935
MÉXICO,NAUCALPAN DE JUAREZ,1,290,4,295,1934
MÉXICO,NAUCALPAN DE JUAREZ,23,180,2,205,1447
MÉXICO,NAUCALPAN DE JUAREZ,16,155,0,171,1446
MÉXICO,NAUCALPAN DE JUAREZ,45,242,1,288,1798
MÉXICO,NAUCALPAN DE JUAREZ,37,223,3,263,1798
MÉXICO,NAUCALPAN DE JUAREZ,26,198,5,229,1481
MÉXICO,NAUCALPAN DE JUAREZ,17,198,2,217,1481
MÉXICO,NAUCALPAN DE JUAREZ,19,190,2,211,1480
MÉXICO,NAUCALPAN DE JUAREZ,33,240,4,277,1890
MÉXICO,NAUCALPAN DE JUAREZ,23,246,3,272,1889
MÉXICO,NAUCALPAN DE JUAREZ,17,189,3,209,1561
MÉXICO,NAUCALPAN DE JUAREZ,17,162,2,181,1561
MÉXICO,NAUCALPAN DE JUAREZ,33,207,2,242,1666
MÉXICO,NAUCALPAN DE JUAREZ,14,201,4,219,1666
MÉXICO,NAUCALPAN DE JUAREZ,17,219,3,239,1336
MÉXICO,NAUCALPAN DE JUAREZ,19,211,4,234,1336
MÉXICO,NAUCALPAN DE JUAREZ,17,206,4,227,1335
MÉXICO,NAUCALPAN DE JUAREZ,29,216,3,248,1561
MÉXICO,NAUCALPAN DE JUAREZ,32,227,3,262,1561
MÉXICO,NAUCALPAN DE JUAREZ,25,237,2,264,1879
MÉXICO,NAUCALPAN DE JUAREZ,34,275,5,314,1879
MÉXICO,NAUCALPAN DE JUAREZ,27,261,6,294,1737
MÉXICO,NAUCALPAN DE JUAREZ,32,254,0,286,1736
MÉXICO,NAUCALPAN DE JUAREZ,28,250,1,279,1881
MÉXICO,NAUCALPAN DE JUAREZ,18,200,4,222,1880
MÉXICO,NAUCALPAN DE JUAREZ,16,102,2,120,1381
MÉXICO,NAUCALPAN DE JUAREZ,91,15,0,106,1381
MÉXICO,NAUCALPAN DE JUAREZ,11,115,0,126,1701
MÉXICO,NAUCALPAN DE JUAREZ,24,110,1,135,1701
MÉXICO,NAUCALPAN DE JUAREZ,24,96,4,124,1701
MÉXICO,NAUCALPAN DE JUAREZ,32,217,6,255,1589
MÉXICO,NAUCALPAN DE JUAREZ,30,245,1,276,1588
MÉXICO,NAUCALPAN DE JUAREZ,19,106,1,126,978
MÉXICO,NAUCALPAN DE JUAREZ,12,93,2,107,978
MÉXICO,NAUCALPAN DE JUAREZ,19,218,2,239,1739
MÉXICO,NAUCALPAN DE JUAREZ,40,192,8,240,1739
MÉXICO,NAUCALPAN DE JUAREZ,8,129,3,140,1118
MÉXICO,NAUCALPAN DE JUAREZ,13,139,3,155,1117
MÉXICO,NAUCALPAN DE JUAREZ,9,143,1,153,1464
MÉXICO,NAUCALPAN DE JUAREZ,7,150,5,162,1463
MÉXICO,NAUCALPAN DE JUAREZ,21,176,2,199,1463
MÉXICO,NAUCALPAN DE JUAREZ,11,213,4,228,1875
MÉXICO,NAUCALPAN DE JUAREZ,9,234,1,244,1875
MÉXICO,NAUCALPAN DE JUAREZ,19,178,3,200,1851
MÉXICO,NAUCALPAN DE JUAREZ,13,162,4,179,1851
MÉXICO,NAUCALPAN DE JUAREZ,21,185,4,210,1479
MÉXICO,NAUCALPAN DE JUAREZ,14,187,5,206,1478
MÉXICO,NAUCALPAN DE JUAREZ,25,235,9,269,1733
MÉXICO,NAUCALPAN DE JUAREZ,34,222,1,257,1732
MÉXICO,NAUCALPAN DE JUAREZ,20,144,4,168,1063
MÉXICO,NAUCALPAN DE JUAREZ,15,151,1,167,1062
MÉXICO,NAUCALPAN DE JUAREZ,14,205,4,223,1376
MÉXICO,NAUCALPAN DE JUAREZ,35,188,5,228,1375
MÉXICO,NAUCALPAN DE JUAREZ,26,248,5,279,1711
MÉXICO,NAUCALPAN DE JUAREZ,31,256,5,292,1710
MÉXICO,NAUCALPAN DE JUAREZ,30,296,6,332,1905
MÉXICO,NAUCALPAN DE JUAREZ,22,232,14,268,1905
MÉXICO,NAUCALPAN DE JUAREZ,23,146,3,172,1147
MÉXICO,NAUCALPAN DE JUAREZ,23,126,8,157,1146
MÉXICO,NAUCALPAN DE JUAREZ,25,137,0,162,1130
MÉXICO,NAUCALPAN DE JUAREZ,17,134,2,153,1130
MÉXICO,NAUCALPAN DE JUAREZ,10,159,5,174,1288
MÉXICO,NAUCALPAN DE JUAREZ,18,169,3,190,1287
MÉXICO,NAUCALPAN DE JUAREZ,22,181,3,206,1923
MÉXICO,NAUCALPAN DE JUAREZ,15,196,7,218,1923
MÉXICO,NAUCALPAN DE JUAREZ,18,121,0,139,1169
MÉXICO,NAUCALPAN DE JUAREZ,12,145,4,161,1169
MÉXICO,NAUCALPAN DE JUAREZ,15,259,6,280,1918
MÉXICO,NAUCALPAN DE JUAREZ,31,264,4,299,1918
MÉXICO,NAUCALPAN DE JUAREZ,23,217,7,247,1858
MÉXICO,NAUCALPAN DE JUAREZ,13,277,1,291,1857
MÉXICO,NAUCALPAN DE JUAREZ,12,124,1,137,1041
MÉXICO,NAUCALPAN DE JUAREZ,11,122,1,134,1040
MÉXICO,NAUCALPAN DE JUAREZ,28,167,6,201,1743
MÉXICO,NAUCALPAN DE JUAREZ,14,179,5,198,1743
MÉXICO,NAUCALPAN DE JUAREZ,83,618,6,707,0
MÉXICO,NAUCALPAN DE JUAREZ,11,170,5,186,1664
MÉXICO,NAUCALPAN DE JUAREZ,24,169,2,195,1663
MÉXICO,NAUCALPAN DE JUAREZ,23,204,7,234,1546
MÉXICO,NAUCALPAN DE JUAREZ,17,208,9,234,1546
MÉXICO,NAUCALPAN DE JUAREZ,14,142,5,161,1113
MÉXICO,NAUCALPAN DE JUAREZ,11,145,3,159,1113
MÉXICO,NAUCALPAN DE JUAREZ,33,154,4,191,1345
MÉXICO,NAUCALPAN DE JUAREZ,19,166,6,191,1345
MÉXICO,NAUCALPAN DE JUAREZ,33,186,7,226,1356
MÉXICO,NAUCALPAN DE JUAREZ,24,140,4,168,1355
MÉXICO,NAUCALPAN DE JUAREZ,21,252,6,279,1671
MÉXICO,NAUCALPAN DE JUAREZ,21,236,1,258,1671
MÉXICO,NAUCALPAN DE JUAREZ,13,130,2,145,1181
MÉXICO,NAUCALPAN DE JUAREZ,17,135,2,154,1181
MÉXICO,NAUCALPAN DE JUAREZ,16,127,2,145,1258
MÉXICO,NAUCALPAN DE JUAREZ,15,145,2,162,1258
MÉXICO,NAUCALPAN DE JUAREZ,29,159,1,189,1212
MÉXICO,NAUCALPAN DE JUAREZ,177,28,4,209,1211
MÉXICO,NAUCALPAN DE JUAREZ,27,227,2,256,1638
MÉXICO,NAUCALPAN DE JUAREZ,18,224,1,243,1638
MÉXICO,NAUCALPAN DE JUAREZ,24,178,0,202,1680
MÉXICO,NAUCALPAN DE JUAREZ,21,203,3,227,1680
MÉXICO,NAUCALPAN DE JUAREZ,16,133,2,151,1156
MÉXICO,NAUCALPAN DE JUAREZ,34,140,3,177,1156
MÉXICO,NAUCALPAN DE JUAREZ,50,191,2,243,1737
MÉXICO,NAUCALPAN DE JUAREZ,30,222,2,254,1736
MÉXICO,NAUCALPAN DE JUAREZ,16,88,0,104,1106
MÉXICO,NAUCALPAN DE JUAREZ,24,71,2,97,1106
MÉXICO,NAUCALPAN DE JUAREZ,33,148,0,181,1832
MÉXICO,NAUCALPAN DE JUAREZ,14,27,0,41,1717
MÉXICO,NAUCALPAN DE JUAREZ,9,24,1,34,1717
MÉXICO,NAUCALPAN DE JUAREZ,21,56,1,78,1568
MÉXICO,NAUCALPAN DE JUAREZ,13,82,0,95,1567
MÉXICO,NAUCALPAN DE JUAREZ,25,151,4,180,1813
MÉXICO,NAUCALPAN DE JUAREZ,26,176,3,205,1813
MÉXICO,NAUCALPAN DE JUAREZ,35,177,1,213,1813
MÉXICO,NAUCALPAN DE JUAREZ,17,246,1,264,1720
MÉXICO,NAUCALPAN DE JUAREZ,13,226,4,243,1720
MÉXICO,NAUCALPAN DE JUAREZ,16,213,5,234,1719
MÉXICO,NAUCALPAN DE JUAREZ,31,248,0,279,1892
MÉXICO,NAUCALPAN DE JUAREZ,34,205,5,244,1892
MÉXICO,NAUCALPAN DE JUAREZ,33,230,5,268,1939
MÉXICO,NAUCALPAN DE JUAREZ,23,210,4,237,1939
MÉXICO,NAUCALPAN DE JUAREZ,28,211,2,241,1893
MÉXICO,NAUCALPAN DE JUAREZ,9,113,4,126,1265
MÉXICO,NAUCALPAN DE JUAREZ,19,130,9,158,1264
MÉXICO,NAUCALPAN DE JUAREZ,23,188,4,215,1391
MÉXICO,NAUCALPAN DE JUAREZ,16,184,2,202,1390
MÉXICO,NAUCALPAN DE JUAREZ,22,218,1,241,1861
MÉXICO,NAUCALPAN DE JUAREZ,17,177,5,199,1860
MÉXICO,NAUCALPAN DE JUAREZ,20,172,2,194,1251
MÉXICO,NAUCALPAN DE JUAREZ,15,186,2,203,1251
MÉXICO,NAUCALPAN DE JUAREZ,11,172,1,184,1191
MÉXICO,NAUCALPAN DE JUAREZ,7,134,0,141,1191
MÉXICO,NAUCALPAN DE JUAREZ,8,159,9,176,1533
MÉXICO,NAUCALPAN DE JUAREZ,18,178,3,199,1533
MÉXICO,NAUCALPAN DE JUAREZ,13,111,4,128,1248
MÉXICO,NAUCALPAN DE JUAREZ,11,124,2,137,1247
MÉXICO,NAUCALPAN DE JUAREZ,5,123,8,136,1045
MÉXICO,NAUCALPAN DE JUAREZ,11,146,1,158,1045
MÉXICO,NAUCALPAN DE JUAREZ,20,128,0,148,1153
MÉXICO,NAUCALPAN DE JUAREZ,9,154,1,164,1153
MÉXICO,NAUCALPAN DE JUAREZ,13,131,2,146,1272
MÉXICO,NAUCALPAN DE JUAREZ,8,141,1,150,1272
MÉXICO,NAUCALPAN DE JUAREZ,25,186,3,214,1604
MÉXICO,NAUCALPAN DE JUAREZ,9,188,3,200,1603
MÉXICO,NAUCALPAN DE JUAREZ,12,177,3,192,1989
MÉXICO,NAUCALPAN DE JUAREZ,19,168,3,190,1989
MÉXICO,NAUCALPAN DE JUAREZ,9,145,1,155,1206
MÉXICO,NAUCALPAN DE JUAREZ,10,145,3,158,1205
MÉXICO,NAUCALPAN DE JUAREZ,22,192,5,219,1869
MÉXICO,NAUCALPAN DE JUAREZ,17,215,6,238,1868
MÉXICO,NAUCALPAN DE JUAREZ,17,199,3,219,1740
MÉXICO,NAUCALPAN DE JUAREZ,20,242,4,266,1739
MÉXICO,NAUCALPAN DE JUAREZ,11,177,1,189,1445
MÉXICO,NAUCALPAN DE JUAREZ,13,173,0,186,1444
MÉXICO,NAUCALPAN DE JUAREZ,16,188,1,205,1444
MÉXICO,NAUCALPAN DE JUAREZ,31,188,1,220,1536
MÉXICO,NAUCALPAN DE JUAREZ,23,194,4,221,1536
MÉXICO,NAUCALPAN DE JUAREZ,21,181,0,202,1344
MÉXICO,NAUCALPAN DE JUAREZ,19,171,4,194,1343
MÉXICO,NAUCALPAN DE JUAREZ,32,227,8,267,1758
MÉXICO,NAUCALPAN DE JUAREZ,22,237,4,263,1757
MÉXICO,NAUCALPAN DE JUAREZ,23,209,6,238,1440
MÉXICO,NAUCALPAN DE JUAREZ,16,218,6,240,1440
MÉXICO,NAUCALPAN DE JUAREZ,15,198,5,218,1440
MÉXICO,NAUCALPAN DE JUAREZ,18,189,4,211,1453
MÉXICO,NAUCALPAN DE JUAREZ,11,163,1,175,1452
MÉXICO,NAUCALPAN DE JUAREZ,12,190,0,202,1452
MÉXICO,NAUCALPAN DE JUAREZ,28,235,4,267,1858
MÉXICO,NAUCALPAN DE JUAREZ,22,227,4,253,1858
MÉXICO,NAUCALPAN DE JUAREZ,17,225,4,246,1859
MÉXICO,NAUCALPAN DE JUAREZ,19,243,3,265,1859
MÉXICO,NAUCALPAN DE JUAREZ,22,246,10,278,1870
MÉXICO,NAUCALPAN DE JUAREZ,19,229,5,253,1869
MÉXICO,NAUCALPAN DE JUAREZ,17,163,2,182,1527
MÉXICO,NAUCALPAN DE JUAREZ,11,167,5,183,1526
MÉXICO,NAUCALPAN DE JUAREZ,26,134,3,163,1526
MÉXICO,NAUCALPAN DE JUAREZ,15,245,5,265,1412
MÉXICO,NAUCALPAN DE JUAREZ,24,235,2,261,1411
MÉXICO,NAUCALPAN DE JUAREZ,22,163,3,188,1729
MÉXICO,NAUCALPAN DE JUAREZ,18,203,2,223,1729
MÉXICO,NAUCALPAN DE JUAREZ,15,210,2,227,1850
MÉXICO,NAUCALPAN DE JUAREZ,18,213,5,236,1850
MÉXICO,NAUCALPAN DE JUAREZ,21,214,5,240,1885
MÉXICO,NAUCALPAN DE JUAREZ,29,190,2,221,1884
MÉXICO,NAUCALPAN DE JUAREZ,22,152,2,176,1217
MÉXICO,NAUCALPAN DE JUAREZ,19,191,1,211,1217
MÉXICO,NAUCALPAN DE JUAREZ,29,169,2,200,1298
MÉXICO,NAUCALPAN DE JUAREZ,20,163,4,187,1298
MÉXICO,NAUCALPAN DE JUAREZ,27,162,5,194,1175
MÉXICO,NAUCALPAN DE JUAREZ,16,170,0,186,1174
MÉXICO,NAUCALPAN DE JUAREZ,24,184,5,213,1660
MÉXICO,NAUCALPAN DE JUAREZ,20,207,1,228,1660
MÉXICO,NAUCALPAN DE JUAREZ,15,220,5,240,1640
MÉXICO,NAUCALPAN DE JUAREZ,10,200,3,213,1640
MÉXICO,NAUCALPAN DE JUAREZ,18,253,9,280,1793
MÉXICO,NAUCALPAN DE JUAREZ,7,220,1,228,1792
MÉXICO,NAUCALPAN DE JUAREZ,26,215,6,247,1805
MÉXICO,NAUCALPAN DE JUAREZ,17,199,6,222,1805
MÉXICO,NAUCALPAN DE JUAREZ,21,141,1,163,1780
MÉXICO,NAUCALPAN DE JUAREZ,12,161,0,173,1780
MÉXICO,NAUCALPAN DE JUAREZ,24,194,8,226,1525
MÉXICO,NAUCALPAN DE JUAREZ,26,169,3,198,1524
MÉXICO,NAUCALPAN DE JUAREZ,20,176,1,197,1524
MÉXICO,NAUCALPAN DE JUAREZ,16,215,3,234,1939
MÉXICO,NAUCALPAN DE JUAREZ,23,198,1,222,1938
MÉXICO,NAUCALPAN DE JUAREZ,4,166,0,170,1507
MÉXICO,NAUCALPAN DE JUAREZ,10,162,6,178,1506
MÉXICO,NAUCALPAN DE JUAREZ,24,139,2,165,1423
MÉXICO,NAUCALPAN DE JUAREZ,12,122,3,137,1423
MÉXICO,NAUCALPAN DE JUAREZ,19,108,21,148,1422
MÉXICO,NAUCALPAN DE JUAREZ,23,202,1,226,1762
MÉXICO,NAUCALPAN DE JUAREZ,14,174,1,189,1761
MÉXICO,NAUCALPAN DE JUAREZ,25,218,3,246,1777
MÉXICO,NAUCALPAN DE JUAREZ,25,217,4,246,1776
MÉXICO,CHIMALHUACAN,27,204,5,236,1661
MÉXICO,CHIMALHUACAN,24,218,5,247,1661
MÉXICO,CHIMALHUACAN,26,241,2,269,1518
MÉXICO,CHIMALHUACAN,23,251,2,276,1518
MÉXICO,CHIMALHUACAN,31,194,5,230,1518
MÉXICO,CHIMALHUACAN,30,229,7,266,1555
MÉXICO,CHIMALHUACAN,9,218,0,227,1555
MÉXICO,CHIMALHUACAN,21,198,4,223,1555
MÉXICO,CHIMALHUACAN,44,312,7,363,1842
MÉXICO,CHIMALHUACAN,8,142,3,153,1066
MÉXICO,CHIMALHUACAN,9,114,3,126,1066
MÉXICO,CHIMALHUACAN,31,149,4,184,1143
MÉXICO,CHIMALHUACAN,20,172,8,200,1143
MÉXICO,CHIMALHUACAN,18,236,5,259,1649
MÉXICO,CHIMALHUACAN,23,219,4,246,1648
MÉXICO,CHIMALHUACAN,41,211,5,257,1560
MÉXICO,CHIMALHUACAN,27,205,5,237,1946
MÉXICO,CHIMALHUACAN,29,203,3,235,1723
MÉXICO,CHIMALHUACAN,27,245,4,276,1722
MÉXICO,CHIMALHUACAN,22,210,2,234,1324
MÉXICO,CHIMALHUACAN,10,248,4,262,1323
MÉXICO,CHIMALHUACAN,28,233,5,266,1151
MÉXICO,CHIMALHUACAN,22,178,5,205,1151
MÉXICO,CHIMALHUACAN,30,192,6,228,1730
MÉXICO,CHIMALHUACAN,24,214,6,244,1730
MÉXICO,CHIMALHUACAN,14,212,3,229,1827
MÉXICO,CHIMALHUACAN,22,195,6,223,1827
MÉXICO,CHIMALHUACAN,23,204,6,233,1826
MÉXICO,CHIMALHUACAN,26,214,3,243,1826
MÉXICO,CHIMALHUACAN,23,149,5,177,1081
MÉXICO,CHIMALHUACAN,9,155,1,165,1080
MÉXICO,CHIMALHUACAN,25,198,2,225,1292
MÉXICO,CHIMALHUACAN,33,169,2,204,1292
MÉXICO,CHIMALHUACAN,18,291,5,314,1038
MÉXICO,CHIMALHUACAN,15,182,4,201,1038
MÉXICO,CHIMALHUACAN,19,158,3,180,1133
MÉXICO,CHIMALHUACAN,33,131,2,166,1132
MÉXICO,CHIMALHUACAN,23,195,2,220,1557
MÉXICO,CHIMALHUACAN,12,199,0,211,1556
MÉXICO,CHIMALHUACAN,22,163,5,190,1329
MÉXICO,CHIMALHUACAN,19,159,2,180,1329
MÉXICO,CHIMALHUACAN,12,146,0,158,1329
MÉXICO,CHIMALHUACAN,22,177,6,205,1576
MÉXICO,CHIMALHUACAN,21,225,7,253,1575
MÉXICO,CHIMALHUACAN,19,229,2,250,1315
MÉXICO,CHIMALHUACAN,32,225,2,259,1314
MÉXICO,CHIMALHUACAN,28,177,4,209,1228
MÉXICO,CHIMALHUACAN,28,165,0,193,1228
MÉXICO,CHIMALHUACAN,18,181,2,201,1287
MÉXICO,CHIMALHUACAN,19,199,2,220,1287
MÉXICO,CHIMALHUACAN,13,177,5,195,1118
MÉXICO,CHIMALHUACAN,29,179,1,209,1117
MÉXICO,CHIMALHUACAN,19,322,5,346,1951
MÉXICO,CHIMALHUACAN,11,161,4,176,1144
MÉXICO,CHIMALHUACAN,16,170,2,188,1143
MÉXICO,CHIMALHUACAN,21,296,6,323,1964
MÉXICO,CHIMALHUACAN,15,186,2,203,1040
MÉXICO,CHIMALHUACAN,16,214,2,232,1039
MÉXICO,CHIMALHUACAN,11,194,7,212,1209
MÉXICO,CHIMALHUACAN,13,158,5,176,1208
MÉXICO,CHIMALHUACAN,19,204,8,231,1075
MÉXICO,CHIMALHUACAN,15,183,5,203,1075
MÉXICO,CHIMALHUACAN,22,228,3,253,1162
MÉXICO,CHIMALHUACAN,11,155,5,171,1161
MÉXICO,CHIMALHUACAN,28,242,7,277,1844
MÉXICO,CHIMALHUACAN,17,125,1,143,1008
MÉXICO,CHIMALHUACAN,16,167,3,186,1007
MÉXICO,CHIMALHUACAN,15,268,3,286,1789
MÉXICO,CHIMALHUACAN,26,176,1,203,1046
MÉXICO,CHIMALHUACAN,29,153,4,186,1045
MÉXICO,CHIMALHUACAN,39,167,7,213,1245
MÉXICO,CHIMALHUACAN,34,223,9,266,1245
MÉXICO,CHIMALHUACAN,23,182,2,207,1429
MÉXICO,CHIMALHUACAN,18,188,3,209,1429
MÉXICO,CHIMALHUACAN,25,195,0,220,1428
MÉXICO,CHIMALHUACAN,28,258,4,290,1830
MÉXICO,CHIMALHUACAN,17,223,1,241,1830
MÉXICO,CHIMALHUACAN,32,265,2,299,1830
MÉXICO,CHIMALHUACAN,27,241,1,269,1829
MÉXICO,CHIMALHUACAN,25,213,7,245,1829
MÉXICO,CHIMALHUACAN,58,530,4,592,0
MÉXICO,CHIMALHUACAN,19,256,3,278,1936
MÉXICO,CHIMALHUACAN,24,261,5,290,1935
MÉXICO,CHIMALHUACAN,23,315,6,344,1935
MÉXICO,CHIMALHUACAN,16,222,3,241,1610
MÉXICO,CHIMALHUACAN,24,182,0,206,1609
MÉXICO,CHIMALHUACAN,22,236,3,261,1771
MÉXICO,CHIMALHUACAN,42,291,5,338,1980
MÉXICO,CHIMALHUACAN,31,391,8,430,1990
MÉXICO,CHIMALHUACAN,20,180,2,202,1007
MÉXICO,CHIMALHUACAN,17,189,5,211,1007
MÉXICO,CHIMALHUACAN,13,209,7,229,1223
MÉXICO,CHIMALHUACAN,12,152,4,168,1222
MÉXICO,CHIMALHUACAN,20,174,6,200,1200
MÉXICO,CHIMALHUACAN,26,164,3,193,1200
MÉXICO,CHIMALHUACAN,18,233,5,256,1846
MÉXICO,CHIMALHUACAN,32,209,3,244,1845
MÉXICO,CHIMALHUACAN,18,129,5,152,1042
MÉXICO,CHIMALHUACAN,37,147,2,186,1041
MÉXICO,CHIMALHUACAN,18,285,1,304,1564
MÉXICO,CHIMALHUACAN,9,227,4,240,1563
MÉXICO,CHIMALHUACAN,15,203,7,225,1205
MÉXICO,CHIMALHUACAN,17,189,8,214,1204
MÉXICO,CHIMALHUACAN,38,320,5,363,1879
MÉXICO,CHIMALHUACAN,17,177,2,196,1035
MÉXICO,CHIMALHUACAN,8,182,1,191,1034
MÉXICO,CHIMALHUACAN,13,212,3,228,1470
MÉXICO,CHIMALHUACAN,13,223,3,239,1470
MÉXICO,CHIMALHUACAN,24,302,2,328,1801
MÉXICO,CHIMALHUACAN,27,290,3,320,1800
MÉXICO,CHIMALHUACAN,28,312,6,346,1852
MÉXICO,CHIMALHUACAN,22,287,3,312,1800
MÉXICO,CHIMALHUACAN,21,243,3,267,1799
MÉXICO,CHIMALHUACAN,13,184,6,203,1638
MÉXICO,CHIMALHUACAN,14,185,5,204,1638
MÉXICO,CHIMALHUACAN,15,171,2,188,1637
MÉXICO,CHIMALHUACAN,20,186,5,211,1462
MÉXICO,CHIMALHUACAN,15,157,4,176,1462
MÉXICO,CHIMALHUACAN,17,156,2,175,1462
MÉXICO,CHIMALHUACAN,22,270,3,295,1504
MÉXICO,CHIMALHUACAN,33,231,4,268,1504
MÉXICO,CHIMALHUACAN,16,264,0,280,1504
MÉXICO,CHIMALHUACAN,7,223,1,231,1511
MÉXICO,CHIMALHUACAN,12,202,4,218,1511
MÉXICO,CHIMALHUACAN,28,295,5,328,1695
MÉXICO,CHIMALHUACAN,15,196,7,218,1101
MÉXICO,CHIMALHUACAN,12,166,2,180,1101
MÉXICO,CHIMALHUACAN,23,312,4,339,1744
MÉXICO,CHIMALHUACAN,33,295,8,336,1744
MÉXICO,CHIMALHUACAN,27,239,4,270,1885
MÉXICO,CHIMALHUACAN,22,253,0,275,1885
MÉXICO,CHIMALHUACAN,22,230,3,255,1498
MÉXICO,CHIMALHUACAN,35,210,2,247,1498
MÉXICO,CHIMALHUACAN,23,227,3,253,1504
MÉXICO,CHIMALHUACAN,19,224,4,247,1383
MÉXICO,CHIMALHUACAN,19,169,7,195,1382
MÉXICO,CHIMALHUACAN,23,321,5,349,1691
MÉXICO,CHIMALHUACAN,41,343,8,392,1895
MÉXICO,CHIMALHUACAN,48,339,10,397,1946
MÉXICO,CHIMALHUACAN,43,281,16,340,1886
MÉXICO,CHIMALHUACAN,27,351,3,381,1898
MÉXICO,CHIMALHUACAN,35,325,6,366,1928
MÉXICO,CHIMALHUACAN,26,195,4,225,1047
MÉXICO,CHIMALHUACAN,21,207,2,230,1047
MÉXICO,CHIMALHUACAN,25,222,8,255,1417
MÉXICO,CHIMALHUACAN,16,258,8,282,1417
MÉXICO,CHIMALHUACAN,22,242,7,271,1742
MÉXICO,CHIMALHUACAN,21,150,81,252,1741
MÉXICO,CHIMALHUACAN,12,211,3,226,1863
MÉXICO,CHIMALHUACAN,22,210,1,233,1863
MÉXICO,CHIMALHUACAN,13,222,3,238,1863
MÉXICO,CHIMALHUACAN,26,227,6,259,1863
MÉXICO,CHIMALHUACAN,19,215,2,236,1857
MÉXICO,CHIMALHUACAN,26,222,5,253,1857
MÉXICO,CHIMALHUACAN,14,181,4,199,1857
MÉXICO,CHIMALHUACAN,13,211,4,228,1857
MÉXICO,CHIMALHUACAN,9,226,1,236,1857
MÉXICO,CHIMALHUACAN,26,203,5,234,1857
MÉXICO,CHIMALHUACAN,12,203,2,217,1857
MÉXICO,CHIMALHUACAN,16,196,5,217,1856
MÉXICO,CHIMALHUACAN,18,204,5,227,1856
MÉXICO,CHIMALHUACAN,23,177,1,201,1331
MÉXICO,CHIMALHUACAN,11,181,2,194,1331
MÉXICO,CHIMALHUACAN,15,304,2,321,1991
MÉXICO,CHIMALHUACAN,11,140,4,155,1131
MÉXICO,CHIMALHUACAN,15,149,1,165,1131
MÉXICO,CHIMALHUACAN,260,37,2,299,1893
MÉXICO,CHIMALHUACAN,20,150,1,171,1177
MÉXICO,CHIMALHUACAN,21,147,5,173,1177
MÉXICO,CHIMALHUACAN,19,162,2,183,1199
MÉXICO,CHIMALHUACAN,23,171,2,196,1198
MÉXICO,CHIMALHUACAN,15,194,3,212,1898
MÉXICO,CHIMALHUACAN,23,197,2,222,1898
MÉXICO,CHIMALHUACAN,14,176,10,200,1897
MÉXICO,TOLUCA DE LERDO,13,128,1,142,1569
MÉXICO,TOLUCA DE LERDO,28,163,1,192,1850
MÉXICO,TOLUCA DE LERDO,20,172,1,193,1850
MÉXICO,TOLUCA DE LERDO,48,169,2,219,1693
MÉXICO,TOLUCA DE LERDO,45,169,2,216,1692
MÉXICO,TOLUCA DE LERDO,34,154,0,188,1775
MÉXICO,TOLUCA DE LERDO,51,213,3,267,1628
MÉXICO,TOLUCA DE LERDO,67,210,1,278,1850
MÉXICO,TOLUCA DE LERDO,21,141,1,163,1172
MÉXICO,TOLUCA DE LERDO,26,167,2,195,1171
MÉXICO,TOLUCA DE LERDO,28,219,2,249,1941
MÉXICO,TOLUCA DE LERDO,22,229,5,256,1940
MÉXICO,TOLUCA DE LERDO,37,169,4,210,1434
MÉXICO,TOLUCA DE LERDO,31,157,3,191,1433
MÉXICO,TOLUCA DE LERDO,43,257,1,301,2084
MÉXICO,TOLUCA DE LERDO,33,150,1,184,1453
MÉXICO,TOLUCA DE LERDO,35,147,1,183,1452
MÉXICO,TOLUCA DE LERDO,28,154,4,186,1452
MÉXICO,TOLUCA DE LERDO,26,156,3,185,1585
MÉXICO,TOLUCA DE LERDO,21,139,1,161,1313
MÉXICO,TOLUCA DE LERDO,19,145,4,168,1313
MÉXICO,TOLUCA DE LERDO,58,179,3,240,1803
MÉXICO,TOLUCA DE LERDO,44,128,2,174,1560
MÉXICO,TOLUCA DE LERDO,37,123,0,160,1560
MÉXICO,TOLUCA DE LERDO,21,151,0,172,1796
MÉXICO,TOLUCA DE LERDO,14,181,5,200,1796
MÉXICO,TOLUCA DE LERDO,9,126,3,138,1582
MÉXICO,TOLUCA DE LERDO,9,159,5,173,1582
MÉXICO,TOLUCA DE LERDO,14,101,2,117,1515
MÉXICO,TOLUCA DE LERDO,7,152,3,162,1514
MÉXICO,TOLUCA DE LERDO,15,143,3,161,1514
MÉXICO,TOLUCA DE LERDO,13,155,4,172,1664
MÉXICO,TOLUCA DE LERDO,5,162,5,172,1663
MÉXICO,TOLUCA DE LERDO,16,153,1,170,1663
MÉXICO,TOLUCA DE LERDO,15,183,6,204,1781
MÉXICO,TOLUCA DE LERDO,11,173,3,187,1780
MÉXICO,TOLUCA DE LERDO,30,179,5,214,1758
MÉXICO,TOLUCA DE LERDO,28,161,3,192,1758
MÉXICO,TOLUCA DE LERDO,22,171,2,195,1758
MÉXICO,TOLUCA DE LERDO,18,184,6,208,1758
MÉXICO,TOLUCA DE LERDO,21,173,3,197,1758
MÉXICO,TOLUCA DE LERDO,43,239,1,283,1699
MÉXICO,TOLUCA DE LERDO,49,205,1,255,1699
MÉXICO,TOLUCA DE LERDO,23,243,3,269,1926
MÉXICO,TOLUCA DE LERDO,25,179,5,209,1185
MÉXICO,TOLUCA DE LERDO,19,160,3,182,1185
MÉXICO,TOLUCA DE LERDO,28,215,1,244,1663
MÉXICO,TOLUCA DE LERDO,24,268,3,295,1662
MÉXICO,TOLUCA DE LERDO,27,243,0,270,2110
MÉXICO,TOLUCA DE LERDO,29,202,3,234,1426
MÉXICO,TOLUCA DE LERDO,32,224,4,260,1426
MÉXICO,TOLUCA DE LERDO,35,210,6,251,1425
MÉXICO,TOLUCA DE LERDO,52,223,2,277,1783
MÉXICO,TOLUCA DE LERDO,28,263,3,294,1823
MÉXICO,TOLUCA DE LERDO,24,246,3,273,1823
MÉXICO,TOLUCA DE LERDO,25,217,2,244,1427
MÉXICO,TOLUCA DE LERDO,15,207,2,224,1427
MÉXICO,TOLUCA DE LERDO,37,212,0,249,1653
MÉXICO,TOLUCA DE LERDO,44,178,2,224,1653
MÉXICO,TOLUCA DE LERDO,26,163,2,191,1448
MÉXICO,TOLUCA DE LERDO,50,157,3,210,1448
MÉXICO,TOLUCA DE LERDO,33,177,1,211,2012
MÉXICO,TOLUCA DE LERDO,40,224,4,268,2012
MÉXICO,TOLUCA DE LERDO,29,218,1,248,2012
MÉXICO,TOLUCA DE LERDO,16,187,2,205,2012
MÉXICO,TOLUCA DE LERDO,32,153,0,185,1459
MÉXICO,TOLUCA DE LERDO,22,192,3,217,1458
MÉXICO,TOLUCA DE LERDO,71,230,4,305,1941
MÉXICO,TOLUCA DE LERDO,68,206,1,275,1941
MÉXICO,TOLUCA DE LERDO,36,86,2,124,1183
MÉXICO,TOLUCA DE LERDO,28,120,3,151,1182
MÉXICO,TOLUCA DE LERDO,30,193,3,226,1498
MÉXICO,TOLUCA DE LERDO,20,186,3,209,1497
MÉXICO,TOLUCA DE LERDO,26,191,2,219,1497
MÉXICO,TOLUCA DE LERDO,13,81,2,96,1466
MÉXICO,TOLUCA DE LERDO,10,94,4,108,1466
MÉXICO,TOLUCA DE LERDO,21,96,4,121,1465
MÉXICO,TOLUCA DE LERDO,7,183,2,192,1442
MÉXICO,TOLUCA DE LERDO,10,151,4,165,1441
MÉXICO,TOLUCA DE LERDO,9,99,3,111,1679
MÉXICO,TOLUCA DE LERDO,31,141,8,180,2101
MÉXICO,TOLUCA DE LERDO,44,210,11,265,1882
MÉXICO,TOLUCA DE LERDO,39,158,4,201,1881
MÉXICO,TOLUCA DE LERDO,21,191,2,214,1882
MÉXICO,TOLUCA DE LERDO,16,180,3,199,1882
MÉXICO,TOLUCA DE LERDO,22,119,4,145,1167
MÉXICO,TOLUCA DE LERDO,13,127,2,142,1166
MÉXICO,TOLUCA DE LERDO,30,200,2,232,1991
MÉXICO,TOLUCA DE LERDO,23,178,4,205,1991
MÉXICO,TOLUCA DE LERDO,20,225,4,249,1990
MÉXICO,TOLUCA DE LERDO,22,189,3,214,1990
MÉXICO,TOLUCA DE LERDO,27,182,0,209,2060
MÉXICO,TOLUCA DE LERDO,27,160,1,188,2060
MÉXICO,TOLUCA DE LERDO,20,201,2,223,1745
MÉXICO,TOLUCA DE LERDO,20,241,3,264,1745
MÉXICO,TOLUCA DE LERDO,17,177,2,196,1750
MÉXICO,TOLUCA DE LERDO,21,206,4,231,1750
MÉXICO,TOLUCA DE LERDO,13,102,4,119,1107
MÉXICO,TOLUCA DE LERDO,15,125,3,143,1106
MÉXICO,TOLUCA DE LERDO,15,112,4,131,1604
MÉXICO,TOLUCA DE LERDO,13,101,7,121,1603
MÉXICO,TOLUCA DE LERDO,17,159,3,179,1105
MÉXICO,TOLUCA DE LERDO,25,171,4,200,1105
MÉXICO,TOLUCA DE LERDO,22,101,4,127,1452
MÉXICO,TOLUCA DE LERDO,16,122,2,140,1451
MÉXICO,TOLUCA DE LERDO,19,194,3,216,1486
MÉXICO,TOLUCA DE LERDO,18,188,3,209,1486
MÉXICO,TOLUCA DE LERDO,21,191,2,214,1486
MÉXICO,TOLUCA DE LERDO,38,191,4,233,1615
MÉXICO,TOLUCA DE LERDO,19,198,5,222,1614
MÉXICO,TOLUCA DE LERDO,4,171,1,176,1387
MÉXICO,TOLUCA DE LERDO,8,130,0,138,1386
MÉXICO,TOLUCA DE LERDO,6,123,7,136,1332
MÉXICO,TOLUCA DE LERDO,13,132,6,151,1332
MÉXICO,TOLUCA DE LERDO,16,172,0,188,1440
MÉXICO,TOLUCA DE LERDO,9,138,6,153,1440
MÉXICO,TOLUCA DE LERDO,14,185,1,200,1440
MÉXICO,TOLUCA DE LERDO,17,166,3,186,1765
MÉXICO,TOLUCA DE LERDO,28,195,4,227,1714
MÉXICO,TOLUCA DE LERDO,21,190,6,217,1714
MÉXICO,TOLUCA DE LERDO,23,179,0,202,1376
MÉXICO,TOLUCA DE LERDO,15,175,3,193,1375
MÉXICO,TOLUCA DE LERDO,16,294,5,315,2098
MÉXICO,TOLUCA DE LERDO,18,192,9,219,2034
MÉXICO,TOLUCA DE LERDO,20,189,7,216,2034
MÉXICO,TOLUCA DE LERDO,7,202,5,214,1640
MÉXICO,TOLUCA DE LERDO,9,181,3,193,1639
MÉXICO,TOLUCA DE LERDO,8,174,1,183,1639
MÉXICO,TOLUCA DE LERDO,16,140,6,162,1206
MÉXICO,TOLUCA DE LERDO,15,144,4,163,1205
MÉXICO,TOLUCA DE LERDO,28,240,2,270,1772
MÉXICO,TOLUCA DE LERDO,27,207,2,236,1771
MÉXICO,TOLUCA DE LERDO,16,180,2,198,1838
MÉXICO,TOLUCA DE LERDO,231,19,4,254,1837
MÉXICO,TOLUCA DE LERDO,19,227,6,252,1792
MÉXICO,TOLUCA DE LERDO,24,228,7,259,2052
MÉXICO,TOLUCA DE LERDO,22,202,9,233,2051
MÉXICO,TOLUCA DE LERDO,14,168,5,187,1999
MÉXICO,TOLUCA DE LERDO,10,190,6,206,1999
MÉXICO,TOLUCA DE LERDO,22,231,0,253,1628
MÉXICO,TOLUCA DE LERDO,17,232,3,252,1628
MÉXICO,TOLUCA DE LERDO,29,202,0,231,1628
MÉXICO,TOLUCA DE LERDO,50,416,0,466,0
MÉXICO,TOLUCA DE LERDO,16,151,2,169,1403
MÉXICO,TOLUCA DE LERDO,13,164,1,178,1402
MÉXICO,TOLUCA DE LERDO,19,181,4,204,1516
MÉXICO,TOLUCA DE LERDO,19,192,3,214,1515
MÉXICO,TOLUCA DE LERDO,19,213,1,233,1491
MÉXICO,TOLUCA DE LERDO,15,186,6,207,1490
MÉXICO,TOLUCA DE LERDO,58,200,5,263,2029
MÉXICO,TOLUCA DE LERDO,46,256,2,304,2029
MÉXICO,TOLUCA DE LERDO,23,193,7,223,2096
MÉXICO,TOLUCA DE LERDO,12,165,13,190,2020
MÉXICO,TOLUCA DE LERDO,10,158,3,171,2020
MÉXICO,TOLUCA DE LERDO,19,262,2,283,1619
MÉXICO,TOLUCA DE LERDO,18,261,7,286,1618
MÉXICO,TOLUCA DE LERDO,33,301,4,338,1729
MÉXICO,TOLUCA DE LERDO,28,303,3,334,1729
MÉXICO,TOLUCA DE LERDO,17,391,9,417,2132
MÉXICO,TOLUCA DE LERDO,24,187,10,221,1734
MÉXICO,TOLUCA DE LERDO,19,155,8,182,1733
MÉXICO,TOLUCA DE LERDO,25,309,6,340,1948
MÉXICO,TOLUCA DE LERDO,18,210,4,232,1522
MÉXICO,TOLUCA DE LERDO,19,250,0,269,1521
MÉXICO,TOLUCA DE LERDO,13,174,3,190,1994
MÉXICO,TOLUCA DE LERDO,17,192,7,216,1994
MÉXICO,TOLUCA DE LERDO,31,215,2,248,1542
MÉXICO,TOLUCA DE LERDO,33,249,5,287,1542
MÉXICO,TOLUCA DE LERDO,20,242,5,267,1466
MÉXICO,TOLUCA DE LERDO,15,224,3,242,1465
MÉXICO,TOLUCA DE LERDO,22,215,1,238,1474
MÉXICO,TOLUCA DE LERDO,12,220,2,234,1473
MÉXICO,TOLUCA DE LERDO,24,159,1,184,1312
MÉXICO,TOLUCA DE LERDO,23,199,4,226,1312
MÉXICO,TOLUCA DE LERDO,19,165,6,190,1144
MÉXICO,TOLUCA DE LERDO,13,133,4,150,1144
MÉXICO,TOLUCA DE LERDO,25,198,4,227,1594
MÉXICO,TOLUCA DE LERDO,19,202,2,223,1593
MÉXICO,TOLUCA DE LERDO,19,173,2,194,1593
MÉXICO,TOLUCA DE LERDO,11,197,2,210,1496
MÉXICO,TOLUCA DE LERDO,21,161,4,186,1496
MÉXICO,TOLUCA DE LERDO,39,206,3,248,1777
MÉXICO,TOLUCA DE LERDO,28,206,2,236,1776
MÉXICO,TOLUCA DE LERDO,22,188,0,210,1810
MÉXICO,TOLUCA DE LERDO,31,192,2,225,1810
MÉXICO,TOLUCA DE LERDO,22,165,2,189,1809
MÉXICO,TOLUCA DE LERDO,30,208,3,241,1709
MÉXICO,TOLUCA DE LERDO,19,233,2,254,1709
MÉXICO,TOLUCA DE LERDO,34,162,3,199,1598
MÉXICO,TOLUCA DE LERDO,25,191,2,218,1597
MÉXICO,TOLUCA DE LERDO,31,181,0,212,1597
MÉXICO,TOLUCA DE LERDO,61,165,1,227,1591
MÉXICO,TOLUCA DE LERDO,34,136,2,172,1591
MÉXICO,TOLUCA DE LERDO,27,167,0,194,1590
MÉXICO,TOLUCA DE LERDO,42,161,3,206,1590
MÉXICO,TOLUCA DE LERDO,38,178,0,216,1825
MÉXICO,TOLUCA DE LERDO,12,149,11,172,1432
MÉXICO,TOLUCA DE LERDO,26,140,7,173,1432
MÉXICO,TOLUCA DE LERDO,65,218,3,286,2095
MÉXICO,TOLUCA DE LERDO,58,238,2,298,2094
MÉXICO,TOLUCA DE LERDO,42,157,2,201,1527
MÉXICO,TOLUCA DE LERDO,56,140,1,197,1526
MÉXICO,TOLUCA DE LERDO,34,178,0,212,1526
MÉXICO,TOLUCA DE LERDO,58,209,3,270,1920
MÉXICO,TOLUCA DE LERDO,48,212,1,261,1920
MÉXICO,METEPEC,11,111,1,123,1466
MÉXICO,METEPEC,19,133,3,155,1466
MÉXICO,METEPEC,14,140,9,163,1465
MÉXICO,METEPEC,23,255,3,281,1838
MÉXICO,METEPEC,13,272,0,285,1801
MÉXICO,METEPEC,10,210,0,220,1679
MÉXICO,METEPEC,13,125,0,138,1046
MÉXICO,METEPEC,12,124,1,137,1045
MÉXICO,METEPEC,14,222,1,237,1807
MÉXICO,METEPEC,13,222,4,239,1807
MÉXICO,METEPEC,74,336,4,414,0
MÉXICO,METEPEC,15,171,4,190,1754
MÉXICO,METEPEC,15,171,4,190,1753
MÉXICO,METEPEC,27,181,1,209,1929
MÉXICO,METEPEC,21,200,0,221,1929
MÉXICO,METEPEC,33,201,0,234,1928
MÉXICO,METEPEC,19,238,4,261,1680
MÉXICO,METEPEC,14,181,1,196,1680
MÉXICO,METEPEC,11,107,3,121,1580
MÉXICO,METEPEC,11,104,2,117,1579
MÉXICO,METEPEC,7,88,3,98,1231
MÉXICO,METEPEC,4,79,3,86,1231
MÉXICO,METEPEC,18,241,4,263,1926
MÉXICO,METEPEC,19,166,1,186,1489
MÉXICO,METEPEC,14,153,2,169,1489
MÉXICO,METEPEC,13,220,4,237,1789
MÉXICO,METEPEC,16,235,0,251,1789
MÉXICO,METEPEC,32,331,2,365,2005
MÉXICO,METEPEC,34,293,1,328,2005
MÉXICO,METEPEC,14,273,3,290,2005
MÉXICO,METEPEC,25,259,1,285,1266
MÉXICO,METEPEC,10,233,0,243,1265
MÉXICO,METEPEC,40,184,2,226,1416
MÉXICO,METEPEC,36,152,2,190,1416
MÉXICO,METEPEC,32,135,2,169,1420
MÉXICO,METEPEC,27,120,2,149,1420
MÉXICO,METEPEC,26,184,0,210,1480
MÉXICO,METEPEC,31,146,3,180,1479
MÉXICO,METEPEC,27,166,3,196,1745
MÉXICO,METEPEC,17,184,2,203,1745
MÉXICO,METEPEC,24,89,2,115,1444
MÉXICO,METEPEC,22,103,0,125,1443
MÉXICO,METEPEC,16,60,2,78,1443
MÉXICO,METEPEC,23,165,2,190,1294
MÉXICO,METEPEC,22,145,3,170,1294
MÉXICO,METEPEC,41,180,3,224,1726
MÉXICO,METEPEC,30,214,4,248,1844
MÉXICO,METEPEC,69,201,3,273,1747
MÉXICO,METEPEC,56,211,4,271,1747
MÉXICO,METEPEC,47,283,0,330,1730
MÉXICO,METEPEC,69,298,7,374,1825
MÉXICO,METEPEC,53,245,3,301,1933
MÉXICO,METEPEC,29,149,1,179,1929
MÉXICO,METEPEC,27,155,1,183,1929
MÉXICO,METEPEC,36,149,2,187,1929
MÉXICO,METEPEC,45,139,1,185,1929
MÉXICO,METEPEC,43,249,9,301,1974
MÉXICO,METEPEC,62,247,5,314,1974
MÉXICO,METEPEC,66,238,4,308,1653
MÉXICO,METEPEC,45,226,3,274,1793
MÉXICO,METEPEC,43,246,0,289,1792
MÉXICO,METEPEC,55,289,5,349,1803
MÉXICO,METEPEC,28,220,2,250,1491
MÉXICO,METEPEC,25,177,3,205,1978
MÉXICO,METEPEC,31,170,0,201,1978
MÉXICO,METEPEC,28,172,3,203,1978
MÉXICO,METEPEC,45,120,1,166,1286
MÉXICO,METEPEC,36,111,2,149,1286
MÉXICO,METEPEC,29,37,0,66,1357
MÉXICO,METEPEC,22,64,2,88,1357
MÉXICO,METEPEC,78,277,3,358,1912
MÉXICO,METEPEC,39,239,2,280,1628
MÉXICO,METEPEC,41,152,3,196,1627
MÉXICO,METEPEC,20,171,1,192,1470
MÉXICO,METEPEC,27,133,5,165,1470
MÉXICO,METEPEC,42,109,2,153,1084
MÉXICO,METEPEC,36,121,2,159,1084
MÉXICO,METEPEC,70,231,3,304,1779
MÉXICO,METEPEC,45,234,5,284,1778
MÉXICO,METEPEC,68,221,0,289,2062
MÉXICO,METEPEC,23,241,5,269,1735
MÉXICO,METEPEC,46,224,1,271,1735
MÉXICO,METEPEC,29,215,2,246,1523
MÉXICO,METEPEC,38,197,2,237,1523
MÉXICO,METEPEC,48,212,1,261,1642
MÉXICO,METEPEC,33,236,1,270,1738
MÉXICO,METEPEC,34,116,2,152,1979
MÉXICO,METEPEC,40,103,0,143,1979
MÉXICO,METEPEC,29,95,1,125,1978
MÉXICO,METEPEC,22,146,2,170,1476
MÉXICO,METEPEC,20,140,0,160,1475
MÉXICO,METEPEC,28,127,1,156,1475
MÉXICO,METEPEC,43,128,2,173,1993
MÉXICO,METEPEC,45,113,0,158,1993
MÉXICO,METEPEC,53,250,1,304,1970
MÉXICO,METEPEC,35,203,3,241,1586
MÉXICO,METEPEC,49,205,2,256,1585
MÉXICO,METEPEC,24,186,1,211,1924
MÉXICO,METEPEC,33,156,0,189,1924
MÉXICO,METEPEC,23,148,2,173,1360
MÉXICO,METEPEC,22,134,0,156,1359
MÉXICO,METEPEC,29,119,2,150,1509
MÉXICO,METEPEC,25,123,1,149,1509
MÉXICO,METEPEC,45,226,3,274,1759
MÉXICO,METEPEC,47,236,1,284,1634
MÉXICO,METEPEC,63,253,2,318,1789
MÉXICO,METEPEC,33,134,1,168,1326
MÉXICO,METEPEC,25,125,1,151,1326
MÉXICO,METEPEC,11,84,1,96,1053
MÉXICO,METEPEC,15,73,1,89,1053
MÉXICO,METEPEC,27,217,2,246,1655
MÉXICO,METEPEC,56,266,4,326,2006
MÉXICO,METEPEC,27,188,3,218,1708
MÉXICO,METEPEC,29,62,2,93,1708
MÉXICO,METEPEC,54,156,2,212,1490
MÉXICO,METEPEC,31,155,1,187,1490
MÉXICO,METEPEC,16,165,0,181,1409
MÉXICO,METEPEC,24,186,3,213,1409
MÉXICO,METEPEC,14,119,0,133,1351
MÉXICO,METEPEC,14,83,2,99,1350
MÉXICO,METEPEC,27,192,3,222,1397
MÉXICO,METEPEC,33,189,6,228,1396
MÉXICO,METEPEC,15,234,3,252,1403
MÉXICO,METEPEC,27,209,0,236,1403
MÉXICO,METEPEC,27,216,3,246,1402
MÉXICO,METEPEC,33,187,1,221,1856
MÉXICO,METEPEC,25,180,1,206,1855
MÉXICO,METEPEC,28,200,1,229,1855
MÉXICO,METEPEC,17,237,1,255,1796
MÉXICO,METEPEC,13,180,0,193,1796
MÉXICO,METEPEC,29,226,3,258,1313
MÉXICO,METEPEC,26,204,5,235,1313
MÉXICO,METEPEC,31,174,0,205,1742
MÉXICO,METEPEC,28,206,3,237,1742
MÉXICO,METEPEC,32,248,8,288,1726
MÉXICO,METEPEC,35,250,4,289,1725
MÉXICO,METEPEC,18,219,1,238,1321
MÉXICO,METEPEC,28,237,5,270,1321
MÉXICO,METEPEC,45,222,2,269,1701
MÉXICO,METEPEC,12,245,6,263,1764
MÉXICO,METEPEC,15,216,5,236,1764
MÉXICO,METEPEC,11,284,7,302,1764
MÉXICO,METEPEC,23,201,4,228,1794
MÉXICO,METEPEC,19,209,2,230,1793
MÉXICO,METEPEC,24,177,3,204,1633
MÉXICO,METEPEC,17,209,5,231,1632
MÉXICO,METEPEC,21,230,0,251,2019
MÉXICO,METEPEC,15,231,2,248,2018
MÉXICO,METEPEC,17,161,0,178,1073
MÉXICO,METEPEC,11,161,1,173,1072
MÉXICO,METEPEC,18,244,2,264,1778
MÉXICO,METEPEC,19,238,1,258,1778
MÉXICO,METEPEC,11,232,1,244,1781
MÉXICO,METEPEC,25,246,0,271,1781
MÉXICO,METEPEC,21,177,2,200,1781
MÉXICO,METEPEC,21,198,3,222,1781
MÉXICO,METEPEC,22,233,0,255,1781
MÉXICO,METEPEC,15,323,5,343,1729
MÉXICO,METEPEC,14,295,2,311,1729
MÉXICO,METEPEC,13,311,4,328,1639
MÉXICO,METEPEC,12,310,6,328,1638
MÉXICO,METEPEC,11,285,0,296,1580
MÉXICO,METEPEC,23,213,3,239,1580
MÉXICO,METEPEC,20,163,1,184,1734
MÉXICO,METEPEC,29,236,2,267,1733
MÉXICO,METEPEC,34,211,4,249,1406
MÉXICO,METEPEC,30,185,1,216,1406
MÉXICO,METEPEC,18,178,0,196,1515
MÉXICO,METEPEC,20,227,1,248,1515
MÉXICO,METEPEC,63,291,5,359,2020
MÉXICO,METEPEC,48,269,2,319,1842
MÉXICO,METEPEC,17,238,0,255,1519
MÉXICO,METEPEC,9,255,2,266,1519
MÉXICO,METEPEC,17,228,4,249,1519
MÉXICO,METEPEC,14,332,4,350,1798
MÉXICO,METEPEC,14,296,0,310,1798
MÉXICO,METEPEC,7,191,2,200,1366
MÉXICO,METEPEC,15,169,2,186,1365
MÉXICO,METEPEC,18,207,0,225,1404
MÉXICO,METEPEC,10,185,1,196,1404
MÉXICO,METEPEC,18,225,2,245,1404
MÉXICO,METEPEC,18,217,0,235,1458
MÉXICO,METEPEC,17,189,1,207,1457
MÉXICO,METEPEC,21,185,1,207,1457
MÉXICO,METEPEC,15,235,2,252,1899
MÉXICO,METEPEC,11,211,5,227,1899
MÉXICO,METEPEC,180,14,8,202,1338
MÉXICO,METEPEC,13,187,0,200,1338
MÉXICO,METEPEC,15,265,5,285,1821
MÉXICO,METEPEC,14,289,3,306,1931
MÉXICO,METEPEC,10,237,5,252,1931
MÉXICO,METEPEC,14,248,1,263,1840
MÉXICO,METEPEC,8,272,4,284,1840
MÉXICO,METEPEC,15,263,2,280,1839
MÉXICO,METEPEC,9,167,3,179,1119
MÉXICO,METEPEC,13,163,1,177,1118
MÉXICO,METEPEC,7,162,3,172,1365
MÉXICO,METEPEC,5,171,2,178,1364
MÉXICO,METEPEC,13,230,5,248,1823
MÉXICO,METEPEC,9,179,8,196,1822
MÉXICO,METEPEC,7,105,0,112,1034
MÉXICO,METEPEC,18,115,0,133,1033
MÉXICO,METEPEC,22,168,2,192,1510
MÉXICO,METEPEC,24,128,3,155,1510
MÉXICO,METEPEC,25,186,3,214,1510
MÉXICO,METEPEC,9,137,6,152,1174
MÉXICO,METEPEC,11,141,2,154,1174
MÉXICO,METEPEC,10,130,1,141,1173
MÉXICO,ZUMPANGO DE OCAMPO,21,338,2,361,1957
MÉXICO,ZUMPANGO DE OCAMPO,12,367,3,382,1957
MÉXICO,ZUMPANGO DE OCAMPO,15,226,3,244,1423
MÉXICO,ZUMPANGO DE OCAMPO,11,256,3,270,1422
MÉXICO,ZUMPANGO DE OCAMPO,6,364,3,373,1887
MÉXICO,ZUMPANGO DE OCAMPO,16,340,3,359,1886
MÉXICO,ZUMPANGO DE OCAMPO,13,212,4,229,1684
MÉXICO,ZUMPANGO DE OCAMPO,9,193,1,203,1684
MÉXICO,ZUMPANGO DE OCAMPO,8,222,1,231,1683
MÉXICO,ZUMPANGO DE OCAMPO,11,299,2,312,1866
MÉXICO,ZUMPANGO DE OCAMPO,10,271,2,283,1866
MÉXICO,ZUMPANGO DE OCAMPO,12,299,3,314,1532
MÉXICO,ZUMPANGO DE OCAMPO,7,294,2,303,1532
MÉXICO,ZUMPANGO DE OCAMPO,13,97,1,111,1773
MÉXICO,ZUMPANGO DE OCAMPO,6,99,2,107,1772
MÉXICO,ZUMPANGO DE OCAMPO,6,106,0,112,1772
MÉXICO,ZUMPANGO DE OCAMPO,9,122,1,132,1772
MÉXICO,ZUMPANGO DE OCAMPO,7,114,1,122,1772
MÉXICO,ZUMPANGO DE OCAMPO,11,191,4,206,1780
MÉXICO,ZUMPANGO DE OCAMPO,11,220,2,233,1779
MÉXICO,ZUMPANGO DE OCAMPO,10,200,2,212,1917
MÉXICO,ZUMPANGO DE OCAMPO,2,202,1,205,1917
MÉXICO,ZUMPANGO DE OCAMPO,3,182,1,186,1892
MÉXICO,ZUMPANGO DE OCAMPO,9,132,2,143,1892
MÉXICO,ZUMPANGO DE OCAMPO,11,189,0,200,1891
MÉXICO,ZUMPANGO DE OCAMPO,153,5,4,162,1891
MÉXICO,ZUMPANGO DE OCAMPO,8,148,0,156,1653
MÉXICO,ZUMPANGO DE OCAMPO,9,126,1,136,1653
MÉXICO,ZUMPANGO DE OCAMPO,11,124,5,140,1653
MÉXICO,ZUMPANGO DE OCAMPO,11,124,5,140,1653
MÉXICO,ZUMPANGO DE OCAMPO,12,125,1,138,1653
MÉXICO,ZUMPANGO DE OCAMPO,18,156,0,174,1652
MÉXICO,ZUMPANGO DE OCAMPO,5,95,2,102,1114
MÉXICO,ZUMPANGO DE OCAMPO,5,82,1,88,1113
MÉXICO,ZUMPANGO DE OCAMPO,15,252,4,271,1954
MÉXICO,ZUMPANGO DE OCAMPO,9,214,3,226,1953
MÉXICO,ZUMPANGO DE OCAMPO,10,171,4,185,1397
MÉXICO,ZUMPANGO DE OCAMPO,6,161,3,170,1396
MÉXICO,ZUMPANGO DE OCAMPO,11,149,1,161,1396
MÉXICO,ZUMPANGO DE OCAMPO,15,198,3,216,1739
MÉXICO,ZUMPANGO DE OCAMPO,12,194,1,207,1739
MÉXICO,ZUMPANGO DE OCAMPO,21,222,2,245,1405
MÉXICO,ZUMPANGO DE OCAMPO,19,235,4,258,1405
MÉXICO,ZUMPANGO DE OCAMPO,16,233,3,252,1355
MÉXICO,ZUMPANGO DE OCAMPO,7,214,2,223,1354
MÉXICO,ZUMPANGO DE OCAMPO,6,226,1,233,1354
MÉXICO,ZUMPANGO DE OCAMPO,17,284,1,302,1756
MÉXICO,ZUMPANGO DE OCAMPO,10,266,4,280,1755
MÉXICO,ZUMPANGO DE OCAMPO,14,352,8,374,1791
MÉXICO,ZUMPANGO DE OCAMPO,26,320,17,363,2062
MÉXICO,ZUMPANGO DE OCAMPO,14,229,9,252,1111
MÉXICO,ZUMPANGO DE OCAMPO,22,225,5,252,1110
MÉXICO,ZUMPANGO DE OCAMPO,11,306,5,322,1280
MÉXICO,ZUMPANGO DE OCAMPO,7,284,2,293,1279
MÉXICO,ZUMPANGO DE OCAMPO,8,302,1,311,1646
MÉXICO,ZUMPANGO DE OCAMPO,12,303,5,320,1646
MÉXICO,ZUMPANGO DE OCAMPO,9,301,8,318,1549
MÉXICO,ZUMPANGO DE OCAMPO,8,327,2,337,1548
MÉXICO,ZUMPANGO DE OCAMPO,10,311,4,325,1548
MÉXICO,ZUMPANGO DE OCAMPO,12,318,6,336,1548
MÉXICO,ZUMPANGO DE OCAMPO,10,423,6,439,1851
MÉXICO,ZUMPANGO DE OCAMPO,12,439,9,460,1850
MÉXICO,ZUMPANGO DE OCAMPO,10,297,7,314,2049
MÉXICO,ZUMPANGO DE OCAMPO,22,250,3,275,1398
MÉXICO,ZUMPANGO DE OCAMPO,5,264,6,275,1398
MÉXICO,ZUMPANGO DE OCAMPO,7,247,1,255,1397
MÉXICO,ZUMPANGO DE OCAMPO,13,263,2,278,1213
MÉXICO,ZUMPANGO DE OCAMPO,14,289,0,303,1212
MÉXICO,ZUMPANGO DE OCAMPO,10,249,3,262,1395
MÉXICO,ZUMPANGO DE OCAMPO,13,254,3,270,1394
MÉXICO,ZUMPANGO DE OCAMPO,10,239,4,253,1394
MÉXICO,ZUMPANGO DE OCAMPO,8,317,3,328,1503
MÉXICO,ZUMPANGO DE OCAMPO,8,244,5,257,1503
MÉXICO,ZUMPANGO DE OCAMPO,27,461,4,492,2134
MÉXICO,ZUMPANGO DE OCAMPO,11,220,2,233,1346
MÉXICO,ZUMPANGO DE OCAMPO,13,271,3,287,1346
MÉXICO,ZUMPANGO DE OCAMPO,5,235,7,247,1346
MÉXICO,ZUMPANGO DE OCAMPO,12,384,3,399,1885
MÉXICO,ZUMPANGO DE OCAMPO,23,410,3,436,1885
MÉXICO,ZUMPANGO DE OCAMPO,17,250,1,268,1892
MÉXICO,ZUMPANGO DE OCAMPO,8,238,3,249,1891
MÉXICO,ZUMPANGO DE OCAMPO,10,238,6,254,1891
MÉXICO,ZUMPANGO DE OCAMPO,16,255,6,277,1735
MÉXICO,ZUMPANGO DE OCAMPO,20,274,4,298,1734
MÉXICO,ZUMPANGO DE OCAMPO,33,189,1,223,1214
MÉXICO,ZUMPANGO DE OCAMPO,28,214,0,242,1213
MÉXICO,ZUMPANGO DE OCAMPO,43,867,9,919,0
MÉXICO,ZUMPANGO DE OCAMPO,16,181,3,200,1815
MÉXICO,ZUMPANGO DE OCAMPO,17,158,0,175,1815
MÉXICO,ZUMPANGO DE OCAMPO,19,177,2,198,1815
MÉXICO,ZUMPANGO DE OCAMPO,15,180,1,196,1815
MÉXICO,ZUMPANGO DE OCAMPO,18,183,3,204,1815
MÉXICO,ZUMPANGO DE OCAMPO,9,363,3,375,1815
MÉXICO,ZUMPANGO DE OCAMPO,11,184,2,197,1814
MÉXICO,ZUMPANGO DE OCAMPO,20,202,2,224,1814
MÉXICO,ZUMPANGO DE OCAMPO,15,229,5,249,1920
MÉXICO,ZUMPANGO DE OCAMPO,14,238,5,257,1919
MÉXICO,ZUMPANGO DE OCAMPO,12,235,3,250,1919
MÉXICO,ZUMPANGO DE OCAMPO,2,231,3,236,1919
MÉXICO,ZUMPANGO DE OCAMPO,15,235,1,251,1919
MÉXICO,ZUMPANGO DE OCAMPO,10,197,3,210,1919
MÉXICO,ZUMPANGO DE OCAMPO,13,210,2,225,1919
MÉXICO,ZUMPANGO DE OCAMPO,31,301,4,336,1756
MÉXICO,ZUMPANGO DE OCAMPO,34,280,6,320,1756
MÉXICO,ZUMPANGO DE OCAMPO,27,269,4,300,1756
MÉXICO,ZUMPANGO DE OCAMPO,24,283,2,309,1881
MÉXICO,ZUMPANGO DE OCAMPO,27,301,8,336,1881
MÉXICO,ZUMPANGO DE OCAMPO,28,279,7,314,1880
MÉXICO,ZUMPANGO DE OCAMPO,20,240,3,263,1316
MÉXICO,ZUMPANGO DE OCAMPO,26,264,7,297,1315
MÉXICO,ZUMPANGO DE OCAMPO,15,177,2,194,1128
MÉXICO,ZUMPANGO DE OCAMPO,8,191,2,201,1128
MÉXICO,ZUMPANGO DE OCAMPO,27,247,4,278,1282
MÉXICO,ZUMPANGO DE OCAMPO,25,249,2,276,1282
MÉXICO,ZUMPANGO DE OCAMPO,17,202,0,219,1165
MÉXICO,ZUMPANGO DE OCAMPO,20,206,4,230,1165
MÉXICO,ZUMPANGO DE OCAMPO,23,356,7,386,1812
MÉXICO,ZUMPANGO DE OCAMPO,30,347,7,384,1811
MÉXICO,ZUMPANGO DE OCAMPO,16,245,1,262,1346
MÉXICO,ZUMPANGO DE OCAMPO,19,271,6,296,1345
MÉXICO,ZUMPANGO DE OCAMPO,16,331,4,351,1510
MÉXICO,ZUMPANGO DE OCAMPO,23,349,6,378,1509
MÉXICO,ZUMPANGO DE OCAMPO,13,241,6,260,1338
MÉXICO,ZUMPANGO DE OCAMPO,17,220,4,241,1337
MÉXICO,ZUMPANGO DE OCAMPO,21,238,1,260,1337
MÉXICO,ZUMPANGO DE OCAMPO,34,413,4,451,1590
MÉXICO,ZUMPANGO DE OCAMPO,37,281,7,325,1758
MÉXICO,ZUMPANGO DE OCAMPO,26,223,8,257,1942
MÉXICO,ZUMPANGO DE OCAMPO,22,280,8,310,1942
MÉXICO,ZUMPANGO DE OCAMPO,4,170,3,177,1771
MÉXICO,ZUMPANGO DE OCAMPO,5,158,3,166,1771
MÉXICO,ZUMPANGO DE OCAMPO,9,191,3,203,1770
MÉXICO,ZUMPANGO DE OCAMPO,6,190,0,196,1770
MÉXICO,ZUMPANGO DE OCAMPO,21,217,3,241,1410
MÉXICO,ZUMPANGO DE OCAMPO,11,181,2,194,1410
MÉXICO,ZUMPANGO DE OCAMPO,19,191,2,212,1409
MÉXICO,ZUMPANGO DE OCAMPO,15,238,1,254,1665
MÉXICO,ZUMPANGO DE OCAMPO,20,198,4,222,1664
MÉXICO,ZUMPANGO DE OCAMPO,22,206,5,233,1664
MÉXICO,ZUMPANGO DE OCAMPO,15,167,3,185,1879
MÉXICO,ZUMPANGO DE OCAMPO,14,181,4,199,1879
MÉXICO,ZUMPANGO DE OCAMPO,18,161,0,179,1879
MÉXICO,ZUMPANGO DE OCAMPO,14,153,0,167,1879
MÉXICO,ZUMPANGO DE OCAMPO,16,182,6,204,1879
MÉXICO,ZUMPANGO DE OCAMPO,62,269,0,331,1879
MÉXICO,ZUMPANGO DE OCAMPO,20,181,2,203,1879
MÉXICO,ZUMPANGO DE OCAMPO,27,170,1,198,1879
MÉXICO,ZUMPANGO DE OCAMPO,19,324,74,417,1878
MÉXICO,ZUMPANGO DE OCAMPO,12,234,5,251,1812
MÉXICO,ZUMPANGO DE OCAMPO,12,219,9,240,1811
MÉXICO,ZUMPANGO DE OCAMPO,14,256,5,275,1481
MÉXICO,ZUMPANGO DE OCAMPO,7,280,5,292,1481
MÉXICO,ZUMPANGO DE OCAMPO,10,280,8,298,1481
MÉXICO,ZUMPANGO DE OCAMPO,19,386,3,408,1625
MÉXICO,ZUMPANGO DE OCAMPO,5,306,10,321,1624
MÉXICO,ZUMPANGO DE OCAMPO,11,263,3,277,1353
MÉXICO,ZUMPANGO DE OCAMPO,14,299,3,316,1352
MÉXICO,ZUMPANGO DE OCAMPO,18,257,7,282,1207
MÉXICO,ZUMPANGO DE OCAMPO,12,291,1,304,1207
MÉXICO,ZUMPANGO DE OCAMPO,21,376,4,401,1672
MÉXICO,ZUMPANGO DE OCAMPO,13,389,3,405,1671
MÉXICO,ZUMPANGO DE OCAMPO,6,322,4,332,1896
MÉXICO,ZUMPANGO DE OCAMPO,15,300,4,319,1896
MÉXICO,ZUMPANGO DE OCAMPO,8,183,0,191,1952
MÉXICO,ZUMPANGO DE OCAMPO,24,184,2,210,1952
MÉXICO,ZUMPANGO DE OCAMPO,18,188,2,208,1952
MÉXICO,ZUMPANGO DE OCAMPO,15,167,2,184,1952
MÉXICO,ZUMPANGO DE OCAMPO,21,200,1,222,1952
MÉXICO,ZUMPANGO DE OCAMPO,15,164,2,181,1952
MÉXICO,ZUMPANGO DE OCAMPO,15,209,0,224,1951
MÉXICO,ZUMPANGO DE OCAMPO,22,182,1,205,1951
MÉXICO,ZUMPANGO DE OCAMPO,11,211,1,223,1951
MÉXICO,ZUMPANGO DE OCAMPO,25,197,1,223,1671
MÉXICO,ZUMPANGO DE OCAMPO,13,212,5,230,1671
MÉXICO,ZUMPANGO DE OCAMPO,30,262,5,297,1175
MÉXICO,ZUMPANGO DE OCAMPO,25,191,9,225,1174
MÉXICO,ZUMPANGO DE OCAMPO,30,227,9,266,1393
MÉXICO,ZUMPANGO DE OCAMPO,27,216,5,248,1393
MÉXICO,ZUMPANGO DE OCAMPO,13,234,1,248,1393
MÉXICO,ZUMPANGO DE OCAMPO,24,235,4,263,1917
MÉXICO,ZUMPANGO DE OCAMPO,22,286,6,314,1917
MÉXICO,ZUMPANGO DE OCAMPO,15,138,0,153,1868
MÉXICO,ZUMPANGO DE OCAMPO,8,145,0,153,1868
MÉXICO,ZUMPANGO DE OCAMPO,13,130,0,143,1867
MÉXICO,ZUMPANGO DE OCAMPO,16,182,2,200,1868
MÉXICO,ZUMPANGO DE OCAMPO,12,164,1,177,1868
MÉXICO,ZUMPANGO DE OCAMPO,12,170,3,185,1868
MÉXICO,ZUMPANGO DE OCAMPO,7,80,0,87,1798
MÉXICO,ZUMPANGO DE OCAMPO,1,79,0,80,1798
MÉXICO,ZUMPANGO DE OCAMPO,14,141,0,155,1747
MÉXICO,ZUMPANGO DE OCAMPO,3,158,17,178,1747
MÉXICO,ZUMPANGO DE OCAMPO,15,143,0,158,1551
MÉXICO,ZUMPANGO DE OCAMPO,9,161,2,172,1550
MÉXICO,ZUMPANGO DE OCAMPO,7,164,2,173,1550
MÉXICO,ZUMPANGO DE OCAMPO,15,171,0,186,1670
MÉXICO,ZUMPANGO DE OCAMPO,15,170,0,185,1669
MÉXICO,ZUMPANGO DE OCAMPO,13,176,0,189,1871
MÉXICO,ZUMPANGO DE OCAMPO,20,170,0,190,1870
MÉXICO,ZUMPANGO DE OCAMPO,20,174,2,196,1870
MÉXICO,ZUMPANGO DE OCAMPO,16,116,0,132,1208
MÉXICO,ZUMPANGO DE OCAMPO,12,98,1,111,1208
MÉXICO,ZUMPANGO DE OCAMPO,16,113,26,155,1463
MÉXICO,ZUMPANGO DE OCAMPO,14,130,0,144,1463
MÉXICO,ZUMPANGO DE OCAMPO,14,143,0,157,1364
MÉXICO,ZUMPANGO DE OCAMPO,6,156,0,162,1363
MÉXICO,ZUMPANGO DE OCAMPO,11,111,0,122,1103
MÉXICO,ZUMPANGO DE OCAMPO,8,144,2,154,1103
MÉXICO,ZUMPANGO DE OCAMPO,5,101,1,107,1585
MÉXICO,ZUMPANGO DE OCAMPO,7,99,1,107,1584
MÉXICO,ZUMPANGO DE OCAMPO,3,107,1,111,1584
MÉXICO,ZUMPANGO DE OCAMPO,9,203,0,212,1792
MÉXICO,ZUMPANGO DE OCAMPO,8,171,3,182,1792
MÉXICO,CD. NEZAHUALCOYOTL,21,255,4,280,1303
MÉXICO,CD. NEZAHUALCOYOTL,23,243,5,271,1303
MÉXICO,CD. NEZAHUALCOYOTL,36,349,4,389,1779
MÉXICO,CD. NEZAHUALCOYOTL,28,276,4,308,1779
MÉXICO,CD. NEZAHUALCOYOTL,35,329,7,371,1722
MÉXICO,CD. NEZAHUALCOYOTL,27,323,4,354,1721
MÉXICO,CD. NEZAHUALCOYOTL,17,291,1,309,1397
MÉXICO,CD. NEZAHUALCOYOTL,26,247,1,274,1397
MÉXICO,CD. NEZAHUALCOYOTL,27,276,9,312,1524
MÉXICO,CD. NEZAHUALCOYOTL,27,303,2,332,1523
MÉXICO,CD. NEZAHUALCOYOTL,25,255,2,282,1366
MÉXICO,CD. NEZAHUALCOYOTL,32,249,1,282,1366
MÉXICO,CD. NEZAHUALCOYOTL,54,298,6,358,1853
MÉXICO,CD. NEZAHUALCOYOTL,50,335,9,394,1853
MÉXICO,CD. NEZAHUALCOYOTL,38,306,2,346,1833
MÉXICO,CD. NEZAHUALCOYOTL,30,332,4,366,1832
MÉXICO,CD. NEZAHUALCOYOTL,33,235,4,272,1330
MÉXICO,CD. NEZAHUALCOYOTL,26,211,2,239,1330
MÉXICO,CD. NEZAHUALCOYOTL,26,291,5,322,1751
MÉXICO,CD. NEZAHUALCOYOTL,22,294,2,318,1750
MÉXICO,CD. NEZAHUALCOYOTL,25,275,3,303,1425
MÉXICO,CD. NEZAHUALCOYOTL,32,242,6,280,1425
MÉXICO,CD. NEZAHUALCOYOTL,21,220,2,243,1072
MÉXICO,CD. NEZAHUALCOYOTL,21,222,5,248,1071
MÉXICO,CD. NEZAHUALCOYOTL,34,316,10,360,1873
MÉXICO,CD. NEZAHUALCOYOTL,40,394,2,436,1873
MÉXICO,CD. NEZAHUALCOYOTL,44,385,11,440,1891
MÉXICO,CD. NEZAHUALCOYOTL,30,384,8,422,1890
MÉXICO,CD. NEZAHUALCOYOTL,37,295,3,335,1625
MÉXICO,CD. NEZAHUALCOYOTL,39,327,7,373,1624
MÉXICO,CD. NEZAHUALCOYOTL,18,313,17,348,1781
MÉXICO,CD. NEZAHUALCOYOTL,53,355,8,416,1839
MÉXICO,CD. NEZAHUALCOYOTL,33,313,6,352,1838
MÉXICO,CD. NEZAHUALCOYOTL,25,186,7,218,1117
MÉXICO,CD. NEZAHUALCOYOTL,43,199,3,245,1116
MÉXICO,CD. NEZAHUALCOYOTL,34,344,4,382,1755
MÉXICO,CD. NEZAHUALCOYOTL,28,348,7,383,1755
MÉXICO,CD. NEZAHUALCOYOTL,31,258,5,294,1554
MÉXICO,CD. NEZAHUALCOYOTL,25,257,1,283,1554
MÉXICO,CD. NEZAHUALCOYOTL,31,257,2,290,1553
MÉXICO,CD. NEZAHUALCOYOTL,26,290,3,319,1805
MÉXICO,CD. NEZAHUALCOYOTL,42,321,2,365,1804
MÉXICO,CD. NEZAHUALCOYOTL,42,322,4,368,1845
MÉXICO,CD. NEZAHUALCOYOTL,41,326,6,373,1844
MÉXICO,CD. NEZAHUALCOYOTL,36,285,3,324,1733
MÉXICO,CD. NEZAHUALCOYOTL,21,296,4,321,1732
MÉXICO,CD. NEZAHUALCOYOTL,29,292,7,328,1565
MÉXICO,CD. NEZAHUALCOYOTL,58,305,3,366,1843
MÉXICO,CD. NEZAHUALCOYOTL,35,299,6,340,1842
MÉXICO,CD. NEZAHUALCOYOTL,16,227,8,251,1313
MÉXICO,CD. NEZAHUALCOYOTL,28,242,5,275,1312
MÉXICO,CD. NEZAHUALCOYOTL,43,379,2,424,1906
MÉXICO,CD. NEZAHUALCOYOTL,42,328,4,374,1905
MÉXICO,CD. NEZAHUALCOYOTL,32,320,3,355,1632
MÉXICO,CD. NEZAHUALCOYOTL,28,317,4,349,1632
MÉXICO,CD. NEZAHUALCOYOTL,32,337,4,373,1864
MÉXICO,CD. NEZAHUALCOYOTL,29,393,2,424,1864
MÉXICO,CD. NEZAHUALCOYOTL,31,335,5,371,1804
MÉXICO,CD. NEZAHUALCOYOTL,29,316,2,347,1804
MÉXICO,CD. NEZAHUALCOYOTL,22,239,5,266,1362
MÉXICO,CD. NEZAHUALCOYOTL,22,211,2,235,1362
MÉXICO,CD. NEZAHUALCOYOTL,22,231,3,256,1361
MÉXICO,CD. NEZAHUALCOYOTL,21,361,6,388,1822
MÉXICO,CD. NEZAHUALCOYOTL,27,339,3,369,1822
MÉXICO,CD. NEZAHUALCOYOTL,54,311,4,369,1577
MÉXICO,CD. NEZAHUALCOYOTL,48,406,5,459,1958
MÉXICO,CD. NEZAHUALCOYOTL,42,383,2,427,1957
MÉXICO,CD. NEZAHUALCOYOTL,40,343,3,386,1787
MÉXICO,CD. NEZAHUALCOYOTL,35,370,3,408,1787
MÉXICO,CD. NEZAHUALCOYOTL,28,325,8,361,1595
MÉXICO,CD. NEZAHUALCOYOTL,21,316,4,341,1594
MÉXICO,CD. NEZAHUALCOYOTL,47,414,5,466,1797
MÉXICO,CD. NEZAHUALCOYOTL,46,266,5,317,1489
MÉXICO,CD. NEZAHUALCOYOTL,25,251,0,276,1443
MÉXICO,CD. NEZAHUALCOYOTL,32,267,4,303,1442
MÉXICO,CD. NEZAHUALCOYOTL,24,355,1,380,1890
MÉXICO,CD. NEZAHUALCOYOTL,45,289,7,341,1919
MÉXICO,CD. NEZAHUALCOYOTL,36,320,7,363,1918
MÉXICO,CD. NEZAHUALCOYOTL,42,349,9,400,2013
MÉXICO,CD. NEZAHUALCOYOTL,36,329,2,367,1792
MÉXICO,CD. NEZAHUALCOYOTL,39,352,5,396,1792
MÉXICO,CD. NEZAHUALCOYOTL,42,370,4,416,1862
MÉXICO,CD. NEZAHUALCOYOTL,33,319,5,357,1862
MÉXICO,CD. NEZAHUALCOYOTL,48,360,9,417,2017
MÉXICO,CD. NEZAHUALCOYOTL,30,180,5,215,1082
MÉXICO,CD. NEZAHUALCOYOTL,28,178,2,208,1082
MÉXICO,CD. NEZAHUALCOYOTL,40,338,4,382,1940
MÉXICO,CD. NEZAHUALCOYOTL,31,345,4,380,1940
MÉXICO,CD. NEZAHUALCOYOTL,44,315,2,361,1894
MÉXICO,CD. NEZAHUALCOYOTL,36,269,8,313,1840
MÉXICO,CD. NEZAHUALCOYOTL,27,245,1,273,1840
MÉXICO,CD. NEZAHUALCOYOTL,20,262,4,286,1491
MÉXICO,CD. NEZAHUALCOYOTL,21,273,1,295,1491
MÉXICO,CD. NEZAHUALCOYOTL,40,355,7,402,1929
MÉXICO,CD. NEZAHUALCOYOTL,38,321,12,371,1928
MÉXICO,CD. NEZAHUALCOYOTL,49,339,5,393,1923
MÉXICO,CD. NEZAHUALCOYOTL,49,266,5,320,1477
MÉXICO,CD. NEZAHUALCOYOTL,37,284,3,324,1477
MÉXICO,CD. NEZAHUALCOYOTL,41,294,5,340,1860
MÉXICO,CD. NEZAHUALCOYOTL,28,269,3,300,1859
MÉXICO,CD. NEZAHUALCOYOTL,30,323,7,360,1785
MÉXICO,CD. NEZAHUALCOYOTL,26,310,6,342,1784
MÉXICO,CD. NEZAHUALCOYOTL,40,267,1,308,1220
MÉXICO,CD. NEZAHUALCOYOTL,22,271,3,296,1220
MÉXICO,CD. NEZAHUALCOYOTL,23,226,4,253,1062
MÉXICO,CD. NEZAHUALCOYOTL,27,209,6,242,1061
MÉXICO,CD. NEZAHUALCOYOTL,30,309,12,351,1627
MÉXICO,CD. NEZAHUALCOYOTL,40,306,9,355,1627
MÉXICO,CD. NEZAHUALCOYOTL,30,301,3,334,1750
MÉXICO,CD. NEZAHUALCOYOTL,25,313,10,348,1749
MÉXICO,CD. NEZAHUALCOYOTL,23,192,1,216,1108
MÉXICO,CD. NEZAHUALCOYOTL,16,193,1,210,1108
MÉXICO,CD. NEZAHUALCOYOTL,41,321,13,375,1845
MÉXICO,CD. NEZAHUALCOYOTL,44,322,1,367,1416
MÉXICO,CD. NEZAHUALCOYOTL,39,285,0,324,1415
MÉXICO,CD. NEZAHUALCOYOTL,31,328,4,363,1674
MÉXICO,CD. NEZAHUALCOYOTL,31,323,2,356,1673
MÉXICO,CD. NEZAHUALCOYOTL,30,309,2,341,1750
MÉXICO,CD. NEZAHUALCOYOTL,28,290,4,322,1749
MÉXICO,CD. NEZAHUALCOYOTL,121,1263,9,1393,0
MÉXICO,CD. NEZAHUALCOYOTL,36,317,4,357,1929
MÉXICO,CD. NEZAHUALCOYOTL,39,325,7,371,1929
MÉXICO,CD. NEZAHUALCOYOTL,33,344,6,383,1719
MÉXICO,CD. NEZAHUALCOYOTL,29,344,1,374,1718
MÉXICO,CD. NEZAHUALCOYOTL,41,331,11,383,1750
MÉXICO,CD. NEZAHUALCOYOTL,45,289,4,338,1750
MÉXICO,CD. NEZAHUALCOYOTL,33,310,6,349,1794
MÉXICO,CD. NEZAHUALCOYOTL,39,296,7,342,1793
MÉXICO,CD. NEZAHUALCOYOTL,39,301,5,345,1710
MÉXICO,CD. NEZAHUALCOYOTL,23,291,3,317,1710
MÉXICO,CD. NEZAHUALCOYOTL,55,367,12,434,1866
MÉXICO,CD. NEZAHUALCOYOTL,23,177,4,204,1050
MÉXICO,CD. NEZAHUALCOYOTL,27,210,3,240,1050
MÉXICO,CD. NEZAHUALCOYOTL,29,232,10,271,1363
MÉXICO,CD. NEZAHUALCOYOTL,20,202,2,224,1363
MÉXICO,CD. NEZAHUALCOYOTL,26,253,2,281,1363
MÉXICO,CD. NEZAHUALCOYOTL,40,343,8,391,1843
MÉXICO,CD. NEZAHUALCOYOTL,40,383,5,428,1842
MÉXICO,CD. NEZAHUALCOYOTL,30,252,9,291,1387
MÉXICO,CD. NEZAHUALCOYOTL,27,250,1,278,1387
MÉXICO,CD. NEZAHUALCOYOTL,23,264,3,290,1386
MÉXICO,CD. NEZAHUALCOYOTL,39,293,3,335,1957
MÉXICO,CD. NEZAHUALCOYOTL,25,238,7,270,1243
MÉXICO,CD. NEZAHUALCOYOTL,30,213,3,246,1242
MÉXICO,CD. NEZAHUALCOYOTL,32,316,2,350,1788
MÉXICO,CD. NEZAHUALCOYOTL,33,313,8,354,1788
MÉXICO,CD. NEZAHUALCOYOTL,48,301,5,354,1841
MÉXICO,CD. NEZAHUALCOYOTL,40,328,6,374,1840
MÉXICO,CD. NEZAHUALCOYOTL,45,370,5,420,1931
MÉXICO,CD. NEZAHUALCOYOTL,36,390,7,433,1930
MÉXICO,CD. NEZAHUALCOYOTL,27,321,4,352,1690
MÉXICO,CD. NEZAHUALCOYOTL,38,332,4,374,1689
MÉXICO,CD. NEZAHUALCOYOTL,31,232,6,269,1346
MÉXICO,CD. NEZAHUALCOYOTL,33,241,3,277,1346
MÉXICO,CD. NEZAHUALCOYOTL,30,255,3,288,1346
MÉXICO,CD. NEZAHUALCOYOTL,30,315,7,352,1795
MÉXICO,CD. NEZAHUALCOYOTL,37,327,7,371,1795
MÉXICO,CD. NEZAHUALCOYOTL,27,273,2,302,1370
MÉXICO,CD. NEZAHUALCOYOTL,25,245,2,272,1370
MÉXICO,CD. NEZAHUALCOYOTL,35,326,3,364,1830
MÉXICO,CD. NEZAHUALCOYOTL,28,381,3,412,1829
MÉXICO,CD. NEZAHUALCOYOTL,43,330,5,378,1664
MÉXICO,CD. NEZAHUALCOYOTL,32,351,8,391,1794
MÉXICO,CD. NEZAHUALCOYOTL,38,323,2,363,1793
MÉXICO,CD. NEZAHUALCOYOTL,54,318,6,378,1803
MÉXICO,CD. NEZAHUALCOYOTL,44,373,15,432,1803
MÉXICO,CD. NEZAHUALCOYOTL,36,317,3,356,1643
MÉXICO,CD. NEZAHUALCOYOTL,38,345,3,386,1969
MÉXICO,CD. NEZAHUALCOYOTL,42,398,8,448,1968
MÉXICO,CD. NEZAHUALCOYOTL,36,294,1,331,1319
MÉXICO,CD. NEZAHUALCOYOTL,29,297,4,330,1319
MÉXICO,CD. NEZAHUALCOYOTL,63,423,9,495,1936
MÉXICO,CD. NEZAHUALCOYOTL,59,357,9,425,1936
MÉXICO,CD. NEZAHUALCOYOTL,49,266,3,318,1461
MÉXICO,CD. NEZAHUALCOYOTL,26,281,6,313,1460
MÉXICO,CD. NEZAHUALCOYOTL,46,312,1,359,1460
MÉXICO,CD. NEZAHUALCOYOTL,25,284,4,313,1393
MÉXICO,CD. NEZAHUALCOYOTL,30,301,3,334,1393
MÉXICO,CD. NEZAHUALCOYOTL,35,319,2,356,1392
MÉXICO,CHIMALHUACAN,58,272,10,340,1604
MÉXICO,CHIMALHUACAN,47,284,10,341,1604
MÉXICO,CHIMALHUACAN,52,277,13,342,1603
MÉXICO,CHIMALHUACAN,35,216,3,254,1423
MÉXICO,CHIMALHUACAN,39,206,8,253,1422
MÉXICO,CHIMALHUACAN,66,365,5,436,1854
MÉXICO,CHIMALHUACAN,117,951,19,1087,0
MÉXICO,CHIMALHUACAN,57,232,8,297,1419
MÉXICO,CHIMALHUACAN,40,266,7,313,1419
MÉXICO,CHIMALHUACAN,32,287,9,328,1821
MÉXICO,CHIMALHUACAN,32,239,3,274,1821
MÉXICO,CHIMALHUACAN,40,260,7,307,1821
MÉXICO,CHIMALHUACAN,44,185,2,231,1181
MÉXICO,CHIMALHUACAN,48,180,8,236,1181
MÉXICO,CHIMALHUACAN,53,330,5,388,1601
MÉXICO,CHIMALHUACAN,42,305,9,356,1569
MÉXICO,CHIMALHUACAN,35,313,1,349,1519
MÉXICO,CHIMALHUACAN,40,320,6,366,1745
MÉXICO,CHIMALHUACAN,48,330,3,381,1745
MÉXICO,CHIMALHUACAN,38,304,6,348,1745
MÉXICO,CHIMALHUACAN,44,213,4,261,1243
MÉXICO,CHIMALHUACAN,31,232,5,268,1243
MÉXICO,CHIMALHUACAN,57,275,13,345,1829
MÉXICO,CHIMALHUACAN,58,310,9,377,1829
MÉXICO,CHIMALHUACAN,49,338,5,392,1472
MÉXICO,CHIMALHUACAN,34,320,6,360,1471
MÉXICO,CHIMALHUACAN,41,317,12,370,1709
MÉXICO,CHIMALHUACAN,35,306,6,347,1709
MÉXICO,CHIMALHUACAN,59,341,6,406,1568
MÉXICO,CHIMALHUACAN,60,309,6,375,1534
MÉXICO,CHIMALHUACAN,50,392,7,449,1927
MÉXICO,CHIMALHUACAN,61,396,5,462,1927
MÉXICO,CHIMALHUACAN,45,407,10,462,1724
MÉXICO,CHIMALHUACAN,51,284,6,341,1478
MÉXICO,CHIMALHUACAN,35,309,7,351,1477
MÉXICO,CHIMALHUACAN,47,346,8,401,1610
MÉXICO,CHIMALHUACAN,44,330,9,383,1744
MÉXICO,CHIMALHUACAN,31,216,3,250,1234
MÉXICO,CHIMALHUACAN,34,255,4,293,1234
MÉXICO,CHIMALHUACAN,31,339,4,374,1815
MÉXICO,CHIMALHUACAN,46,338,11,395,1815
MÉXICO,CHIMALHUACAN,18,158,3,179,1106
MÉXICO,CHIMALHUACAN,22,137,3,162,1106
MÉXICO,CHIMALHUACAN,22,193,2,217,1418
MÉXICO,CHIMALHUACAN,24,244,6,274,1417
MÉXICO,CHIMALHUACAN,38,221,2,261,1495
MÉXICO,CHIMALHUACAN,20,234,5,259,1495
MÉXICO,CHIMALHUACAN,28,191,4,223,1432
MÉXICO,CHIMALHUACAN,15,207,3,225,1432
MÉXICO,CHIMALHUACAN,14,165,3,182,1432
MÉXICO,CHIMALHUACAN,27,224,4,255,1540
MÉXICO,CHIMALHUACAN,21,245,3,269,1540
MÉXICO,CHIMALHUACAN,17,219,2,238,1540
MÉXICO,CHIMALHUACAN,34,208,4,246,1744
MÉXICO,CHIMALHUACAN,27,179,2,208,1744
MÉXICO,CHIMALHUACAN,23,182,3,208,1744
MÉXICO,CHIMALHUACAN,26,180,3,209,1744
MÉXICO,CHIMALHUACAN,34,180,3,217,1744
MÉXICO,CHIMALHUACAN,25,198,1,224,1743
MÉXICO,CHIMALHUACAN,18,221,2,241,1754
MÉXICO,CHIMALHUACAN,26,210,4,240,1754
MÉXICO,CHIMALHUACAN,29,192,4,225,1754
MÉXICO,CHIMALHUACAN,13,191,3,207,1753
MÉXICO,CHIMALHUACAN,20,191,1,212,1408
MÉXICO,CHIMALHUACAN,23,205,2,230,1408
MÉXICO,CHIMALHUACAN,21,215,2,238,1486
MÉXICO,CHIMALHUACAN,13,214,0,227,1485
MÉXICO,CHIMALHUACAN,20,221,2,243,1665
MÉXICO,CHIMALHUACAN,29,212,3,244,1665
MÉXICO,CHIMALHUACAN,24,239,1,264,1665
MÉXICO,CHIMALHUACAN,26,240,2,268,1665
MÉXICO,CHIMALHUACAN,20,196,1,217,1664
MÉXICO,CHIMALHUACAN,24,221,3,248,1664
MÉXICO,CHIMALHUACAN,24,224,2,250,1627
MÉXICO,CHIMALHUACAN,30,251,3,284,1627
MÉXICO,CHIMALHUACAN,15,210,0,225,1318
MÉXICO,CHIMALHUACAN,20,215,1,236,1318
MÉXICO,CHIMALHUACAN,25,226,7,258,1709
MÉXICO,CHIMALHUACAN,21,229,6,256,1709
MÉXICO,CHIMALHUACAN,19,187,3,209,1777
MÉXICO,CHIMALHUACAN,18,146,5,169,1777
MÉXICO,CHIMALHUACAN,22,148,5,175,1777
MÉXICO,CHIMALHUACAN,21,164,1,186,1776
MÉXICO,CHIMALHUACAN,20,164,6,190,1776
MÉXICO,CHIMALHUACAN,25,146,2,173,1776
MÉXICO,CHIMALHUACAN,0,249,3,252,1752
MÉXICO,CHIMALHUACAN,28,221,4,253,1752
MÉXICO,CHIMALHUACAN,11,197,1,209,1735
MÉXICO,CHIMALHUACAN,13,177,8,198,1735
MÉXICO,CHIMALHUACAN,13,184,5,202,1735
MÉXICO,CHIMALHUACAN,16,173,2,191,1735
MÉXICO,CHIMALHUACAN,21,200,4,225,1942
MÉXICO,CHIMALHUACAN,22,191,5,218,1942
MÉXICO,CHIMALHUACAN,19,166,1,186,1942
MÉXICO,CHIMALHUACAN,14,161,3,178,1942
MÉXICO,CHIMALHUACAN,18,151,0,169,1464
MÉXICO,CHIMALHUACAN,22,159,3,184,1463
MÉXICO,CHIMALHUACAN,12,160,0,172,1463
MÉXICO,CHIMALHUACAN,19,116,2,137,1532
MÉXICO,CHIMALHUACAN,16,112,1,129,1532
MÉXICO,CHIMALHUACAN,13,131,4,148,1532
MÉXICO,CHIMALHUACAN,8,131,0,139,1807
MÉXICO,CHIMALHUACAN,6,163,3,172,1807
MÉXICO,CHIMALHUACAN,13,130,1,144,1807
MÉXICO,CHIMALHUACAN,7,134,3,144,1807
MÉXICO,CHIMALHUACAN,10,141,2,153,1807
MÉXICO,CHIMALHUACAN,5,118,2,125,1807
MÉXICO,CHIMALHUACAN,12,130,2,144,1807
MÉXICO,CHIMALHUACAN,6,129,2,137,1806
MÉXICO,CHIMALHUACAN,8,140,4,152,1806
MÉXICO,CHIMALHUACAN,31,213,5,249,1697
MÉXICO,CHIMALHUACAN,19,213,3,235,1696
MÉXICO,CHIMALHUACAN,23,123,4,150,1470
MÉXICO,CHIMALHUACAN,16,152,2,170,1469
MÉXICO,CHIMALHUACAN,14,153,1,168,1807
MÉXICO,CHIMALHUACAN,20,167,4,191,1807
MÉXICO,CHIMALHUACAN,20,136,6,162,1807
MÉXICO,CHIMALHUACAN,27,234,5,266,1669
MÉXICO,CHIMALHUACAN,13,241,2,256,1921
MÉXICO,CHIMALHUACAN,12,153,4,169,1064
MÉXICO,CHIMALHUACAN,7,131,2,140,1063
MÉXICO,CHIMALHUACAN,33,218,3,254,1904
MÉXICO,CHIMALHUACAN,26,252,2,280,1904
MÉXICO,CHIMALHUACAN,21,169,5,195,1575
MÉXICO,CHIMALHUACAN,17,174,7,198,1575
MÉXICO,CHIMALHUACAN,26,197,2,225,1681
MÉXICO,CHIMALHUACAN,17,191,4,212,1680
MÉXICO,CHIMALHUACAN,21,166,1,188,1512
MÉXICO,CHIMALHUACAN,17,167,5,189,1308
MÉXICO,CHIMALHUACAN,14,157,4,175,1307
MÉXICO,CHIMALHUACAN,35,269,9,313,1943
MÉXICO,CHIMALHUACAN,35,244,8,287,1741
MÉXICO,CHIMALHUACAN,281,40,5,326,1741
MÉXICO,CHIMALHUACAN,32,172,3,207,1102
MÉXICO,CHIMALHUACAN,28,194,2,224,1102
MÉXICO,CHIMALHUACAN,28,216,1,245,1144
MÉXICO,CHIMALHUACAN,31,219,1,251,1144
MÉXICO,CHIMALHUACAN,42,254,5,301,1411
MÉXICO,CHIMALHUACAN,43,233,4,280,1410
MÉXICO,CHIMALHUACAN,39,192,7,238,1364
MÉXICO,CHIMALHUACAN,32,208,2,242,1364
MÉXICO,CHIMALHUACAN,30,232,1,263,1175
MÉXICO,CHIMALHUACAN,42,197,2,241,1174
MÉXICO,CHIMALHUACAN,24,181,5,210,1197
MÉXICO,CHIMALHUACAN,30,213,2,245,1197
MÉXICO,CHIMALHUACAN,66,312,12,390,1941
MÉXICO,CHIMALHUACAN,43,220,4,267,1570
MÉXICO,CHIMALHUACAN,40,240,4,284,1570
MÉXICO,CHIMALHUACAN,34,182,4,220,1066
MÉXICO,CHIMALHUACAN,34,183,6,223,1066
MÉXICO,CHIMALHUACAN,51,216,4,271,1324
MÉXICO,CHIMALHUACAN,47,248,3,298,1323
MÉXICO,CHIMALHUACAN,43,305,3,351,1815
MÉXICO,CHIMALHUACAN,52,326,5,383,1815
MÉXICO,CHIMALHUACAN,26,185,2,213,1208
MÉXICO,CHIMALHUACAN,52,164,0,216,1208
MÉXICO,CHIMALHUACAN,28,185,3,216,1035
MÉXICO,CHIMALHUACAN,39,187,9,235,1034
MÉXICO,CHIMALHUACAN,49,254,4,307,1558
MÉXICO,CHIMALHUACAN,43,266,5,314,1557
MÉXICO,CHIMALHUACAN,56,311,8,375,1820
MÉXICO,CHIMALHUACAN,57,323,7,387,1819
MÉXICO,CHIMALHUACAN,46,320,6,372,1665
MÉXICO,CHIMALHUACAN,58,287,13,358,1496
MÉXICO,CHIMALHUACAN,67,301,14,382,1718
MÉXICO,CHIMALHUACAN,45,259,6,310,1738
MÉXICO,CHIMALHUACAN,42,313,5,360,1826
MÉXICO,CHIMALHUACAN,28,146,1,175,1095
MÉXICO,CHIMALHUACAN,24,161,2,187,1094
MÉXICO,CHIMALHUACAN,69,281,6,356,1912
MÉXICO,CHIMALHUACAN,49,224,6,279,1342
MÉXICO,CHIMALHUACAN,55,212,5,272,1341
MÉXICO,CHIMALHUACAN,30,227,3,260,1579
MÉXICO,CHIMALHUACAN,31,221,5,257,1578
MÉXICO,CHIMALHUACAN,32,210,3,245,1532
MÉXICO,CHIMALHUACAN,22,201,7,230,1531
MÉXICO,CHIMALHUACAN,47,193,3,243,1531
MÉXICO,CHIMALHUACAN,67,310,6,383,1946
MÉXICO,CHIMALHUACAN,69,319,7,395,1780
MÉXICO,CHIMALHUACAN,33,214,4,251,1165
MÉXICO,CHIMALHUACAN,41,192,4,237,1164
MÉXICO,CHIMALHUACAN,55,271,7,333,1549
MÉXICO,CD. NEZAHUALCOYOTL,23,236,5,264,1789
MÉXICO,CD. NEZAHUALCOYOTL,26,288,4,318,1788
MÉXICO,CD. NEZAHUALCOYOTL,37,332,3,372,1833
MÉXICO,CD. NEZAHUALCOYOTL,23,356,5,384,1833
MÉXICO,CD. NEZAHUALCOYOTL,33,269,6,308,1613
MÉXICO,CD. NEZAHUALCOYOTL,34,279,3,316,1612
MÉXICO,CD. NEZAHUALCOYOTL,50,245,5,300,1612
MÉXICO,CD. NEZAHUALCOYOTL,25,326,2,353,1827
MÉXICO,CD. NEZAHUALCOYOTL,45,310,2,357,1827
MÉXICO,CD. NEZAHUALCOYOTL,39,357,4,400,1970
MÉXICO,CD. NEZAHUALCOYOTL,38,330,3,371,1969
MÉXICO,CD. NEZAHUALCOYOTL,30,341,5,376,1969
MÉXICO,CD. NEZAHUALCOYOTL,34,279,11,324,1796
MÉXICO,CD. NEZAHUALCOYOTL,28,385,4,417,1796
MÉXICO,CD. NEZAHUALCOYOTL,28,234,3,265,1391
MÉXICO,CD. NEZAHUALCOYOTL,32,226,4,262,1390
MÉXICO,CD. NEZAHUALCOYOTL,19,287,6,312,1390
MÉXICO,CD. NEZAHUALCOYOTL,43,306,4,353,1512
MÉXICO,CD. NEZAHUALCOYOTL,37,306,7,350,1512
MÉXICO,CD. NEZAHUALCOYOTL,56,310,7,373,1511
MÉXICO,CD. NEZAHUALCOYOTL,35,342,7,384,1549
MÉXICO,CD. NEZAHUALCOYOTL,33,304,7,344,1548
MÉXICO,CD. NEZAHUALCOYOTL,38,320,7,365,1676
MÉXICO,CD. NEZAHUALCOYOTL,31,349,8,388,1676
MÉXICO,CD. NEZAHUALCOYOTL,32,251,6,289,1373
MÉXICO,CD. NEZAHUALCOYOTL,28,236,9,273,1373
MÉXICO,CD. NEZAHUALCOYOTL,48,310,5,363,1825
MÉXICO,CD. NEZAHUALCOYOTL,34,340,7,381,1824
MÉXICO,CD. NEZAHUALCOYOTL,28,259,9,296,1341
MÉXICO,CD. NEZAHUALCOYOTL,25,265,2,292,1341
MÉXICO,CD. NEZAHUALCOYOTL,41,236,7,284,1341
MÉXICO,CD. NEZAHUALCOYOTL,34,330,4,368,1700
MÉXICO,CD. NEZAHUALCOYOTL,29,301,3,333,1699
MÉXICO,CD. NEZAHUALCOYOTL,39,276,2,317,1480
MÉXICO,CD. NEZAHUALCOYOTL,37,239,4,280,1480
MÉXICO,CD. NEZAHUALCOYOTL,38,254,5,297,1480
MÉXICO,CD. NEZAHUALCOYOTL,17,279,5,301,1593
MÉXICO,CD. NEZAHUALCOYOTL,24,278,3,305,1593
MÉXICO,CD. NEZAHUALCOYOTL,41,294,4,339,1610
MÉXICO,CD. NEZAHUALCOYOTL,32,302,6,340,1610
MÉXICO,CD. NEZAHUALCOYOTL,28,267,3,298,1610
MÉXICO,CD. NEZAHUALCOYOTL,15,355,3,373,1921
MÉXICO,CD. NEZAHUALCOYOTL,37,361,4,402,1920
MÉXICO,CD. NEZAHUALCOYOTL,28,300,0,328,1499
MÉXICO,CD. NEZAHUALCOYOTL,26,284,6,316,1498
MÉXICO,CD. NEZAHUALCOYOTL,24,254,5,283,1487
MÉXICO,CD. NEZAHUALCOYOTL,27,255,3,285,1486
MÉXICO,CD. NEZAHUALCOYOTL,21,292,12,325,1498
MÉXICO,CD. NEZAHUALCOYOTL,29,275,7,311,1497
MÉXICO,CD. NEZAHUALCOYOTL,32,342,6,380,1903
MÉXICO,CD. NEZAHUALCOYOTL,19,330,1,350,1903
MÉXICO,CD. NEZAHUALCOYOTL,32,352,6,390,1936
MÉXICO,CD. NEZAHUALCOYOTL,36,329,6,371,1936
MÉXICO,CD. NEZAHUALCOYOTL,30,357,5,392,1858
MÉXICO,CD. NEZAHUALCOYOTL,38,357,4,399,1858
MÉXICO,CD. NEZAHUALCOYOTL,21,252,6,279,1437
MÉXICO,CD. NEZAHUALCOYOTL,25,225,12,262,1436
MÉXICO,CD. NEZAHUALCOYOTL,25,249,8,282,1517
MÉXICO,CD. NEZAHUALCOYOTL,29,261,10,300,1516
MÉXICO,CD. NEZAHUALCOYOTL,34,267,6,307,1648
MÉXICO,CD. NEZAHUALCOYOTL,26,264,5,295,1648
MÉXICO,CD. NEZAHUALCOYOTL,13,251,4,268,1533
MÉXICO,CD. NEZAHUALCOYOTL,15,259,4,278,1532
MÉXICO,CD. NEZAHUALCOYOTL,42,359,2,403,1825
MÉXICO,CD. NEZAHUALCOYOTL,38,357,3,398,1824
MÉXICO,CD. NEZAHUALCOYOTL,21,173,6,200,1055
MÉXICO,CD. NEZAHUALCOYOTL,25,177,2,204,1054
MÉXICO,CD. NEZAHUALCOYOTL,19,152,2,173,1001
MÉXICO,CD. NEZAHUALCOYOTL,17,197,3,217,1001
MÉXICO,CD. NEZAHUALCOYOTL,17,240,3,260,1337
MÉXICO,CD. NEZAHUALCOYOTL,28,308,7,343,1337
MÉXICO,CD. NEZAHUALCOYOTL,29,276,7,312,1404
MÉXICO,CD. NEZAHUALCOYOTL,34,242,5,281,1404
MÉXICO,CD. NEZAHUALCOYOTL,37,291,7,335,1574
MÉXICO,CD. NEZAHUALCOYOTL,41,327,2,370,1573
MÉXICO,CD. NEZAHUALCOYOTL,43,376,6,425,1900
MÉXICO,CD. NEZAHUALCOYOTL,32,376,2,410,1899
MÉXICO,CD. NEZAHUALCOYOTL,32,383,7,422,1933
MÉXICO,CD. NEZAHUALCOYOTL,37,365,0,402,1932
MÉXICO,CD. NEZAHUALCOYOTL,52,844,12,908,0
MÉXICO,CD. NEZAHUALCOYOTL,24,347,5,376,1801
MÉXICO,CD. NEZAHUALCOYOTL,30,357,3,390,1800
MÉXICO,CD. NEZAHUALCOYOTL,34,329,1,364,1647
MÉXICO,CD. NEZAHUALCOYOTL,33,296,6,335,1647
MÉXICO,CD. NEZAHUALCOYOTL,18,238,4,260,1084
MÉXICO,CD. NEZAHUALCOYOTL,13,213,3,229,1083
MÉXICO,CD. NEZAHUALCOYOTL,25,395,4,424,1870
MÉXICO,CD. NEZAHUALCOYOTL,51,340,1,392,1869
MÉXICO,CD. NEZAHUALCOYOTL,14,218,2,234,991
MÉXICO,CD. NEZAHUALCOYOTL,16,173,3,192,990
MÉXICO,CD. NEZAHUALCOYOTL,24,379,2,405,1866
MÉXICO,CD. NEZAHUALCOYOTL,29,361,4,394,1865
MÉXICO,CD. NEZAHUALCOYOTL,62,355,8,425,1814
MÉXICO,CD. NEZAHUALCOYOTL,50,323,4,377,1814
MÉXICO,CD. NEZAHUALCOYOTL,41,294,3,338,1656
MÉXICO,CD. NEZAHUALCOYOTL,32,324,5,361,1656
MÉXICO,CD. NEZAHUALCOYOTL,24,257,2,283,1220
MÉXICO,CD. NEZAHUALCOYOTL,23,238,2,263,1220
MÉXICO,CD. NEZAHUALCOYOTL,27,328,4,359,1690
MÉXICO,CD. NEZAHUALCOYOTL,46,310,4,360,1690
MÉXICO,CD. NEZAHUALCOYOTL,43,329,5,377,1909
MÉXICO,CD. NEZAHUALCOYOTL,27,369,6,402,1909
MÉXICO,CD. NEZAHUALCOYOTL,34,315,3,352,1571
MÉXICO,CD. NEZAHUALCOYOTL,34,295,5,334,1571
MÉXICO,CD. NEZAHUALCOYOTL,43,267,2,312,1605
MÉXICO,CD. NEZAHUALCOYOTL,23,299,7,329,1605
MÉXICO,CD. NEZAHUALCOYOTL,35,356,2,393,1904
MÉXICO,CD. NEZAHUALCOYOTL,39,335,5,379,1903
MÉXICO,CD. NEZAHUALCOYOTL,42,392,4,438,1876
MÉXICO,CD. NEZAHUALCOYOTL,34,344,6,384,1876
MÉXICO,CD. NEZAHUALCOYOTL,50,346,7,403,1877
MÉXICO,CD. NEZAHUALCOYOTL,35,330,10,375,1876
MÉXICO,CD. NEZAHUALCOYOTL,46,342,4,392,1830
MÉXICO,CD. NEZAHUALCOYOTL,35,342,6,383,1829
MÉXICO,CD. NEZAHUALCOYOTL,34,363,5,402,1931
MÉXICO,CD. NEZAHUALCOYOTL,37,367,2,406,1930
MÉXICO,CD. NEZAHUALCOYOTL,25,306,5,336,1503
MÉXICO,CD. NEZAHUALCOYOTL,24,330,7,361,1503
MÉXICO,CD. NEZAHUALCOYOTL,28,299,2,329,1658
MÉXICO,CD. NEZAHUALCOYOTL,23,348,0,371,1658
MÉXICO,CD. NEZAHUALCOYOTL,19,192,1,212,1162
MÉXICO,CD. NEZAHUALCOYOTL,14,205,2,221,1162
MÉXICO,CD. NEZAHUALCOYOTL,16,248,2,266,1188
MÉXICO,CD. NEZAHUALCOYOTL,13,217,0,230,1187
MÉXICO,CD. NEZAHUALCOYOTL,23,215,4,242,1365
MÉXICO,CD. NEZAHUALCOYOTL,29,218,5,252,1365
MÉXICO,CD. NEZAHUALCOYOTL,36,293,0,329,1901
MÉXICO,CD. NEZAHUALCOYOTL,30,296,11,337,1900
MÉXICO,CD. NEZAHUALCOYOTL,26,201,7,234,1248
MÉXICO,CD. NEZAHUALCOYOTL,31,211,4,246,1247
MÉXICO,CD. NEZAHUALCOYOTL,20,221,5,246,1558
MÉXICO,CD. NEZAHUALCOYOTL,22,231,8,261,1558
MÉXICO,CD. NEZAHUALCOYOTL,23,304,3,330,1777
MÉXICO,CD. NEZAHUALCOYOTL,33,305,6,344,1776
MÉXICO,CD. NEZAHUALCOYOTL,26,267,1,294,1617
MÉXICO,CD. NEZAHUALCOYOTL,27,277,4,308,1616
MÉXICO,CD. NEZAHUALCOYOTL,39,321,8,368,1611
MÉXICO,CD. NEZAHUALCOYOTL,24,353,5,382,1611
MÉXICO,CD. NEZAHUALCOYOTL,24,300,4,328,1796
MÉXICO,CD. NEZAHUALCOYOTL,32,307,9,348,1796
MÉXICO,CD. NEZAHUALCOYOTL,37,360,3,400,1872
MÉXICO,CD. NEZAHUALCOYOTL,37,369,4,410,1871
MÉXICO,CD. NEZAHUALCOYOTL,36,346,7,389,1871
MÉXICO,CD. NEZAHUALCOYOTL,30,279,9,318,1418
MÉXICO,CD. NEZAHUALCOYOTL,35,300,4,339,1417
MÉXICO,CD. NEZAHUALCOYOTL,35,277,4,316,1417
MÉXICO,CD. NEZAHUALCOYOTL,38,285,7,330,1646
MÉXICO,CD. NEZAHUALCOYOTL,29,302,6,337,1645
MÉXICO,CD. NEZAHUALCOYOTL,34,312,6,352,1459
MÉXICO,CD. NEZAHUALCOYOTL,21,290,3,314,1459
MÉXICO,CD. NEZAHUALCOYOTL,26,279,5,310,1423
MÉXICO,CD. NEZAHUALCOYOTL,30,266,3,299,1423
MÉXICO,CD. NEZAHUALCOYOTL,29,271,1,301,1423
MÉXICO,CD. NEZAHUALCOYOTL,51,416,8,475,1963
MÉXICO,CD. NEZAHUALCOYOTL,52,365,5,422,1963
MÉXICO,CD. NEZAHUALCOYOTL,30,223,2,255,1212
MÉXICO,CD. NEZAHUALCOYOTL,43,223,0,266,1212
MÉXICO,CD. NEZAHUALCOYOTL,30,321,7,358,1830
MÉXICO,CD. NEZAHUALCOYOTL,34,354,3,391,1830
MÉXICO,CD. NEZAHUALCOYOTL,32,315,4,351,1828
MÉXICO,CD. NEZAHUALCOYOTL,39,290,7,336,1827
MÉXICO,CD. NEZAHUALCOYOTL,58,388,13,459,1949
MÉXICO,CD. NEZAHUALCOYOTL,44,400,7,451,1948
MÉXICO,CD. NEZAHUALCOYOTL,43,334,6,383,1851
MÉXICO,CD. NEZAHUALCOYOTL,31,316,1,348,1850
MÉXICO,CD. NEZAHUALCOYOTL,43,344,9,396,1791
MÉXICO,CD. NEZAHUALCOYOTL,39,307,7,353,1790
MÉXICO,CD. NEZAHUALCOYOTL,37,299,6,342,1654
MÉXICO,CD. NEZAHUALCOYOTL,30,345,5,380,1653
MÉXICO,CD. NEZAHUALCOYOTL,33,256,5,294,1355
MÉXICO,CD. NEZAHUALCOYOTL,27,263,6,296,1354
MÉXICO,CD. NEZAHUALCOYOTL,21,285,3,309,1491
MÉXICO,CD. NEZAHUALCOYOTL,29,286,4,319,1490
MÉXICO,CD. NEZAHUALCOYOTL,44,385,7,436,1945
MÉXICO,CD. NEZAHUALCOYOTL,36,333,5,374,1944
MÉXICO,CD. NEZAHUALCOYOTL,21,298,6,325,1470
MÉXICO,CD. NEZAHUALCOYOTL,21,255,3,279,1470
MÉXICO,VALLE DE CHALCO SOLIDARIDAD,60,447,9,516,1964
MÉXICO,VALLE DE CHALCO SOLIDARIDAD,22,280,2,304,1132
MÉXICO,VALLE DE CHALCO SOLIDARIDAD,21,292,2,315,1132
MÉXICO,VALLE DE CHALCO SOLIDARIDAD,28,323,2,353,1878
MÉXICO,VALLE DE CHALCO SOLIDARIDAD,23,191,11,225,1129
MÉXICO,VALLE DE CHALCO SOLIDARIDAD,19,260,4,283,1129
MÉXICO,VALLE DE CHALCO SOLIDARIDAD,30,228,7,265,1077
MÉXICO,VALLE DE CHALCO SOLIDARIDAD,13,231,8,252,1077
MÉXICO,VALLE DE CHALCO SOLIDARIDAD,28,335,1,364,1589
MÉXICO,VALLE DE CHALCO SOLIDARIDAD,33,355,10,398,1570
MÉXICO,VALLE DE CHALCO SOLIDARIDAD,46,318,11,375,1569
MÉXICO,VALLE DE CHALCO SOLIDARIDAD,54,362,12,428,1730
MÉXICO,VALLE DE CHALCO SOLIDARIDAD,27,212,6,245,992
MÉXICO,VALLE DE CHALCO SOLIDARIDAD,24,195,4,223,992
MÉXICO,VALLE DE CHALCO SOLIDARIDAD,30,288,5,323,1335
MÉXICO,VALLE DE CHALCO SOLIDARIDAD,15,252,3,270,1334
MÉXICO,VALLE DE CHALCO SOLIDARIDAD,23,261,5,289,1257
MÉXICO,VALLE DE CHALCO SOLIDARIDAD,24,253,4,281,1257
MÉXICO,VALLE DE CHALCO SOLIDARIDAD,41,374,2,417,1844
MÉXICO,VALLE DE CHALCO SOLIDARIDAD,36,387,4,427,1843
MÉXICO,VALLE DE CHALCO SOLIDARIDAD,26,405,4,435,1606
MÉXICO,VALLE DE CHALCO SOLIDARIDAD,29,373,10,412,1673
MÉXICO,VALLE DE CHALCO SOLIDARIDAD,38,352,5,395,1672
MÉXICO,VALLE DE CHALCO SOLIDARIDAD,47,393,9,449,1913
MÉXICO,VALLE DE CHALCO SOLIDARIDAD,32,297,7,336,1198
MÉXICO,VALLE DE CHALCO SOLIDARIDAD,18,296,5,319,1197
MÉXICO,VALLE DE CHALCO SOLIDARIDAD,2,386,9,397,1900
MÉXICO,VALLE DE CHALCO SOLIDARIDAD,29,387,6,422,1899
MÉXICO,VALLE DE CHALCO SOLIDARIDAD,33,280,4,317,1743
MÉXICO,VALLE DE CHALCO SOLIDARIDAD,29,300,5,334,1743
MÉXICO,VALLE DE CHALCO SOLIDARIDAD,28,249,4,281,1269
MÉXICO,VALLE DE CHALCO SOLIDARIDAD,31,236,6,273,1268
MÉXICO,VALLE DE CHALCO SOLIDARIDAD,39,289,7,335,1668
MÉXICO,VALLE DE CHALCO SOLIDARIDAD,42,324,10,376,1667
MÉXICO,VALLE DE CHALCO SOLIDARIDAD,45,392,6,443,1771
MÉXICO,VALLE DE CHALCO SOLIDARIDAD,49,375,3,427,1771
MÉXICO,VALLE DE CHALCO SOLIDARIDAD,32,207,5,244,1087
MÉXICO,VALLE DE CHALCO SOLIDARIDAD,19,182,9,210,1086
MÉXICO,VALLE DE CHALCO SOLIDARIDAD,24,204,4,232,1108
MÉXICO,VALLE DE CHALCO SOLIDARIDAD,18,218,4,240,1108
MÉXICO,VALLE DE CHALCO SOLIDARIDAD,28,274,4,306,1183
MÉXICO,VALLE DE CHALCO SOLIDARIDAD,30,273,9,312,1182
MÉXICO,VALLE DE CHALCO SOLIDARIDAD,24,388,8,420,1968
MÉXICO,VALLE DE CHALCO SOLIDARIDAD,39,371,9,419,1967
MÉXICO,VALLE DE CHALCO SOLIDARIDAD,25,383,9,417,1725
MÉXICO,VALLE DE CHALCO SOLIDARIDAD,22,344,9,375,1724
MÉXICO,VALLE DE CHALCO SOLIDARIDAD,31,386,5,422,1733
MÉXICO,VALLE DE CHALCO SOLIDARIDAD,34,383,7,424,1733
MÉXICO,VALLE DE CHALCO SOLIDARIDAD,33,280,4,317,1464
MÉXICO,VALLE DE CHALCO SOLIDARIDAD,28,256,2,286,1464
MÉXICO,VALLE DE CHALCO SOLIDARIDAD,17,220,4,241,1174
MÉXICO,VALLE DE CHALCO SOLIDARIDAD,18,232,5,255,1174
MÉXICO,VALLE DE CHALCO SOLIDARIDAD,31,405,7,443,1825
MÉXICO,VALLE DE CHALCO SOLIDARIDAD,23,279,4,306,1422
MÉXICO,VALLE DE CHALCO SOLIDARIDAD,22,268,5,295,1422
MÉXICO,VALLE DE CHALCO SOLIDARIDAD,34,272,6,312,1250
MÉXICO,VALLE DE CHALCO SOLIDARIDAD,23,268,4,295,1249
MÉXICO,VALLE DE CHALCO SOLIDARIDAD,39,436,2,477,1967
MÉXICO,VALLE DE CHALCO SOLIDARIDAD,29,312,7,348,1862
MÉXICO,VALLE DE CHALCO SOLIDARIDAD,32,308,4,344,1861
MÉXICO,VALLE DE CHALCO SOLIDARIDAD,28,369,4,401,1811
MÉXICO,VALLE DE CHALCO SOLIDARIDAD,31,328,8,367,1811
MÉXICO,VALLE DE CHALCO SOLIDARIDAD,19,287,5,311,1132
MÉXICO,VALLE DE CHALCO SOLIDARIDAD,16,292,3,311,1131
MÉXICO,VALLE DE CHALCO SOLIDARIDAD,11,236,4,251,1049
MÉXICO,VALLE DE CHALCO SOLIDARIDAD,13,204,6,223,1049
MÉXICO,VALLE DE CHALCO SOLIDARIDAD,17,270,2,289,1217
MÉXICO,VALLE DE CHALCO SOLIDARIDAD,14,240,6,260,1217
MÉXICO,VALLE DE CHALCO SOLIDARIDAD,24,253,6,283,1415
MÉXICO,VALLE DE CHALCO SOLIDARIDAD,21,283,3,307,1415
MÉXICO,VALLE DE CHALCO SOLIDARIDAD,23,209,6,238,1225
MÉXICO,VALLE DE CHALCO SOLIDARIDAD,26,230,6,262,1224
MÉXICO,VALLE DE CHALCO SOLIDARIDAD,28,227,9,264,1276
MÉXICO,VALLE DE CHALCO SOLIDARIDAD,19,227,5,251,1275
MÉXICO,VALLE DE CHALCO SOLIDARIDAD,54,405,10,469,1932
MÉXICO,VALLE DE CHALCO SOLIDARIDAD,32,379,5,416,1931
MÉXICO,VALLE DE CHALCO SOLIDARIDAD,21,227,5,253,1133
MÉXICO,VALLE DE CHALCO SOLIDARIDAD,36,238,3,277,1133
MÉXICO,VALLE DE CHALCO SOLIDARIDAD,36,302,7,345,1348
MÉXICO,VALLE DE CHALCO SOLIDARIDAD,24,299,12,335,1348
MÉXICO,VALLE DE CHALCO SOLIDARIDAD,22,219,2,243,1023
MÉXICO,VALLE DE CHALCO SOLIDARIDAD,35,173,6,214,1023
MÉXICO,VALLE DE CHALCO SOLIDARIDAD,43,352,14,409,1798
MÉXICO,VALLE DE CHALCO SOLIDARIDAD,33,384,11,428,1798
MÉXICO,VALLE DE CHALCO SOLIDARIDAD,36,367,11,414,1700
MÉXICO,VALLE DE CHALCO SOLIDARIDAD,42,371,3,416,1700
MÉXICO,VALLE DE CHALCO SOLIDARIDAD,18,253,9,280,1182
MÉXICO,VALLE DE CHALCO SOLIDARIDAD,33,247,5,285,1181
MÉXICO,VALLE DE CHALCO SOLIDARIDAD,32,299,5,336,1608
MÉXICO,VALLE DE CHALCO SOLIDARIDAD,22,287,11,320,1608
MÉXICO,VALLE DE CHALCO SOLIDARIDAD,39,322,8,369,1608
MÉXICO,VALLE DE CHALCO SOLIDARIDAD,29,289,3,321,1608
MÉXICO,VALLE DE CHALCO SOLIDARIDAD,18,290,3,311,1608
MÉXICO,VALLE DE CHALCO SOLIDARIDAD,19,198,3,220,1048
MÉXICO,VALLE DE CHALCO SOLIDARIDAD,27,180,4,211,1047
MÉXICO,VALLE DE CHALCO SOLIDARIDAD,26,348,1,375,1457
MÉXICO,VALLE DE CHALCO SOLIDARIDAD,29,329,12,370,1457
MÉXICO,VALLE DE CHALCO SOLIDARIDAD,43,749,5,797,0
MÉXICO,VALLE DE CHALCO SOLIDARIDAD,47,263,8,318,1475
MÉXICO,VALLE DE CHALCO SOLIDARIDAD,28,308,11,347,1475
MÉXICO,VALLE DE CHALCO SOLIDARIDAD,37,461,8,506,1937
MÉXICO,VALLE DE CHALCO SOLIDARIDAD,46,425,11,482,1937
MÉXICO,VALLE DE CHALCO SOLIDARIDAD,22,220,6,248,1050
MÉXICO,VALLE DE CHALCO SOLIDARIDAD,23,229,2,254,1049
MÉXICO,VALLE DE CHALCO SOLIDARIDAD,16,266,2,284,1087
MÉXICO,VALLE DE CHALCO SOLIDARIDAD,27,214,4,245,1086
MÉXICO,VALLE DE CHALCO SOLIDARIDAD,37,246,3,286,1275
MÉXICO,VALLE DE CHALCO SOLIDARIDAD,21,274,3,298,1275
MÉXICO,VALLE DE CHALCO SOLIDARIDAD,24,262,7,293,1171
MÉXICO,VALLE DE CHALCO SOLIDARIDAD,27,278,8,313,1171
MÉXICO,VALLE DE CHALCO SOLIDARIDAD,28,251,10,289,1197
MÉXICO,VALLE DE CHALCO SOLIDARIDAD,28,269,10,307,1197
MÉXICO,VALLE DE CHALCO SOLIDARIDAD,26,328,10,364,1565
MÉXICO,VALLE DE CHALCO SOLIDARIDAD,37,351,2,390,1564
MÉXICO,VALLE DE CHALCO SOLIDARIDAD,31,465,13,509,1869
MÉXICO,VALLE DE CHALCO SOLIDARIDAD,39,292,4,335,1481
MÉXICO,VALLE DE CHALCO SOLIDARIDAD,36,296,6,338,1481
MÉXICO,VALLE DE CHALCO SOLIDARIDAD,37,267,6,310,1346
MÉXICO,VALLE DE CHALCO SOLIDARIDAD,34,284,10,328,1346
MÉXICO,VALLE DE CHALCO SOLIDARIDAD,20,278,3,301,1323
MÉXICO,VALLE DE CHALCO SOLIDARIDAD,28,261,3,292,1323
MÉXICO,VALLE DE CHALCO SOLIDARIDAD,26,240,8,274,1333
MÉXICO,VALLE DE CHALCO SOLIDARIDAD,32,233,9,274,1332
MÉXICO,VALLE DE CHALCO SOLIDARIDAD,37,270,7,314,1357
MÉXICO,VALLE DE CHALCO SOLIDARIDAD,29,248,10,287,1357
MÉXICO,VALLE DE CHALCO SOLIDARIDAD,44,310,2,356,1865
MÉXICO,VALLE DE CHALCO SOLIDARIDAD,48,343,13,404,1865
MÉXICO,VALLE DE CHALCO SOLIDARIDAD,30,239,7,276,1067
MÉXICO,VALLE DE CHALCO SOLIDARIDAD,34,206,6,246,1067
MÉXICO,VALLE DE CHALCO SOLIDARIDAD,15,247,6,268,1147
MÉXICO,VALLE DE CHALCO SOLIDARIDAD,27,233,9,269,1146
MÉXICO,VALLE DE CHALCO SOLIDARIDAD,42,335,11,388,1625
MÉXICO,VALLE DE CHALCO SOLIDARIDAD,24,297,6,327,1625
MÉXICO,VALLE DE CHALCO SOLIDARIDAD,21,388,10,419,1887
MÉXICO,VALLE DE CHALCO SOLIDARIDAD,24,262,9,295,1478
MÉXICO,VALLE DE CHALCO SOLIDARIDAD,29,261,4,294,1478
MÉXICO,VALLE DE CHALCO SOLIDARIDAD,23,255,10,288,1327
MÉXICO,VALLE DE CHALCO SOLIDARIDAD,29,300,6,335,1327
MÉXICO,VALLE DE CHALCO SOLIDARIDAD,19,297,5,321,1299
MÉXICO,VALLE DE CHALCO SOLIDARIDAD,18,293,2,313,1298
MÉXICO,VALLE DE CHALCO SOLIDARIDAD,29,272,8,309,1208
MÉXICO,VALLE DE CHALCO SOLIDARIDAD,29,280,11,320,1208
MÉXICO,VALLE DE CHALCO SOLIDARIDAD,22,266,5,293,1173
MÉXICO,VALLE DE CHALCO SOLIDARIDAD,20,255,7,282,1173
MÉXICO,VALLE DE CHALCO SOLIDARIDAD,23,213,4,240,1105
MÉXICO,VALLE DE CHALCO SOLIDARIDAD,48,217,6,271,1105
MÉXICO,VALLE DE CHALCO SOLIDARIDAD,44,223,7,274,1062
MÉXICO,VALLE DE CHALCO SOLIDARIDAD,39,226,4,269,1062
MÉXICO,VALLE DE CHALCO SOLIDARIDAD,30,226,5,261,1121
MÉXICO,VALLE DE CHALCO SOLIDARIDAD,28,217,5,250,1121
MÉXICO,VALLE DE CHALCO SOLIDARIDAD,29,226,7,262,1066
MÉXICO,VALLE DE CHALCO SOLIDARIDAD,30,220,3,253,1066
MÉXICO,VALLE DE CHALCO SOLIDARIDAD,28,292,7,327,1424
MÉXICO,VALLE DE CHALCO SOLIDARIDAD,29,278,4,311,1423
MÉXICO,VALLE DE CHALCO SOLIDARIDAD,35,317,0,352,1371
MÉXICO,VALLE DE CHALCO SOLIDARIDAD,44,290,2,336,1371
MÉXICO,VALLE DE CHALCO SOLIDARIDAD,29,295,3,327,1361
MÉXICO,VALLE DE CHALCO SOLIDARIDAD,21,282,6,309,1360
MÉXICO,VALLE DE CHALCO SOLIDARIDAD,19,246,6,271,1186
MÉXICO,VALLE DE CHALCO SOLIDARIDAD,32,257,7,296,1186
MÉXICO,VALLE DE CHALCO SOLIDARIDAD,14,208,4,226,1040
MÉXICO,VALLE DE CHALCO SOLIDARIDAD,15,197,3,215,1039
MÉXICO,VALLE DE CHALCO SOLIDARIDAD,34,300,8,342,1521
MÉXICO,VALLE DE CHALCO SOLIDARIDAD,29,275,3,307,1520
MÉXICO,VALLE DE CHALCO SOLIDARIDAD,34,320,8,362,1941
MÉXICO,VALLE DE CHALCO SOLIDARIDAD,38,277,6,321,1941
MÉXICO,VALLE DE CHALCO SOLIDARIDAD,42,301,0,343,1940
MÉXICO,VALLE DE CHALCO SOLIDARIDAD,32,290,4,326,1940
MÉXICO,VALLE DE CHALCO SOLIDARIDAD,36,337,5,378,1732
MÉXICO,VALLE DE CHALCO SOLIDARIDAD,41,327,3,371,1731
MÉXICO,VALLE DE CHALCO SOLIDARIDAD,31,286,2,319,1731
MÉXICO,VALLE DE CHALCO SOLIDARIDAD,46,422,10,478,1928
MÉXICO,VALLE DE CHALCO SOLIDARIDAD,29,269,2,300,1268
MÉXICO,VALLE DE CHALCO SOLIDARIDAD,30,251,4,285,1267
MÉXICO,VALLE DE CHALCO SOLIDARIDAD,24,211,2,237,1010
MÉXICO,VALLE DE CHALCO SOLIDARIDAD,16,236,4,256,1009
MÉXICO,VALLE DE CHALCO SOLIDARIDAD,23,343,4,370,1670
MÉXICO,VALLE DE CHALCO SOLIDARIDAD,34,343,8,385,1670
MÉXICO,VALLE DE CHALCO SOLIDARIDAD,22,377,7,406,1974
MÉXICO,VALLE DE CHALCO SOLIDARIDAD,29,332,5,366,1973
MÉXICO,VALLE DE CHALCO SOLIDARIDAD,20,227,3,250,1396
MÉXICO,VALLE DE CHALCO SOLIDARIDAD,28,250,7,285,1396
MÉXICO,VALLE DE CHALCO SOLIDARIDAD,22,397,6,425,1945
MÉXICO,VALLE DE CHALCO SOLIDARIDAD,33,431,11,475,1925
MÉXICO,VALLE DE CHALCO SOLIDARIDAD,36,442,5,483,1925
MÉXICO,VALLE DE CHALCO SOLIDARIDAD,16,223,8,247,1544
MÉXICO,VALLE DE CHALCO SOLIDARIDAD,9,201,5,215,1544
MÉXICO,VALLE DE CHALCO SOLIDARIDAD,15,197,5,217,1544
MÉXICO,CHALCO DE DIAZ COVARRUBIAS,13,247,1,261,1004
MÉXICO,CHALCO DE DIAZ COVARRUBIAS,11,204,1,216,1003
MÉXICO,CHALCO DE DIAZ COVARRUBIAS,26,339,2,367,1452
MÉXICO,CHALCO DE DIAZ COVARRUBIAS,25,339,2,366,1452
MÉXICO,CHALCO DE DIAZ COVARRUBIAS,28,362,4,394,1452
MÉXICO,CHALCO DE DIAZ COVARRUBIAS,27,415,3,445,1857
MÉXICO,CHALCO DE DIAZ COVARRUBIAS,30,358,4,392,1856
MÉXICO,CHALCO DE DIAZ COVARRUBIAS,28,408,4,440,1925
MÉXICO,CHALCO DE DIAZ COVARRUBIAS,20,229,9,258,1702
MÉXICO,CHALCO DE DIAZ COVARRUBIAS,16,219,3,238,1701
MÉXICO,CHALCO DE DIAZ COVARRUBIAS,24,249,3,276,1701
MÉXICO,CHALCO DE DIAZ COVARRUBIAS,17,244,2,263,1701
MÉXICO,CHALCO DE DIAZ COVARRUBIAS,19,247,0,266,1701
MÉXICO,CHALCO DE DIAZ COVARRUBIAS,26,265,7,298,1501
MÉXICO,CHALCO DE DIAZ COVARRUBIAS,27,263,2,292,1501
MÉXICO,CHALCO DE DIAZ COVARRUBIAS,14,204,2,220,1081
MÉXICO,CHALCO DE DIAZ COVARRUBIAS,26,201,6,233,1080
MÉXICO,CHALCO DE DIAZ COVARRUBIAS,29,349,5,383,2001
MÉXICO,CHALCO DE DIAZ COVARRUBIAS,26,227,2,255,1489
MÉXICO,CHALCO DE DIAZ COVARRUBIAS,19,222,5,246,1488
MÉXICO,CHALCO DE DIAZ COVARRUBIAS,28,272,3,303,1815
MÉXICO,CHALCO DE DIAZ COVARRUBIAS,22,230,1,253,1815
MÉXICO,CHALCO DE DIAZ COVARRUBIAS,25,282,9,316,1815
MÉXICO,CHALCO DE DIAZ COVARRUBIAS,46,280,5,331,1814
MÉXICO,CHALCO DE DIAZ COVARRUBIAS,18,206,6,230,1154
MÉXICO,CHALCO DE DIAZ COVARRUBIAS,21,166,4,191,1153
MÉXICO,CHALCO DE DIAZ COVARRUBIAS,27,317,5,349,1967
MÉXICO,CHALCO DE DIAZ COVARRUBIAS,31,302,3,336,1967
MÉXICO,CHALCO DE DIAZ COVARRUBIAS,32,336,2,370,1966
MÉXICO,CHALCO DE DIAZ COVARRUBIAS,23,328,2,353,1862
MÉXICO,CHALCO DE DIAZ COVARRUBIAS,33,381,6,420,1861
MÉXICO,CHALCO DE DIAZ COVARRUBIAS,34,357,6,397,1861
MÉXICO,CHALCO DE DIAZ COVARRUBIAS,24,203,8,235,1043
MÉXICO,CHALCO DE DIAZ COVARRUBIAS,155,15,5,175,1043
MÉXICO,CHALCO DE DIAZ COVARRUBIAS,34,292,1,327,1642
MÉXICO,CHALCO DE DIAZ COVARRUBIAS,22,257,5,284,1641
MÉXICO,CHALCO DE DIAZ COVARRUBIAS,27,327,6,360,1746
MÉXICO,CHALCO DE DIAZ COVARRUBIAS,24,278,2,304,1746
MÉXICO,CHALCO DE DIAZ COVARRUBIAS,27,256,4,287,1746
MÉXICO,CHALCO DE DIAZ COVARRUBIAS,34,285,3,322,1746
MÉXICO,CHALCO DE DIAZ COVARRUBIAS,27,274,12,313,1745
MÉXICO,CHALCO DE DIAZ COVARRUBIAS,32,276,7,315,1597
MÉXICO,CHALCO DE DIAZ COVARRUBIAS,31,308,7,346,1596
MÉXICO,CHALCO DE DIAZ COVARRUBIAS,22,301,10,333,1596
MÉXICO,CHALCO DE DIAZ COVARRUBIAS,21,270,4,295,1596
MÉXICO,CHALCO DE DIAZ COVARRUBIAS,22,288,4,314,1596
MÉXICO,CHALCO DE DIAZ COVARRUBIAS,22,195,3,220,1089
MÉXICO,CHALCO DE DIAZ COVARRUBIAS,21,192,5,218,1089
MÉXICO,CHALCO DE DIAZ COVARRUBIAS,12,196,1,209,1202
MÉXICO,CHALCO DE DIAZ COVARRUBIAS,17,203,5,225,1201
MÉXICO,CHALCO DE DIAZ COVARRUBIAS,20,231,5,256,1561
MÉXICO,CHALCO DE DIAZ COVARRUBIAS,23,284,1,308,1560
MÉXICO,CHALCO DE DIAZ COVARRUBIAS,31,247,5,283,1793
MÉXICO,CHALCO DE DIAZ COVARRUBIAS,22,278,3,303,1793
MÉXICO,CHALCO DE DIAZ COVARRUBIAS,27,263,0,290,1644
MÉXICO,CHALCO DE DIAZ COVARRUBIAS,24,250,5,279,1643
MÉXICO,CHALCO DE DIAZ COVARRUBIAS,27,305,6,338,1643
MÉXICO,CHALCO DE DIAZ COVARRUBIAS,21,233,1,255,1520
MÉXICO,CHALCO DE DIAZ COVARRUBIAS,20,205,1,226,1520
MÉXICO,CHALCO DE DIAZ COVARRUBIAS,19,214,3,236,1520
MÉXICO,CHALCO DE DIAZ COVARRUBIAS,108,1130,14,1252,0
MÉXICO,CHALCO DE DIAZ COVARRUBIAS,21,162,1,184,1263
MÉXICO,CHALCO DE DIAZ COVARRUBIAS,21,187,0,208,1263
MÉXICO,CHALCO DE DIAZ COVARRUBIAS,25,193,7,225,1355
MÉXICO,CHALCO DE DIAZ COVARRUBIAS,19,229,4,252,1354
MÉXICO,CHALCO DE DIAZ COVARRUBIAS,23,184,6,213,1354
MÉXICO,CHALCO DE DIAZ COVARRUBIAS,26,243,4,273,1476
MÉXICO,CHALCO DE DIAZ COVARRUBIAS,36,236,2,274,1475
MÉXICO,CHALCO DE DIAZ COVARRUBIAS,28,232,6,266,1475
MÉXICO,CHALCO DE DIAZ COVARRUBIAS,24,215,3,242,1112
MÉXICO,CHALCO DE DIAZ COVARRUBIAS,25,177,2,204,1111
MÉXICO,CHALCO DE DIAZ COVARRUBIAS,33,260,6,299,1821
MÉXICO,CHALCO DE DIAZ COVARRUBIAS,18,271,5,294,1820
MÉXICO,CHALCO DE DIAZ COVARRUBIAS,29,221,3,253,1811
MÉXICO,CHALCO DE DIAZ COVARRUBIAS,17,203,5,225,1810
MÉXICO,CHALCO DE DIAZ COVARRUBIAS,25,221,2,248,1810
MÉXICO,CHALCO DE DIAZ COVARRUBIAS,31,216,0,247,1810
MÉXICO,CHALCO DE DIAZ COVARRUBIAS,27,287,4,318,1815
MÉXICO,CHALCO DE DIAZ COVARRUBIAS,26,271,0,297,1815
MÉXICO,CHALCO DE DIAZ COVARRUBIAS,31,294,1,326,1815
MÉXICO,CHALCO DE DIAZ COVARRUBIAS,30,237,4,271,1984
MÉXICO,CHALCO DE DIAZ COVARRUBIAS,38,244,5,287,1984
MÉXICO,CHALCO DE DIAZ COVARRUBIAS,27,230,3,260,1984
MÉXICO,CHALCO DE DIAZ COVARRUBIAS,22,220,2,244,1984
MÉXICO,CHALCO DE DIAZ COVARRUBIAS,24,227,2,253,1983
MÉXICO,CHALCO DE DIAZ COVARRUBIAS,27,257,2,286,1983
MÉXICO,CHALCO DE DIAZ COVARRUBIAS,27,226,3,256,1983
MÉXICO,CHALCO DE DIAZ COVARRUBIAS,44,267,6,317,1962
MÉXICO,CHALCO DE DIAZ COVARRUBIAS,45,257,9,311,1962
MÉXICO,CHALCO DE DIAZ COVARRUBIAS,32,287,3,322,1962
MÉXICO,CHALCO DE DIAZ COVARRUBIAS,19,207,4,230,1368
MÉXICO,CHALCO DE DIAZ COVARRUBIAS,21,217,3,241,1367
MÉXICO,CHALCO DE DIAZ COVARRUBIAS,16,191,1,208,1367
MÉXICO,CHALCO DE DIAZ COVARRUBIAS,40,272,8,320,1729
MÉXICO,CHALCO DE DIAZ COVARRUBIAS,33,327,5,365,1729
MÉXICO,CHALCO DE DIAZ COVARRUBIAS,24,178,2,204,1538
MÉXICO,CHALCO DE DIAZ COVARRUBIAS,22,177,1,200,1538
MÉXICO,CHALCO DE DIAZ COVARRUBIAS,13,180,5,198,1538
MÉXICO,CHALCO DE DIAZ COVARRUBIAS,26,191,4,221,1854
MÉXICO,CHALCO DE DIAZ COVARRUBIAS,30,182,12,224,1853
MÉXICO,CHALCO DE DIAZ COVARRUBIAS,18,164,2,184,1899
MÉXICO,CHALCO DE DIAZ COVARRUBIAS,18,146,5,169,1899
MÉXICO,CHALCO DE DIAZ COVARRUBIAS,16,155,4,175,1899
MÉXICO,CHALCO DE DIAZ COVARRUBIAS,27,152,6,185,1899
MÉXICO,CHALCO DE DIAZ COVARRUBIAS,13,156,1,170,1899
MÉXICO,CHALCO DE DIAZ COVARRUBIAS,15,143,4,162,1899
MÉXICO,CHALCO DE DIAZ COVARRUBIAS,15,168,3,186,1898
MÉXICO,CHALCO DE DIAZ COVARRUBIAS,13,146,3,162,1898
MÉXICO,CHALCO DE DIAZ COVARRUBIAS,15,228,4,247,1253
MÉXICO,CHALCO DE DIAZ COVARRUBIAS,19,237,2,258,1252
MÉXICO,CHALCO DE DIAZ COVARRUBIAS,25,177,0,202,1937
MÉXICO,CHALCO DE DIAZ COVARRUBIAS,20,181,4,205,1937
MÉXICO,CHALCO DE DIAZ COVARRUBIAS,22,149,0,171,1937
MÉXICO,CHALCO DE DIAZ COVARRUBIAS,18,129,0,147,1937
MÉXICO,CHALCO DE DIAZ COVARRUBIAS,16,156,2,174,1936
MÉXICO,CHALCO DE DIAZ COVARRUBIAS,18,156,2,176,1936
MÉXICO,CHALCO DE DIAZ COVARRUBIAS,16,165,1,182,1936
MÉXICO,CHALCO DE DIAZ COVARRUBIAS,26,161,1,188,1936
MÉXICO,CHALCO DE DIAZ COVARRUBIAS,29,165,1,195,1936
MÉXICO,CHALCO DE DIAZ COVARRUBIAS,35,204,3,242,1652
MÉXICO,CHALCO DE DIAZ COVARRUBIAS,13,230,1,244,1652
MÉXICO,CHALCO DE DIAZ COVARRUBIAS,19,216,0,235,1652
MÉXICO,CHALCO DE DIAZ COVARRUBIAS,17,246,2,265,1652
MÉXICO,CHALCO DE DIAZ COVARRUBIAS,27,251,11,289,1919
MÉXICO,CHALCO DE DIAZ COVARRUBIAS,12,129,6,147,1285
MÉXICO,CHALCO DE DIAZ COVARRUBIAS,20,111,0,131,1285
MÉXICO,CHALCO DE DIAZ COVARRUBIAS,27,200,2,229,1791
MÉXICO,CHALCO DE DIAZ COVARRUBIAS,27,201,7,235,1790
MÉXICO,CHALCO DE DIAZ COVARRUBIAS,21,180,5,206,1479
MÉXICO,CHALCO DE DIAZ COVARRUBIAS,23,189,5,217,1479
MÉXICO,CHALCO DE DIAZ COVARRUBIAS,23,278,2,303,1389
MÉXICO,CHALCO DE DIAZ COVARRUBIAS,21,260,4,285,1388
MÉXICO,CHALCO DE DIAZ COVARRUBIAS,24,211,9,244,1390
MÉXICO,CHALCO DE DIAZ COVARRUBIAS,13,234,4,251,1390
MÉXICO,CHALCO DE DIAZ COVARRUBIAS,15,247,3,265,1550
MÉXICO,CHALCO DE DIAZ COVARRUBIAS,18,229,4,251,1550
MÉXICO,CHALCO DE DIAZ COVARRUBIAS,23,244,4,271,1923
MÉXICO,CHALCO DE DIAZ COVARRUBIAS,22,235,2,259,1923
MÉXICO,CHALCO DE DIAZ COVARRUBIAS,27,257,8,292,1922
MÉXICO,CHALCO DE DIAZ COVARRUBIAS,20,287,3,310,1922
MÉXICO,CHALCO DE DIAZ COVARRUBIAS,32,249,5,286,1653
MÉXICO,CHALCO DE DIAZ COVARRUBIAS,23,227,5,255,1653
MÉXICO,CHALCO DE DIAZ COVARRUBIAS,11,201,3,215,1304
MÉXICO,CHALCO DE DIAZ COVARRUBIAS,12,170,1,183,1303
MÉXICO,CHALCO DE DIAZ COVARRUBIAS,11,181,1,193,1090
MÉXICO,CHALCO DE DIAZ COVARRUBIAS,5,202,4,211,1090
MÉXICO,CHALCO DE DIAZ COVARRUBIAS,16,181,2,199,1132
MÉXICO,CHALCO DE DIAZ COVARRUBIAS,14,206,1,221,1132
MÉXICO,CHALCO DE DIAZ COVARRUBIAS,29,266,8,303,1647
MÉXICO,CHALCO DE DIAZ COVARRUBIAS,17,279,8,304,1647
MÉXICO,CHALCO DE DIAZ COVARRUBIAS,28,264,10,302,1932
MÉXICO,CHALCO DE DIAZ COVARRUBIAS,38,280,6,324,1932
MÉXICO,CHALCO DE DIAZ COVARRUBIAS,37,242,5,284,1931
MÉXICO,CHALCO DE DIAZ COVARRUBIAS,19,235,5,259,1401
MÉXICO,CHALCO DE DIAZ COVARRUBIAS,29,229,6,264,1400
MÉXICO,CHALCO DE DIAZ COVARRUBIAS,16,224,2,242,1400
MÉXICO,CHALCO DE DIAZ COVARRUBIAS,24,270,2,296,1490
MÉXICO,CHALCO DE DIAZ COVARRUBIAS,21,254,5,280,1490
MÉXICO,CHALCO DE DIAZ COVARRUBIAS,26,273,2,301,1489
MÉXICO,CHALCO DE DIAZ COVARRUBIAS,26,216,4,246,1530
MÉXICO,CHALCO DE DIAZ COVARRUBIAS,30,262,10,302,1529
MÉXICO,CHALCO DE DIAZ COVARRUBIAS,32,274,5,311,1529
MÉXICO,CHALCO DE DIAZ COVARRUBIAS,10,154,5,169,1056
MÉXICO,CHALCO DE DIAZ COVARRUBIAS,13,147,4,164,1055
MÉXICO,CHALCO DE DIAZ COVARRUBIAS,16,179,2,197,1207
MÉXICO,CHALCO DE DIAZ COVARRUBIAS,12,158,3,173,1206
MÉXICO,CHALCO DE DIAZ COVARRUBIAS,23,228,5,256,1410
MÉXICO,CHALCO DE DIAZ COVARRUBIAS,18,244,3,265,1410
MÉXICO,CHALCO DE DIAZ COVARRUBIAS,33,238,4,275,1410
MÉXICO,CHALCO DE DIAZ COVARRUBIAS,41,326,13,380,1943
MÉXICO,CHALCO DE DIAZ COVARRUBIAS,49,335,5,389,1943
MÉXICO,CHALCO DE DIAZ COVARRUBIAS,26,229,3,258,1525
MÉXICO,CHALCO DE DIAZ COVARRUBIAS,20,196,3,219,1525
MÉXICO,CHALCO DE DIAZ COVARRUBIAS,30,239,2,271,1920
MÉXICO,CHALCO DE DIAZ COVARRUBIAS,19,258,3,280,1919
MÉXICO,CHALCO DE DIAZ COVARRUBIAS,26,284,4,314,1919
MÉXICO,CHALCO DE DIAZ COVARRUBIAS,14,185,2,201,1061
MÉXICO,CHALCO DE DIAZ COVARRUBIAS,202,8,1,211,1060
MÉXICO,TOLUCA DE LERDO,38,182,1,221,1950
MÉXICO,TOLUCA DE LERDO,39,198,11,248,1950
MÉXICO,TOLUCA DE LERDO,48,198,3,249,2053
MÉXICO,TOLUCA DE LERDO,32,156,4,192,1733
MÉXICO,TOLUCA DE LERDO,41,174,1,216,1732
MÉXICO,TOLUCA DE LERDO,57,228,4,289,1980
MÉXICO,TOLUCA DE LERDO,55,202,2,259,1980
MÉXICO,TOLUCA DE LERDO,61,189,3,253,1980
MÉXICO,TOLUCA DE LERDO,40,117,1,158,1345
MÉXICO,TOLUCA DE LERDO,32,84,1,117,1344
MÉXICO,TOLUCA DE LERDO,26,106,7,139,1344
MÉXICO,TOLUCA DE LERDO,30,79,2,111,1015
MÉXICO,TOLUCA DE LERDO,35,85,3,123,1014
MÉXICO,TOLUCA DE LERDO,58,155,1,214,1674
MÉXICO,TOLUCA DE LERDO,25,128,0,153,1674
MÉXICO,TOLUCA DE LERDO,38,206,2,246,1874
MÉXICO,TOLUCA DE LERDO,29,169,1,199,1873
MÉXICO,TOLUCA DE LERDO,52,204,5,261,1952
MÉXICO,TOLUCA DE LERDO,59,208,1,268,1952
MÉXICO,TOLUCA DE LERDO,39,169,4,212,1791
MÉXICO,TOLUCA DE LERDO,42,181,1,224,1790
MÉXICO,TOLUCA DE LERDO,24,107,0,131,1449
MÉXICO,TOLUCA DE LERDO,37,129,2,168,1448
MÉXICO,TOLUCA DE LERDO,37,96,0,133,1448
MÉXICO,TOLUCA DE LERDO,52,153,1,206,1777
MÉXICO,TOLUCA DE LERDO,51,164,2,217,1777
MÉXICO,TOLUCA DE LERDO,38,163,1,202,1303
MÉXICO,TOLUCA DE LERDO,44,144,0,188,1302
MÉXICO,TOLUCA DE LERDO,29,122,0,151,1141
MÉXICO,TOLUCA DE LERDO,30,140,0,170,1140
MÉXICO,TOLUCA DE LERDO,30,119,0,149,1244
MÉXICO,TOLUCA DE LERDO,32,103,0,135,1243
MÉXICO,TOLUCA DE LERDO,36,142,5,183,1467
MÉXICO,TOLUCA DE LERDO,24,165,2,191,1467
MÉXICO,TOLUCA DE LERDO,19,163,1,183,1467
MÉXICO,TOLUCA DE LERDO,51,185,5,241,1802
MÉXICO,TOLUCA DE LERDO,47,184,11,242,1802
MÉXICO,TOLUCA DE LERDO,71,159,2,232,1583
MÉXICO,TOLUCA DE LERDO,44,183,1,228,1582
MÉXICO,TOLUCA DE LERDO,28,155,0,183,1535
MÉXICO,TOLUCA DE LERDO,20,138,1,159,1535
MÉXICO,TOLUCA DE LERDO,20,131,0,151,1534
MÉXICO,TOLUCA DE LERDO,19,145,1,165,1292
MÉXICO,TOLUCA DE LERDO,39,132,2,173,1292
MÉXICO,TOLUCA DE LERDO,38,168,4,210,1776
MÉXICO,TOLUCA DE LERDO,29,229,8,266,1775
MÉXICO,TOLUCA DE LERDO,35,172,3,210,1721
MÉXICO,TOLUCA DE LERDO,24,190,2,216,1720
MÉXICO,TOLUCA DE LERDO,28,197,0,225,1438
MÉXICO,TOLUCA DE LERDO,31,162,3,196,1437
MÉXICO,TOLUCA DE LERDO,27,152,2,181,1338
MÉXICO,TOLUCA DE LERDO,20,173,5,198,1337
MÉXICO,TOLUCA DE LERDO,21,149,1,171,1337
MÉXICO,TOLUCA DE LERDO,47,242,4,293,1797
MÉXICO,TOLUCA DE LERDO,48,227,6,281,1797
MÉXICO,TOLUCA DE LERDO,32,190,2,224,1219
MÉXICO,TOLUCA DE LERDO,52,202,3,257,1218
MÉXICO,TOLUCA DE LERDO,52,194,2,248,1635
MÉXICO,TOLUCA DE LERDO,35,177,2,214,1635
MÉXICO,TOLUCA DE LERDO,39,179,2,220,1634
MÉXICO,TOLUCA DE LERDO,32,190,1,223,1634
MÉXICO,TOLUCA DE LERDO,33,164,1,198,1792
MÉXICO,TOLUCA DE LERDO,48,147,1,196,1792
MÉXICO,TOLUCA DE LERDO,24,224,4,252,1442
MÉXICO,TOLUCA DE LERDO,42,229,2,273,1441
MÉXICO,TOLUCA DE LERDO,28,233,4,265,1441
MÉXICO,TOLUCA DE LERDO,24,214,1,239,1599
MÉXICO,TOLUCA DE LERDO,26,238,1,265,1598
MÉXICO,TOLUCA DE LERDO,34,177,2,213,1415
MÉXICO,TOLUCA DE LERDO,18,189,4,211,1414
MÉXICO,TOLUCA DE LERDO,38,189,2,229,1414
MÉXICO,TOLUCA DE LERDO,45,227,2,274,1667
MÉXICO,TOLUCA DE LERDO,49,227,8,284,1667
MÉXICO,TOLUCA DE LERDO,37,199,3,239,1398
MÉXICO,TOLUCA DE LERDO,28,192,2,222,1397
MÉXICO,TOLUCA DE LERDO,23,208,1,232,1397
MÉXICO,TOLUCA DE LERDO,29,198,6,233,1773
MÉXICO,TOLUCA DE LERDO,27,180,1,208,1773
MÉXICO,TOLUCA DE LERDO,27,154,0,181,1773
MÉXICO,TOLUCA DE LERDO,32,181,6,219,1713
MÉXICO,TOLUCA DE LERDO,41,191,4,236,1712
MÉXICO,TOLUCA DE LERDO,28,196,2,226,1712
MÉXICO,TOLUCA DE LERDO,31,204,3,238,1712
MÉXICO,TOLUCA DE LERDO,18,122,2,142,1484
MÉXICO,TOLUCA DE LERDO,20,122,1,143,1484
MÉXICO,TOLUCA DE LERDO,11,136,2,149,1484
MÉXICO,TOLUCA DE LERDO,20,127,2,149,1935
MÉXICO,TOLUCA DE LERDO,14,161,1,176,1935
MÉXICO,TOLUCA DE LERDO,17,184,2,203,1934
MÉXICO,TOLUCA DE LERDO,215,1250,12,1477,0
MÉXICO,TOLUCA DE LERDO,22,287,0,309,1930
MÉXICO,TOLUCA DE LERDO,23,283,0,306,1929
MÉXICO,TOLUCA DE LERDO,31,232,0,263,1645
MÉXICO,TOLUCA DE LERDO,39,203,2,244,1644
MÉXICO,TOLUCA DE LERDO,31,156,0,187,1105
MÉXICO,TOLUCA DE LERDO,27,125,2,154,1105
MÉXICO,TOLUCA DE LERDO,47,167,2,216,1775
MÉXICO,TOLUCA DE LERDO,46,185,5,236,1775
MÉXICO,TOLUCA DE LERDO,26,145,2,173,1189
MÉXICO,TOLUCA DE LERDO,16,102,0,118,1188
MÉXICO,TOLUCA DE LERDO,24,186,4,214,1715
MÉXICO,TOLUCA DE LERDO,36,193,1,230,1714
MÉXICO,TOLUCA DE LERDO,22,198,3,223,1714
MÉXICO,TOLUCA DE LERDO,13,165,3,181,1443
MÉXICO,TOLUCA DE LERDO,23,162,0,185,1443
MÉXICO,TOLUCA DE LERDO,25,173,2,200,1442
MÉXICO,TOLUCA DE LERDO,28,165,4,197,1201
MÉXICO,TOLUCA DE LERDO,25,169,3,197,1201
MÉXICO,TOLUCA DE LERDO,29,187,0,216,1566
MÉXICO,TOLUCA DE LERDO,37,143,4,184,1565
MÉXICO,TOLUCA DE LERDO,34,198,6,238,1932
MÉXICO,TOLUCA DE LERDO,28,190,3,221,1932
MÉXICO,TOLUCA DE LERDO,26,184,1,211,1322
MÉXICO,TOLUCA DE LERDO,29,146,1,176,1321
MÉXICO,TOLUCA DE LERDO,23,200,4,227,1456
MÉXICO,TOLUCA DE LERDO,29,169,1,199,1456
MÉXICO,TOLUCA DE LERDO,22,170,1,193,1455
MÉXICO,TOLUCA DE LERDO,16,161,0,177,1135
MÉXICO,TOLUCA DE LERDO,15,174,2,191,1134
MÉXICO,TOLUCA DE LERDO,21,209,5,235,1811
MÉXICO,TOLUCA DE LERDO,34,274,1,309,1811
MÉXICO,TOLUCA DE LERDO,32,174,5,211,1275
MÉXICO,TOLUCA DE LERDO,29,155,2,186,1275
MÉXICO,TOLUCA DE LERDO,35,162,1,198,1285
MÉXICO,TOLUCA DE LERDO,31,144,3,178,1285
MÉXICO,TOLUCA DE LERDO,32,148,0,180,1534
MÉXICO,TOLUCA DE LERDO,25,165,1,191,1533
MÉXICO,TOLUCA DE LERDO,36,168,3,207,1533
MÉXICO,TOLUCA DE LERDO,23,238,1,262,1521
MÉXICO,TOLUCA DE LERDO,12,209,1,222,1520
MÉXICO,TOLUCA DE LERDO,31,155,4,190,1460
MÉXICO,TOLUCA DE LERDO,35,164,3,202,1460
MÉXICO,TOLUCA DE LERDO,25,158,0,183,1460
MÉXICO,TOLUCA DE LERDO,35,187,1,223,1938
MÉXICO,TOLUCA DE LERDO,34,161,4,199,1938
MÉXICO,TOLUCA DE LERDO,35,199,0,234,1938
MÉXICO,TOLUCA DE LERDO,31,131,2,164,1346
MÉXICO,TOLUCA DE LERDO,35,152,1,188,1346
MÉXICO,TOLUCA DE LERDO,28,156,3,187,1708
MÉXICO,TOLUCA DE LERDO,20,187,2,209,1707
MÉXICO,TOLUCA DE LERDO,15,136,2,153,1025
MÉXICO,TOLUCA DE LERDO,22,122,6,150,1025
MÉXICO,TOLUCA DE LERDO,33,192,4,229,1233
MÉXICO,TOLUCA DE LERDO,24,179,3,206,1232
MÉXICO,TOLUCA DE LERDO,18,196,3,217,1577
MÉXICO,TOLUCA DE LERDO,63,315,1,379,1960
MÉXICO,TOLUCA DE LERDO,24,170,2,196,1590
MÉXICO,TOLUCA DE LERDO,22,194,3,219,1589
MÉXICO,TOLUCA DE LERDO,31,157,0,188,1589
MÉXICO,TOLUCA DE LERDO,26,186,2,214,1589
MÉXICO,TOLUCA DE LERDO,31,131,1,163,1473
MÉXICO,TOLUCA DE LERDO,34,142,0,176,1473
MÉXICO,TOLUCA DE LERDO,37,146,4,187,1472
MÉXICO,TOLUCA DE LERDO,37,134,0,171,1536
MÉXICO,TOLUCA DE LERDO,46,147,1,194,1535
MÉXICO,TOLUCA DE LERDO,31,158,5,194,1208
MÉXICO,TOLUCA DE LERDO,21,171,2,194,1207
MÉXICO,TOLUCA DE LERDO,34,162,2,198,1393
MÉXICO,TOLUCA DE LERDO,14,201,0,215,1392
MÉXICO,TOLUCA DE LERDO,22,175,1,198,1634
MÉXICO,TOLUCA DE LERDO,25,134,0,159,1634
MÉXICO,TOLUCA DE LERDO,35,151,5,191,1633
MÉXICO,TOLUCA DE LERDO,21,114,1,136,1633
MÉXICO,TOLUCA DE LERDO,32,189,1,222,1952
MÉXICO,TOLUCA DE LERDO,25,186,1,212,1952
MÉXICO,TOLUCA DE LERDO,32,195,2,229,1952
MÉXICO,TOLUCA DE LERDO,28,193,1,222,1951
MÉXICO,TOLUCA DE LERDO,30,174,4,208,1811
MÉXICO,TOLUCA DE LERDO,22,204,1,227,1810
MÉXICO,TOLUCA DE LERDO,40,150,1,191,1008
MÉXICO,TOLUCA DE LERDO,34,172,1,207,1008
MÉXICO,TOLUCA DE LERDO,12,127,3,142,1542
MÉXICO,TOLUCA DE LERDO,13,135,0,148,1541
MÉXICO,TOLUCA DE LERDO,18,125,0,143,1541
MÉXICO,TOLUCA DE LERDO,20,100,1,121,1541
MÉXICO,TOLUCA DE LERDO,23,198,0,221,1708
MÉXICO,TOLUCA DE LERDO,29,201,0,230,1708
MÉXICO,TOLUCA DE LERDO,22,134,1,157,1056
MÉXICO,TOLUCA DE LERDO,17,115,1,133,1055
MÉXICO,TOLUCA DE LERDO,58,199,1,258,1823
MÉXICO,TOLUCA DE LERDO,35,209,1,245,1823
MÉXICO,TOLUCA DE LERDO,32,177,6,215,1154
MÉXICO,TOLUCA DE LERDO,34,189,3,226,1153
MÉXICO,TOLUCA DE LERDO,24,198,3,225,1541
MÉXICO,TOLUCA DE LERDO,24,198,3,225,1541
MÉXICO,TOLUCA DE LERDO,35,220,3,258,1972
MÉXICO,TOLUCA DE LERDO,35,244,6,285,1972
MÉXICO,TOLUCA DE LERDO,34,230,7,271,1972
MÉXICO,TOLUCA DE LERDO,18,92,0,110,1105
MÉXICO,TOLUCA DE LERDO,12,83,1,96,1105
MÉXICO,TOLUCA DE LERDO,10,160,3,173,1456
MÉXICO,TOLUCA DE LERDO,12,136,0,148,1455
MÉXICO,TOLUCA DE LERDO,10,159,3,172,1455
MÉXICO,TOLUCA DE LERDO,16,245,3,264,1981
MÉXICO,TOLUCA DE LERDO,237,13,2,252,1981
MÉXICO,TOLUCA DE LERDO,16,209,2,227,1839
MÉXICO,TOLUCA DE LERDO,21,219,3,243,1839
MÉXICO,TOLUCA DE LERDO,17,284,2,303,1943
MÉXICO,TOLUCA DE LERDO,11,264,3,278,1942
MÉXICO,TOLUCA DE LERDO,38,273,4,315,1724
MÉXICO,TOLUCA DE LERDO,33,255,5,293,1723
MÉXICO,TOLUCA DE LERDO,32,178,3,213,1017
MÉXICO,TOLUCA DE LERDO,27,192,3,222,1017
MÉXICO,TOLUCA DE LERDO,40,207,5,252,1622
MÉXICO,TOLUCA DE LERDO,23,159,2,184,1622
MÉXICO,TOLUCA DE LERDO,27,174,1,202,1381
MÉXICO,TOLUCA DE LERDO,25,180,1,206,1381
MÉXICO,TOLUCA DE LERDO,14,162,2,178,1380
MÉXICO,TOLUCA DE LERDO,22,228,5,255,1992
MÉXICO,TOLUCA DE LERDO,25,169,5,199,1992
MÉXICO,TOLUCA DE LERDO,24,242,2,268,1982
MÉXICO,TOLUCA DE LERDO,24,236,7,267,1981
MÉXICO,TOLUCA DE LERDO,44,137,0,181,1660
MÉXICO,TOLUCA DE LERDO,39,120,4,163,1660
MÉXICO,TOLUCA DE LERDO,24,157,3,184,1659
MÉXICO,TOLUCA DE LERDO,17,178,1,196,1659
MÉXICO,TOLUCA DE LERDO,25,147,2,174,1659
MÉXICO,TENANCINGO DE DEGOLLADO,9,110,3,122,1210
MÉXICO,TENANCINGO DE DEGOLLADO,7,110,3,120,1210
MÉXICO,TENANCINGO DE DEGOLLADO,5,126,1,132,1784
MÉXICO,TENANCINGO DE DEGOLLADO,7,106,2,115,1784
MÉXICO,TENANCINGO DE DEGOLLADO,12,134,1,147,1548
MÉXICO,TENANCINGO DE DEGOLLADO,5,150,3,158,1547
MÉXICO,TENANCINGO DE DEGOLLADO,8,105,0,113,1225
MÉXICO,TENANCINGO DE DEGOLLADO,14,137,1,152,1224
MÉXICO,TENANCINGO DE DEGOLLADO,5,18,0,23,1500
MÉXICO,TENANCINGO DE DEGOLLADO,7,35,3,45,1383
MÉXICO,TENANCINGO DE DEGOLLADO,2,41,1,44,1383
MÉXICO,TENANCINGO DE DEGOLLADO,8,51,0,59,1382
MÉXICO,TENANCINGO DE DEGOLLADO,12,54,7,73,1865
MÉXICO,TENANCINGO DE DEGOLLADO,10,37,3,50,1864
MÉXICO,TENANCINGO DE DEGOLLADO,5,112,3,120,1587
MÉXICO,TENANCINGO DE DEGOLLADO,2,83,5,90,1587
MÉXICO,TENANCINGO DE DEGOLLADO,7,91,4,102,1876
MÉXICO,TENANCINGO DE DEGOLLADO,7,101,4,112,1876
MÉXICO,TENANCINGO DE DEGOLLADO,26,243,5,274,1625
MÉXICO,TENANCINGO DE DEGOLLADO,27,236,4,267,1624
MÉXICO,TENANCINGO DE DEGOLLADO,26,242,10,278,1577
MÉXICO,TENANCINGO DE DEGOLLADO,19,247,10,276,1576
MÉXICO,TENANCINGO DE DEGOLLADO,17,245,1,263,1757
MÉXICO,TENANCINGO DE DEGOLLADO,31,266,6,303,1757
MÉXICO,TENANCINGO DE DEGOLLADO,26,173,2,201,1465
MÉXICO,TENANCINGO DE DEGOLLADO,17,169,8,194,1465
MÉXICO,TENANCINGO DE DEGOLLADO,16,189,6,211,1465
MÉXICO,TENANCINGO DE DEGOLLADO,19,69,9,97,1196
MÉXICO,TENANCINGO DE DEGOLLADO,13,40,0,53,1195
MÉXICO,TENANCINGO DE DEGOLLADO,23,148,6,177,1390
MÉXICO,TENANCINGO DE DEGOLLADO,18,127,4,149,1390
MÉXICO,TENANCINGO DE DEGOLLADO,22,176,7,205,1389
MÉXICO,TENANCINGO DE DEGOLLADO,11,116,6,133,1673
MÉXICO,TENANCINGO DE DEGOLLADO,10,127,5,142,1672
MÉXICO,TENANCINGO DE DEGOLLADO,29,187,12,228,1810
MÉXICO,TENANCINGO DE DEGOLLADO,14,183,4,201,1619
MÉXICO,TENANCINGO DE DEGOLLADO,25,327,1,353,1983
MÉXICO,TENANCINGO DE DEGOLLADO,4,195,6,205,1859
MÉXICO,TENANCINGO DE DEGOLLADO,8,232,6,246,1859
MÉXICO,TENANCINGO DE DEGOLLADO,9,218,2,229,1113
MÉXICO,TENANCINGO DE DEGOLLADO,13,204,2,219,1112
MÉXICO,TENANCINGO DE DEGOLLADO,15,191,4,210,1255
MÉXICO,TENANCINGO DE DEGOLLADO,8,181,7,196,1255
MÉXICO,TENANCINGO DE DEGOLLADO,17,227,3,247,1513
MÉXICO,TENANCINGO DE DEGOLLADO,13,224,3,240,1513
MÉXICO,TENANCINGO DE DEGOLLADO,14,289,6,309,1786
MÉXICO,TENANCINGO DE DEGOLLADO,8,300,8,316,1786
MÉXICO,TENANCINGO DE DEGOLLADO,5,283,6,294,1911
MÉXICO,TENANCINGO DE DEGOLLADO,14,281,9,304,1910
MÉXICO,TENANCINGO DE DEGOLLADO,6,136,4,146,1748
MÉXICO,TENANCINGO DE DEGOLLADO,5,97,4,106,1748
MÉXICO,TENANCINGO DE DEGOLLADO,5,111,1,117,1748
MÉXICO,TENANCINGO DE DEGOLLADO,6,197,7,210,1410
MÉXICO,TENANCINGO DE DEGOLLADO,8,234,5,247,1409
MÉXICO,TENANCINGO DE DEGOLLADO,6,275,4,285,1409
MÉXICO,TENANCINGO DE DEGOLLADO,19,259,4,282,1550
MÉXICO,TENANCINGO DE DEGOLLADO,26,225,3,254,1550
MÉXICO,TENANCINGO DE DEGOLLADO,25,298,3,326,1966
MÉXICO,TENANCINGO DE DEGOLLADO,6,242,0,248,1203
MÉXICO,TENANCINGO DE DEGOLLADO,5,248,0,253,1202
MÉXICO,TENANCINGO DE DEGOLLADO,13,286,3,302,1971
MÉXICO,TENANCINGO DE DEGOLLADO,21,121,4,146,1626
MÉXICO,TENANCINGO DE DEGOLLADO,10,164,5,179,1626
MÉXICO,TENANCINGO DE DEGOLLADO,16,238,3,257,1780
MÉXICO,TENANCINGO DE DEGOLLADO,20,253,6,279,1779
MÉXICO,TENANCINGO DE DEGOLLADO,13,216,4,233,1779
MÉXICO,TENANCINGO DE DEGOLLADO,54,552,7,613,0
MÉXICO,TENANCINGO DE DEGOLLADO,12,141,1,154,1310
MÉXICO,TENANCINGO DE DEGOLLADO,11,136,3,150,1309
MÉXICO,TENANCINGO DE DEGOLLADO,25,263,2,290,1738
MÉXICO,TENANCINGO DE DEGOLLADO,26,266,4,296,1737
MÉXICO,TENANCINGO DE DEGOLLADO,8,128,0,136,1063
MÉXICO,TENANCINGO DE DEGOLLADO,10,164,3,177,1063
MÉXICO,TENANCINGO DE DEGOLLADO,16,244,4,264,1897
MÉXICO,TENANCINGO DE DEGOLLADO,19,241,4,264,1897
MÉXICO,TENANCINGO DE DEGOLLADO,18,304,2,324,1878
MÉXICO,TENANCINGO DE DEGOLLADO,25,259,3,287,1877
MÉXICO,TENANCINGO DE DEGOLLADO,11,157,3,171,1763
MÉXICO,TENANCINGO DE DEGOLLADO,23,219,3,245,1763
MÉXICO,TENANCINGO DE DEGOLLADO,22,227,4,253,1534
MÉXICO,TENANCINGO DE DEGOLLADO,16,228,0,244,1534
MÉXICO,TENANCINGO DE DEGOLLADO,16,202,2,220,1533
MÉXICO,TENANCINGO DE DEGOLLADO,14,241,0,255,1879
MÉXICO,TENANCINGO DE DEGOLLADO,16,340,11,367,1879
MÉXICO,TENANCINGO DE DEGOLLADO,21,224,6,251,1338
MÉXICO,TENANCINGO DE DEGOLLADO,20,204,3,227,1337
MÉXICO,TENANCINGO DE DEGOLLADO,20,296,2,318,1845
MÉXICO,TENANCINGO DE DEGOLLADO,14,186,10,210,1845
MÉXICO,TENANCINGO DE DEGOLLADO,9,70,1,80,1627
MÉXICO,TENANCINGO DE DEGOLLADO,4,138,0,142,1626
MÉXICO,TENANCINGO DE DEGOLLADO,14,129,4,147,1548
MÉXICO,TENANCINGO DE DEGOLLADO,13,165,2,180,1547
MÉXICO,TENANCINGO DE DEGOLLADO,14,272,4,290,1320
MÉXICO,TENANCINGO DE DEGOLLADO,14,275,8,297,1320
MÉXICO,TENANCINGO DE DEGOLLADO,11,112,4,127,1662
MÉXICO,TENANCINGO DE DEGOLLADO,15,133,2,150,1236
MÉXICO,TENANCINGO DE DEGOLLADO,12,98,5,115,1235
MÉXICO,TENANCINGO DE DEGOLLADO,20,363,9,392,1837
MÉXICO,TENANCINGO DE DEGOLLADO,17,395,7,419,1836
MÉXICO,TENANCINGO DE DEGOLLADO,20,224,9,253,1860
MÉXICO,TENANCINGO DE DEGOLLADO,17,220,12,249,1860
MÉXICO,TENANCINGO DE DEGOLLADO,14,154,5,173,1031
MÉXICO,TENANCINGO DE DEGOLLADO,8,110,3,121,1030
MÉXICO,TENANCINGO DE DEGOLLADO,18,239,7,264,1596
MÉXICO,TENANCINGO DE DEGOLLADO,22,188,5,215,1595
MÉXICO,TENANCINGO DE DEGOLLADO,13,151,1,165,1340
MÉXICO,TENANCINGO DE DEGOLLADO,13,125,8,146,1339
MÉXICO,TENANCINGO DE DEGOLLADO,19,253,5,277,1664
MÉXICO,TENANCINGO DE DEGOLLADO,27,243,4,274,1664
MÉXICO,TENANCINGO DE DEGOLLADO,26,220,7,253,1910
MÉXICO,TENANCINGO DE DEGOLLADO,21,243,4,268,1909
MÉXICO,TENANCINGO DE DEGOLLADO,28,240,4,272,1756
MÉXICO,TENANCINGO DE DEGOLLADO,25,237,2,264,1755
MÉXICO,TENANCINGO DE DEGOLLADO,8,195,5,208,1325
MÉXICO,TENANCINGO DE DEGOLLADO,5,162,3,170,1325
MÉXICO,TENANCINGO DE DEGOLLADO,10,158,2,170,1321
MÉXICO,TENANCINGO DE DEGOLLADO,9,158,1,168,1320
MÉXICO,TENANCINGO DE DEGOLLADO,22,155,3,180,1147
MÉXICO,TENANCINGO DE DEGOLLADO,25,200,0,225,1147
MÉXICO,TENANCINGO DE DEGOLLADO,35,243,9,287,1897
MÉXICO,TENANCINGO DE DEGOLLADO,25,225,6,256,1897
MÉXICO,TENANCINGO DE DEGOLLADO,22,214,5,241,1129
MÉXICO,TENANCINGO DE DEGOLLADO,12,220,2,234,1129
MÉXICO,TENANCINGO DE DEGOLLADO,18,302,5,325,1753
MÉXICO,TENANCINGO DE DEGOLLADO,11,249,5,265,1752
MÉXICO,TENANCINGO DE DEGOLLADO,26,197,6,229,1479
MÉXICO,TENANCINGO DE DEGOLLADO,20,210,5,235,1478
MÉXICO,TENANCINGO DE DEGOLLADO,7,290,8,305,1797
MÉXICO,TENANCINGO DE DEGOLLADO,10,184,3,197,1004
MÉXICO,TENANCINGO DE DEGOLLADO,13,146,1,160,1003
MÉXICO,TENANCINGO DE DEGOLLADO,19,116,1,136,1853
MÉXICO,TENANCINGO DE DEGOLLADO,17,103,0,120,1852
MÉXICO,TENANCINGO DE DEGOLLADO,15,111,1,127,1852
MÉXICO,TENANCINGO DE DEGOLLADO,10,275,6,291,1718
MÉXICO,TENANCINGO DE DEGOLLADO,11,228,2,241,1718
MÉXICO,TENANCINGO DE DEGOLLADO,16,191,5,212,1507
MÉXICO,TENANCINGO DE DEGOLLADO,8,163,5,176,1506
MÉXICO,TENANCINGO DE DEGOLLADO,10,88,1,99,1451
MÉXICO,TENANCINGO DE DEGOLLADO,9,84,1,94,1451
MÉXICO,TENANCINGO DE DEGOLLADO,11,124,5,140,1386
MÉXICO,TENANCINGO DE DEGOLLADO,2,117,0,119,1385
MÉXICO,TENANCINGO DE DEGOLLADO,18,226,13,257,1896
MÉXICO,TENANCINGO DE DEGOLLADO,8,251,5,264,1895
MÉXICO,TENANCINGO DE DEGOLLADO,9,392,4,405,1494
MÉXICO,TENANCINGO DE DEGOLLADO,14,391,5,410,1494
MÉXICO,TENANCINGO DE DEGOLLADO,5,375,8,388,1416
MÉXICO,TENANCINGO DE DEGOLLADO,14,427,3,444,1416
MÉXICO,TENANCINGO DE DEGOLLADO,13,318,4,335,1889
MÉXICO,TENANCINGO DE DEGOLLADO,13,245,5,263,1889
MÉXICO,TENANCINGO DE DEGOLLADO,16,227,3,246,1888
MÉXICO,TENANCINGO DE DEGOLLADO,16,182,7,205,1617
MÉXICO,TENANCINGO DE DEGOLLADO,14,187,1,202,1616
MÉXICO,TENANCINGO DE DEGOLLADO,13,215,1,229,1762
MÉXICO,TENANCINGO DE DEGOLLADO,8,120,0,128,1357
MÉXICO,TENANCINGO DE DEGOLLADO,17,86,0,103,1356
MÉXICO,TENANCINGO DE DEGOLLADO,14,105,0,119,1580
MÉXICO,TENANCINGO DE DEGOLLADO,8,110,0,118,1580
MÉXICO,TENANCINGO DE DEGOLLADO,14,111,1,126,1445
MÉXICO,TENANCINGO DE DEGOLLADO,6,103,2,111,1445
MÉXICO,TENANCINGO DE DEGOLLADO,8,49,1,58,1973
MÉXICO,TENANCINGO DE DEGOLLADO,13,34,0,47,1972
MÉXICO,TENANCINGO DE DEGOLLADO,19,94,2,115,1975
MÉXICO,TENANCINGO DE DEGOLLADO,10,68,0,78,1782
MÉXICO,TENANCINGO DE DEGOLLADO,3,51,0,54,1782
MÉXICO,TENANCINGO DE DEGOLLADO,6,77,2,85,1237
MÉXICO,TENANCINGO DE DEGOLLADO,8,71,2,81,1236
MÉXICO,TENANCINGO DE DEGOLLADO,25,118,2,145,1931
MÉXICO,TENANCINGO DE DEGOLLADO,12,87,4,103,1930
MÉXICO,TENANCINGO DE DEGOLLADO,17,125,1,143,1431
MÉXICO,TENANCINGO DE DEGOLLADO,16,85,1,102,1431
MÉXICO,TENANCINGO DE DEGOLLADO,8,23,0,31,1033
MÉXICO,TENANCINGO DE DEGOLLADO,9,35,0,44,1032
MÉXICO,TENANCINGO DE DEGOLLADO,5,113,1,119,1237
MÉXICO,TENANCINGO DE DEGOLLADO,10,90,2,102,1237
MÉXICO,TENANCINGO DE DEGOLLADO,22,95,1,118,1879
MÉXICO,TENANCINGO DE DEGOLLADO,14,93,0,107,1878
MÉXICO,TENANCINGO DE DEGOLLADO,12,42,0,54,1071
MÉXICO,TENANCINGO DE DEGOLLADO,12,46,0,58,1071
MÉXICO,TENANCINGO DE DEGOLLADO,11,96,2,109,1332
MÉXICO,TENANCINGO DE DEGOLLADO,9,63,1,73,1332
MÉXICO,TENANCINGO DE DEGOLLADO,7,69,0,76,1861
MÉXICO,TENANCINGO DE DEGOLLADO,7,89,0,96,1860
MÉXICO,TENANCINGO DE DEGOLLADO,22,228,14,264,1725
MÉXICO,TENANCINGO DE DEGOLLADO,16,253,18,287,1724
MÉXICO,TENANCINGO DE DEGOLLADO,19,211,12,242,1888
MÉXICO,TENANCINGO DE DEGOLLADO,21,203,12,236,1888
MÉXICO,TENANCINGO DE DEGOLLADO,9,187,5,201,1893
MÉXICO,TENANCINGO DE DEGOLLADO,7,117,2,126,1893
MÉXICO,TENANCINGO DE DEGOLLADO,6,176,6,188,1094
MÉXICO,TENANCINGO DE DEGOLLADO,7,157,8,172,1094
MÉXICO,TEJUPILCO DE HIDALGO,7,299,10,316,1647
MÉXICO,TEJUPILCO DE HIDALGO,10,253,9,272,1647
MÉXICO,TEJUPILCO DE HIDALGO,14,279,11,304,1646
MÉXICO,TEJUPILCO DE HIDALGO,6,247,1,254,1186
MÉXICO,TEJUPILCO DE HIDALGO,11,161,3,175,1185
MÉXICO,TEJUPILCO DE HIDALGO,7,204,3,214,1601
MÉXICO,TEJUPILCO DE HIDALGO,12,224,4,240,1601
MÉXICO,TEJUPILCO DE HIDALGO,14,331,12,357,1547
MÉXICO,TEJUPILCO DE HIDALGO,10,195,7,212,1792
MÉXICO,TEJUPILCO DE HIDALGO,12,210,5,227,1792
MÉXICO,TEJUPILCO DE HIDALGO,9,83,9,101,1375
MÉXICO,TEJUPILCO DE HIDALGO,20,86,10,116,1374
MÉXICO,TEJUPILCO DE HIDALGO,9,136,5,150,1385
MÉXICO,TEJUPILCO DE HIDALGO,12,205,3,220,1385
MÉXICO,TEJUPILCO DE HIDALGO,8,199,10,217,1147
MÉXICO,TEJUPILCO DE HIDALGO,9,167,11,187,1147
MÉXICO,TEJUPILCO DE HIDALGO,8,201,3,212,1894
MÉXICO,TEJUPILCO DE HIDALGO,20,152,5,177,1549
MÉXICO,TEJUPILCO DE HIDALGO,17,153,2,172,1549
MÉXICO,TEJUPILCO DE HIDALGO,9,155,6,170,1114
MÉXICO,TEJUPILCO DE HIDALGO,7,173,7,187,1113
MÉXICO,TEJUPILCO DE HIDALGO,14,291,14,319,1779
MÉXICO,TEJUPILCO DE HIDALGO,11,333,12,356,1779
MÉXICO,TEJUPILCO DE HIDALGO,8,366,9,383,1778
MÉXICO,TEJUPILCO DE HIDALGO,6,233,4,243,2003
MÉXICO,TEJUPILCO DE HIDALGO,5,241,6,252,2003
MÉXICO,TEJUPILCO DE HIDALGO,5,314,2,321,1988
MÉXICO,TEJUPILCO DE HIDALGO,7,331,0,338,1988
MÉXICO,TEJUPILCO DE HIDALGO,0,379,2,381,1987
MÉXICO,TEJUPILCO DE HIDALGO,4,321,0,325,1668
MÉXICO,TEJUPILCO DE HIDALGO,3,281,2,286,1668
MÉXICO,TEJUPILCO DE HIDALGO,6,268,5,279,1667
MÉXICO,TEJUPILCO DE HIDALGO,28,408,9,445,1789
MÉXICO,TEJUPILCO DE HIDALGO,11,358,20,389,1789
MÉXICO,TEJUPILCO DE HIDALGO,14,447,7,468,1691
MÉXICO,TEJUPILCO DE HIDALGO,14,576,9,599,2025
MÉXICO,TEJUPILCO DE HIDALGO,15,522,6,543,2024
MÉXICO,TEJUPILCO DE HIDALGO,7,273,4,284,1750
MÉXICO,TEJUPILCO DE HIDALGO,14,254,4,272,1749
MÉXICO,TEJUPILCO DE HIDALGO,15,401,5,421,1749
MÉXICO,TEJUPILCO DE HIDALGO,14,381,11,406,1926
MÉXICO,TEJUPILCO DE HIDALGO,3,338,3,344,1860
MÉXICO,TEJUPILCO DE HIDALGO,9,250,5,264,1754
MÉXICO,TEJUPILCO DE HIDALGO,10,288,3,301,1898
MÉXICO,TEJUPILCO DE HIDALGO,17,271,4,292,1577
MÉXICO,TEJUPILCO DE HIDALGO,19,218,4,241,1576
MÉXICO,TEJUPILCO DE HIDALGO,24,230,6,260,1576
MÉXICO,TEJUPILCO DE HIDALGO,35,123,16,174,1243
MÉXICO,TEJUPILCO DE HIDALGO,17,121,25,163,1243
MÉXICO,TEJUPILCO DE HIDALGO,18,128,4,150,1789
MÉXICO,TEJUPILCO DE HIDALGO,10,135,6,151,1788
MÉXICO,TEJUPILCO DE HIDALGO,12,191,3,206,1514
MÉXICO,TEJUPILCO DE HIDALGO,20,219,6,245,2124
MÉXICO,TEJUPILCO DE HIDALGO,9,225,11,245,1627
MÉXICO,TEJUPILCO DE HIDALGO,15,271,11,297,1626
MÉXICO,TEJUPILCO DE HIDALGO,5,255,3,263,2028
MÉXICO,TEJUPILCO DE HIDALGO,11,296,3,310,1928
MÉXICO,TEJUPILCO DE HIDALGO,13,250,5,268,1928
MÉXICO,TEJUPILCO DE HIDALGO,18,256,0,274,1928
MÉXICO,TEJUPILCO DE HIDALGO,27,595,7,629,0
MÉXICO,TEJUPILCO DE HIDALGO,15,191,8,214,1441
MÉXICO,TEJUPILCO DE HIDALGO,14,195,5,214,1440
MÉXICO,TEJUPILCO DE HIDALGO,15,182,10,207,1440
MÉXICO,TEJUPILCO DE HIDALGO,5,180,2,187,1617
MÉXICO,TEJUPILCO DE HIDALGO,9,199,1,209,1617
MÉXICO,TEJUPILCO DE HIDALGO,9,201,1,211,1616
MÉXICO,TEJUPILCO DE HIDALGO,6,259,1,266,1862
MÉXICO,TEJUPILCO DE HIDALGO,14,226,4,244,1862
MÉXICO,TEJUPILCO DE HIDALGO,21,260,2,283,1949
MÉXICO,TEJUPILCO DE HIDALGO,12,285,3,300,1948
MÉXICO,TEJUPILCO DE HIDALGO,15,235,2,252,1948
MÉXICO,TEJUPILCO DE HIDALGO,12,275,5,292,1887
MÉXICO,TEJUPILCO DE HIDALGO,11,245,2,258,1886
MÉXICO,TEJUPILCO DE HIDALGO,19,244,2,265,1886
MÉXICO,TEJUPILCO DE HIDALGO,6,464,7,477,1629
MÉXICO,TEJUPILCO DE HIDALGO,10,442,5,457,1629
MÉXICO,TEJUPILCO DE HIDALGO,13,174,9,196,1140
MÉXICO,TEJUPILCO DE HIDALGO,9,159,9,177,1140
MÉXICO,TEJUPILCO DE HIDALGO,9,156,2,167,1315
MÉXICO,TEJUPILCO DE HIDALGO,9,178,3,190,1315
MÉXICO,TEJUPILCO DE HIDALGO,4,317,3,324,2046
MÉXICO,TEJUPILCO DE HIDALGO,5,294,6,305,2046
MÉXICO,TEJUPILCO DE HIDALGO,8,428,3,439,2143
MÉXICO,TEJUPILCO DE HIDALGO,8,352,8,368,1963
MÉXICO,TEJUPILCO DE HIDALGO,4,211,3,218,1148
MÉXICO,TEJUPILCO DE HIDALGO,5,221,1,227,1147
MÉXICO,TEJUPILCO DE HIDALGO,5,339,9,353,2000
MÉXICO,TEJUPILCO DE HIDALGO,12,365,9,386,2088
MÉXICO,TEJUPILCO DE HIDALGO,11,303,12,326,1617
MÉXICO,TEJUPILCO DE HIDALGO,16,198,3,217,1597
MÉXICO,TEJUPILCO DE HIDALGO,15,198,1,214,1597
MÉXICO,TEJUPILCO DE HIDALGO,8,209,5,222,1596
MÉXICO,TEJUPILCO DE HIDALGO,7,261,6,274,1789
MÉXICO,TEJUPILCO DE HIDALGO,25,132,10,167,1489
MÉXICO,TEJUPILCO DE HIDALGO,18,150,4,172,1489
MÉXICO,TEJUPILCO DE HIDALGO,26,153,14,193,1488
MÉXICO,TEJUPILCO DE HIDALGO,14,245,4,263,1838
MÉXICO,TEJUPILCO DE HIDALGO,13,197,10,220,1838
MÉXICO,TEJUPILCO DE HIDALGO,7,81,2,90,1167
MÉXICO,TEJUPILCO DE HIDALGO,11,83,2,96,1167
MÉXICO,TEJUPILCO DE HIDALGO,9,149,4,162,1268
MÉXICO,TEJUPILCO DE HIDALGO,4,158,2,164,1267
MÉXICO,TEJUPILCO DE HIDALGO,21,175,5,201,1763
MÉXICO,TEJUPILCO DE HIDALGO,11,161,1,173,1763
MÉXICO,TEJUPILCO DE HIDALGO,14,231,8,253,1746
MÉXICO,TEJUPILCO DE HIDALGO,17,190,10,217,1746
MÉXICO,TEJUPILCO DE HIDALGO,9,152,0,161,1374
MÉXICO,TEJUPILCO DE HIDALGO,9,175,3,187,1373
MÉXICO,TEJUPILCO DE HIDALGO,5,161,4,170,1519
MÉXICO,TEJUPILCO DE HIDALGO,8,136,0,144,1519
MÉXICO,TEJUPILCO DE HIDALGO,8,61,0,69,1807
MÉXICO,TEJUPILCO DE HIDALGO,10,66,3,79,1806
MÉXICO,TEJUPILCO DE HIDALGO,11,98,2,111,1096
MÉXICO,TEJUPILCO DE HIDALGO,12,60,5,77,1096
MÉXICO,TEJUPILCO DE HIDALGO,11,114,4,129,1585
MÉXICO,TEJUPILCO DE HIDALGO,14,31,3,48,1419
MÉXICO,TEJUPILCO DE HIDALGO,21,51,2,74,1419
MÉXICO,TEJUPILCO DE HIDALGO,12,42,4,58,1419
MÉXICO,TEJUPILCO DE HIDALGO,7,97,14,118,1942
MÉXICO,TEJUPILCO DE HIDALGO,19,132,4,155,1852
MÉXICO,TEJUPILCO DE HIDALGO,12,309,7,328,1479
MÉXICO,TEJUPILCO DE HIDALGO,7,195,5,207,1367
MÉXICO,TEJUPILCO DE HIDALGO,7,228,5,240,1367
MÉXICO,TEJUPILCO DE HIDALGO,11,237,2,250,1865
MÉXICO,TEJUPILCO DE HIDALGO,8,266,10,284,1865
MÉXICO,TEJUPILCO DE HIDALGO,44,152,8,204,1627
MÉXICO,TEJUPILCO DE HIDALGO,32,128,8,168,1626
MÉXICO,TEJUPILCO DE HIDALGO,9,185,3,197,1410
MÉXICO,TEJUPILCO DE HIDALGO,14,240,6,260,1410
MÉXICO,TEJUPILCO DE HIDALGO,17,172,21,210,1906
MÉXICO,TEJUPILCO DE HIDALGO,2,195,3,200,1905
MÉXICO,TEJUPILCO DE HIDALGO,8,304,2,314,1235
MÉXICO,TEJUPILCO DE HIDALGO,6,261,1,268,1234
MÉXICO,TEJUPILCO DE HIDALGO,4,254,3,261,1402
MÉXICO,TEJUPILCO DE HIDALGO,4,232,0,236,1401
MÉXICO,TEJUPILCO DE HIDALGO,0,236,4,240,1401
MÉXICO,TEJUPILCO DE HIDALGO,2,224,6,232,1114
MÉXICO,TEJUPILCO DE HIDALGO,8,238,4,250,1114
MÉXICO,TEJUPILCO DE HIDALGO,15,287,6,308,1818
MÉXICO,TEJUPILCO DE HIDALGO,8,243,1,252,1818
MÉXICO,TEJUPILCO DE HIDALGO,1,327,4,332,1624
MÉXICO,TEJUPILCO DE HIDALGO,2,347,7,356,1624
MÉXICO,TEJUPILCO DE HIDALGO,2,313,0,315,1623
MÉXICO,TEJUPILCO DE HIDALGO,3,413,1,417,1864
MÉXICO,TEJUPILCO DE HIDALGO,2,353,3,358,1864
MÉXICO,TEJUPILCO DE HIDALGO,3,248,5,256,1455
MÉXICO,TEJUPILCO DE HIDALGO,2,260,1,263,1455
MÉXICO,TEJUPILCO DE HIDALGO,3,236,0,239,1455
MÉXICO,TEJUPILCO DE HIDALGO,12,227,2,241,1587
MÉXICO,TEJUPILCO DE HIDALGO,20,202,1,223,1416
MÉXICO,TEJUPILCO DE HIDALGO,16,213,2,231,1416
MÉXICO,TEJUPILCO DE HIDALGO,12,223,2,237,1415
MÉXICO,TEJUPILCO DE HIDALGO,18,298,7,323,2139
MÉXICO,TEJUPILCO DE HIDALGO,12,181,4,197,1233
MÉXICO,TEJUPILCO DE HIDALGO,16,164,1,181,1232
MÉXICO,TEJUPILCO DE HIDALGO,13,178,2,193,1331
MÉXICO,TEJUPILCO DE HIDALGO,16,187,2,205,1330
MÉXICO,TEJUPILCO DE HIDALGO,9,131,1,141,1090
MÉXICO,TEJUPILCO DE HIDALGO,9,125,4,138,1089
MÉXICO,TEJUPILCO DE HIDALGO,25,247,2,274,1956
MÉXICO,TEJUPILCO DE HIDALGO,18,260,3,281,1955
MÉXICO,TEJUPILCO DE HIDALGO,12,134,1,147,1870
MÉXICO,TEJUPILCO DE HIDALGO,11,128,0,139,1869
MÉXICO,TEJUPILCO DE HIDALGO,8,62,0,70,1561
MÉXICO,TEJUPILCO DE HIDALGO,10,90,1,101,1561
MÉXICO,TEJUPILCO DE HIDALGO,14,195,10,219,1690
MÉXICO,TEJUPILCO DE HIDALGO,13,187,4,204,1689
MÉXICO,TEJUPILCO DE HIDALGO,14,176,3,193,1489
MÉXICO,TEJUPILCO DE HIDALGO,14,198,2,214,1488
MÉXICO,TEJUPILCO DE HIDALGO,6,60,2,68,1107
MÉXICO,TEJUPILCO DE HIDALGO,4,60,3,67,1107
MÉXICO,TEJUPILCO DE HIDALGO,5,75,0,80,1375
MÉXICO,TEJUPILCO DE HIDALGO,9,59,2,70,1375
MÉXICO,TEJUPILCO DE HIDALGO,8,50,4,62,1374
MÉXICO,TEJUPILCO DE HIDALGO,7,122,2,131,1827
MÉXICO,TEJUPILCO DE HIDALGO,15,227,6,248,1657
MÉXICO,TEJUPILCO DE HIDALGO,14,198,6,218,1140
MÉXICO,TEJUPILCO DE HIDALGO,10,238,5,253,1139
MÉXICO,TEJUPILCO DE HIDALGO,22,406,2,430,1672
MÉXICO,TEJUPILCO DE HIDALGO,19,438,8,465,1930
MÉXICO,TEJUPILCO DE HIDALGO,18,445,8,471,1929
MÉXICO,TEJUPILCO DE HIDALGO,7,255,12,274,1493
MÉXICO,TEJUPILCO DE HIDALGO,8,273,10,291,1493
MÉXICO,TEJUPILCO DE HIDALGO,12,209,7,228,1531
MÉXICO,TEJUPILCO DE HIDALGO,13,191,4,208,1531
MÉXICO,TEJUPILCO DE HIDALGO,7,220,8,235,1531
MÉXICO,TEJUPILCO DE HIDALGO,27,234,7,268,1537
MÉXICO,TEJUPILCO DE HIDALGO,22,210,12,244,1536
MÉXICO,TEJUPILCO DE HIDALGO,5,140,0,145,1514
MÉXICO,TEJUPILCO DE HIDALGO,12,134,8,154,1504
MÉXICO,TEJUPILCO DE HIDALGO,10,265,3,278,1791
MÉXICO,TEJUPILCO DE HIDALGO,16,281,4,301,1791
MÉXICO,TEJUPILCO DE HIDALGO,8,242,6,256,1791
MÉXICO,CUAUTITLAN,12,220,4,236,1734
MÉXICO,CUAUTITLAN,8,202,3,213,1734
MÉXICO,CUAUTITLAN,9,237,3,249,1733
MÉXICO,CUAUTITLAN,9,312,0,321,1882
MÉXICO,CUAUTITLAN,9,337,1,347,1882
MÉXICO,CUAUTITLAN,16,319,2,337,1552
MÉXICO,CUAUTITLAN,12,298,4,314,1552
MÉXICO,CUAUTITLAN,7,262,3,272,1551
MÉXICO,CUAUTITLAN,19,315,4,338,1850
MÉXICO,CUAUTITLAN,15,317,4,336,1607
MÉXICO,CUAUTITLAN,20,285,7,312,1606
MÉXICO,CUAUTITLAN,24,255,5,284,1827
MÉXICO,CUAUTITLAN,15,214,5,234,1826
MÉXICO,CUAUTITLAN,14,195,3,212,1459
MÉXICO,CUAUTITLAN,10,201,2,213,1458
MÉXICO,CUAUTITLAN,23,371,3,397,1747
MÉXICO,CUAUTITLAN,14,283,7,304,1950
MÉXICO,CUAUTITLAN,13,261,3,277,1949
MÉXICO,CUAUTITLAN,3,187,0,190,1389
MÉXICO,CUAUTITLAN,4,182,1,187,1389
MÉXICO,CUAUTITLAN,7,167,2,176,1389
MÉXICO,CUAUTITLAN,28,239,1,268,1981
MÉXICO,CUAUTITLAN,45,246,5,296,1657
MÉXICO,CUAUTITLAN,36,235,2,273,1657
MÉXICO,CUAUTITLAN,24,244,1,269,1604
MÉXICO,CUAUTITLAN,18,223,0,241,1604
MÉXICO,CUAUTITLAN,21,286,3,310,1695
MÉXICO,CUAUTITLAN,20,295,5,320,1694
MÉXICO,CUAUTITLAN,22,198,2,222,1896
MÉXICO,CUAUTITLAN,17,229,4,250,1895
MÉXICO,CUAUTITLAN,24,222,2,248,1895
MÉXICO,CUAUTITLAN,32,202,0,234,1895
MÉXICO,CUAUTITLAN,34,212,0,246,1895
MÉXICO,CUAUTITLAN,19,234,4,257,1895
MÉXICO,CUAUTITLAN,33,214,0,247,1895
MÉXICO,CUAUTITLAN,29,227,10,266,1533
MÉXICO,CUAUTITLAN,17,263,1,281,1532
MÉXICO,CUAUTITLAN,30,225,4,259,1532
MÉXICO,CUAUTITLAN,34,251,0,285,1633
MÉXICO,CUAUTITLAN,16,220,3,239,1616
MÉXICO,CUAUTITLAN,87,742,7,836,0
MÉXICO,CUAUTITLAN,32,321,2,355,1751
MÉXICO,CUAUTITLAN,35,351,2,388,1751
MÉXICO,CUAUTITLAN,26,145,1,172,1086
MÉXICO,CUAUTITLAN,14,134,0,148,1086
MÉXICO,CUAUTITLAN,30,234,2,266,1826
MÉXICO,CUAUTITLAN,32,339,4,375,1889
MÉXICO,CUAUTITLAN,27,331,4,362,1888
MÉXICO,CUAUTITLAN,20,254,1,275,1899
MÉXICO,CUAUTITLAN,24,253,0,277,1898
MÉXICO,CUAUTITLAN,27,226,3,256,1898
MÉXICO,CUAUTITLAN,19,257,0,276,1898
MÉXICO,CUAUTITLAN,18,229,3,250,1898
MÉXICO,CUAUTITLAN,21,232,2,255,1898
MÉXICO,CUAUTITLAN,28,232,0,260,1706
MÉXICO,CUAUTITLAN,24,249,2,275,1706
MÉXICO,CUAUTITLAN,17,225,4,246,1705
MÉXICO,CUAUTITLAN,9,119,0,128,1028
MÉXICO,CUAUTITLAN,12,122,0,134,1027
MÉXICO,CUAUTITLAN,26,164,0,190,1101
MÉXICO,CUAUTITLAN,8,175,2,185,1100
MÉXICO,CUAUTITLAN,27,224,0,251,1883
MÉXICO,CUAUTITLAN,12,228,1,241,1882
MÉXICO,CUAUTITLAN,19,219,1,239,1882
MÉXICO,CUAUTITLAN,17,229,4,250,1882
MÉXICO,CUAUTITLAN,15,242,7,264,1832
MÉXICO,CUAUTITLAN,7,263,1,271,1832
MÉXICO,CUAUTITLAN,16,240,4,260,1897
MÉXICO,CUAUTITLAN,28,262,0,290,1897
MÉXICO,CUAUTITLAN,23,226,3,252,1897
MÉXICO,CUAUTITLAN,19,244,2,265,1897
MÉXICO,CUAUTITLAN,18,228,2,248,1897
MÉXICO,CUAUTITLAN,22,243,0,265,1896
MÉXICO,CUAUTITLAN,13,233,3,249,1429
MÉXICO,CUAUTITLAN,21,274,2,297,1429
MÉXICO,CUAUTITLAN,21,310,1,332,1429
MÉXICO,CUAUTITLAN,12,296,2,310,1692
MÉXICO,CUAUTITLAN,22,399,1,422,1691
MÉXICO,CUAUTITLAN,21,323,3,347,1982
MÉXICO,CUAUTITLAN,21,366,12,399,1982
MÉXICO,CUAUTITLAN,18,324,2,344,1976
MÉXICO,CUAUTITLAN,15,338,6,359,1976
MÉXICO,CUAUTITLAN,16,285,3,304,1542
MÉXICO,CUAUTITLAN,13,341,4,358,1541
MÉXICO,CUAUTITLAN,18,362,5,385,1618
MÉXICO,CUAUTITLAN,18,360,1,379,1617
MÉXICO,CUAUTITLAN,15,240,2,257,1245
MÉXICO,CUAUTITLAN,22,234,2,258,1244
MÉXICO,CUAUTITLAN,21,329,5,355,1543
MÉXICO,CUAUTITLAN,26,303,2,331,1543
MÉXICO,CUAUTITLAN,18,354,2,374,1543
MÉXICO,CUAUTITLAN,21,255,3,279,1688
MÉXICO,CUAUTITLAN,23,243,3,269,1688
MÉXICO,CUAUTITLAN,30,288,8,326,1687
MÉXICO,CUAUTITLAN,26,254,9,289,1953
MÉXICO,CUAUTITLAN,15,268,2,285,1953
MÉXICO,CUAUTITLAN,18,291,5,314,1953
MÉXICO,CUAUTITLAN,9,229,4,242,1532
MÉXICO,CUAUTITLAN,10,254,2,266,1532
MÉXICO,CUAUTITLAN,12,236,1,249,1474
MÉXICO,CUAUTITLAN,21,260,1,282,1474
MÉXICO,CUAUTITLAN,14,250,2,266,1560
MÉXICO,CUAUTITLAN,18,229,1,248,1559
MÉXICO,CUAUTITLAN,0,237,4,241,1559
MÉXICO,CUAUTITLAN,17,201,1,219,1783
MÉXICO,CUAUTITLAN,22,279,1,302,1580
MÉXICO,CUAUTITLAN,16,328,3,347,1580
MÉXICO,CUAUTITLAN,14,207,4,225,1117
MÉXICO,CUAUTITLAN,7,213,0,220,1116
MÉXICO,CUAUTITLAN,22,289,0,311,1891
MÉXICO,CUAUTITLAN,11,198,1,210,1574
MÉXICO,CUAUTITLAN,10,204,4,218,1573
MÉXICO,CUAUTITLAN,11,219,4,234,1573
MÉXICO,CUAUTITLAN,13,227,2,242,1344
MÉXICO,CUAUTITLAN,12,268,0,280,1343
MÉXICO,CUAUTITLAN,18,281,1,300,1501
MÉXICO,CUAUTITLAN,12,269,1,282,1501
MÉXICO,CUAUTITLAN,28,365,4,397,1842
MÉXICO,CUAUTITLAN,12,137,1,150,998
MÉXICO,CUAUTITLAN,9,134,1,144,997
MÉXICO,CUAUTITLAN,7,219,1,227,1234
MÉXICO,CUAUTITLAN,11,218,0,229,1233
MÉXICO,CUAUTITLAN,10,268,2,280,1456
MÉXICO,CUAUTITLAN,13,232,3,248,1455
MÉXICO,CUAUTITLAN,10,261,2,273,1605
MÉXICO,CUAUTITLAN,16,264,2,282,1604
MÉXICO,CUAUTITLAN,9,195,9,213,1718
MÉXICO,CUAUTITLAN,12,233,4,249,1717
MÉXICO,CUAUTITLAN,18,354,6,378,1764
MÉXICO,CUAUTITLAN,14,281,1,296,1902
MÉXICO,CUAUTITLAN,26,249,1,276,1902
MÉXICO,CUAUTITLAN,10,326,5,341,1917
MÉXICO,CUAUTITLAN,4,227,1,232,1363
MÉXICO,CUAUTITLAN,9,194,3,206,1363
MÉXICO,CUAUTITLAN,9,186,4,199,1362
MÉXICO,CUAUTITLAN,11,158,2,171,1199
MÉXICO,CUAUTITLAN,12,220,1,233,1198
MÉXICO,CUAUTITLAN,16,203,0,219,1496
MÉXICO,CUAUTITLAN,5,201,0,206,1496
MÉXICO,CUAUTITLAN,13,190,0,203,1496
MÉXICO,CUAUTITLAN,12,267,2,281,1990
MÉXICO,CUAUTITLAN,20,249,2,271,1587
MÉXICO,CUAUTITLAN,15,242,2,259,1586
MÉXICO,CUAUTITLAN,7,205,1,213,1304
MÉXICO,CUAUTITLAN,16,194,0,210,1304
MÉXICO,CUAUTITLAN,20,278,5,303,1815
MÉXICO,CUAUTITLAN,33,287,6,326,1814
MÉXICO,CUAUTITLAN,19,250,2,271,1919
MÉXICO,CUAUTITLAN,23,326,3,352,1918
MÉXICO,CUAUTITLAN,18,284,2,304,1342
MÉXICO,CUAUTITLAN,19,299,5,323,1341
MÉXICO,CUAUTITLAN,26,307,2,335,1780
MÉXICO,CUAUTITLAN,32,280,0,312,1779
MÉXICO,CUAUTITLAN,12,153,0,165,1127
MÉXICO,CUAUTITLAN,9,174,0,183,1126
MÉXICO,CUAUTITLAN,20,198,2,220,1185
MÉXICO,CUAUTITLAN,3,164,3,170,1184
MÉXICO,CUAUTITLAN,28,240,2,270,1354
MÉXICO,CUAUTITLAN,23,240,4,267,1353
MÉXICO,CUAUTITLAN,26,195,1,222,1313
MÉXICO,CUAUTITLAN,19,210,0,229,1313
MÉXICO,CUAUTITLAN,18,185,1,204,1086
MÉXICO,CUAUTITLAN,20,186,0,206,1085
MÉXICO,CUAUTITLAN,36,298,5,339,1915
MÉXICO,CUAUTITLAN,23,294,3,320,1914
MÉXICO,CUAUTITLAN,10,228,3,241,1216
MÉXICO,CUAUTITLAN,17,181,0,198,1216
MÉXICO,CUAUTITLAN,19,274,4,297,1714
MÉXICO,CUAUTITLAN,20,266,5,291,1713
MÉXICO,CUAUTITLAN,25,213,4,242,1596
MÉXICO,CUAUTITLAN,13,196,10,219,1595
MÉXICO,CUAUTITLAN,13,235,8,256,1573
MÉXICO,CUAUTITLAN,24,220,2,246,1573
MÉXICO,CUAUTITLAN,14,210,2,226,1572
MÉXICO,CUAUTITLAN,15,232,1,248,1572
MÉXICO,CUAUTITLAN,18,207,2,227,1686
MÉXICO,CUAUTITLAN,19,217,1,237,1686
MÉXICO,CUAUTITLAN,12,189,3,204,1686
MÉXICO,CUAUTITLAN,14,189,0,203,1159
MÉXICO,CUAUTITLAN,7,169,4,180,1159
MÉXICO,CUAUTITLAN,11,133,3,147,1447
MÉXICO,CUAUTITLAN,18,196,3,217,1447
MÉXICO,CUAUTITLAN,20,163,2,185,1399
MÉXICO,CUAUTITLAN,15,144,2,161,1399
MÉXICO,CUAUTITLAN,12,178,2,192,1399
MÉXICO,CUAUTITLAN,31,225,1,257,1572
MÉXICO,CUAUTITLAN,25,196,1,222,1790
MÉXICO,CUAUTITLAN,27,158,1,186,1537
MÉXICO,CUAUTITLAN,26,156,0,182,1537
MÉXICO,CUAUTITLAN,23,192,2,217,1598
MÉXICO,CUAUTITLAN,16,310,1,327,1794
MÉXICO,CUAUTITLAN,36,236,2,274,1884
MÉXICO,CUAUTITLAN,25,233,1,259,1858
MÉXICO,TEXCOCO DE MORA,28,256,2,286,1729
MÉXICO,TEXCOCO DE MORA,14,269,9,292,1729
MÉXICO,TEXCOCO DE MORA,21,193,2,216,1098
MÉXICO,TEXCOCO DE MORA,10,185,1,196,1097
MÉXICO,TEXCOCO DE MORA,20,231,3,254,1776
MÉXICO,TEXCOCO DE MORA,272,17,2,291,1776
MÉXICO,TEXCOCO DE MORA,17,265,4,286,1371
MÉXICO,TEXCOCO DE MORA,25,213,1,239,1371
MÉXICO,TEXCOCO DE MORA,22,246,2,270,1660
MÉXICO,TEXCOCO DE MORA,14,266,2,282,1660
MÉXICO,TEXCOCO DE MORA,32,197,7,236,1925
MÉXICO,TEXCOCO DE MORA,29,211,9,249,1924
MÉXICO,TEXCOCO DE MORA,43,188,10,241,1924
MÉXICO,TEXCOCO DE MORA,32,212,6,250,1924
MÉXICO,TEXCOCO DE MORA,28,214,5,247,1924
MÉXICO,TEXCOCO DE MORA,30,189,4,223,1732
MÉXICO,TEXCOCO DE MORA,18,212,1,231,1732
MÉXICO,TEXCOCO DE MORA,5,15,2,22,1208
MÉXICO,TEXCOCO DE MORA,3,16,1,20,1208
MÉXICO,TEXCOCO DE MORA,0,33,0,33,1255
MÉXICO,TEXCOCO DE MORA,0,16,0,16,1254
MÉXICO,TEXCOCO DE MORA,0,0,0,0,1632
MÉXICO,TEXCOCO DE MORA,0,0,0,0,1631
MÉXICO,TEXCOCO DE MORA,0,0,0,0,1596
MÉXICO,TEXCOCO DE MORA,0,0,0,0,1595
MÉXICO,TEXCOCO DE MORA,18,169,2,189,1456
MÉXICO,TEXCOCO DE MORA,13,160,1,174,1456
MÉXICO,TEXCOCO DE MORA,18,152,2,172,1456
MÉXICO,TEXCOCO DE MORA,15,142,5,162,1589
MÉXICO,TEXCOCO DE MORA,17,135,1,153,1589
MÉXICO,TEXCOCO DE MORA,10,220,1,231,1429
MÉXICO,TEXCOCO DE MORA,8,208,9,225,1429
MÉXICO,TEXCOCO DE MORA,11,235,1,247,1428
MÉXICO,TEXCOCO DE MORA,13,241,0,254,1614
MÉXICO,TEXCOCO DE MORA,24,224,8,256,1613
MÉXICO,TEXCOCO DE MORA,14,149,1,164,1064
MÉXICO,TEXCOCO DE MORA,12,172,1,185,1064
MÉXICO,TEXCOCO DE MORA,9,216,4,229,1504
MÉXICO,TEXCOCO DE MORA,11,206,2,219,1503
MÉXICO,TEXCOCO DE MORA,11,184,3,198,1503
MÉXICO,TEXCOCO DE MORA,9,201,0,210,1221
MÉXICO,TEXCOCO DE MORA,12,240,0,252,1220
MÉXICO,TEXCOCO DE MORA,28,256,1,285,1104
MÉXICO,TEXCOCO DE MORA,30,234,4,268,1103
MÉXICO,TEXCOCO DE MORA,18,201,1,220,1206
MÉXICO,TEXCOCO DE MORA,22,155,3,180,1205
MÉXICO,TEXCOCO DE MORA,37,377,13,427,2019
MÉXICO,TEXCOCO DE MORA,35,330,9,374,2018
MÉXICO,TEXCOCO DE MORA,32,218,2,252,1811
MÉXICO,TEXCOCO DE MORA,29,221,6,256,1810
MÉXICO,TEXCOCO DE MORA,41,275,2,318,1653
MÉXICO,TEXCOCO DE MORA,34,189,5,228,1653
MÉXICO,TEXCOCO DE MORA,42,266,6,314,1867
MÉXICO,TEXCOCO DE MORA,31,257,6,294,1867
MÉXICO,TEXCOCO DE MORA,28,117,3,148,1142
MÉXICO,TEXCOCO DE MORA,24,153,2,179,1141
MÉXICO,TEXCOCO DE MORA,144,1448,13,1605,0
MÉXICO,TEXCOCO DE MORA,37,297,6,340,1683
MÉXICO,TEXCOCO DE MORA,41,288,6,335,1683
MÉXICO,TEXCOCO DE MORA,52,282,6,340,1683
MÉXICO,TEXCOCO DE MORA,35,297,10,342,1835
MÉXICO,TEXCOCO DE MORA,49,252,5,306,1835
MÉXICO,TEXCOCO DE MORA,52,321,4,377,1815
MÉXICO,TEXCOCO DE MORA,43,331,5,379,1814
MÉXICO,TEXCOCO DE MORA,37,325,1,363,1938
MÉXICO,TEXCOCO DE MORA,27,344,3,374,1938
MÉXICO,TEXCOCO DE MORA,19,163,5,187,1445
MÉXICO,TEXCOCO DE MORA,15,161,4,180,1444
MÉXICO,TEXCOCO DE MORA,14,162,3,179,1444
MÉXICO,TEXCOCO DE MORA,30,200,2,232,1411
MÉXICO,TEXCOCO DE MORA,27,160,0,187,1411
MÉXICO,TEXCOCO DE MORA,39,290,5,334,1753
MÉXICO,TEXCOCO DE MORA,31,286,2,319,1752
MÉXICO,TEXCOCO DE MORA,27,313,3,343,1913
MÉXICO,TEXCOCO DE MORA,33,297,6,336,1912
MÉXICO,TEXCOCO DE MORA,23,194,8,225,1156
MÉXICO,TEXCOCO DE MORA,15,184,4,203,1156
MÉXICO,TEXCOCO DE MORA,36,271,8,315,1886
MÉXICO,TEXCOCO DE MORA,40,303,4,347,1886
MÉXICO,TEXCOCO DE MORA,19,180,5,204,1607
MÉXICO,TEXCOCO DE MORA,18,188,6,212,1606
MÉXICO,TEXCOCO DE MORA,25,215,3,243,1582
MÉXICO,TEXCOCO DE MORA,36,188,4,228,1581
MÉXICO,TEXCOCO DE MORA,26,193,3,222,1581
MÉXICO,TEXCOCO DE MORA,20,369,3,392,2015
MÉXICO,TEXCOCO DE MORA,25,373,2,400,2015
MÉXICO,TEXCOCO DE MORA,25,244,1,270,1838
MÉXICO,TEXCOCO DE MORA,13,184,1,198,1838
MÉXICO,TEXCOCO DE MORA,17,231,2,250,1838
MÉXICO,TEXCOCO DE MORA,15,216,0,231,1837
MÉXICO,TEXCOCO DE MORA,22,322,2,346,1612
MÉXICO,TEXCOCO DE MORA,29,265,2,296,1612
MÉXICO,TEXCOCO DE MORA,18,291,5,314,1612
MÉXICO,TEXCOCO DE MORA,31,295,3,329,1725
MÉXICO,TEXCOCO DE MORA,21,269,1,291,1725
MÉXICO,TEXCOCO DE MORA,26,462,14,502,1738
MÉXICO,TEXCOCO DE MORA,23,421,4,448,1738
MÉXICO,TEXCOCO DE MORA,46,260,4,310,1685
MÉXICO,TEXCOCO DE MORA,46,247,5,298,1685
MÉXICO,TEXCOCO DE MORA,28,294,6,328,1689
MÉXICO,TEXCOCO DE MORA,34,285,7,326,1689
MÉXICO,TEXCOCO DE MORA,21,216,5,242,1239
MÉXICO,TEXCOCO DE MORA,44,212,6,262,1238
MÉXICO,TEXCOCO DE MORA,14,191,2,207,1736
MÉXICO,TEXCOCO DE MORA,16,161,4,181,1736
MÉXICO,TEXCOCO DE MORA,37,258,6,301,1583
MÉXICO,TEXCOCO DE MORA,28,248,4,280,1583
MÉXICO,TEXCOCO DE MORA,17,238,3,258,1381
MÉXICO,TEXCOCO DE MORA,25,248,2,275,1381
MÉXICO,TEXCOCO DE MORA,19,252,11,282,1933
MÉXICO,TEXCOCO DE MORA,33,260,2,295,1932
MÉXICO,TEXCOCO DE MORA,15,190,0,205,1422
MÉXICO,TEXCOCO DE MORA,23,196,7,226,1422
MÉXICO,TEXCOCO DE MORA,30,257,3,290,1180
MÉXICO,TEXCOCO DE MORA,22,207,2,231,1180
MÉXICO,TEXCOCO DE MORA,17,131,7,155,1050
MÉXICO,TEXCOCO DE MORA,10,114,4,128,1050
MÉXICO,TEXCOCO DE MORA,29,337,9,375,2031
MÉXICO,TEXCOCO DE MORA,20,170,2,192,1155
MÉXICO,TEXCOCO DE MORA,20,157,1,178,1155
MÉXICO,TEXCOCO DE MORA,13,191,1,205,1215
MÉXICO,TEXCOCO DE MORA,16,218,5,239,1214
MÉXICO,TEXCOCO DE MORA,31,359,7,397,2056
MÉXICO,TEXCOCO DE MORA,33,238,6,277,1758
MÉXICO,TEXCOCO DE MORA,30,259,1,290,1758
MÉXICO,TEXCOCO DE MORA,40,244,2,286,1527
MÉXICO,TEXCOCO DE MORA,40,231,1,272,1526
MÉXICO,TEXCOCO DE MORA,18,147,5,170,1057
MÉXICO,TEXCOCO DE MORA,22,142,5,169,1057
MÉXICO,TEXCOCO DE MORA,12,174,2,188,1301
MÉXICO,TEXCOCO DE MORA,26,200,4,230,1300
MÉXICO,TEXCOCO DE MORA,22,227,10,259,1887
MÉXICO,TEXCOCO DE MORA,16,212,1,229,1887
MÉXICO,TEXCOCO DE MORA,24,224,3,251,1700
MÉXICO,TEXCOCO DE MORA,21,193,8,222,1700
MÉXICO,TEXCOCO DE MORA,19,191,6,216,1398
MÉXICO,TEXCOCO DE MORA,31,163,3,197,1398
MÉXICO,TEXCOCO DE MORA,29,170,3,202,1666
MÉXICO,TEXCOCO DE MORA,27,204,5,236,1666
MÉXICO,TEXCOCO DE MORA,18,177,4,199,1665
MÉXICO,TEXCOCO DE MORA,22,166,4,192,1665
MÉXICO,TEXCOCO DE MORA,46,305,12,363,1921
MÉXICO,TEXCOCO DE MORA,37,289,5,331,1920
MÉXICO,TEXCOCO DE MORA,41,290,6,337,1920
MÉXICO,TEXCOCO DE MORA,29,263,1,293,1773
MÉXICO,TEXCOCO DE MORA,38,384,0,422,1772
MÉXICO,TEXCOCO DE MORA,39,205,6,250,1329
MÉXICO,TEXCOCO DE MORA,17,207,4,228,1329
MÉXICO,TEXCOCO DE MORA,78,99,3,180,1047
MÉXICO,TEXCOCO DE MORA,2,79,5,86,1047
MÉXICO,TEXCOCO DE MORA,37,288,3,328,1530
MÉXICO,TEXCOCO DE MORA,36,282,4,322,1530
MÉXICO,TEXCOCO DE MORA,21,314,3,338,1530
MÉXICO,TEXCOCO DE MORA,20,268,3,291,1530
MÉXICO,TEXCOCO DE MORA,21,192,4,217,1334
MÉXICO,TEXCOCO DE MORA,24,213,1,238,1334
MÉXICO,TEXCOCO DE MORA,11,87,3,101,1575
MÉXICO,TEXCOCO DE MORA,9,97,3,109,1574
MÉXICO,TEXCOCO DE MORA,6,94,0,100,1574
MÉXICO,TEXCOCO DE MORA,8,111,1,120,1574
MÉXICO,TEXCOCO DE MORA,14,159,5,178,1075
MÉXICO,TEXCOCO DE MORA,15,217,7,239,1074
MÉXICO,TEXCOCO DE MORA,8,123,1,132,1202
MÉXICO,TEXCOCO DE MORA,11,141,1,153,1202
MÉXICO,TEXCOCO DE MORA,38,308,6,352,1976
MÉXICO,TEXCOCO DE MORA,30,285,1,316,1976
MÉXICO,TEXCOCO DE MORA,20,223,2,245,1548
MÉXICO,TEXCOCO DE MORA,20,210,4,234,1548
MÉXICO,TEXCOCO DE MORA,21,243,4,268,1548
MÉXICO,TEXCOCO DE MORA,21,177,9,207,1801
MÉXICO,TEXCOCO DE MORA,18,179,6,203,1801
MÉXICO,TEXCOCO DE MORA,12,202,2,216,1800
MÉXICO,TEXCOCO DE MORA,8,160,1,169,1800
MÉXICO,TEXCOCO DE MORA,19,194,2,215,1800
MÉXICO,TEXCOCO DE MORA,20,155,2,177,1800
MÉXICO,TEXCOCO DE MORA,15,148,3,166,1800
MÉXICO,TEXCOCO DE MORA,22,229,5,256,1862
MÉXICO,TEXCOCO DE MORA,19,213,0,232,1862
MÉXICO,TEXCOCO DE MORA,10,222,0,232,1862
MÉXICO,TEXCOCO DE MORA,25,249,4,278,1934
MÉXICO,TEXCOCO DE MORA,29,233,5,267,1933
MÉXICO,TEXCOCO DE MORA,10,236,6,252,1933
MÉXICO,TEXCOCO DE MORA,20,295,4,319,1912
MÉXICO,TEXCOCO DE MORA,19,279,3,301,1911
MÉXICO,TEXCOCO DE MORA,21,185,3,209,1311
MÉXICO,TEXCOCO DE MORA,24,155,0,179,1310
MÉXICO,TEXCOCO DE MORA,30,231,4,265,1770
MÉXICO,TEXCOCO DE MORA,24,245,4,273,1770
MÉXICO,TEXCOCO DE MORA,29,246,2,277,1769
MÉXICO,TEXCOCO DE MORA,33,292,3,328,1653
MÉXICO,TEXCOCO DE MORA,31,284,5,320,1652
MÉXICO,TEXCOCO DE MORA,30,261,3,294,1772
MÉXICO,TEXCOCO DE MORA,32,253,7,292,1772
MÉXICO,LOS REYES ACAQUILPAN,22,341,4,367,1915
MÉXICO,LOS REYES ACAQUILPAN,43,388,7,438,1918
MÉXICO,LOS REYES ACAQUILPAN,11,198,2,211,1001
MÉXICO,LOS REYES ACAQUILPAN,16,182,2,200,1001
MÉXICO,LOS REYES ACAQUILPAN,24,186,0,210,1095
MÉXICO,LOS REYES ACAQUILPAN,20,199,4,223,1095
MÉXICO,LOS REYES ACAQUILPAN,25,254,6,285,1853
MÉXICO,LOS REYES ACAQUILPAN,27,244,2,273,1607
MÉXICO,LOS REYES ACAQUILPAN,19,217,4,240,1606
MÉXICO,LOS REYES ACAQUILPAN,19,266,3,288,1447
MÉXICO,LOS REYES ACAQUILPAN,15,268,2,285,1446
MÉXICO,LOS REYES ACAQUILPAN,27,276,8,311,1861
MÉXICO,LOS REYES ACAQUILPAN,23,293,4,320,1861
MÉXICO,LOS REYES ACAQUILPAN,15,238,0,253,1698
MÉXICO,LOS REYES ACAQUILPAN,18,247,4,269,1698
MÉXICO,LOS REYES ACAQUILPAN,23,184,0,207,1190
MÉXICO,LOS REYES ACAQUILPAN,19,196,0,215,1190
MÉXICO,LOS REYES ACAQUILPAN,24,243,3,270,1659
MÉXICO,LOS REYES ACAQUILPAN,26,290,3,319,1659
MÉXICO,LOS REYES ACAQUILPAN,41,281,4,326,1727
MÉXICO,LOS REYES ACAQUILPAN,18,216,4,238,1662
MÉXICO,LOS REYES ACAQUILPAN,24,221,3,248,1662
MÉXICO,LOS REYES ACAQUILPAN,13,222,2,237,1662
MÉXICO,LOS REYES ACAQUILPAN,27,307,3,337,1867
MÉXICO,LOS REYES ACAQUILPAN,19,280,3,302,1866
MÉXICO,LOS REYES ACAQUILPAN,26,185,4,215,1517
MÉXICO,LOS REYES ACAQUILPAN,24,185,3,212,1517
MÉXICO,LOS REYES ACAQUILPAN,17,195,2,214,1517
MÉXICO,LOS REYES ACAQUILPAN,26,220,2,248,1368
MÉXICO,LOS REYES ACAQUILPAN,18,227,2,247,1367
MÉXICO,LOS REYES ACAQUILPAN,36,223,1,260,1367
MÉXICO,LOS REYES ACAQUILPAN,12,153,1,166,1350
MÉXICO,LOS REYES ACAQUILPAN,11,134,5,150,1350
MÉXICO,LOS REYES ACAQUILPAN,9,142,1,152,1349
MÉXICO,LOS REYES ACAQUILPAN,19,228,4,251,1595
MÉXICO,LOS REYES ACAQUILPAN,16,181,3,200,1365
MÉXICO,LOS REYES ACAQUILPAN,14,170,4,188,1365
MÉXICO,LOS REYES ACAQUILPAN,19,206,4,229,1364
MÉXICO,LOS REYES ACAQUILPAN,11,167,1,179,1027
MÉXICO,LOS REYES ACAQUILPAN,22,127,0,149,1026
MÉXICO,LOS REYES ACAQUILPAN,20,214,3,237,1692
MÉXICO,LOS REYES ACAQUILPAN,21,247,7,275,1691
MÉXICO,LOS REYES ACAQUILPAN,24,229,3,256,1691
MÉXICO,LOS REYES ACAQUILPAN,16,176,4,196,1691
MÉXICO,LOS REYES ACAQUILPAN,10,257,0,267,1639
MÉXICO,LOS REYES ACAQUILPAN,28,260,6,294,1639
MÉXICO,LOS REYES ACAQUILPAN,19,249,3,271,1639
MÉXICO,LOS REYES ACAQUILPAN,13,216,6,235,1838
MÉXICO,LOS REYES ACAQUILPAN,18,177,2,197,1838
MÉXICO,LOS REYES ACAQUILPAN,19,199,4,222,1838
MÉXICO,LOS REYES ACAQUILPAN,9,191,8,208,1838
MÉXICO,LOS REYES ACAQUILPAN,15,187,3,205,1837
MÉXICO,LOS REYES ACAQUILPAN,9,172,2,183,1837
MÉXICO,LOS REYES ACAQUILPAN,15,177,5,197,1837
MÉXICO,LOS REYES ACAQUILPAN,17,171,4,192,1837
MÉXICO,LOS REYES ACAQUILPAN,16,184,0,200,1837
MÉXICO,LOS REYES ACAQUILPAN,16,186,1,203,1837
MÉXICO,LOS REYES ACAQUILPAN,29,245,4,278,1544
MÉXICO,LOS REYES ACAQUILPAN,15,221,5,241,1544
MÉXICO,LOS REYES ACAQUILPAN,21,229,0,250,1544
MÉXICO,LOS REYES ACAQUILPAN,21,267,3,291,1806
MÉXICO,LOS REYES ACAQUILPAN,27,271,6,304,1806
MÉXICO,LOS REYES ACAQUILPAN,26,267,1,294,1805
MÉXICO,LOS REYES ACAQUILPAN,19,271,4,294,1805
MÉXICO,LOS REYES ACAQUILPAN,22,225,2,249,1879
MÉXICO,LOS REYES ACAQUILPAN,21,235,2,258,1879
MÉXICO,LOS REYES ACAQUILPAN,26,227,2,255,1879
MÉXICO,LOS REYES ACAQUILPAN,36,293,2,331,1794
MÉXICO,LOS REYES ACAQUILPAN,24,297,5,326,1793
MÉXICO,LOS REYES ACAQUILPAN,27,196,2,225,1235
MÉXICO,LOS REYES ACAQUILPAN,19,193,3,215,1235
MÉXICO,LOS REYES ACAQUILPAN,13,181,3,197,1213
MÉXICO,LOS REYES ACAQUILPAN,17,189,16,222,1212
MÉXICO,LOS REYES ACAQUILPAN,35,314,3,352,1951
MÉXICO,LOS REYES ACAQUILPAN,20,184,1,205,1157
MÉXICO,LOS REYES ACAQUILPAN,17,172,3,192,1156
MÉXICO,LOS REYES ACAQUILPAN,16,242,3,261,1551
MÉXICO,LOS REYES ACAQUILPAN,32,334,8,374,1993
MÉXICO,LOS REYES ACAQUILPAN,15,184,2,201,1036
MÉXICO,LOS REYES ACAQUILPAN,20,168,5,193,1036
MÉXICO,LOS REYES ACAQUILPAN,20,179,5,204,1053
MÉXICO,LOS REYES ACAQUILPAN,17,186,3,206,1053
MÉXICO,LOS REYES ACAQUILPAN,17,284,3,304,1691
MÉXICO,LOS REYES ACAQUILPAN,15,271,5,291,1565
MÉXICO,LOS REYES ACAQUILPAN,20,297,7,324,1618
MÉXICO,LOS REYES ACAQUILPAN,25,318,4,347,1714
MÉXICO,LOS REYES ACAQUILPAN,22,246,2,270,1523
MÉXICO,LOS REYES ACAQUILPAN,32,253,3,288,1523
MÉXICO,LOS REYES ACAQUILPAN,42,271,1,314,1501
MÉXICO,LOS REYES ACAQUILPAN,22,284,2,308,1931
MÉXICO,LOS REYES ACAQUILPAN,25,288,4,317,1931
MÉXICO,LOS REYES ACAQUILPAN,27,313,2,342,1930
MÉXICO,LOS REYES ACAQUILPAN,42,325,4,371,1698
MÉXICO,LOS REYES ACAQUILPAN,34,284,3,321,1554
MÉXICO,LOS REYES ACAQUILPAN,30,296,8,334,1684
MÉXICO,LOS REYES ACAQUILPAN,15,211,2,228,1531
MÉXICO,LOS REYES ACAQUILPAN,36,322,3,361,1868
MÉXICO,LOS REYES ACAQUILPAN,24,159,7,190,1107
MÉXICO,LOS REYES ACAQUILPAN,14,174,3,191,1107
MÉXICO,LOS REYES ACAQUILPAN,46,354,7,407,1865
MÉXICO,LOS REYES ACAQUILPAN,28,228,8,264,1444
MÉXICO,LOS REYES ACAQUILPAN,29,239,3,271,1443
MÉXICO,LOS REYES ACAQUILPAN,12,197,2,211,1147
MÉXICO,LOS REYES ACAQUILPAN,30,194,3,227,1147
MÉXICO,LOS REYES ACAQUILPAN,21,263,3,287,1458
MÉXICO,LOS REYES ACAQUILPAN,24,219,6,249,1457
MÉXICO,LOS REYES ACAQUILPAN,15,192,4,211,1179
MÉXICO,LOS REYES ACAQUILPAN,15,216,5,236,1179
MÉXICO,LOS REYES ACAQUILPAN,28,226,5,259,1429
MÉXICO,LOS REYES ACAQUILPAN,30,237,4,271,1428
MÉXICO,LOS REYES ACAQUILPAN,26,250,4,280,1869
MÉXICO,LOS REYES ACAQUILPAN,16,281,2,299,1868
MÉXICO,LOS REYES ACAQUILPAN,13,212,0,225,1508
MÉXICO,LOS REYES ACAQUILPAN,12,200,1,213,1507
MÉXICO,LOS REYES ACAQUILPAN,16,196,1,213,1507
MÉXICO,LOS REYES ACAQUILPAN,22,186,0,208,1683
MÉXICO,LOS REYES ACAQUILPAN,18,165,1,184,1683
MÉXICO,LOS REYES ACAQUILPAN,18,161,2,181,1682
MÉXICO,LOS REYES ACAQUILPAN,41,278,9,328,1770
MÉXICO,LOS REYES ACAQUILPAN,35,293,2,330,1821
MÉXICO,LOS REYES ACAQUILPAN,21,261,6,288,1629
MÉXICO,LOS REYES ACAQUILPAN,17,258,0,275,1629
MÉXICO,LOS REYES ACAQUILPAN,29,271,5,305,1816
MÉXICO,LOS REYES ACAQUILPAN,25,283,4,312,1815
MÉXICO,LOS REYES ACAQUILPAN,108,1146,25,1279,0
MÉXICO,LOS REYES ACAQUILPAN,11,188,4,203,1427
MÉXICO,LOS REYES ACAQUILPAN,21,208,1,230,1427
MÉXICO,LOS REYES ACAQUILPAN,22,267,1,290,1789
MÉXICO,LOS REYES ACAQUILPAN,15,284,0,299,1789
MÉXICO,LOS REYES ACAQUILPAN,31,251,3,285,1611
MÉXICO,LOS REYES ACAQUILPAN,14,252,2,268,1673
MÉXICO,LOS REYES ACAQUILPAN,21,225,4,250,1673
MÉXICO,LOS REYES ACAQUILPAN,20,189,3,212,1064
MÉXICO,LOS REYES ACAQUILPAN,19,168,2,189,1064
MÉXICO,LOS REYES ACAQUILPAN,13,168,4,185,1098
MÉXICO,LOS REYES ACAQUILPAN,7,175,2,184,1098
MÉXICO,LOS REYES ACAQUILPAN,38,209,8,255,1593
MÉXICO,LOS REYES ACAQUILPAN,26,292,2,320,1593
MÉXICO,LOS REYES ACAQUILPAN,23,250,4,277,1977
MÉXICO,LOS REYES ACAQUILPAN,26,260,4,290,1977
MÉXICO,LOS REYES ACAQUILPAN,23,239,6,268,1977
MÉXICO,LOS REYES ACAQUILPAN,18,276,5,299,1972
MÉXICO,LOS REYES ACAQUILPAN,0,259,4,263,1972
MÉXICO,LOS REYES ACAQUILPAN,22,229,4,255,1972
MÉXICO,LOS REYES ACAQUILPAN,16,146,2,164,1209
MÉXICO,LOS REYES ACAQUILPAN,12,151,3,166,1208
MÉXICO,LOS REYES ACAQUILPAN,25,243,16,284,1639
MÉXICO,LOS REYES ACAQUILPAN,15,149,5,169,1027
MÉXICO,LOS REYES ACAQUILPAN,11,128,4,143,1026
MÉXICO,LOS REYES ACAQUILPAN,10,127,4,141,1225
MÉXICO,LOS REYES ACAQUILPAN,14,147,4,165,1224
MÉXICO,LOS REYES ACAQUILPAN,24,265,3,292,1721
MÉXICO,LOS REYES ACAQUILPAN,28,247,4,279,1721
MÉXICO,LOS REYES ACAQUILPAN,19,231,7,257,1601
MÉXICO,LOS REYES ACAQUILPAN,17,206,4,227,1601
MÉXICO,LOS REYES ACAQUILPAN,10,158,2,170,1061
MÉXICO,LOS REYES ACAQUILPAN,9,162,3,174,1060
MÉXICO,LOS REYES ACAQUILPAN,25,268,5,298,1892
MÉXICO,LOS REYES ACAQUILPAN,19,164,4,187,1802
MÉXICO,LOS REYES ACAQUILPAN,16,241,3,260,1499
MÉXICO,LOS REYES ACAQUILPAN,22,231,4,257,1498
MÉXICO,LOS REYES ACAQUILPAN,19,304,0,323,1770
MÉXICO,LOS REYES ACAQUILPAN,16,203,3,222,1319
MÉXICO,LOS REYES ACAQUILPAN,13,210,5,228,1319
MÉXICO,LOS REYES ACAQUILPAN,21,241,4,266,1871
MÉXICO,LOS REYES ACAQUILPAN,19,245,8,272,1870
MÉXICO,LOS REYES ACAQUILPAN,24,197,1,222,1791
MÉXICO,LOS REYES ACAQUILPAN,20,192,2,214,1405
MÉXICO,LOS REYES ACAQUILPAN,21,179,3,203,1404
MÉXICO,LOS REYES ACAQUILPAN,19,244,6,269,1859
MÉXICO,LOS REYES ACAQUILPAN,24,207,4,235,1319
MÉXICO,LOS REYES ACAQUILPAN,18,209,3,230,1318
MÉXICO,LOS REYES ACAQUILPAN,18,185,4,207,1525
MÉXICO,LOS REYES ACAQUILPAN,18,129,2,149,1188
MÉXICO,LOS REYES ACAQUILPAN,18,137,1,156,1188
MÉXICO,SAN MIGUEL ZINACANTEPEC,20,118,1,139,1282
MÉXICO,SAN MIGUEL ZINACANTEPEC,23,101,2,126,1281
MÉXICO,SAN MIGUEL ZINACANTEPEC,15,67,9,91,1372
MÉXICO,SAN MIGUEL ZINACANTEPEC,13,68,5,86,1371
MÉXICO,SAN MIGUEL ZINACANTEPEC,28,136,13,177,1139
MÉXICO,SAN MIGUEL ZINACANTEPEC,22,89,14,125,1139
MÉXICO,SAN MIGUEL ZINACANTEPEC,44,221,15,280,1936
MÉXICO,SAN MIGUEL ZINACANTEPEC,41,206,18,265,1935
MÉXICO,SAN MIGUEL ZINACANTEPEC,35,111,11,157,1435
MÉXICO,SAN MIGUEL ZINACANTEPEC,35,133,13,181,1434
MÉXICO,SAN MIGUEL ZINACANTEPEC,33,129,16,178,1434
MÉXICO,SAN MIGUEL ZINACANTEPEC,30,152,9,191,1605
MÉXICO,SAN MIGUEL ZINACANTEPEC,19,176,13,208,1604
MÉXICO,SAN MIGUEL ZINACANTEPEC,47,143,5,195,1946
MÉXICO,SAN MIGUEL ZINACANTEPEC,36,169,17,222,1945
MÉXICO,SAN MIGUEL ZINACANTEPEC,36,152,13,201,1314
MÉXICO,SAN MIGUEL ZINACANTEPEC,43,149,10,202,1313
MÉXICO,SAN MIGUEL ZINACANTEPEC,25,200,23,248,1722
MÉXICO,SAN MIGUEL ZINACANTEPEC,22,102,3,127,1419
MÉXICO,SAN MIGUEL ZINACANTEPEC,13,110,0,123,1419
MÉXICO,SAN MIGUEL ZINACANTEPEC,10,95,2,107,1418
MÉXICO,SAN MIGUEL ZINACANTEPEC,42,265,4,311,1914
MÉXICO,SAN MIGUEL ZINACANTEPEC,30,247,4,281,1913
MÉXICO,SAN MIGUEL ZINACANTEPEC,36,94,7,137,1936
MÉXICO,SAN MIGUEL ZINACANTEPEC,41,168,10,219,1935
MÉXICO,SAN MIGUEL ZINACANTEPEC,34,69,11,114,1679
MÉXICO,SAN MIGUEL ZINACANTEPEC,28,158,5,191,1948
MÉXICO,SAN MIGUEL ZINACANTEPEC,20,201,3,224,1948
MÉXICO,SAN MIGUEL ZINACANTEPEC,34,225,5,264,1712
MÉXICO,SAN MIGUEL ZINACANTEPEC,15,215,7,237,1712
MÉXICO,SAN MIGUEL ZINACANTEPEC,19,169,4,192,1807
MÉXICO,SAN MIGUEL ZINACANTEPEC,20,139,1,160,1539
MÉXICO,SAN MIGUEL ZINACANTEPEC,16,131,6,153,1539
MÉXICO,SAN MIGUEL ZINACANTEPEC,7,122,4,133,1539
MÉXICO,SAN MIGUEL ZINACANTEPEC,30,157,1,188,1649
MÉXICO,SAN MIGUEL ZINACANTEPEC,25,170,2,197,1649
MÉXICO,SAN MIGUEL ZINACANTEPEC,22,160,3,185,1649
MÉXICO,SAN MIGUEL ZINACANTEPEC,20,118,4,142,1649
MÉXICO,SAN MIGUEL ZINACANTEPEC,26,121,1,148,1648
MÉXICO,SAN MIGUEL ZINACANTEPEC,32,297,6,335,1919
MÉXICO,SAN MIGUEL ZINACANTEPEC,42,281,9,332,1918
MÉXICO,SAN MIGUEL ZINACANTEPEC,8,158,2,168,1558
MÉXICO,SAN MIGUEL ZINACANTEPEC,11,142,1,154,1558
MÉXICO,SAN MIGUEL ZINACANTEPEC,24,127,3,154,1131
MÉXICO,SAN MIGUEL ZINACANTEPEC,17,107,2,126,1130
MÉXICO,SAN MIGUEL ZINACANTEPEC,20,179,2,201,1631
MÉXICO,SAN MIGUEL ZINACANTEPEC,19,180,7,206,1630
MÉXICO,SAN MIGUEL ZINACANTEPEC,34,193,8,235,1506
MÉXICO,SAN MIGUEL ZINACANTEPEC,32,195,8,235,1505
MÉXICO,SAN MIGUEL ZINACANTEPEC,10,135,2,147,1352
MÉXICO,SAN MIGUEL ZINACANTEPEC,13,167,3,183,1352
MÉXICO,SAN MIGUEL ZINACANTEPEC,10,196,5,211,1351
MÉXICO,SAN MIGUEL ZINACANTEPEC,21,154,8,183,1935
MÉXICO,SAN MIGUEL ZINACANTEPEC,18,175,5,198,1935
MÉXICO,SAN MIGUEL ZINACANTEPEC,34,229,5,268,1869
MÉXICO,SAN MIGUEL ZINACANTEPEC,27,95,4,126,1261
MÉXICO,SAN MIGUEL ZINACANTEPEC,13,113,6,132,1260
MÉXICO,SAN MIGUEL ZINACANTEPEC,39,291,3,333,0
MÉXICO,SAN MIGUEL ZINACANTEPEC,28,163,8,199,1430
MÉXICO,SAN MIGUEL ZINACANTEPEC,25,131,9,165,1430
MÉXICO,SAN MIGUEL ZINACANTEPEC,19,179,4,202,1839
MÉXICO,SAN MIGUEL ZINACANTEPEC,34,208,6,248,1692
MÉXICO,SAN MIGUEL ZINACANTEPEC,26,144,1,171,1697
MÉXICO,SAN MIGUEL ZINACANTEPEC,17,147,3,167,1696
MÉXICO,SAN MIGUEL ZINACANTEPEC,35,123,4,162,1696
MÉXICO,SAN MIGUEL ZINACANTEPEC,16,157,5,178,1124
MÉXICO,SAN MIGUEL ZINACANTEPEC,18,144,3,165,1123
MÉXICO,SAN MIGUEL ZINACANTEPEC,22,195,3,220,1430
MÉXICO,SAN MIGUEL ZINACANTEPEC,25,188,4,217,1430
MÉXICO,SAN MIGUEL ZINACANTEPEC,19,167,3,189,1429
MÉXICO,SAN MIGUEL ZINACANTEPEC,20,216,6,242,1407
MÉXICO,SAN MIGUEL ZINACANTEPEC,25,180,5,210,1407
MÉXICO,SAN MIGUEL ZINACANTEPEC,12,219,2,233,1502
MÉXICO,SAN MIGUEL ZINACANTEPEC,21,226,2,249,1501
MÉXICO,SAN MIGUEL ZINACANTEPEC,10,114,2,126,1465
MÉXICO,SAN MIGUEL ZINACANTEPEC,8,95,4,107,1464
MÉXICO,SAN MIGUEL ZINACANTEPEC,15,93,3,111,1464
MÉXICO,SAN MIGUEL ZINACANTEPEC,25,161,54,240,1960
MÉXICO,SAN MIGUEL ZINACANTEPEC,19,201,5,225,1959
MÉXICO,SAN MIGUEL ZINACANTEPEC,6,159,2,167,1880
MÉXICO,SAN MIGUEL ZINACANTEPEC,12,134,5,151,1879
MÉXICO,SAN MIGUEL ZINACANTEPEC,25,277,9,311,1662
MÉXICO,SAN MIGUEL ZINACANTEPEC,24,248,14,286,1662
MÉXICO,SAN MIGUEL ZINACANTEPEC,9,150,3,162,1991
MÉXICO,SAN MIGUEL ZINACANTEPEC,13,167,3,183,1991
MÉXICO,SAN MIGUEL ZINACANTEPEC,12,144,8,164,1350
MÉXICO,SAN MIGUEL ZINACANTEPEC,7,147,4,158,1350
MÉXICO,SAN MIGUEL ZINACANTEPEC,12,118,6,136,1350
MÉXICO,SAN MIGUEL ZINACANTEPEC,17,127,4,148,1784
MÉXICO,SAN MIGUEL ZINACANTEPEC,10,125,9,144,1824
MÉXICO,SAN MIGUEL ZINACANTEPEC,8,131,2,141,1823
MÉXICO,SAN MIGUEL ZINACANTEPEC,24,160,12,196,1067
MÉXICO,SAN MIGUEL ZINACANTEPEC,26,190,8,224,1067
MÉXICO,SAN MIGUEL ZINACANTEPEC,17,127,12,156,1359
MÉXICO,SAN MIGUEL ZINACANTEPEC,12,110,7,129,1359
MÉXICO,SAN MIGUEL ZINACANTEPEC,11,193,5,209,1210
MÉXICO,SAN MIGUEL ZINACANTEPEC,10,190,6,206,1210
MÉXICO,SAN MIGUEL ZINACANTEPEC,34,274,13,321,1676
MÉXICO,SAN MIGUEL ZINACANTEPEC,25,260,11,296,1675
MÉXICO,SAN MIGUEL ZINACANTEPEC,17,120,5,142,1389
MÉXICO,SAN MIGUEL ZINACANTEPEC,18,131,9,158,1389
MÉXICO,SAN MIGUEL ZINACANTEPEC,36,183,7,226,1364
MÉXICO,SAN MIGUEL ZINACANTEPEC,13,180,2,195,1364
MÉXICO,SAN MIGUEL ZINACANTEPEC,14,205,4,223,1364
MÉXICO,SAN MIGUEL ZINACANTEPEC,28,214,5,247,1953
MÉXICO,SAN MIGUEL ZINACANTEPEC,16,92,0,108,1233
MÉXICO,SAN MIGUEL ZINACANTEPEC,11,83,3,97,1233
MÉXICO,SAN MIGUEL ZINACANTEPEC,21,172,5,198,1886
MÉXICO,SAN MIGUEL ZINACANTEPEC,21,176,6,203,1885
MÉXICO,SAN MIGUEL ZINACANTEPEC,24,226,7,257,1850
MÉXICO,SAN MIGUEL ZINACANTEPEC,13,248,5,266,1850
MÉXICO,SAN MIGUEL ZINACANTEPEC,18,257,3,278,1849
MÉXICO,SAN MIGUEL ZINACANTEPEC,21,319,3,343,1638
MÉXICO,SAN MIGUEL ZINACANTEPEC,26,234,5,265,1638
MÉXICO,SAN MIGUEL ZINACANTEPEC,20,229,5,254,1638
MÉXICO,SAN MIGUEL ZINACANTEPEC,38,159,4,201,1740
MÉXICO,SAN MIGUEL ZINACANTEPEC,18,160,6,184,1399
MÉXICO,SAN MIGUEL ZINACANTEPEC,23,173,2,198,1399
MÉXICO,SAN MIGUEL ZINACANTEPEC,18,146,4,168,1546
MÉXICO,SAN MIGUEL ZINACANTEPEC,26,162,2,190,1546
MÉXICO,SAN MIGUEL ZINACANTEPEC,17,153,3,173,1546
MÉXICO,SAN MIGUEL ZINACANTEPEC,14,97,3,114,1114
MÉXICO,SAN MIGUEL ZINACANTEPEC,10,121,1,132,1113
MÉXICO,SAN MIGUEL ZINACANTEPEC,29,193,3,225,1787
MÉXICO,SAN MIGUEL ZINACANTEPEC,26,210,1,237,1786
MÉXICO,SAN MIGUEL ZINACANTEPEC,30,168,2,200,1735
MÉXICO,SAN MIGUEL ZINACANTEPEC,18,151,3,172,1734
MÉXICO,SAN MIGUEL ZINACANTEPEC,27,173,1,201,1734
MÉXICO,SAN MIGUEL ZINACANTEPEC,20,146,7,173,1391
MÉXICO,SAN MIGUEL ZINACANTEPEC,25,177,4,206,1391
MÉXICO,SAN MIGUEL ZINACANTEPEC,24,132,2,158,1715
MÉXICO,SAN MIGUEL ZINACANTEPEC,27,189,2,218,1714
MÉXICO,SAN MIGUEL ZINACANTEPEC,29,203,5,237,1714
MÉXICO,SAN MIGUEL ZINACANTEPEC,12,131,6,149,1304
MÉXICO,SAN MIGUEL ZINACANTEPEC,17,149,0,166,1303
MÉXICO,SAN MIGUEL ZINACANTEPEC,25,125,0,150,1584
MÉXICO,SAN MIGUEL ZINACANTEPEC,24,176,3,203,1717
MÉXICO,SAN MIGUEL ZINACANTEPEC,22,171,0,193,1717
MÉXICO,SAN MIGUEL ZINACANTEPEC,15,161,3,179,1701
MÉXICO,SAN MIGUEL ZINACANTEPEC,13,136,3,152,1700
MÉXICO,SAN MIGUEL ZINACANTEPEC,27,185,3,215,1452
MÉXICO,SAN MIGUEL ZINACANTEPEC,20,148,2,170,1452
MÉXICO,SAN MIGUEL ZINACANTEPEC,13,154,2,169,1452
MÉXICO,SAN MIGUEL ZINACANTEPEC,22,180,5,207,1618
MÉXICO,SAN MIGUEL ZINACANTEPEC,23,160,2,185,1617
MÉXICO,SAN MIGUEL ZINACANTEPEC,13,162,5,180,1617
MÉXICO,SAN MIGUEL ZINACANTEPEC,21,188,1,210,1536
MÉXICO,SAN MIGUEL ZINACANTEPEC,14,169,4,187,1536
MÉXICO,SAN MIGUEL ZINACANTEPEC,14,165,2,181,1536
MÉXICO,SAN MIGUEL ZINACANTEPEC,31,223,2,256,1734
MÉXICO,SAN MIGUEL ZINACANTEPEC,25,181,3,209,1734
MÉXICO,SAN MIGUEL ZINACANTEPEC,28,151,0,179,1734
MÉXICO,SAN MIGUEL ZINACANTEPEC,13,191,1,205,1734
MÉXICO,SAN MIGUEL ZINACANTEPEC,18,179,4,201,1733
MÉXICO,SAN MIGUEL ZINACANTEPEC,38,162,1,201,1733
MÉXICO,SAN MIGUEL ZINACANTEPEC,23,150,1,174,1397
MÉXICO,SAN MIGUEL ZINACANTEPEC,15,177,4,196,1397
MÉXICO,SAN MIGUEL ZINACANTEPEC,21,172,4,197,1054
MÉXICO,SAN MIGUEL ZINACANTEPEC,17,178,3,198,1054
MÉXICO,SAN MIGUEL ZINACANTEPEC,28,183,9,220,1832
MÉXICO,SAN MIGUEL ZINACANTEPEC,27,202,12,241,1832
MÉXICO,SAN MIGUEL ZINACANTEPEC,25,89,7,121,1220
MÉXICO,SAN MIGUEL ZINACANTEPEC,21,90,1,112,1220
MÉXICO,SAN MIGUEL ZINACANTEPEC,15,141,3,159,1358
MÉXICO,SAN MIGUEL ZINACANTEPEC,19,148,4,171,1358
MÉXICO,SAN MIGUEL ZINACANTEPEC,10,152,7,169,1357
MÉXICO,SAN MIGUEL ZINACANTEPEC,20,152,2,174,1537
MÉXICO,SAN MIGUEL ZINACANTEPEC,35,145,2,182,1537
MÉXICO,SAN MIGUEL ZINACANTEPEC,29,159,4,192,1537
MÉXICO,SAN MIGUEL ZINACANTEPEC,47,225,1,273,1734
MÉXICO,SAN MIGUEL ZINACANTEPEC,40,178,1,219,1733
MÉXICO,SAN MIGUEL ZINACANTEPEC,54,191,5,250,1733
MÉXICO,SAN MIGUEL ZINACANTEPEC,27,116,1,144,1501
MÉXICO,SAN MIGUEL ZINACANTEPEC,26,143,0,169,1501
MÉXICO,SAN MIGUEL ZINACANTEPEC,15,198,5,218,1611
MÉXICO,SAN MIGUEL ZINACANTEPEC,16,168,4,188,1611
MÉXICO,SAN MIGUEL ZINACANTEPEC,14,153,9,176,1610
MÉXICO,SAN MIGUEL ZINACANTEPEC,20,202,5,227,1572
MÉXICO,SAN MIGUEL ZINACANTEPEC,18,161,8,187,1572
MÉXICO,SAN MIGUEL ZINACANTEPEC,19,156,2,177,1956
MÉXICO,SAN MIGUEL ZINACANTEPEC,24,155,8,187,1955
MÉXICO,SAN MIGUEL ZINACANTEPEC,20,194,6,220,1955
MÉXICO,SAN MIGUEL ZINACANTEPEC,33,158,6,197,1955
MÉXICO,SAN MIGUEL ZINACANTEPEC,34,168,4,206,1759
MÉXICO,SAN MIGUEL ZINACANTEPEC,25,163,4,192,1758
MÉXICO,SAN MIGUEL ZINACANTEPEC,16,95,5,116,1675
MÉXICO,SAN MIGUEL ZINACANTEPEC,22,96,4,122,1675
MÉXICO,SAN MIGUEL ZINACANTEPEC,19,143,3,165,1674
MÉXICO,SAN MIGUEL ZINACANTEPEC,30,165,12,207,1954
MÉXICO,SAN MIGUEL ZINACANTEPEC,25,151,6,182,1954
MÉXICO,SAN MIGUEL ZINACANTEPEC,40,171,8,219,1954
MÉXICO,SAN MIGUEL ZINACANTEPEC,31,221,6,258,1539
MÉXICO,SAN MIGUEL ZINACANTEPEC,34,214,9,257,1539
MÉXICO,SAN MIGUEL ZINACANTEPEC,26,194,3,223,1614
MÉXICO,SAN MIGUEL ZINACANTEPEC,32,214,3,249,1613
MÉXICO,SAN MIGUEL ZINACANTEPEC,36,211,0,247,1544
MÉXICO,SAN MIGUEL ZINACANTEPEC,22,195,1,218,1543
MÉXICO,SAN MIGUEL ZINACANTEPEC,26,152,4,182,1060
MÉXICO,SAN MIGUEL ZINACANTEPEC,30,158,1,189,1059
MÉXICO,SAN MIGUEL ZINACANTEPEC,15,180,2,197,1206
MÉXICO,SAN MIGUEL ZINACANTEPEC,30,190,10,230,1206
MÉXICO,SAN MIGUEL ZINACANTEPEC,35,186,5,226,1620
MÉXICO,SAN MIGUEL ZINACANTEPEC,44,168,6,218,1619
MÉXICO,SAN MIGUEL ZINACANTEPEC,31,166,5,202,1619
MÉXICO,SAN MIGUEL ZINACANTEPEC,25,197,2,224,1962
MÉXICO,SAN MIGUEL ZINACANTEPEC,27,211,3,241,1961
MÉXICO,SAN MIGUEL ZINACANTEPEC,28,197,8,233,1289
MÉXICO,SAN MIGUEL ZINACANTEPEC,27,182,3,212,1288
MÉXICO,SAN MIGUEL ZINACANTEPEC,36,270,10,316,1528
MÉXICO,SAN MIGUEL ZINACANTEPEC,37,235,7,279,1659
MÉXICO,SAN MIGUEL ZINACANTEPEC,27,61,1,89,1086
MÉXICO,SAN MIGUEL ZINACANTEPEC,30,76,2,108,1086
MÉXICO,OJO DE AGUA,40,361,7,408,1738
MÉXICO,OJO DE AGUA,41,341,6,388,1738
MÉXICO,OJO DE AGUA,26,214,3,243,1372
MÉXICO,OJO DE AGUA,21,223,3,247,1371
MÉXICO,OJO DE AGUA,9,221,3,233,1371
MÉXICO,OJO DE AGUA,25,268,4,297,1307
MÉXICO,OJO DE AGUA,18,273,3,294,1306
MÉXICO,OJO DE AGUA,11,254,4,269,1698
MÉXICO,OJO DE AGUA,23,228,4,255,1698
MÉXICO,OJO DE AGUA,16,243,4,263,1698
MÉXICO,OJO DE AGUA,22,221,2,245,1698
MÉXICO,OJO DE AGUA,20,234,3,257,1697
MÉXICO,OJO DE AGUA,32,227,2,261,1118
MÉXICO,OJO DE AGUA,30,254,4,288,1118
MÉXICO,OJO DE AGUA,72,1128,10,1210,0
MÉXICO,OJO DE AGUA,45,487,22,554,1937
MÉXICO,OJO DE AGUA,37,521,8,566,1937
MÉXICO,OJO DE AGUA,33,408,7,448,1887
MÉXICO,OJO DE AGUA,47,447,1,495,1887
MÉXICO,OJO DE AGUA,52,420,7,479,2031
MÉXICO,OJO DE AGUA,34,384,8,426,1511
MÉXICO,OJO DE AGUA,36,377,3,416,1510
MÉXICO,OJO DE AGUA,43,366,5,414,1610
MÉXICO,OJO DE AGUA,43,373,8,424,1609
MÉXICO,OJO DE AGUA,45,352,8,405,1746
MÉXICO,OJO DE AGUA,43,484,7,534,1980
MÉXICO,OJO DE AGUA,34,361,7,402,1444
MÉXICO,OJO DE AGUA,45,346,10,401,1443
MÉXICO,OJO DE AGUA,47,413,5,465,1443
MÉXICO,OJO DE AGUA,67,415,21,503,2044
MÉXICO,OJO DE AGUA,68,487,10,565,2043
MÉXICO,OJO DE AGUA,35,352,7,394,1674
MÉXICO,OJO DE AGUA,40,354,6,400,1674
MÉXICO,OJO DE AGUA,50,398,7,455,1661
MÉXICO,OJO DE AGUA,51,447,4,502,1660
MÉXICO,OJO DE AGUA,42,244,4,290,1767
MÉXICO,OJO DE AGUA,18,231,1,250,1767
MÉXICO,OJO DE AGUA,28,246,3,277,1767
MÉXICO,OJO DE AGUA,25,217,4,246,1767
MÉXICO,OJO DE AGUA,34,240,2,276,1766
MÉXICO,OJO DE AGUA,37,309,5,351,1370
MÉXICO,OJO DE AGUA,38,254,2,294,1370
MÉXICO,OJO DE AGUA,42,369,7,418,1828
MÉXICO,OJO DE AGUA,33,338,5,376,1827
MÉXICO,OJO DE AGUA,21,382,5,408,1765
MÉXICO,OJO DE AGUA,28,421,5,454,1764
MÉXICO,OJO DE AGUA,44,359,6,409,1900
MÉXICO,OJO DE AGUA,43,368,3,414,1900
MÉXICO,OJO DE AGUA,45,375,4,424,1900
MÉXICO,OJO DE AGUA,42,385,4,431,1900
MÉXICO,OJO DE AGUA,43,413,9,465,1900
MÉXICO,OJO DE AGUA,38,331,3,372,1900
MÉXICO,OJO DE AGUA,39,395,8,442,1900
MÉXICO,OJO DE AGUA,36,377,11,424,1900
MÉXICO,OJO DE AGUA,35,487,11,533,1811
MÉXICO,OJO DE AGUA,50,483,8,541,1811
MÉXICO,OJO DE AGUA,24,364,13,401,1453
MÉXICO,OJO DE AGUA,45,327,13,385,1453
MÉXICO,OJO DE AGUA,32,414,9,455,1893
MÉXICO,OJO DE AGUA,38,405,3,446,1892
MÉXICO,OJO DE AGUA,23,321,6,350,1260
MÉXICO,OJO DE AGUA,94,347,2,443,1260
MÉXICO,OJO DE AGUA,26,332,5,363,1500
MÉXICO,OJO DE AGUA,29,307,11,347,1500
MÉXICO,OJO DE AGUA,23,309,7,339,1480
MÉXICO,OJO DE AGUA,26,291,10,327,1480
MÉXICO,OJO DE AGUA,31,348,13,392,1479
MÉXICO,OJO DE AGUA,33,380,15,428,1637
MÉXICO,OJO DE AGUA,38,373,7,418,1637
MÉXICO,OJO DE AGUA,52,386,5,443,1883
MÉXICO,OJO DE AGUA,42,456,8,506,1883
MÉXICO,OJO DE AGUA,52,396,6,454,1883
MÉXICO,OJO DE AGUA,30,342,5,377,1968
MÉXICO,OJO DE AGUA,43,323,2,368,1968
MÉXICO,OJO DE AGUA,42,357,3,402,1967
MÉXICO,OJO DE AGUA,50,282,3,335,1892
MÉXICO,OJO DE AGUA,50,299,6,355,1891
MÉXICO,OJO DE AGUA,46,296,2,344,1891
MÉXICO,OJO DE AGUA,40,335,5,380,1891
MÉXICO,OJO DE AGUA,35,317,6,358,1891
MÉXICO,OJO DE AGUA,49,362,2,413,1891
MÉXICO,OJO DE AGUA,36,318,0,354,1891
MÉXICO,OJO DE AGUA,49,323,1,373,1891
MÉXICO,OJO DE AGUA,33,338,7,378,1505
MÉXICO,OJO DE AGUA,26,290,10,326,1504
MÉXICO,OJO DE AGUA,16,332,7,355,1648
MÉXICO,OJO DE AGUA,34,338,10,382,1647
MÉXICO,OJO DE AGUA,42,336,7,385,1914
MÉXICO,OJO DE AGUA,30,323,5,358,1914
MÉXICO,OJO DE AGUA,56,339,6,401,1914
MÉXICO,OJO DE AGUA,50,353,11,414,1591
MÉXICO,OJO DE AGUA,58,384,5,447,1590
MÉXICO,OJO DE AGUA,55,388,4,447,1522
MÉXICO,OJO DE AGUA,47,363,6,416,1522
MÉXICO,OJO DE AGUA,50,291,3,344,1429
MÉXICO,OJO DE AGUA,52,306,2,360,1429
MÉXICO,OJO DE AGUA,45,362,6,413,1682
MÉXICO,OJO DE AGUA,48,312,3,363,1680
MÉXICO,OJO DE AGUA,47,264,4,315,2136
MÉXICO,OJO DE AGUA,51,306,5,362,2136
MÉXICO,OJO DE AGUA,42,293,5,340,1276
MÉXICO,OJO DE AGUA,43,307,4,354,1275
MÉXICO,OJO DE AGUA,38,309,5,352,1482
MÉXICO,OJO DE AGUA,43,305,2,350,1482
MÉXICO,OJO DE AGUA,38,273,3,314,1211
MÉXICO,OJO DE AGUA,34,270,0,304,1211
MÉXICO,OJO DE AGUA,27,339,7,373,1329
MÉXICO,OJO DE AGUA,29,298,4,331,1328
MÉXICO,OJO DE AGUA,29,287,3,319,1263
MÉXICO,OJO DE AGUA,33,268,8,309,1263
MÉXICO,OJO DE AGUA,59,464,14,537,1855
MÉXICO,OJO DE AGUA,63,389,15,467,1633
MÉXICO,OJO DE AGUA,39,360,9,408,1632
MÉXICO,OJO DE AGUA,57,403,12,472,1823
MÉXICO,OJO DE AGUA,54,380,12,446,1823
MÉXICO,OJO DE AGUA,44,401,14,459,1822
MÉXICO,OJO DE AGUA,54,366,15,435,1822
MÉXICO,OJO DE AGUA,45,397,11,453,1822
MÉXICO,OJO DE AGUA,56,422,7,485,1822
MÉXICO,OJO DE AGUA,48,372,7,427,1822
MÉXICO,OJO DE AGUA,47,387,13,447,1822
MÉXICO,OJO DE AGUA,45,440,11,496,1822
MÉXICO,OJO DE AGUA,71,384,5,460,1822
MÉXICO,OJO DE AGUA,37,373,16,426,1611
MÉXICO,OJO DE AGUA,43,367,12,422,1611
MÉXICO,OJO DE AGUA,34,418,2,454,1741
MÉXICO,OJO DE AGUA,43,291,5,339,1973
MÉXICO,OJO DE AGUA,51,298,1,350,1984
MÉXICO,OJO DE AGUA,46,266,8,320,1983
MÉXICO,OJO DE AGUA,41,280,4,325,1694
MÉXICO,OJO DE AGUA,65,397,6,468,1789
MÉXICO,OJO DE AGUA,29,188,7,224,1307
MÉXICO,OJO DE AGUA,22,212,3,237,1307
MÉXICO,OJO DE AGUA,40,261,2,303,1702
MÉXICO,OJO DE AGUA,36,264,2,302,1702
MÉXICO,OJO DE AGUA,45,310,2,357,1791
MÉXICO,OJO DE AGUA,40,302,7,349,1791
MÉXICO,OJO DE AGUA,42,371,2,415,1660
MÉXICO,OJO DE AGUA,34,279,5,318,1445
MÉXICO,OJO DE AGUA,42,269,2,313,1445
MÉXICO,OJO DE AGUA,72,383,3,458,1833
MÉXICO,OJO DE AGUA,74,373,10,457,1889
MÉXICO,OJO DE AGUA,67,279,7,353,1499
MÉXICO,OJO DE AGUA,69,258,2,329,1498
MÉXICO,OJO DE AGUA,67,296,7,370,1557
MÉXICO,OJO DE AGUA,42,266,5,313,2028
MÉXICO,OJO DE AGUA,42,248,4,294,2028
MÉXICO,OJO DE AGUA,61,371,2,434,1807
MÉXICO,OJO DE AGUA,57,353,13,423,1832
MÉXICO,OJO DE AGUA,90,425,3,518,1916
MÉXICO,OJO DE AGUA,44,275,5,324,1880
MÉXICO,OJO DE AGUA,57,289,3,349,1880
MÉXICO,OJO DE AGUA,53,273,2,328,1623
MÉXICO,OJO DE AGUA,59,248,4,311,1622
MÉXICO,OJO DE AGUA,50,225,2,277,1900
MÉXICO,OJO DE AGUA,34,246,0,280,1900
MÉXICO,OJO DE AGUA,30,224,4,258,1627
MÉXICO,OJO DE AGUA,29,238,4,271,1627
MÉXICO,OJO DE AGUA,33,153,2,188,1423
MÉXICO,OJO DE AGUA,25,170,3,198,1423
MÉXICO,OJO DE AGUA,39,171,2,212,1177
MÉXICO,OJO DE AGUA,29,180,1,210,1177
MÉXICO,OJO DE AGUA,42,372,1,415,1855
MÉXICO,OJO DE AGUA,48,337,2,387,1837
MÉXICO,OJO DE AGUA,65,388,8,461,1827
MÉXICO,OJO DE AGUA,49,316,1,366,1652
MÉXICO,OJO DE AGUA,40,313,4,357,1873
MÉXICO,OJO DE AGUA,54,258,4,316,1546
MÉXICO,OJO DE AGUA,50,308,2,360,1878
MÉXICO,OJO DE AGUA,53,303,4,360,1555
MÉXICO,OJO DE AGUA,26,221,1,248,1133
MÉXICO,OJO DE AGUA,30,198,3,231,1133
MÉXICO,OJO DE AGUA,52,212,3,267,1244
MÉXICO,OJO DE AGUA,47,227,4,278,1243
MÉXICO,OJO DE AGUA,39,345,2,386,2083
MÉXICO,OJO DE AGUA,48,205,0,253,1658
MÉXICO,OJO DE AGUA,40,184,4,228,1658
MÉXICO,OJO DE AGUA,28,210,3,241,1193
MÉXICO,OJO DE AGUA,24,204,1,229,1193
MÉXICO,OJO DE AGUA,26,200,2,228,1200
MÉXICO,OJO DE AGUA,22,137,2,161,1199
MÉXICO,OJO DE AGUA,48,311,3,362,1932
MÉXICO,OJO DE AGUA,21,179,2,202,1122
MÉXICO,OJO DE AGUA,15,174,1,190,1122
MÉXICO,OJO DE AGUA,25,159,1,185,1430
MÉXICO,OJO DE AGUA,26,164,1,191,1430
MÉXICO,OJO DE AGUA,54,227,2,283,1687
MÉXICO,OJO DE AGUA,41,207,1,249,1686
MÉXICO,OJO DE AGUA,52,206,0,258,1878
MÉXICO,OJO DE AGUA,34,186,3,223,1878
MÉXICO,OJO DE AGUA,35,151,1,187,1153
MÉXICO,OJO DE AGUA,27,186,0,213,1152
MÉXICO,OJO DE AGUA,44,241,4,289,1688
MÉXICO,OJO DE AGUA,45,261,8,314,1687
MÉXICO,OJO DE AGUA,42,265,3,310,1959
MÉXICO,OJO DE AGUA,73,309,3,385,1732
MÉXICO,OJO DE AGUA,33,187,2,222,1622
MÉXICO,OJO DE AGUA,26,166,3,195,1622
MÉXICO,OJO DE AGUA,50,280,3,333,1943
MÉXICO,OJO DE AGUA,50,307,10,367,1419
MÉXICO,OJO DE AGUA,59,261,4,324,1419
MÉXICO,OJO DE AGUA,48,220,4,272,1343
MÉXICO,OJO DE AGUA,33,217,10,260,1343
MÉXICO,OJO DE AGUA,46,253,6,305,1423
MÉXICO,OJO DE AGUA,52,223,3,278,1422
MÉXICO,OJO DE AGUA,37,203,5,245,1376
MÉXICO,OJO DE AGUA,31,197,5,233,1375
MÉXICO,OJO DE AGUA,54,280,4,338,1822
MÉXICO,OJO DE AGUA,39,181,3,223,1316
MÉXICO,OJO DE AGUA,30,193,4,227,1315
MÉXICO,OJO DE AGUA,45,208,2,255,1489
MÉXICO,OJO DE AGUA,50,230,0,280,1489
MICHOACÁN,LAZARO CARDENAS,7,215,7,229,1639
MICHOACÁN,LAZARO CARDENAS,6,233,3,242,1638
MICHOACÁN,LAZARO CARDENAS,8,302,2,312,1743
MICHOACÁN,LAZARO CARDENAS,6,297,3,306,1742
MICHOACÁN,LAZARO CARDENAS,7,274,5,286,1713
MICHOACÁN,LAZARO CARDENAS,8,277,5,290,1712
MICHOACÁN,LAZARO CARDENAS,7,211,7,225,1709
MICHOACÁN,LAZARO CARDENAS,3,210,4,217,1709
MICHOACÁN,LAZARO CARDENAS,6,150,1,157,1709
MICHOACÁN,LAZARO CARDENAS,5,404,3,412,2165
MICHOACÁN,LAZARO CARDENAS,3,343,10,356,1562
MICHOACÁN,LAZARO CARDENAS,6,289,3,298,1562
MICHOACÁN,LAZARO CARDENAS,10,293,3,306,1561
MICHOACÁN,LAZARO CARDENAS,12,349,8,369,1561
MICHOACÁN,LAZARO CARDENAS,12,478,4,494,1973
MICHOACÁN,LAZARO CARDENAS,12,586,1,599,1972
MICHOACÁN,LAZARO CARDENAS,4,839,2,845,1436
MICHOACÁN,LAZARO CARDENAS,6,833,1,840,1436
MICHOACÁN,LAZARO CARDENAS,7,816,2,825,1436
MICHOACÁN,LAZARO CARDENAS,6,942,6,954,1549
MICHOACÁN,LAZARO CARDENAS,6,894,4,904,1549
MICHOACÁN,LAZARO CARDENAS,4,914,11,929,1549
MICHOACÁN,LAZARO CARDENAS,10,758,2,770,1276
MICHOACÁN,LAZARO CARDENAS,5,760,2,767,1275
MICHOACÁN,LAZARO CARDENAS,15,752,5,772,1564
MICHOACÁN,LAZARO CARDENAS,12,768,1,781,1564
MICHOACÁN,LAZARO CARDENAS,1,808,5,814,1563
MICHOACÁN,LAZARO CARDENAS,140,910,8,1058,1728
MICHOACÁN,LAZARO CARDENAS,157,854,16,1027,1728
MICHOACÁN,LAZARO CARDENAS,99,650,11,760,1663
MICHOACÁN,LAZARO CARDENAS,105,964,16,1085,1662
MICHOACÁN,LAZARO CARDENAS,98,723,15,836,1487
MICHOACÁN,LAZARO CARDENAS,89,724,11,824,1487
MICHOACÁN,LAZARO CARDENAS,11,700,5,716,1701
MICHOACÁN,LAZARO CARDENAS,155,840,25,1020,2086
MICHOACÁN,LAZARO CARDENAS,98,888,19,1005,1246
MICHOACÁN,LAZARO CARDENAS,88,545,12,645,1245
MICHOACÁN,LAZARO CARDENAS,47,413,2,462,1388
MICHOACÁN,LAZARO CARDENAS,26,498,0,524,1388
MICHOACÁN,LAZARO CARDENAS,37,735,5,777,1387
MICHOACÁN,LAZARO CARDENAS,11,508,1,520,2001
MICHOACÁN,LAZARO CARDENAS,10,483,2,495,2000
MICHOACÁN,LAZARO CARDENAS,12,483,4,499,2000
MICHOACÁN,LAZARO CARDENAS,15,496,2,513,2000
MICHOACÁN,LAZARO CARDENAS,12,636,6,654,2035
MICHOACÁN,LAZARO CARDENAS,15,583,1,599,2035
MICHOACÁN,LAZARO CARDENAS,12,310,0,322,1473
MICHOACÁN,LAZARO CARDENAS,7,333,1,341,1473
MICHOACÁN,LAZARO CARDENAS,12,444,3,459,1963
MICHOACÁN,LAZARO CARDENAS,20,434,3,457,1962
MICHOACÁN,LAZARO CARDENAS,11,443,4,458,1815
MICHOACÁN,LAZARO CARDENAS,18,422,5,445,1815
MICHOACÁN,LAZARO CARDENAS,19,467,2,488,1827
MICHOACÁN,LAZARO CARDENAS,12,459,0,471,1826
MICHOACÁN,LAZARO CARDENAS,16,336,0,352,1516
MICHOACÁN,LAZARO CARDENAS,11,307,1,319,1516
MICHOACÁN,LAZARO CARDENAS,13,315,1,329,1515
MICHOACÁN,LAZARO CARDENAS,9,387,2,398,1565
MICHOACÁN,LAZARO CARDENAS,13,468,1,482,1564
MICHOACÁN,LAZARO CARDENAS,42,1422,3,1467,0
MICHOACÁN,LAZARO CARDENAS,10,343,3,356,1384
MICHOACÁN,LAZARO CARDENAS,8,351,0,359,1383
MICHOACÁN,LAZARO CARDENAS,9,351,1,361,1312
MICHOACÁN,LAZARO CARDENAS,11,337,3,351,1312
MICHOACÁN,LAZARO CARDENAS,10,336,0,346,1904
MICHOACÁN,LAZARO CARDENAS,17,386,1,404,1904
MICHOACÁN,LAZARO CARDENAS,16,260,2,278,1260
MICHOACÁN,LAZARO CARDENAS,9,259,2,270,1259
MICHOACÁN,LAZARO CARDENAS,12,532,2,546,2064
MICHOACÁN,LAZARO CARDENAS,17,542,2,561,2063
MICHOACÁN,LAZARO CARDENAS,3,115,1,119,1318
MICHOACÁN,LAZARO CARDENAS,8,95,3,106,1317
MICHOACÁN,LAZARO CARDENAS,15,302,6,323,1959
MICHOACÁN,LAZARO CARDENAS,6,331,1,338,1599
MICHOACÁN,LAZARO CARDENAS,6,344,0,350,1599
MICHOACÁN,LAZARO CARDENAS,10,497,4,511,1690
MICHOACÁN,LAZARO CARDENAS,8,400,1,409,1689
MICHOACÁN,LAZARO CARDENAS,10,408,0,418,1527
MICHOACÁN,LAZARO CARDENAS,10,399,3,412,1526
MICHOACÁN,LAZARO CARDENAS,4,407,7,418,1526
MICHOACÁN,LAZARO CARDENAS,9,458,3,470,1852
MICHOACÁN,LAZARO CARDENAS,13,427,7,447,1851
MICHOACÁN,LAZARO CARDENAS,4,304,4,312,1552
MICHOACÁN,LAZARO CARDENAS,7,333,3,343,1551
MICHOACÁN,LAZARO CARDENAS,4,327,7,338,1551
MICHOACÁN,LAZARO CARDENAS,12,434,7,453,1869
MICHOACÁN,LAZARO CARDENAS,12,411,3,426,1869
MICHOACÁN,LAZARO CARDENAS,5,468,2,475,1868
MICHOACÁN,LAZARO CARDENAS,9,422,5,436,1843
MICHOACÁN,LAZARO CARDENAS,8,454,3,465,1843
MICHOACÁN,LAZARO CARDENAS,13,431,2,446,1787
MICHOACÁN,LAZARO CARDENAS,6,477,3,486,1787
MICHOACÁN,LAZARO CARDENAS,8,447,3,458,1787
MICHOACÁN,LAZARO CARDENAS,1,320,3,324,1437
MICHOACÁN,LAZARO CARDENAS,2,324,0,326,1436
MICHOACÁN,LAZARO CARDENAS,4,333,1,338,1436
MICHOACÁN,LAZARO CARDENAS,8,459,4,471,1618
MICHOACÁN,LAZARO CARDENAS,9,441,7,457,1617
MICHOACÁN,LAZARO CARDENAS,7,435,6,448,1867
MICHOACÁN,LAZARO CARDENAS,8,514,2,524,1866
MICHOACÁN,LAZARO CARDENAS,7,472,7,486,1859
MICHOACÁN,LAZARO CARDENAS,10,464,7,481,1858
MICHOACÁN,LAZARO CARDENAS,9,440,1,450,1948
MICHOACÁN,LAZARO CARDENAS,7,419,4,430,1947
MICHOACÁN,LAZARO CARDENAS,9,421,2,432,1947
MICHOACÁN,LAZARO CARDENAS,0,399,0,399,1926
MICHOACÁN,LAZARO CARDENAS,4,418,4,426,1925
MICHOACÁN,LAZARO CARDENAS,13,365,2,380,1925
MICHOACÁN,LAZARO CARDENAS,4,310,2,316,1800
MICHOACÁN,LAZARO CARDENAS,9,338,7,354,1800
MICHOACÁN,LAZARO CARDENAS,0,347,2,349,1799
MICHOACÁN,LAZARO CARDENAS,4,347,5,356,1799
MICHOACÁN,LAZARO CARDENAS,1,771,1,773,2166
MICHOACÁN,LAZARO CARDENAS,10,452,3,465,1941
MICHOACÁN,LAZARO CARDENAS,1,445,4,450,1940
MICHOACÁN,LAZARO CARDENAS,13,400,2,415,1803
MICHOACÁN,LAZARO CARDENAS,7,277,0,284,1803
MICHOACÁN,LAZARO CARDENAS,14,396,7,417,1803
MICHOACÁN,LAZARO CARDENAS,6,403,2,411,1802
MICHOACÁN,LAZARO CARDENAS,10,379,2,391,1802
MICHOACÁN,LAZARO CARDENAS,8,366,1,375,1802
MICHOACÁN,LAZARO CARDENAS,11,666,11,688,1775
MICHOACÁN,LAZARO CARDENAS,6,1084,17,1107,1774
MICHOACÁN,LAZARO CARDENAS,3,324,4,331,1733
MICHOACÁN,LAZARO CARDENAS,14,1487,26,1527,1733
MICHOACÁN,LAZARO CARDENAS,11,1683,21,1715,1732
MICHOACÁN,LAZARO CARDENAS,11,758,9,778,1847
MICHOACÁN,LAZARO CARDENAS,5,1351,13,1369,1847
MICHOACÁN,LAZARO CARDENAS,3,1270,13,1286,1899
MICHOACÁN,LAZARO CARDENAS,27,1495,18,1540,1898
MICHOACÁN,LAZARO CARDENAS,3,329,7,339,1587
MICHOACÁN,LAZARO CARDENAS,10,270,5,285,1586
MICHOACÁN,LAZARO CARDENAS,27,346,7,380,1899
MICHOACÁN,LAZARO CARDENAS,14,321,5,340,1899
MICHOACÁN,LAZARO CARDENAS,5,211,2,218,1435
MICHOACÁN,LAZARO CARDENAS,4,162,3,169,1435
MICHOACÁN,LAZARO CARDENAS,1,844,3,848,1712
MICHOACÁN,LAZARO CARDENAS,12,804,1,817,1712
MICHOACÁN,LAZARO CARDENAS,5,792,8,805,1712
MICHOACÁN,LAZARO CARDENAS,4,821,4,829,1977
MICHOACÁN,LAZARO CARDENAS,4,839,1,844,1977
MICHOACÁN,LAZARO CARDENAS,14,323,0,337,1557
MICHOACÁN,LAZARO CARDENAS,17,305,5,327,1557
MICHOACÁN,LAZARO CARDENAS,24,298,4,326,1557
MICHOACÁN,LAZARO CARDENAS,17,348,5,370,1557
MICHOACÁN,LAZARO CARDENAS,3,341,8,352,1596
MICHOACÁN,LAZARO CARDENAS,9,377,2,388,1595
MICHOACÁN,LAZARO CARDENAS,0,609,0,609,1408
MICHOACÁN,LAZARO CARDENAS,4,755,5,764,1407
MICHOACÁN,LAZARO CARDENAS,8,280,54,342,2064
MICHOACÁN,LAZARO CARDENAS,57,350,4,411,2064
MICHOACÁN,LAZARO CARDENAS,4,180,5,189,1445
MICHOACÁN,LAZARO CARDENAS,3,218,1,222,1444
MICHOACÁN,LAZARO CARDENAS,6,194,2,202,1444
MICHOACÁN,LAZARO CARDENAS,8,232,4,244,1795
MICHOACÁN,LAZARO CARDENAS,6,309,0,315,1794
MICHOACÁN,LAZARO CARDENAS,36,603,20,659,1638
MICHOACÁN,LAZARO CARDENAS,22,865,3,890,1637
MICHOACÁN,LAZARO CARDENAS,2,340,5,347,1324
MICHOACÁN,LAZARO CARDENAS,3,339,2,344,1324
MICHOACÁN,PURUANDIRO,22,228,2,252,1727
MICHOACÁN,PURUANDIRO,12,246,9,267,1726
MICHOACÁN,PURUANDIRO,10,190,2,202,1573
MICHOACÁN,PURUANDIRO,8,193,9,210,1573
MICHOACÁN,PURUANDIRO,15,237,10,262,1292
MICHOACÁN,PURUANDIRO,6,259,1,266,1291
MICHOACÁN,PURUANDIRO,12,176,6,194,1549
MICHOACÁN,PURUANDIRO,8,191,3,202,1548
MICHOACÁN,PURUANDIRO,4,175,1,180,1137
MICHOACÁN,PURUANDIRO,17,168,5,190,1136
MICHOACÁN,PURUANDIRO,9,128,3,140,1074
MICHOACÁN,PURUANDIRO,9,138,1,148,1073
MICHOACÁN,PURUANDIRO,16,486,12,514,1558
MICHOACÁN,PURUANDIRO,27,523,8,558,1558
MICHOACÁN,PURUANDIRO,21,491,6,518,1557
MICHOACÁN,PURUANDIRO,12,498,5,515,1411
MICHOACÁN,PURUANDIRO,22,509,8,539,1410
MICHOACÁN,PURUANDIRO,22,524,8,554,1410
MICHOACÁN,PURUANDIRO,19,426,15,460,1089
MICHOACÁN,PURUANDIRO,11,424,11,446,1088
MICHOACÁN,PURUANDIRO,9,185,2,196,1814
MICHOACÁN,PURUANDIRO,7,204,0,211,1813
MICHOACÁN,PURUANDIRO,22,372,4,398,1905
MICHOACÁN,PURUANDIRO,16,318,5,339,1904
MICHOACÁN,PURUANDIRO,6,261,7,274,1628
MICHOACÁN,PURUANDIRO,10,236,3,249,1628
MICHOACÁN,PURUANDIRO,5,169,4,178,1712
MICHOACÁN,PURUANDIRO,17,182,1,200,1711
MICHOACÁN,PURUANDIRO,16,248,4,268,1368
MICHOACÁN,PURUANDIRO,5,222,3,230,1368
MICHOACÁN,PURUANDIRO,7,225,3,235,1367
MICHOACÁN,PURUANDIRO,4,115,4,123,1429
MICHOACÁN,PURUANDIRO,1,98,4,103,1429
MICHOACÁN,PURUANDIRO,6,135,0,141,1429
MICHOACÁN,PURUANDIRO,75,296,3,374,1947
MICHOACÁN,PURUANDIRO,10,261,6,277,1946
MICHOACÁN,PURUANDIRO,9,313,1,323,1946
MICHOACÁN,PURUANDIRO,11,319,15,345,2055
MICHOACÁN,PURUANDIRO,21,157,5,183,1437
MICHOACÁN,PURUANDIRO,17,149,9,175,1437
MICHOACÁN,PURUANDIRO,14,156,3,173,1437
MICHOACÁN,PURUANDIRO,25,186,13,224,1333
MICHOACÁN,PURUANDIRO,15,188,5,208,1332
MICHOACÁN,PURUANDIRO,22,172,14,208,2078
MICHOACÁN,PURUANDIRO,13,130,6,149,1537
MICHOACÁN,PURUANDIRO,12,162,9,183,1537
MICHOACÁN,PURUANDIRO,6,137,8,151,1536
MICHOACÁN,PURUANDIRO,23,93,8,124,1538
MICHOACÁN,PURUANDIRO,26,76,4,106,1538
MICHOACÁN,PURUANDIRO,19,213,9,241,1285
MICHOACÁN,PURUANDIRO,8,163,10,181,1285
MICHOACÁN,PURUANDIRO,23,207,13,243,1191
MICHOACÁN,PURUANDIRO,19,213,14,246,1191
MICHOACÁN,PURUANDIRO,4,266,5,275,1632
MICHOACÁN,PURUANDIRO,14,262,3,279,1631
MICHOACÁN,PURUANDIRO,20,209,0,229,1745
MICHOACÁN,PURUANDIRO,21,286,6,313,1745
MICHOACÁN,PURUANDIRO,10,235,6,251,1726
MICHOACÁN,PURUANDIRO,16,295,8,319,1726
MICHOACÁN,PURUANDIRO,5,250,2,257,1716
MICHOACÁN,PURUANDIRO,7,234,7,248,1715
MICHOACÁN,PURUANDIRO,5,277,4,286,1908
MICHOACÁN,PURUANDIRO,6,169,10,185,1077
MICHOACÁN,PURUANDIRO,14,155,3,172,1076
MICHOACÁN,PURUANDIRO,9,180,7,196,1472
MICHOACÁN,PURUANDIRO,21,190,8,219,1471
MICHOACÁN,PURUANDIRO,13,194,6,213,1471
MICHOACÁN,PURUANDIRO,11,182,8,201,1533
MICHOACÁN,PURUANDIRO,0,171,14,185,1532
MICHOACÁN,PURUANDIRO,9,261,5,275,1185
MICHOACÁN,PURUANDIRO,8,268,3,279,1184
MICHOACÁN,PURUANDIRO,12,228,9,249,1817
MICHOACÁN,PURUANDIRO,10,289,7,306,1816
MICHOACÁN,PURUANDIRO,9,196,4,209,1675
MICHOACÁN,PURUANDIRO,9,139,3,151,1675
MICHOACÁN,PURUANDIRO,5,131,2,138,1805
MICHOACÁN,PURUANDIRO,6,138,7,151,1805
MICHOACÁN,PURUANDIRO,9,135,2,146,1804
MICHOACÁN,PURUANDIRO,8,180,2,190,1681
MICHOACÁN,PURUANDIRO,11,188,0,199,1681
MICHOACÁN,PURUANDIRO,6,228,4,238,1460
MICHOACÁN,PURUANDIRO,2,223,0,225,1459
MICHOACÁN,PURUANDIRO,4,226,1,231,1459
MICHOACÁN,PURUANDIRO,3,191,4,198,1270
MICHOACÁN,PURUANDIRO,4,240,4,248,1270
MICHOACÁN,PURUANDIRO,5,419,0,424,1836
MICHOACÁN,PURUANDIRO,7,376,3,386,1836
MICHOACÁN,PURUANDIRO,5,157,2,164,1618
MICHOACÁN,PURUANDIRO,6,202,2,210,1618
MICHOACÁN,PURUANDIRO,6,219,2,227,1223
MICHOACÁN,PURUANDIRO,1,250,7,258,1222
MICHOACÁN,PURUANDIRO,9,229,2,240,1504
MICHOACÁN,PURUANDIRO,2,220,3,225,1503
MICHOACÁN,PURUANDIRO,12,223,1,236,1254
MICHOACÁN,PURUANDIRO,7,217,5,229,1254
MICHOACÁN,PURUANDIRO,23,373,15,411,1961
MICHOACÁN,PURUANDIRO,21,357,25,403,1960
MICHOACÁN,PURUANDIRO,20,411,12,443,1960
MICHOACÁN,PURUANDIRO,28,417,15,460,1958
MICHOACÁN,PURUANDIRO,27,339,11,377,1673
MICHOACÁN,PURUANDIRO,25,363,13,401,1673
MICHOACÁN,PURUANDIRO,15,886,5,906,1892
MICHOACÁN,PURUANDIRO,19,376,0,395,1892
MICHOACÁN,PURUANDIRO,14,1341,15,1370,1921
MICHOACÁN,PURUANDIRO,16,337,9,362,1505
MICHOACÁN,PURUANDIRO,22,345,11,378,1504
MICHOACÁN,PURUANDIRO,14,342,8,364,1264
MICHOACÁN,PURUANDIRO,345,12,17,374,1264
MICHOACÁN,PURUANDIRO,22,165,1,188,1602
MICHOACÁN,PURUANDIRO,7,154,0,161,1601
MICHOACÁN,PURUANDIRO,7,229,6,242,1742
MICHOACÁN,PURUANDIRO,5,191,2,198,1741
MICHOACÁN,PURUANDIRO,9,109,6,124,1121
MICHOACÁN,PURUANDIRO,6,103,2,111,1121
MICHOACÁN,PURUANDIRO,11,153,0,164,1432
MICHOACÁN,PURUANDIRO,7,143,1,151,1432
MICHOACÁN,PURUANDIRO,7,200,1,208,1530
MICHOACÁN,PURUANDIRO,6,183,3,192,1529
MICHOACÁN,PURUANDIRO,9,209,5,223,1529
MICHOACÁN,PURUANDIRO,13,181,4,198,1940
MICHOACÁN,PURUANDIRO,20,188,3,211,1940
MICHOACÁN,PURUANDIRO,27,162,5,194,0
MICHOACÁN,PURUANDIRO,5,153,2,160,1600
MICHOACÁN,PURUANDIRO,7,126,4,137,1600
MICHOACÁN,PURUANDIRO,10,162,6,178,1600
MICHOACÁN,PURUANDIRO,12,169,1,182,1684
MICHOACÁN,PURUANDIRO,20,182,1,203,1684
MICHOACÁN,PURUANDIRO,14,176,4,194,1683
MICHOACÁN,PURUANDIRO,6,102,3,111,1777
MICHOACÁN,PURUANDIRO,4,159,5,168,1777
MICHOACÁN,PURUANDIRO,6,152,1,159,1776
MICHOACÁN,PURUANDIRO,8,162,4,174,1580
MICHOACÁN,PURUANDIRO,5,131,0,136,1580
MICHOACÁN,PURUANDIRO,10,164,1,175,1580
MICHOACÁN,PURUANDIRO,12,144,6,162,1544
MICHOACÁN,PURUANDIRO,2,145,1,148,1543
MICHOACÁN,PURUANDIRO,5,134,4,143,1543
MICHOACÁN,PURUANDIRO,6,132,3,141,1543
MICHOACÁN,PURUANDIRO,13,176,4,193,1373
MICHOACÁN,PURUANDIRO,9,160,5,174,1373
MICHOACÁN,PURUANDIRO,8,386,0,394,1748
MICHOACÁN,PURUANDIRO,11,365,4,380,1747
MICHOACÁN,PURUANDIRO,2,149,5,156,1740
MICHOACÁN,PURUANDIRO,11,129,2,142,1740
MICHOACÁN,PURUANDIRO,44,330,3,377,2056
MICHOACÁN,PURUANDIRO,28,313,7,348,2056
MICHOACÁN,PURUANDIRO,2,255,5,262,1461
MICHOACÁN,PURUANDIRO,8,259,4,271,1461
MICHOACÁN,PURUANDIRO,22,148,5,175,1908
MICHOACÁN,PURUANDIRO,9,110,6,125,1908
MICHOACÁN,PURUANDIRO,19,164,4,187,1375
MICHOACÁN,PURUANDIRO,15,116,2,133,1374
MICHOACÁN,PURUANDIRO,9,171,5,185,1751
MICHOACÁN,PURUANDIRO,2,146,12,160,1751
MICHOACÁN,PURUANDIRO,10,147,2,159,1750
MICHOACÁN,PURUANDIRO,8,181,3,192,1982
MICHOACÁN,PURUANDIRO,4,190,7,201,1981
MICHOACÁN,PURUANDIRO,8,141,3,152,1516
MICHOACÁN,PURUANDIRO,9,132,4,145,1516
MICHOACÁN,PURUANDIRO,9,126,4,139,1515
MICHOACÁN,PURUANDIRO,4,154,2,160,1416
MICHOACÁN,PURUANDIRO,1,140,1,142,1416
MICHOACÁN,PURUANDIRO,8,91,4,103,1516
MICHOACÁN,PURUANDIRO,10,128,10,148,1515
MICHOACÁN,PURUANDIRO,7,161,10,178,1816
MICHOACÁN,PURUANDIRO,8,149,3,160,1815
MICHOACÁN,PURUANDIRO,4,156,18,178,1815
MICHOACÁN,PURUANDIRO,2,157,3,162,1524
MICHOACÁN,PURUANDIRO,7,118,5,130,1524
MICHOACÁN,PURUANDIRO,8,143,6,157,1524
MICHOACÁN,PURUANDIRO,9,281,1,291,1733
MICHOACÁN,PURUANDIRO,7,294,9,310,1733
MICHOACÁN,PURUANDIRO,12,280,5,297,1733
MICHOACÁN,PURUANDIRO,5,235,1,241,1604
MICHOACÁN,PURUANDIRO,10,183,2,195,1603
MICHOACÁN,PURUANDIRO,6,177,1,184,1603
MICHOACÁN,PURUANDIRO,7,167,8,182,2067
MICHOACÁN,PURUANDIRO,12,147,4,163,1594
MICHOACÁN,PURUANDIRO,17,114,5,136,1593
MICHOACÁN,PURUANDIRO,5,146,2,153,1492
MICHOACÁN,PURUANDIRO,10,125,2,137,1492
MICHOACÁN,PURUANDIRO,2,135,3,140,1491
MICHOACÁN,PURUANDIRO,15,155,2,172,1906
MICHOACÁN,PURUANDIRO,15,159,3,177,1906
MICHOACÁN,PURUANDIRO,0,141,4,145,1906
MICHOACÁN,PURUANDIRO,10,142,2,154,1906
MICHOACÁN,PURUANDIRO,11,154,0,165,1906
MICHOACÁN,PURUANDIRO,9,125,1,135,1906
MICHOACÁN,PURUANDIRO,14,106,0,120,1401
MICHOACÁN,PURUANDIRO,4,109,2,115,1400
MICHOACÁN,PURUANDIRO,14,110,3,127,1400
MICHOACÁN,PURUANDIRO,5,69,2,76,1394
MICHOACÁN,PURUANDIRO,11,61,0,72,1393
MICHOACÁN,PURUANDIRO,10,69,3,82,1393
MICHOACÁN,PURUANDIRO,9,100,0,109,1450
MICHOACÁN,PURUANDIRO,12,99,2,113,1449
MICHOACÁN,PURUANDIRO,17,126,0,143,1449
MICHOACÁN,PURUANDIRO,8,96,1,105,1386
MICHOACÁN,PURUANDIRO,6,102,3,111,1386
MICHOACÁN,PURUANDIRO,8,85,2,95,1386
MICHOACÁN,PURUANDIRO,17,158,5,180,1814
MICHOACÁN,PURUANDIRO,7,173,2,182,1813
MICHOACÁN,PURUANDIRO,21,175,3,199,2092
MICHOACÁN,PURUANDIRO,22,174,1,197,1269
MICHOACÁN,PURUANDIRO,19,164,1,184,1268
MICHOACÁN,HEROICA ZITACUARO,17,277,12,306,1561
MICHOACÁN,HEROICA ZITACUARO,15,277,12,304,1560
MICHOACÁN,HEROICA ZITACUARO,19,249,14,282,1560
MICHOACÁN,HEROICA ZITACUARO,11,260,9,280,1642
MICHOACÁN,HEROICA ZITACUARO,10,285,4,299,1642
MICHOACÁN,HEROICA ZITACUARO,109,868,21,998,1553
MICHOACÁN,HEROICA ZITACUARO,48,602,19,669,1553
MICHOACÁN,HEROICA ZITACUARO,95,880,14,989,1553
MICHOACÁN,HEROICA ZITACUARO,12,947,9,968,1397
MICHOACÁN,HEROICA ZITACUARO,7,838,3,848,1396
MICHOACÁN,HEROICA ZITACUARO,7,332,4,343,1936
MICHOACÁN,HEROICA ZITACUARO,5,352,1,358,1936
MICHOACÁN,HEROICA ZITACUARO,8,335,4,347,1936
MICHOACÁN,HEROICA ZITACUARO,3,372,0,375,1904
MICHOACÁN,HEROICA ZITACUARO,7,370,6,383,1904
MICHOACÁN,HEROICA ZITACUARO,3,317,1,321,1903
MICHOACÁN,HEROICA ZITACUARO,8,349,0,357,1932
MICHOACÁN,HEROICA ZITACUARO,9,364,5,378,1932
MICHOACÁN,HEROICA ZITACUARO,4,326,2,332,1931
MICHOACÁN,HEROICA ZITACUARO,5,220,1,226,1212
MICHOACÁN,HEROICA ZITACUARO,6,234,4,244,1212
MICHOACÁN,HEROICA ZITACUARO,7,323,7,337,1855
MICHOACÁN,HEROICA ZITACUARO,7,397,0,404,1854
MICHOACÁN,HEROICA ZITACUARO,3,339,4,346,1854
MICHOACÁN,HEROICA ZITACUARO,3,230,8,241,1543
MICHOACÁN,HEROICA ZITACUARO,3,224,2,229,1542
MICHOACÁN,HEROICA ZITACUARO,1,224,7,232,1542
MICHOACÁN,HEROICA ZITACUARO,3,117,3,123,1341
MICHOACÁN,HEROICA ZITACUARO,5,145,3,153,1341
MICHOACÁN,HEROICA ZITACUARO,10,244,3,257,1863
MICHOACÁN,HEROICA ZITACUARO,8,262,0,270,1863
MICHOACÁN,HEROICA ZITACUARO,7,229,6,242,1863
MICHOACÁN,HEROICA ZITACUARO,8,279,3,290,1863
MICHOACÁN,HEROICA ZITACUARO,8,100,0,108,1612
MICHOACÁN,HEROICA ZITACUARO,13,145,1,159,1612
MICHOACÁN,HEROICA ZITACUARO,63,1002,42,1107,1437
MICHOACÁN,HEROICA ZITACUARO,9,186,10,205,1437
MICHOACÁN,HEROICA ZITACUARO,16,192,7,215,1436
MICHOACÁN,HEROICA ZITACUARO,7,196,7,210,1680
MICHOACÁN,HEROICA ZITACUARO,11,228,3,242,1680
MICHOACÁN,HEROICA ZITACUARO,12,203,5,220,1679
MICHOACÁN,HEROICA ZITACUARO,11,101,1,113,1195
MICHOACÁN,HEROICA ZITACUARO,16,108,2,126,1195
MICHOACÁN,HEROICA ZITACUARO,15,180,5,200,1573
MICHOACÁN,HEROICA ZITACUARO,5,581,2,588,1572
MICHOACÁN,HEROICA ZITACUARO,11,218,4,233,1413
MICHOACÁN,HEROICA ZITACUARO,13,220,9,242,1412
MICHOACÁN,HEROICA ZITACUARO,15,195,6,216,1412
MICHOACÁN,HEROICA ZITACUARO,11,163,4,178,1357
MICHOACÁN,HEROICA ZITACUARO,5,186,5,196,1357
MICHOACÁN,HEROICA ZITACUARO,4,33,3,40,1164
MICHOACÁN,HEROICA ZITACUARO,6,29,1,36,1164
MICHOACÁN,HEROICA ZITACUARO,29,65,7,101,1539
MICHOACÁN,HEROICA ZITACUARO,30,76,11,117,1539
MICHOACÁN,HEROICA ZITACUARO,12,87,7,106,1538
MICHOACÁN,HEROICA ZITACUARO,12,173,4,189,1493
MICHOACÁN,HEROICA ZITACUARO,15,162,6,183,1493
MICHOACÁN,HEROICA ZITACUARO,6,428,3,437,1589
MICHOACÁN,HEROICA ZITACUARO,1,400,6,407,1589
MICHOACÁN,HEROICA ZITACUARO,0,369,5,374,1166
MICHOACÁN,HEROICA ZITACUARO,4,273,5,282,993
MICHOACÁN,HEROICA ZITACUARO,2,222,1,225,993
MICHOACÁN,HEROICA ZITACUARO,7,296,7,310,1697
MICHOACÁN,HEROICA ZITACUARO,1,419,1,421,1697
MICHOACÁN,HEROICA ZITACUARO,2,401,3,406,1543
MICHOACÁN,HEROICA ZITACUARO,3,249,0,252,1542
MICHOACÁN,HEROICA ZITACUARO,5,279,1,285,1542
MICHOACÁN,HEROICA ZITACUARO,10,423,3,436,1863
MICHOACÁN,HEROICA ZITACUARO,8,366,3,377,1863
MICHOACÁN,HEROICA ZITACUARO,13,345,4,362,1863
MICHOACÁN,HEROICA ZITACUARO,17,395,8,420,1544
MICHOACÁN,HEROICA ZITACUARO,7,369,2,378,1393
MICHOACÁN,HEROICA ZITACUARO,4,369,1,374,1393
MICHOACÁN,HEROICA ZITACUARO,8,411,5,424,1393
MICHOACÁN,HEROICA ZITACUARO,2,197,2,201,1045
MICHOACÁN,HEROICA ZITACUARO,3,264,33,300,1044
MICHOACÁN,HEROICA ZITACUARO,3,302,0,305,1228
MICHOACÁN,HEROICA ZITACUARO,8,324,4,336,1227
MICHOACÁN,HEROICA ZITACUARO,0,761,2,763,1534
MICHOACÁN,HEROICA ZITACUARO,21,220,9,250,1627
MICHOACÁN,HEROICA ZITACUARO,14,213,6,233,1626
MICHOACÁN,HEROICA ZITACUARO,25,219,9,253,1626
MICHOACÁN,HEROICA ZITACUARO,30,275,3,308,1916
MICHOACÁN,HEROICA ZITACUARO,20,317,4,341,1916
MICHOACÁN,HEROICA ZITACUARO,19,315,4,338,1915
MICHOACÁN,HEROICA ZITACUARO,20,302,7,329,1915
MICHOACÁN,HEROICA ZITACUARO,24,249,8,281,1915
MICHOACÁN,HEROICA ZITACUARO,19,253,12,284,1478
MICHOACÁN,HEROICA ZITACUARO,18,242,9,269,1478
MICHOACÁN,HEROICA ZITACUARO,66,688,13,767,940
MICHOACÁN,HEROICA ZITACUARO,55,1108,15,1178,1800
MICHOACÁN,HEROICA ZITACUARO,8,281,1,290,1853
MICHOACÁN,HEROICA ZITACUARO,12,278,2,292,1852
MICHOACÁN,HEROICA ZITACUARO,28,274,7,309,1127
MICHOACÁN,HEROICA ZITACUARO,23,349,9,381,1127
MICHOACÁN,HEROICA ZITACUARO,4,168,3,175,1062
MICHOACÁN,HEROICA ZITACUARO,7,154,1,162,1061
MICHOACÁN,HEROICA ZITACUARO,3,263,2,268,1451
MICHOACÁN,HEROICA ZITACUARO,13,333,2,348,1450
MICHOACÁN,HEROICA ZITACUARO,13,308,1,322,1450
MICHOACÁN,HEROICA ZITACUARO,4,104,6,114,1312
MICHOACÁN,HEROICA ZITACUARO,8,120,1,129,1311
MICHOACÁN,HEROICA ZITACUARO,9,190,3,202,1688
MICHOACÁN,HEROICA ZITACUARO,7,160,2,169,1687
MICHOACÁN,HEROICA ZITACUARO,8,167,4,179,1687
MICHOACÁN,HEROICA ZITACUARO,21,172,3,196,1778
MICHOACÁN,HEROICA ZITACUARO,20,193,3,216,1777
MICHOACÁN,HEROICA ZITACUARO,17,140,0,157,1965
MICHOACÁN,HEROICA ZITACUARO,17,137,0,154,1964
MICHOACÁN,HEROICA ZITACUARO,8,132,1,141,1425
MICHOACÁN,HEROICA ZITACUARO,14,140,1,155,1424
MICHOACÁN,HEROICA ZITACUARO,83,794,10,887,0
MICHOACÁN,HEROICA ZITACUARO,11,148,0,159,1972
MICHOACÁN,HEROICA ZITACUARO,14,151,4,169,1971
MICHOACÁN,HEROICA ZITACUARO,11,156,3,170,1971
MICHOACÁN,HEROICA ZITACUARO,25,163,3,191,1406
MICHOACÁN,HEROICA ZITACUARO,21,155,4,180,1406
MICHOACÁN,HEROICA ZITACUARO,14,166,0,180,1405
MICHOACÁN,HEROICA ZITACUARO,7,153,3,163,1156
MICHOACÁN,HEROICA ZITACUARO,23,161,3,187,1155
MICHOACÁN,HEROICA ZITACUARO,11,207,4,222,1632
MICHOACÁN,HEROICA ZITACUARO,11,213,1,225,1631
MICHOACÁN,HEROICA ZITACUARO,12,173,1,186,1132
MICHOACÁN,HEROICA ZITACUARO,11,183,2,196,1132
MICHOACÁN,HEROICA ZITACUARO,8,226,4,238,1873
MICHOACÁN,HEROICA ZITACUARO,6,202,4,212,1873
MICHOACÁN,HEROICA ZITACUARO,9,250,1,260,1950
MICHOACÁN,HEROICA ZITACUARO,19,233,3,255,1950
MICHOACÁN,HEROICA ZITACUARO,17,258,5,280,1857
MICHOACÁN,HEROICA ZITACUARO,15,233,4,252,1856
MICHOACÁN,HEROICA ZITACUARO,9,107,3,119,1039
MICHOACÁN,HEROICA ZITACUARO,9,104,1,114,1039
MICHOACÁN,HEROICA ZITACUARO,16,182,3,201,1794
MICHOACÁN,HEROICA ZITACUARO,16,213,1,230,1793
MICHOACÁN,HEROICA ZITACUARO,21,209,4,234,1949
MICHOACÁN,HEROICA ZITACUARO,15,212,6,233,1949
MICHOACÁN,HEROICA ZITACUARO,16,201,1,218,1929
MICHOACÁN,HEROICA ZITACUARO,13,225,3,241,1929
MICHOACÁN,HEROICA ZITACUARO,9,78,2,89,1778
MICHOACÁN,HEROICA ZITACUARO,7,105,4,116,1778
MICHOACÁN,HEROICA ZITACUARO,6,115,5,126,1777
MICHOACÁN,HEROICA ZITACUARO,8,62,2,72,1087
MICHOACÁN,HEROICA ZITACUARO,9,26,2,37,1086
MICHOACÁN,HEROICA ZITACUARO,12,114,3,129,1814
MICHOACÁN,HEROICA ZITACUARO,15,113,8,136,1814
MICHOACÁN,HEROICA ZITACUARO,12,91,4,107,1124
MICHOACÁN,HEROICA ZITACUARO,11,71,1,83,1123
MICHOACÁN,HEROICA ZITACUARO,6,132,4,142,1690
MICHOACÁN,HEROICA ZITACUARO,9,161,3,173,1690
MICHOACÁN,HEROICA ZITACUARO,7,65,3,75,1647
MICHOACÁN,HEROICA ZITACUARO,15,132,2,149,1647
MICHOACÁN,HEROICA ZITACUARO,12,144,5,161,1995
MICHOACÁN,HEROICA ZITACUARO,16,133,3,152,1481
MICHOACÁN,HEROICA ZITACUARO,14,125,1,140,1480
MICHOACÁN,HEROICA ZITACUARO,20,114,3,137,1480
MICHOACÁN,HEROICA ZITACUARO,3,96,2,101,1594
MICHOACÁN,HEROICA ZITACUARO,4,79,1,84,1593
MICHOACÁN,HEROICA ZITACUARO,24,88,8,120,1787
MICHOACÁN,HEROICA ZITACUARO,25,129,6,160,1787
MICHOACÁN,HEROICA ZITACUARO,8,120,12,140,1605
MICHOACÁN,HEROICA ZITACUARO,15,141,12,168,1604
MICHOACÁN,HEROICA ZITACUARO,20,146,1,167,1433
MICHOACÁN,HEROICA ZITACUARO,6,138,10,154,1432
MICHOACÁN,HEROICA ZITACUARO,9,93,2,104,2002
MICHOACÁN,HEROICA ZITACUARO,4,86,1,91,2002
MICHOACÁN,HEROICA ZITACUARO,10,58,1,69,1434
MICHOACÁN,HEROICA ZITACUARO,3,69,4,76,1433
MICHOACÁN,HEROICA ZITACUARO,9,164,2,175,1847
MICHOACÁN,HEROICA ZITACUARO,6,173,6,185,1847
MICHOACÁN,HEROICA ZITACUARO,11,83,3,97,1739
MICHOACÁN,HEROICA ZITACUARO,12,57,2,71,1739
MICHOACÁN,HEROICA ZITACUARO,11,87,0,98,1738
MICHOACÁN,HEROICA ZITACUARO,4,95,2,101,1666
MICHOACÁN,HEROICA ZITACUARO,3,82,4,89,1665
MICHOACÁN,HEROICA ZITACUARO,14,79,6,99,1952
MICHOACÁN,HEROICA ZITACUARO,9,57,2,68,1952
MICHOACÁN,HEROICA ZITACUARO,3,42,3,48,1526
MICHOACÁN,HEROICA ZITACUARO,3,60,4,67,1526
MICHOACÁN,HEROICA ZITACUARO,0,43,3,46,1525
MICHOACÁN,JIQUILPAN DE JUAREZ,17,244,2,263,1293
MICHOACÁN,JIQUILPAN DE JUAREZ,17,274,4,295,1293
MICHOACÁN,JIQUILPAN DE JUAREZ,18,310,0,328,1804
MICHOACÁN,JIQUILPAN DE JUAREZ,17,328,4,349,1803
MICHOACÁN,JIQUILPAN DE JUAREZ,19,63,0,82,1708
MICHOACÁN,JIQUILPAN DE JUAREZ,18,73,1,92,1707
MICHOACÁN,JIQUILPAN DE JUAREZ,14,49,2,65,1707
MICHOACÁN,JIQUILPAN DE JUAREZ,7,71,0,78,1548
MICHOACÁN,JIQUILPAN DE JUAREZ,4,47,2,53,1548
MICHOACÁN,JIQUILPAN DE JUAREZ,7,46,2,55,1547
MICHOACÁN,JIQUILPAN DE JUAREZ,10,57,2,69,1678
MICHOACÁN,JIQUILPAN DE JUAREZ,11,62,0,73,1678
MICHOACÁN,JIQUILPAN DE JUAREZ,10,84,4,98,1677
MICHOACÁN,JIQUILPAN DE JUAREZ,3,147,3,153,1469
MICHOACÁN,JIQUILPAN DE JUAREZ,8,126,1,135,1468
MICHOACÁN,JIQUILPAN DE JUAREZ,10,138,0,148,2082
MICHOACÁN,JIQUILPAN DE JUAREZ,22,123,8,153,2081
MICHOACÁN,JIQUILPAN DE JUAREZ,10,146,1,157,2081
MICHOACÁN,JIQUILPAN DE JUAREZ,4,52,2,58,1642
MICHOACÁN,JIQUILPAN DE JUAREZ,5,69,5,79,1642
MICHOACÁN,JIQUILPAN DE JUAREZ,8,72,4,84,1642
MICHOACÁN,JIQUILPAN DE JUAREZ,5,103,0,108,1434
MICHOACÁN,JIQUILPAN DE JUAREZ,5,97,1,103,1433
MICHOACÁN,JIQUILPAN DE JUAREZ,2,110,0,112,1433
MICHOACÁN,JIQUILPAN DE JUAREZ,12,295,2,309,2027
MICHOACÁN,JIQUILPAN DE JUAREZ,6,276,3,285,2026
MICHOACÁN,JIQUILPAN DE JUAREZ,16,192,2,210,1699
MICHOACÁN,JIQUILPAN DE JUAREZ,14,231,2,247,1699
MICHOACÁN,JIQUILPAN DE JUAREZ,19,263,3,285,1717
MICHOACÁN,JIQUILPAN DE JUAREZ,16,279,13,308,1716
MICHOACÁN,JIQUILPAN DE JUAREZ,15,302,1,318,1727
MICHOACÁN,JIQUILPAN DE JUAREZ,13,292,4,309,1727
MICHOACÁN,JIQUILPAN DE JUAREZ,22,302,1,325,1727
MICHOACÁN,JIQUILPAN DE JUAREZ,8,197,2,207,1496
MICHOACÁN,JIQUILPAN DE JUAREZ,10,176,2,188,1496
MICHOACÁN,JIQUILPAN DE JUAREZ,5,155,2,162,1495
MICHOACÁN,JIQUILPAN DE JUAREZ,42,352,5,399,0
MICHOACÁN,JIQUILPAN DE JUAREZ,10,194,4,208,1466
MICHOACÁN,JIQUILPAN DE JUAREZ,13,166,3,182,1466
MICHOACÁN,JIQUILPAN DE JUAREZ,10,185,2,197,1466
MICHOACÁN,JIQUILPAN DE JUAREZ,9,172,3,184,1620
MICHOACÁN,JIQUILPAN DE JUAREZ,4,209,5,218,1619
MICHOACÁN,JIQUILPAN DE JUAREZ,15,116,3,134,1966
MICHOACÁN,JIQUILPAN DE JUAREZ,13,148,5,166,1965
MICHOACÁN,JIQUILPAN DE JUAREZ,7,144,0,151,1965
MICHOACÁN,JIQUILPAN DE JUAREZ,36,220,7,263,1948
MICHOACÁN,JIQUILPAN DE JUAREZ,25,207,0,232,1947
MICHOACÁN,JIQUILPAN DE JUAREZ,6,277,3,286,1954
MICHOACÁN,JIQUILPAN DE JUAREZ,6,233,4,243,1953
MICHOACÁN,JIQUILPAN DE JUAREZ,6,249,6,261,1953
MICHOACÁN,JIQUILPAN DE JUAREZ,7,225,6,238,1990
MICHOACÁN,JIQUILPAN DE JUAREZ,9,229,2,240,1989
MICHOACÁN,JIQUILPAN DE JUAREZ,13,231,7,251,1505
MICHOACÁN,JIQUILPAN DE JUAREZ,9,245,6,260,1505
MICHOACÁN,JIQUILPAN DE JUAREZ,13,235,4,252,1504
MICHOACÁN,JIQUILPAN DE JUAREZ,2,183,1,186,1602
MICHOACÁN,JIQUILPAN DE JUAREZ,1,220,2,223,1601
MICHOACÁN,JIQUILPAN DE JUAREZ,9,331,0,340,1524
MICHOACÁN,JIQUILPAN DE JUAREZ,12,316,0,328,1523
MICHOACÁN,JIQUILPAN DE JUAREZ,13,312,0,325,1523
MICHOACÁN,JIQUILPAN DE JUAREZ,13,262,1,276,1820
MICHOACÁN,JIQUILPAN DE JUAREZ,19,241,2,262,1820
MICHOACÁN,JIQUILPAN DE JUAREZ,2,132,0,134,1839
MICHOACÁN,JIQUILPAN DE JUAREZ,13,135,0,148,1838
MICHOACÁN,JIQUILPAN DE JUAREZ,10,120,1,131,1838
MICHOACÁN,JIQUILPAN DE JUAREZ,7,151,8,166,1657
MICHOACÁN,JIQUILPAN DE JUAREZ,3,152,7,162,1657
MICHOACÁN,JIQUILPAN DE JUAREZ,15,146,6,167,1890
MICHOACÁN,JIQUILPAN DE JUAREZ,8,124,7,139,1890
MICHOACÁN,JIQUILPAN DE JUAREZ,14,110,0,124,1561
MICHOACÁN,JIQUILPAN DE JUAREZ,5,123,1,129,1560
MICHOACÁN,JIQUILPAN DE JUAREZ,8,114,4,126,1350
MICHOACÁN,JIQUILPAN DE JUAREZ,8,116,1,125,1349
MICHOACÁN,JIQUILPAN DE JUAREZ,17,133,2,152,1617
MICHOACÁN,JIQUILPAN DE JUAREZ,7,147,2,156,1617
MICHOACÁN,JIQUILPAN DE JUAREZ,12,150,4,166,1984
MICHOACÁN,JIQUILPAN DE JUAREZ,4,157,1,162,1983
MICHOACÁN,JIQUILPAN DE JUAREZ,4,124,1,129,1859
MICHOACÁN,JIQUILPAN DE JUAREZ,3,92,2,97,1858
MICHOACÁN,JIQUILPAN DE JUAREZ,16,228,2,246,2140
MICHOACÁN,JIQUILPAN DE JUAREZ,6,103,0,109,1482
MICHOACÁN,JIQUILPAN DE JUAREZ,9,98,2,109,1481
MICHOACÁN,JIQUILPAN DE JUAREZ,4,102,0,106,1481
MICHOACÁN,JIQUILPAN DE JUAREZ,5,114,0,119,1630
MICHOACÁN,JIQUILPAN DE JUAREZ,9,121,3,133,1629
MICHOACÁN,JIQUILPAN DE JUAREZ,7,116,2,125,1629
MICHOACÁN,JIQUILPAN DE JUAREZ,8,419,14,441,1856
MICHOACÁN,JIQUILPAN DE JUAREZ,17,409,16,442,1855
MICHOACÁN,JIQUILPAN DE JUAREZ,18,298,8,324,1234
MICHOACÁN,JIQUILPAN DE JUAREZ,6,300,1,307,1234
MICHOACÁN,JIQUILPAN DE JUAREZ,24,227,9,260,1990
MICHOACÁN,JIQUILPAN DE JUAREZ,43,206,5,254,1990
MICHOACÁN,JIQUILPAN DE JUAREZ,6,117,6,129,1109
MICHOACÁN,JIQUILPAN DE JUAREZ,7,95,0,102,1108
MICHOACÁN,JIQUILPAN DE JUAREZ,13,107,0,120,2026
MICHOACÁN,JIQUILPAN DE JUAREZ,3,79,3,85,1597
MICHOACÁN,JIQUILPAN DE JUAREZ,0,82,1,83,1596
MICHOACÁN,JIQUILPAN DE JUAREZ,11,149,6,166,1589
MICHOACÁN,JIQUILPAN DE JUAREZ,13,170,1,184,1589
MICHOACÁN,JIQUILPAN DE JUAREZ,4,148,0,152,2087
MICHOACÁN,JIQUILPAN DE JUAREZ,4,145,1,150,2087
MICHOACÁN,JIQUILPAN DE JUAREZ,9,125,2,136,1726
MICHOACÁN,JIQUILPAN DE JUAREZ,10,123,0,133,1725
MICHOACÁN,JIQUILPAN DE JUAREZ,21,188,5,214,1807
MICHOACÁN,JIQUILPAN DE JUAREZ,14,205,4,223,1806
MICHOACÁN,JIQUILPAN DE JUAREZ,26,143,0,169,1915
MICHOACÁN,JIQUILPAN DE JUAREZ,28,175,1,204,1914
MICHOACÁN,JIQUILPAN DE JUAREZ,20,129,1,150,1489
MICHOACÁN,JIQUILPAN DE JUAREZ,13,137,1,151,1489
MICHOACÁN,JIQUILPAN DE JUAREZ,27,117,4,148,1489
MICHOACÁN,JIQUILPAN DE JUAREZ,11,135,5,151,1539
MICHOACÁN,JIQUILPAN DE JUAREZ,12,125,3,140,1539
MICHOACÁN,JIQUILPAN DE JUAREZ,10,146,1,157,2097
MICHOACÁN,JIQUILPAN DE JUAREZ,15,157,2,174,2096
MICHOACÁN,JIQUILPAN DE JUAREZ,19,230,6,255,1930
MICHOACÁN,JIQUILPAN DE JUAREZ,14,197,2,213,1930
MICHOACÁN,JIQUILPAN DE JUAREZ,22,236,6,264,1764
MICHOACÁN,JIQUILPAN DE JUAREZ,16,235,3,254,1763
MICHOACÁN,JIQUILPAN DE JUAREZ,12,227,3,242,1763
MICHOACÁN,JIQUILPAN DE JUAREZ,7,125,5,137,1499
MICHOACÁN,JIQUILPAN DE JUAREZ,7,101,4,112,1498
MICHOACÁN,JIQUILPAN DE JUAREZ,4,117,1,122,1498
MICHOACÁN,JIQUILPAN DE JUAREZ,6,81,1,88,1500
MICHOACÁN,JIQUILPAN DE JUAREZ,7,105,0,112,1500
MICHOACÁN,JIQUILPAN DE JUAREZ,13,151,0,164,2073
MICHOACÁN,JIQUILPAN DE JUAREZ,9,158,0,167,2073
MICHOACÁN,JIQUILPAN DE JUAREZ,16,225,2,243,1980
MICHOACÁN,JIQUILPAN DE JUAREZ,14,226,3,243,1979
MICHOACÁN,JIQUILPAN DE JUAREZ,13,329,6,348,1957
MICHOACÁN,JIQUILPAN DE JUAREZ,23,274,1,298,1957
MICHOACÁN,JIQUILPAN DE JUAREZ,2,131,0,133,1297
MICHOACÁN,JIQUILPAN DE JUAREZ,3,61,0,64,1297
MICHOACÁN,JIQUILPAN DE JUAREZ,19,184,3,206,1894
MICHOACÁN,JIQUILPAN DE JUAREZ,17,215,4,236,1893
MICHOACÁN,JIQUILPAN DE JUAREZ,17,183,5,205,1893
MICHOACÁN,JIQUILPAN DE JUAREZ,3,252,1,256,2000
MICHOACÁN,JIQUILPAN DE JUAREZ,6,266,4,276,1999
MICHOACÁN,JIQUILPAN DE JUAREZ,8,130,3,141,1776
MICHOACÁN,JIQUILPAN DE JUAREZ,11,202,9,222,1776
MICHOACÁN,JIQUILPAN DE JUAREZ,6,115,3,124,1959
MICHOACÁN,JIQUILPAN DE JUAREZ,10,139,4,153,1958
MICHOACÁN,JIQUILPAN DE JUAREZ,9,132,2,143,1209
MICHOACÁN,JIQUILPAN DE JUAREZ,3,132,1,136,1208
MICHOACÁN,JIQUILPAN DE JUAREZ,25,119,0,144,1661
MICHOACÁN,JIQUILPAN DE JUAREZ,18,90,3,111,1660
MICHOACÁN,JIQUILPAN DE JUAREZ,10,120,6,136,1783
MICHOACÁN,JIQUILPAN DE JUAREZ,12,87,2,101,1783
MICHOACÁN,JIQUILPAN DE JUAREZ,28,128,1,157,1274
MICHOACÁN,JIQUILPAN DE JUAREZ,18,102,4,124,1274
MICHOACÁN,JIQUILPAN DE JUAREZ,6,86,2,94,1433
MICHOACÁN,JIQUILPAN DE JUAREZ,5,83,2,90,1432
MICHOACÁN,JIQUILPAN DE JUAREZ,9,285,10,304,1966
MICHOACÁN,JIQUILPAN DE JUAREZ,16,339,5,360,1965
MICHOACÁN,JIQUILPAN DE JUAREZ,11,335,10,356,1888
MICHOACÁN,JIQUILPAN DE JUAREZ,13,344,6,363,1888
MICHOACÁN,JIQUILPAN DE JUAREZ,9,375,6,390,1794
MICHOACÁN,JIQUILPAN DE JUAREZ,8,372,3,383,1793
MICHOACÁN,JIQUILPAN DE JUAREZ,3,177,2,182,1278
MICHOACÁN,JIQUILPAN DE JUAREZ,8,200,2,210,1277
MICHOACÁN,JIQUILPAN DE JUAREZ,9,255,0,264,1858
MICHOACÁN,JIQUILPAN DE JUAREZ,9,396,2,407,1858
MICHOACÁN,JIQUILPAN DE JUAREZ,5,186,7,198,1918
MICHOACÁN,JIQUILPAN DE JUAREZ,9,186,10,205,1917
MICHOACÁN,JIQUILPAN DE JUAREZ,10,299,3,312,1732
MICHOACÁN,JIQUILPAN DE JUAREZ,8,303,3,314,1731
MICHOACÁN,JIQUILPAN DE JUAREZ,5,73,1,79,2143
MICHOACÁN,JIQUILPAN DE JUAREZ,11,89,7,107,1114
MICHOACÁN,JIQUILPAN DE JUAREZ,15,78,2,95,1113
MICHOACÁN,JIQUILPAN DE JUAREZ,6,146,1,153,1917
MICHOACÁN,JIQUILPAN DE JUAREZ,3,130,2,135,1916
MICHOACÁN,JIQUILPAN DE JUAREZ,9,243,1,253,1864
MICHOACÁN,JIQUILPAN DE JUAREZ,9,263,9,281,1864
MICHOACÁN,JIQUILPAN DE JUAREZ,17,239,9,265,1864
MICHOACÁN,JIQUILPAN DE JUAREZ,8,221,7,236,1989
MICHOACÁN,JIQUILPAN DE JUAREZ,8,251,5,264,1988
MICHOACÁN,JIQUILPAN DE JUAREZ,3,155,0,158,1414
MICHOACÁN,JIQUILPAN DE JUAREZ,4,151,2,157,1414
MICHOACÁN,JIQUILPAN DE JUAREZ,9,231,4,244,1687
MICHOACÁN,JIQUILPAN DE JUAREZ,15,270,8,293,1686
MICHOACÁN,ZAMORA DE HIDALGO,10,246,4,260,1955
MICHOACÁN,ZAMORA DE HIDALGO,14,227,3,244,1954
MICHOACÁN,ZAMORA DE HIDALGO,7,135,2,144,1787
MICHOACÁN,ZAMORA DE HIDALGO,2,84,2,88,1786
MICHOACÁN,ZAMORA DE HIDALGO,5,94,3,102,1516
MICHOACÁN,ZAMORA DE HIDALGO,4,116,2,122,1516
MICHOACÁN,ZAMORA DE HIDALGO,6,94,2,102,1515
MICHOACÁN,ZAMORA DE HIDALGO,5,153,6,164,1767
MICHOACÁN,ZAMORA DE HIDALGO,6,127,4,137,1767
MICHOACÁN,ZAMORA DE HIDALGO,6,161,3,170,1766
MICHOACÁN,ZAMORA DE HIDALGO,6,143,7,156,1567
MICHOACÁN,ZAMORA DE HIDALGO,1,181,3,185,1566
MICHOACÁN,ZAMORA DE HIDALGO,7,106,6,119,1749
MICHOACÁN,ZAMORA DE HIDALGO,1,98,2,101,1749
MICHOACÁN,ZAMORA DE HIDALGO,3,118,2,123,1749
MICHOACÁN,ZAMORA DE HIDALGO,4,151,3,158,1307
MICHOACÁN,ZAMORA DE HIDALGO,5,194,2,201,1306
MICHOACÁN,ZAMORA DE HIDALGO,5,85,0,90,1602
MICHOACÁN,ZAMORA DE HIDALGO,2,74,1,77,1602
MICHOACÁN,ZAMORA DE HIDALGO,3,78,1,82,1601
MICHOACÁN,ZAMORA DE HIDALGO,6,73,0,79,1601
MICHOACÁN,ZAMORA DE HIDALGO,8,141,0,149,1220
MICHOACÁN,ZAMORA DE HIDALGO,6,142,2,150,1220
MICHOACÁN,ZAMORA DE HIDALGO,14,129,1,144,1424
MICHOACÁN,ZAMORA DE HIDALGO,15,140,1,156,1423
MICHOACÁN,ZAMORA DE HIDALGO,8,139,0,147,1459
MICHOACÁN,ZAMORA DE HIDALGO,8,125,0,133,1459
MICHOACÁN,ZAMORA DE HIDALGO,7,99,2,108,1459
MICHOACÁN,ZAMORA DE HIDALGO,13,194,1,208,1888
MICHOACÁN,ZAMORA DE HIDALGO,19,189,2,210,1887
MICHOACÁN,ZAMORA DE HIDALGO,11,143,3,157,1876
MICHOACÁN,ZAMORA DE HIDALGO,4,134,1,139,1876
MICHOACÁN,ZAMORA DE HIDALGO,7,65,2,74,1743
MICHOACÁN,ZAMORA DE HIDALGO,6,58,0,64,1742
MICHOACÁN,ZAMORA DE HIDALGO,9,137,1,147,1474
MICHOACÁN,ZAMORA DE HIDALGO,7,121,2,130,1474
MICHOACÁN,ZAMORA DE HIDALGO,9,166,1,176,1474
MICHOACÁN,ZAMORA DE HIDALGO,8,198,0,206,1576
MICHOACÁN,ZAMORA DE HIDALGO,9,176,1,186,1575
MICHOACÁN,ZAMORA DE HIDALGO,8,185,0,193,1575
MICHOACÁN,ZAMORA DE HIDALGO,4,116,3,123,1852
MICHOACÁN,ZAMORA DE HIDALGO,15,112,0,127,1851
MICHOACÁN,ZAMORA DE HIDALGO,9,120,7,136,1851
MICHOACÁN,ZAMORA DE HIDALGO,11,152,0,163,1488
MICHOACÁN,ZAMORA DE HIDALGO,16,160,2,178,1487
MICHOACÁN,ZAMORA DE HIDALGO,14,162,3,179,1789
MICHOACÁN,ZAMORA DE HIDALGO,13,160,2,175,1788
MICHOACÁN,ZAMORA DE HIDALGO,7,158,1,166,1913
MICHOACÁN,ZAMORA DE HIDALGO,6,177,4,187,1912
MICHOACÁN,ZAMORA DE HIDALGO,13,115,1,129,1853
MICHOACÁN,ZAMORA DE HIDALGO,20,142,1,163,1852
MICHOACÁN,ZAMORA DE HIDALGO,9,127,4,140,1414
MICHOACÁN,ZAMORA DE HIDALGO,13,128,2,143,1414
MICHOACÁN,ZAMORA DE HIDALGO,8,149,2,159,1900
MICHOACÁN,ZAMORA DE HIDALGO,7,127,2,136,1899
MICHOACÁN,ZAMORA DE HIDALGO,10,173,1,184,1797
MICHOACÁN,ZAMORA DE HIDALGO,7,145,5,157,1796
MICHOACÁN,ZAMORA DE HIDALGO,2,98,1,101,1346
MICHOACÁN,ZAMORA DE HIDALGO,1,92,1,94,1346
MICHOACÁN,ZAMORA DE HIDALGO,2,107,1,110,1346
MICHOACÁN,ZAMORA DE HIDALGO,7,113,1,121,1624
MICHOACÁN,ZAMORA DE HIDALGO,8,106,0,114,1623
MICHOACÁN,ZAMORA DE HIDALGO,13,69,1,83,1480
MICHOACÁN,ZAMORA DE HIDALGO,7,79,1,87,1479
MICHOACÁN,ZAMORA DE HIDALGO,11,100,2,113,1479
MICHOACÁN,ZAMORA DE HIDALGO,14,116,5,135,1775
MICHOACÁN,ZAMORA DE HIDALGO,14,126,3,143,1774
MICHOACÁN,ZAMORA DE HIDALGO,6,60,1,67,1343
MICHOACÁN,ZAMORA DE HIDALGO,3,55,0,58,1342
MICHOACÁN,ZAMORA DE HIDALGO,4,69,1,74,1342
MICHOACÁN,ZAMORA DE HIDALGO,13,158,0,171,1961
MICHOACÁN,ZAMORA DE HIDALGO,9,181,8,198,1961
MICHOACÁN,ZAMORA DE HIDALGO,6,259,3,268,1805
MICHOACÁN,ZAMORA DE HIDALGO,6,259,5,270,1804
MICHOACÁN,ZAMORA DE HIDALGO,5,244,1,250,1804
MICHOACÁN,ZAMORA DE HIDALGO,1,186,1,188,1518
MICHOACÁN,ZAMORA DE HIDALGO,6,179,1,186,1518
MICHOACÁN,ZAMORA DE HIDALGO,4,147,4,155,1518
MICHOACÁN,ZAMORA DE HIDALGO,3,285,6,294,1772
MICHOACÁN,ZAMORA DE HIDALGO,5,223,2,230,1771
MICHOACÁN,ZAMORA DE HIDALGO,9,263,5,277,1917
MICHOACÁN,ZAMORA DE HIDALGO,10,199,2,211,1917
MICHOACÁN,ZAMORA DE HIDALGO,15,246,2,263,1982
MICHOACÁN,ZAMORA DE HIDALGO,13,248,4,265,1982
MICHOACÁN,ZAMORA DE HIDALGO,19,181,3,203,1797
MICHOACÁN,ZAMORA DE HIDALGO,16,194,5,215,1797
MICHOACÁN,ZAMORA DE HIDALGO,12,134,5,151,1754
MICHOACÁN,ZAMORA DE HIDALGO,8,158,4,170,1753
MICHOACÁN,ZAMORA DE HIDALGO,12,152,1,165,1640
MICHOACÁN,ZAMORA DE HIDALGO,12,149,6,167,1640
MICHOACÁN,ZAMORA DE HIDALGO,0,146,0,146,1640
MICHOACÁN,ZAMORA DE HIDALGO,2,110,0,112,1821
MICHOACÁN,ZAMORA DE HIDALGO,3,100,2,105,1820
MICHOACÁN,ZAMORA DE HIDALGO,15,164,5,184,1875
MICHOACÁN,ZAMORA DE HIDALGO,13,177,5,195,1875
MICHOACÁN,ZAMORA DE HIDALGO,8,114,7,129,1214
MICHOACÁN,ZAMORA DE HIDALGO,3,123,1,127,1213
MICHOACÁN,ZAMORA DE HIDALGO,9,189,2,200,1898
MICHOACÁN,ZAMORA DE HIDALGO,10,172,7,189,1897
MICHOACÁN,ZAMORA DE HIDALGO,6,141,3,150,1876
MICHOACÁN,ZAMORA DE HIDALGO,9,177,0,186,1876
MICHOACÁN,ZAMORA DE HIDALGO,23,177,0,200,1975
MICHOACÁN,ZAMORA DE HIDALGO,13,179,2,194,1975
MICHOACÁN,ZAMORA DE HIDALGO,10,229,3,242,1805
MICHOACÁN,ZAMORA DE HIDALGO,12,192,3,207,1804
MICHOACÁN,ZAMORA DE HIDALGO,14,90,0,104,1564
MICHOACÁN,ZAMORA DE HIDALGO,4,83,5,92,1564
MICHOACÁN,ZAMORA DE HIDALGO,7,81,3,91,1277
MICHOACÁN,ZAMORA DE HIDALGO,17,64,2,83,1276
MICHOACÁN,ZAMORA DE HIDALGO,14,133,2,149,1356
MICHOACÁN,ZAMORA DE HIDALGO,9,115,3,127,1356
MICHOACÁN,ZAMORA DE HIDALGO,11,135,5,151,1356
MICHOACÁN,ZAMORA DE HIDALGO,14,191,3,208,1567
MICHOACÁN,ZAMORA DE HIDALGO,21,174,2,197,1566
MICHOACÁN,ZAMORA DE HIDALGO,21,133,4,158,1494
MICHOACÁN,ZAMORA DE HIDALGO,24,150,3,177,1493
MICHOACÁN,ZAMORA DE HIDALGO,13,117,0,130,1493
MICHOACÁN,ZAMORA DE HIDALGO,20,182,4,206,1689
MICHOACÁN,ZAMORA DE HIDALGO,12,169,5,186,1688
MICHOACÁN,ZAMORA DE HIDALGO,12,176,7,195,1472
MICHOACÁN,ZAMORA DE HIDALGO,8,163,5,176,1472
MICHOACÁN,ZAMORA DE HIDALGO,5,180,7,192,1461
MICHOACÁN,ZAMORA DE HIDALGO,2,155,2,159,1461
MICHOACÁN,ZAMORA DE HIDALGO,10,145,2,157,1026
MICHOACÁN,ZAMORA DE HIDALGO,7,126,3,136,1026
MICHOACÁN,ZAMORA DE HIDALGO,5,125,1,131,1956
MICHOACÁN,ZAMORA DE HIDALGO,10,126,5,141,1955
MICHOACÁN,ZAMORA DE HIDALGO,9,163,1,173,1955
MICHOACÁN,ZAMORA DE HIDALGO,6,141,2,149,1955
MICHOACÁN,ZAMORA DE HIDALGO,9,111,2,122,1955
MICHOACÁN,ZAMORA DE HIDALGO,15,138,4,157,1955
MICHOACÁN,ZAMORA DE HIDALGO,13,156,2,171,1955
MICHOACÁN,ZAMORA DE HIDALGO,10,122,0,132,1955
MICHOACÁN,ZAMORA DE HIDALGO,17,175,1,193,1351
MICHOACÁN,ZAMORA DE HIDALGO,8,161,3,172,1350
MICHOACÁN,ZAMORA DE HIDALGO,11,212,4,227,1690
MICHOACÁN,ZAMORA DE HIDALGO,8,200,6,214,1689
MICHOACÁN,ZAMORA DE HIDALGO,19,175,2,196,1464
MICHOACÁN,ZAMORA DE HIDALGO,10,202,2,214,1464
MICHOACÁN,ZAMORA DE HIDALGO,10,185,5,200,1412
MICHOACÁN,ZAMORA DE HIDALGO,10,149,23,182,1411
MICHOACÁN,ZAMORA DE HIDALGO,11,129,2,142,1623
MICHOACÁN,ZAMORA DE HIDALGO,10,129,1,140,1623
MICHOACÁN,ZAMORA DE HIDALGO,13,112,2,127,1622
MICHOACÁN,ZAMORA DE HIDALGO,9,130,3,142,1622
MICHOACÁN,ZAMORA DE HIDALGO,15,136,2,153,1622
MICHOACÁN,ZAMORA DE HIDALGO,52,593,6,651,0
MICHOACÁN,ZAMORA DE HIDALGO,12,153,3,168,1466
MICHOACÁN,ZAMORA DE HIDALGO,18,143,4,165,1466
MICHOACÁN,ZAMORA DE HIDALGO,18,235,3,256,1681
MICHOACÁN,ZAMORA DE HIDALGO,9,238,5,252,1681
MICHOACÁN,ZAMORA DE HIDALGO,29,177,1,207,1462
MICHOACÁN,ZAMORA DE HIDALGO,18,156,3,177,1462
MICHOACÁN,ZAMORA DE HIDALGO,14,177,1,192,1461
MICHOACÁN,ZAMORA DE HIDALGO,24,175,5,204,1890
MICHOACÁN,ZAMORA DE HIDALGO,25,194,1,220,1889
MICHOACÁN,ZAMORA DE HIDALGO,32,186,2,220,1856
MICHOACÁN,ZAMORA DE HIDALGO,33,200,1,234,1855
MICHOACÁN,ZAMORA DE HIDALGO,25,210,4,239,1705
MICHOACÁN,ZAMORA DE HIDALGO,17,195,2,214,1705
MICHOACÁN,ZAMORA DE HIDALGO,13,166,4,183,1455
MICHOACÁN,ZAMORA DE HIDALGO,9,131,2,142,1455
MICHOACÁN,ZAMORA DE HIDALGO,15,156,1,172,1133
MICHOACÁN,ZAMORA DE HIDALGO,10,130,3,143,1133
MICHOACÁN,ZAMORA DE HIDALGO,10,171,6,187,2003
MICHOACÁN,ZAMORA DE HIDALGO,7,154,3,164,2003
MICHOACÁN,ZAMORA DE HIDALGO,4,125,2,131,1692
MICHOACÁN,ZAMORA DE HIDALGO,7,97,4,108,1692
MICHOACÁN,ZAMORA DE HIDALGO,5,105,2,112,1692
MICHOACÁN,ZAMORA DE HIDALGO,12,146,3,161,1379
MICHOACÁN,ZAMORA DE HIDALGO,9,152,2,163,1379
MICHOACÁN,ZAMORA DE HIDALGO,12,131,2,145,1378
MICHOACÁN,ZAMORA DE HIDALGO,6,141,7,154,1640
MICHOACÁN,ZAMORA DE HIDALGO,5,127,8,140,1639
MICHOACÁN,ZAMORA DE HIDALGO,11,166,8,185,1460
MICHOACÁN,ZAMORA DE HIDALGO,11,175,9,195,1459
MICHOACÁN,ZAMORA DE HIDALGO,6,199,2,207,1671
MICHOACÁN,ZAMORA DE HIDALGO,2,149,0,151,1671
MICHOACÁN,ZAMORA DE HIDALGO,5,133,2,140,1858
MICHOACÁN,ZAMORA DE HIDALGO,10,125,3,138,1858
MICHOACÁN,ZAMORA DE HIDALGO,2,124,1,127,1858
MICHOACÁN,ZAMORA DE HIDALGO,9,136,1,146,1857
MICHOACÁN,ZAMORA DE HIDALGO,2,112,1,115,1857
MICHOACÁN,ZAMORA DE HIDALGO,123,7,0,130,1857
MICHOACÁN,ZAMORA DE HIDALGO,11,111,4,126,1828
MICHOACÁN,ZAMORA DE HIDALGO,17,107,2,126,1828
MICHOACÁN,ZAMORA DE HIDALGO,10,83,3,96,1828
MICHOACÁN,CIUDAD HIDALGO,17,246,8,271,1919
MICHOACÁN,CIUDAD HIDALGO,25,223,4,252,1919
MICHOACÁN,CIUDAD HIDALGO,5,98,1,104,1469
MICHOACÁN,CIUDAD HIDALGO,2,91,3,96,1468
MICHOACÁN,CIUDAD HIDALGO,7,124,1,132,1724
MICHOACÁN,CIUDAD HIDALGO,9,140,2,151,1724
MICHOACÁN,CIUDAD HIDALGO,8,225,4,237,1396
MICHOACÁN,CIUDAD HIDALGO,8,262,5,275,1396
MICHOACÁN,CIUDAD HIDALGO,3,90,0,93,1505
MICHOACÁN,CIUDAD HIDALGO,6,89,0,95,1504
MICHOACÁN,CIUDAD HIDALGO,13,171,6,190,1502
MICHOACÁN,CIUDAD HIDALGO,13,178,5,196,1502
MICHOACÁN,CIUDAD HIDALGO,15,86,3,104,1647
MICHOACÁN,CIUDAD HIDALGO,5,76,0,81,1647
MICHOACÁN,CIUDAD HIDALGO,5,171,1,177,1688
MICHOACÁN,CIUDAD HIDALGO,8,122,7,137,1687
MICHOACÁN,CIUDAD HIDALGO,9,133,6,148,1687
MICHOACÁN,CIUDAD HIDALGO,4,48,0,52,1622
MICHOACÁN,CIUDAD HIDALGO,5,30,1,36,1621
MICHOACÁN,CIUDAD HIDALGO,2,40,4,46,1621
MICHOACÁN,CIUDAD HIDALGO,4,133,6,143,2047
MICHOACÁN,CIUDAD HIDALGO,4,135,6,145,2046
MICHOACÁN,CIUDAD HIDALGO,5,87,4,96,2046
MICHOACÁN,CIUDAD HIDALGO,6,76,0,82,1105
MICHOACÁN,CIUDAD HIDALGO,6,49,0,55,1104
MICHOACÁN,CIUDAD HIDALGO,35,158,4,197,1295
MICHOACÁN,CIUDAD HIDALGO,28,144,11,183,1295
MICHOACÁN,CIUDAD HIDALGO,43,207,8,258,1770
MICHOACÁN,CIUDAD HIDALGO,26,235,11,272,1770
MICHOACÁN,CIUDAD HIDALGO,45,195,16,256,1925
MICHOACÁN,CIUDAD HIDALGO,55,210,7,272,1925
MICHOACÁN,CIUDAD HIDALGO,22,161,5,188,1424
MICHOACÁN,CIUDAD HIDALGO,20,133,4,157,1423
MICHOACÁN,CIUDAD HIDALGO,26,173,0,199,1380
MICHOACÁN,CIUDAD HIDALGO,35,190,0,225,1379
MICHOACÁN,CIUDAD HIDALGO,37,225,7,269,1650
MICHOACÁN,CIUDAD HIDALGO,30,230,14,274,1650
MICHOACÁN,CIUDAD HIDALGO,43,121,11,175,1098
MICHOACÁN,CIUDAD HIDALGO,39,129,10,178,1098
MICHOACÁN,CIUDAD HIDALGO,44,161,6,211,1420
MICHOACÁN,CIUDAD HIDALGO,45,145,14,204,1419
MICHOACÁN,CIUDAD HIDALGO,30,177,6,213,1463
MICHOACÁN,CIUDAD HIDALGO,22,183,3,208,1462
MICHOACÁN,CIUDAD HIDALGO,31,224,3,258,1739
MICHOACÁN,CIUDAD HIDALGO,55,235,9,299,1739
MICHOACÁN,CIUDAD HIDALGO,28,197,10,235,1591
MICHOACÁN,CIUDAD HIDALGO,34,184,6,224,1590
MICHOACÁN,CIUDAD HIDALGO,34,199,10,243,1590
MICHOACÁN,CIUDAD HIDALGO,63,305,7,375,1990
MICHOACÁN,CIUDAD HIDALGO,30,174,5,209,1726
MICHOACÁN,CIUDAD HIDALGO,39,175,2,216,1725
MICHOACÁN,CIUDAD HIDALGO,115,604,30,749,0
MICHOACÁN,CIUDAD HIDALGO,26,186,4,216,1621
MICHOACÁN,CIUDAD HIDALGO,37,183,11,231,1621
MICHOACÁN,CIUDAD HIDALGO,22,147,4,173,1353
MICHOACÁN,CIUDAD HIDALGO,35,169,4,208,1353
MICHOACÁN,CIUDAD HIDALGO,35,282,17,334,1839
MICHOACÁN,CIUDAD HIDALGO,44,295,10,349,1838
MICHOACÁN,CIUDAD HIDALGO,49,178,3,230,1628
MICHOACÁN,CIUDAD HIDALGO,35,178,27,240,1628
MICHOACÁN,CIUDAD HIDALGO,127,376,45,548,1972
MICHOACÁN,CIUDAD HIDALGO,151,330,48,529,1971
MICHOACÁN,CIUDAD HIDALGO,145,335,67,547,1892
MICHOACÁN,CIUDAD HIDALGO,173,309,37,519,1891
MICHOACÁN,CIUDAD HIDALGO,44,121,7,172,1297
MICHOACÁN,CIUDAD HIDALGO,52,125,10,187,1297
MICHOACÁN,CIUDAD HIDALGO,96,330,27,453,1499
MICHOACÁN,CIUDAD HIDALGO,109,200,33,342,1499
MICHOACÁN,CIUDAD HIDALGO,75,264,8,347,1856
MICHOACÁN,CIUDAD HIDALGO,63,251,14,328,1855
MICHOACÁN,CIUDAD HIDALGO,71,249,21,341,1632
MICHOACÁN,CIUDAD HIDALGO,80,221,29,330,1631
MICHOACÁN,CIUDAD HIDALGO,72,213,20,305,1631
MICHOACÁN,CIUDAD HIDALGO,104,294,64,462,2034
MICHOACÁN,CIUDAD HIDALGO,86,212,50,348,1414
MICHOACÁN,CIUDAD HIDALGO,91,223,31,345,1414
MICHOACÁN,CIUDAD HIDALGO,91,253,20,364,1699
MICHOACÁN,CIUDAD HIDALGO,79,269,13,361,1699
MICHOACÁN,CIUDAD HIDALGO,99,244,37,380,1562
MICHOACÁN,CIUDAD HIDALGO,107,224,24,355,1561
MICHOACÁN,CIUDAD HIDALGO,63,163,9,235,2122
MICHOACÁN,CIUDAD HIDALGO,59,158,6,223,2122
MICHOACÁN,CIUDAD HIDALGO,24,117,3,144,1999
MICHOACÁN,CIUDAD HIDALGO,8,133,6,147,1998
MICHOACÁN,CIUDAD HIDALGO,18,159,0,177,1932
MICHOACÁN,CIUDAD HIDALGO,14,187,7,208,1931
MICHOACÁN,CIUDAD HIDALGO,114,10,3,127,1113
MICHOACÁN,CIUDAD HIDALGO,8,110,2,120,1113
MICHOACÁN,CIUDAD HIDALGO,17,157,2,176,1905
MICHOACÁN,CIUDAD HIDALGO,8,187,1,196,1904
MICHOACÁN,CIUDAD HIDALGO,12,224,7,243,1443
MICHOACÁN,CIUDAD HIDALGO,13,185,3,201,1442
MICHOACÁN,CIUDAD HIDALGO,6,108,0,114,1102
MICHOACÁN,CIUDAD HIDALGO,5,115,3,123,1101
MICHOACÁN,CIUDAD HIDALGO,11,205,5,221,1890
MICHOACÁN,CIUDAD HIDALGO,18,201,0,219,1890
MICHOACÁN,CIUDAD HIDALGO,9,194,7,210,2055
MICHOACÁN,CIUDAD HIDALGO,15,203,0,218,2054
MICHOACÁN,CIUDAD HIDALGO,5,129,2,136,1232
MICHOACÁN,CIUDAD HIDALGO,12,115,1,128,1232
MICHOACÁN,CIUDAD HIDALGO,18,184,3,205,1368
MICHOACÁN,CIUDAD HIDALGO,9,144,4,157,1367
MICHOACÁN,CIUDAD HIDALGO,9,106,2,117,1607
MICHOACÁN,CIUDAD HIDALGO,2,114,4,120,1606
MICHOACÁN,CIUDAD HIDALGO,5,91,1,97,1056
MICHOACÁN,CIUDAD HIDALGO,77,4,1,82,1056
MICHOACÁN,CIUDAD HIDALGO,6,148,1,155,1638
MICHOACÁN,CIUDAD HIDALGO,14,164,6,184,1637
MICHOACÁN,CIUDAD HIDALGO,20,207,4,231,1322
MICHOACÁN,CIUDAD HIDALGO,11,167,11,189,1322
MICHOACÁN,CIUDAD HIDALGO,12,133,2,147,1779
MICHOACÁN,CIUDAD HIDALGO,14,109,3,126,1779
MICHOACÁN,CIUDAD HIDALGO,5,108,4,117,1798
MICHOACÁN,CIUDAD HIDALGO,10,131,5,146,1797
MICHOACÁN,CIUDAD HIDALGO,9,94,11,114,1693
MICHOACÁN,CIUDAD HIDALGO,15,98,6,119,1693
MICHOACÁN,CIUDAD HIDALGO,9,140,8,157,1828
MICHOACÁN,CIUDAD HIDALGO,9,146,9,164,1827
MICHOACÁN,CIUDAD HIDALGO,7,107,2,116,1601
MICHOACÁN,CIUDAD HIDALGO,10,93,4,107,1600
MICHOACÁN,CIUDAD HIDALGO,5,60,2,67,1913
MICHOACÁN,CIUDAD HIDALGO,8,47,1,56,1913
MICHOACÁN,CIUDAD HIDALGO,15,121,2,138,2137
MICHOACÁN,CIUDAD HIDALGO,14,95,8,117,2136
MICHOACÁN,CIUDAD HIDALGO,6,104,5,115,1578
MICHOACÁN,CIUDAD HIDALGO,6,80,1,87,1577
MICHOACÁN,CIUDAD HIDALGO,1,123,4,128,1577
MICHOACÁN,CIUDAD HIDALGO,7,199,2,208,1729
MICHOACÁN,CIUDAD HIDALGO,19,194,6,219,1728
MICHOACÁN,CIUDAD HIDALGO,10,215,1,226,1967
MICHOACÁN,CIUDAD HIDALGO,8,236,7,251,1967
MICHOACÁN,CIUDAD HIDALGO,4,104,2,110,1563
MICHOACÁN,CIUDAD HIDALGO,8,110,2,120,1562
MICHOACÁN,CIUDAD HIDALGO,18,142,3,163,1457
MICHOACÁN,CIUDAD HIDALGO,23,185,2,210,1456
MICHOACÁN,CIUDAD HIDALGO,14,544,6,564,1167
MICHOACÁN,CIUDAD HIDALGO,7,601,14,622,1167
MICHOACÁN,CIUDAD HIDALGO,50,979,14,1043,1730
MICHOACÁN,CIUDAD HIDALGO,21,846,20,887,1729
MICHOACÁN,CIUDAD HIDALGO,17,248,11,276,1857
MICHOACÁN,CIUDAD HIDALGO,22,296,17,335,1856
MICHOACÁN,CIUDAD HIDALGO,19,569,12,600,1575
MICHOACÁN,CIUDAD HIDALGO,26,561,12,599,1575
MICHOACÁN,CIUDAD HIDALGO,8,125,1,134,1868
MICHOACÁN,CIUDAD HIDALGO,14,136,5,155,1868
MICHOACÁN,CIUDAD HIDALGO,12,204,3,219,2002
MICHOACÁN,CIUDAD HIDALGO,19,179,7,205,2002
MICHOACÁN,CIUDAD HIDALGO,20,111,3,134,1963
MICHOACÁN,CIUDAD HIDALGO,24,139,6,169,1962
MICHOACÁN,CIUDAD HIDALGO,22,158,5,185,1876
MICHOACÁN,CIUDAD HIDALGO,16,155,3,174,1876
MICHOACÁN,CIUDAD HIDALGO,11,146,3,160,1855
MICHOACÁN,CIUDAD HIDALGO,13,114,3,130,1854
MICHOACÁN,CIUDAD HIDALGO,5,86,0,91,1069
MICHOACÁN,CIUDAD HIDALGO,0,67,4,71,1068
MICHOACÁN,CIUDAD HIDALGO,13,154,3,170,2133
MICHOACÁN,CIUDAD HIDALGO,14,195,4,213,2132
MICHOACÁN,CIUDAD HIDALGO,9,138,2,149,1805
MICHOACÁN,CIUDAD HIDALGO,3,96,1,100,1805
MICHOACÁN,CIUDAD HIDALGO,22,115,4,141,1482
MICHOACÁN,CIUDAD HIDALGO,20,113,3,136,1481
MICHOACÁN,CIUDAD HIDALGO,12,158,5,175,1951
MICHOACÁN,CIUDAD HIDALGO,11,163,4,178,1951
MICHOACÁN,CIUDAD HIDALGO,33,577,23,633,1750
MICHOACÁN,CIUDAD HIDALGO,19,581,9,609,1749
MICHOACÁN,CIUDAD HIDALGO,9,331,1,341,1308
MICHOACÁN,CIUDAD HIDALGO,17,342,17,376,1308
MICHOACÁN,CIUDAD HIDALGO,9,96,4,109,1307
MICHOACÁN,CIUDAD HIDALGO,10,113,7,130,1306
MICHOACÁN,CIUDAD HIDALGO,68,581,19,668,1074
MICHOACÁN,CIUDAD HIDALGO,61,602,14,677,1074
MICHOACÁN,CIUDAD HIDALGO,16,245,4,265,2068
MICHOACÁN,CIUDAD HIDALGO,17,289,11,317,2068
MICHOACÁN,CIUDAD HIDALGO,14,177,6,197,1891
MICHOACÁN,CIUDAD HIDALGO,8,149,4,161,1890
MICHOACÁN,CIUDAD HIDALGO,34,388,2,424,1786
MICHOACÁN,CIUDAD HIDALGO,29,169,3,201,1785
MICHOACÁN,CIUDAD HIDALGO,84,85,5,174,1785
MICHOACÁN,ZACAPU,15,244,8,267,1927
MICHOACÁN,ZACAPU,14,250,5,269,1927
MICHOACÁN,ZACAPU,13,414,17,444,1965
MICHOACÁN,ZACAPU,18,396,7,421,1965
MICHOACÁN,ZACAPU,11,185,6,202,1276
MICHOACÁN,ZACAPU,5,197,16,218,1276
MICHOACÁN,ZACAPU,7,257,3,267,1824
MICHOACÁN,ZACAPU,12,250,7,269,1823
MICHOACÁN,ZACAPU,19,268,14,301,1145
MICHOACÁN,ZACAPU,17,241,12,270,1145
MICHOACÁN,ZACAPU,5,212,3,220,1272
MICHOACÁN,ZACAPU,3,213,6,222,1271
MICHOACÁN,ZACAPU,15,323,1,339,1601
MICHOACÁN,ZACAPU,14,367,4,385,1600
MICHOACÁN,ZACAPU,10,381,0,391,1600
MICHOACÁN,ZACAPU,9,166,2,177,1653
MICHOACÁN,ZACAPU,13,157,9,179,1653
MICHOACÁN,ZACAPU,14,161,2,177,1653
MICHOACÁN,ZACAPU,12,248,15,275,1318
MICHOACÁN,ZACAPU,12,215,24,251,1318
MICHOACÁN,ZACAPU,8,247,0,255,1284
MICHOACÁN,ZACAPU,6,257,1,264,1284
MICHOACÁN,ZACAPU,1,184,1,186,1465
MICHOACÁN,ZACAPU,9,234,1,244,1465
MICHOACÁN,ZACAPU,5,225,2,232,1464
MICHOACÁN,ZACAPU,7,148,0,155,1829
MICHOACÁN,ZACAPU,5,121,3,129,1829
MICHOACÁN,ZACAPU,2,184,3,189,1829
MICHOACÁN,ZACAPU,7,388,4,399,1870
MICHOACÁN,ZACAPU,10,299,11,320,1869
MICHOACÁN,ZACAPU,9,373,2,384,1869
MICHOACÁN,ZACAPU,5,227,8,240,1878
MICHOACÁN,ZACAPU,3,336,9,348,1877
MICHOACÁN,ZACAPU,2,267,4,273,1877
MICHOACÁN,ZACAPU,0,195,3,198,1581
MICHOACÁN,ZACAPU,4,163,3,170,1581
MICHOACÁN,ZACAPU,5,162,3,170,1625
MICHOACÁN,ZACAPU,1,243,2,246,1625
MICHOACÁN,ZACAPU,32,1241,15,1288,1939
MICHOACÁN,ZACAPU,33,507,8,548,1938
MICHOACÁN,ZACAPU,27,440,13,480,1197
MICHOACÁN,ZACAPU,16,683,8,707,1197
MICHOACÁN,ZACAPU,16,357,16,389,1171
MICHOACÁN,ZACAPU,12,340,9,361,1170
MICHOACÁN,ZACAPU,23,495,14,532,1659
MICHOACÁN,ZACAPU,27,473,19,519,1659
MICHOACÁN,ZACAPU,14,171,2,187,1925
MICHOACÁN,ZACAPU,30,193,1,224,1925
MICHOACÁN,ZACAPU,4,169,5,178,1876
MICHOACÁN,ZACAPU,5,161,6,172,1876
MICHOACÁN,ZACAPU,12,162,4,178,1875
MICHOACÁN,ZACAPU,11,160,4,175,1556
MICHOACÁN,ZACAPU,18,136,3,157,1555
MICHOACÁN,ZACAPU,9,160,6,175,1918
MICHOACÁN,ZACAPU,6,180,7,193,1917
MICHOACÁN,ZACAPU,5,160,4,169,1917
MICHOACÁN,ZACAPU,9,138,4,151,1751
MICHOACÁN,ZACAPU,6,124,2,132,1750
MICHOACÁN,ZACAPU,6,97,0,103,1827
MICHOACÁN,ZACAPU,9,80,1,90,1827
MICHOACÁN,ZACAPU,4,75,1,80,1826
MICHOACÁN,ZACAPU,15,185,6,206,2118
MICHOACÁN,ZACAPU,15,176,1,192,2117
MICHOACÁN,ZACAPU,13,161,0,174,2117
MICHOACÁN,ZACAPU,16,187,5,208,2117
MICHOACÁN,ZACAPU,15,214,3,232,2117
MICHOACÁN,ZACAPU,7,134,5,146,1743
MICHOACÁN,ZACAPU,10,129,4,143,1742
MICHOACÁN,ZACAPU,10,168,4,182,1969
MICHOACÁN,ZACAPU,9,168,3,180,1969
MICHOACÁN,ZACAPU,4,94,3,101,1483
MICHOACÁN,ZACAPU,7,95,3,105,1482
MICHOACÁN,ZACAPU,3,88,2,93,1482
MICHOACÁN,ZACAPU,11,112,3,126,1456
MICHOACÁN,ZACAPU,12,102,4,118,1455
MICHOACÁN,ZACAPU,11,191,5,207,1658
MICHOACÁN,ZACAPU,10,168,3,181,1658
MICHOACÁN,ZACAPU,15,219,2,236,1551
MICHOACÁN,ZACAPU,9,246,0,255,1550
MICHOACÁN,ZACAPU,5,140,5,150,1616
MICHOACÁN,ZACAPU,9,175,5,189,1615
MICHOACÁN,ZACAPU,21,293,24,338,1860
MICHOACÁN,ZACAPU,16,320,8,344,1859
MICHOACÁN,ZACAPU,5,338,12,355,1859
MICHOACÁN,ZACAPU,10,271,9,290,1908
MICHOACÁN,ZACAPU,4,113,2,119,1969
MICHOACÁN,ZACAPU,7,115,2,124,1969
MICHOACÁN,ZACAPU,6,236,2,244,1995
MICHOACÁN,ZACAPU,3,201,0,204,1994
MICHOACÁN,ZACAPU,6,248,1,255,1994
MICHOACÁN,ZACAPU,5,236,3,244,1994
MICHOACÁN,ZACAPU,4,280,3,287,1927
MICHOACÁN,ZACAPU,8,280,11,299,1926
MICHOACÁN,ZACAPU,2,280,4,286,1926
MICHOACÁN,ZACAPU,12,374,4,390,1999
MICHOACÁN,ZACAPU,3,299,3,305,1998
MICHOACÁN,ZACAPU,9,317,1,327,1998
MICHOACÁN,ZACAPU,9,334,4,347,1998
MICHOACÁN,ZACAPU,5,221,2,228,1567
MICHOACÁN,ZACAPU,6,192,7,205,1567
MICHOACÁN,ZACAPU,4,173,2,179,1566
MICHOACÁN,ZACAPU,3,231,5,239,1566
MICHOACÁN,ZACAPU,7,414,8,429,1313
MICHOACÁN,ZACAPU,1,472,1,474,1313
MICHOACÁN,ZACAPU,3,469,6,478,1313
MICHOACÁN,ZACAPU,0,323,4,327,1339
MICHOACÁN,ZACAPU,5,364,10,379,1339
MICHOACÁN,ZACAPU,2,201,1,204,1029
MICHOACÁN,ZACAPU,1,198,2,201,1029
MICHOACÁN,ZACAPU,17,171,5,193,1905
MICHOACÁN,ZACAPU,19,176,1,196,1905
MICHOACÁN,ZACAPU,15,120,4,139,1361
MICHOACÁN,ZACAPU,16,131,0,147,1361
MICHOACÁN,ZACAPU,8,169,0,177,1360
MICHOACÁN,ZACAPU,16,192,3,211,1928
MICHOACÁN,ZACAPU,9,169,3,181,1927
MICHOACÁN,ZACAPU,4,179,6,189,1131
MICHOACÁN,ZACAPU,6,161,3,170,1130
MICHOACÁN,ZACAPU,10,238,9,257,1957
MICHOACÁN,ZACAPU,4,260,9,273,1957
MICHOACÁN,ZACAPU,8,243,10,261,1957
MICHOACÁN,ZACAPU,20,213,1,234,0
MICHOACÁN,ZACAPU,5,120,6,131,1410
MICHOACÁN,ZACAPU,6,111,1,118,1410
MICHOACÁN,ZACAPU,6,115,5,126,1410
MICHOACÁN,ZACAPU,14,94,2,110,1325
MICHOACÁN,ZACAPU,6,81,1,88,1325
MICHOACÁN,ZACAPU,17,71,2,90,1324
MICHOACÁN,ZACAPU,11,144,5,160,1837
MICHOACÁN,ZACAPU,5,152,0,157,1836
MICHOACÁN,ZACAPU,12,404,24,440,1908
MICHOACÁN,ZACAPU,13,449,16,478,1907
MICHOACÁN,ZACAPU,10,74,0,84,1415
MICHOACÁN,ZACAPU,4,69,1,74,1415
MICHOACÁN,ZACAPU,4,65,1,70,1415
MICHOACÁN,ZACAPU,12,175,1,188,1924
MICHOACÁN,ZACAPU,8,157,1,166,1924
MICHOACÁN,ZACAPU,6,94,1,101,1333
MICHOACÁN,ZACAPU,6,100,2,108,1333
MICHOACÁN,ZACAPU,8,78,2,88,1332
MICHOACÁN,ZACAPU,8,153,3,164,1597
MICHOACÁN,ZACAPU,13,138,1,152,1597
MICHOACÁN,ZACAPU,17,51,1,69,1969
MICHOACÁN,ZACAPU,4,199,2,205,1444
MICHOACÁN,ZACAPU,3,254,2,259,1444
MICHOACÁN,ZACAPU,6,45,1,52,1782
MICHOACÁN,ZACAPU,2,53,3,58,1781
MICHOACÁN,ZACAPU,7,95,0,102,1139
MICHOACÁN,ZACAPU,2,98,0,100,1138
MICHOACÁN,ZACAPU,2,30,1,33,996
MICHOACÁN,ZACAPU,3,23,0,26,995
MICHOACÁN,ZACAPU,9,129,2,140,1410
MICHOACÁN,ZACAPU,8,86,2,96,1410
MICHOACÁN,ZACAPU,4,97,3,104,1409
MICHOACÁN,ZACAPU,5,61,3,69,1223
MICHOACÁN,ZACAPU,4,73,0,77,1223
MICHOACÁN,ZACAPU,14,229,10,253,1340
MICHOACÁN,ZACAPU,30,274,12,316,1340
MICHOACÁN,ZACAPU,32,267,7,306,1340
MICHOACÁN,ZACAPU,18,287,14,319,1733
MICHOACÁN,ZACAPU,16,289,8,313,1733
MICHOACÁN,ZACAPU,23,276,8,307,1360
MICHOACÁN,ZACAPU,19,293,4,316,1360
MICHOACÁN,ZACAPU,21,244,5,270,1359
MICHOACÁN,ZACAPU,25,282,4,311,1388
MICHOACÁN,ZACAPU,25,271,5,301,1387
MICHOACÁN,ZACAPU,29,270,6,305,1387
MICHOACÁN,ZACAPU,24,241,6,271,1428
MICHOACÁN,ZACAPU,30,249,5,284,1427
MICHOACÁN,ZACAPU,29,264,9,302,1427
MICHOACÁN,ZACAPU,11,280,2,293,1328
MICHOACÁN,ZACAPU,12,247,3,262,1328
MICHOACÁN,ZACAPU,20,291,4,315,1328
MICHOACÁN,ZACAPU,14,305,9,328,1341
MICHOACÁN,ZACAPU,8,304,0,312,1341
MICHOACÁN,ZACAPU,16,261,7,284,1341
MICHOACÁN,ZACAPU,21,226,4,251,1341
MICHOACÁN,ZACAPU,28,236,5,269,1341
MICHOACÁN,ZACAPU,19,252,6,277,1340
MICHOACÁN,ZACAPU,39,359,8,406,1617
MICHOACÁN,ZACAPU,36,371,7,414,1616
MICHOACÁN,ZACAPU,17,308,12,337,1437
MICHOACÁN,ZACAPU,15,319,12,346,1437
MICHOACÁN,ZACAPU,26,334,11,371,1437
MICHOACÁN,ZACAPU,12,398,5,415,1471
MICHOACÁN,ZACAPU,13,382,5,400,1471
MICHOACÁN,ZACAPU,10,485,1,496,1717
MICHOACÁN,ZACAPU,13,444,17,474,1717
MICHOACÁN,ZACAPU,23,544,22,589,1885
MICHOACÁN,ZACAPU,16,586,18,620,1884
MICHOACÁN,ZACAPU,26,322,13,361,1534
MICHOACÁN,ZACAPU,15,329,8,352,1533
MICHOACÁN,ZACAPU,32,242,21,295,1824
MICHOACÁN,ZACAPU,28,207,16,251,1824
MICHOACÁN,ZACAPU,24,449,8,481,1890
MICHOACÁN,ZACAPU,28,437,22,487,1889
MICHOACÁN,MORELIA,9,227,2,238,1898
MICHOACÁN,MORELIA,12,188,4,204,1897
MICHOACÁN,MORELIA,13,191,4,208,1770
MICHOACÁN,MORELIA,13,174,0,187,1769
MICHOACÁN,MORELIA,10,151,4,165,1591
MICHOACÁN,MORELIA,3,130,2,135,1591
MICHOACÁN,MORELIA,5,149,1,155,1590
MICHOACÁN,MORELIA,8,148,2,158,1569
MICHOACÁN,MORELIA,10,149,7,166,1569
MICHOACÁN,MORELIA,8,156,0,164,1671
MICHOACÁN,MORELIA,15,146,1,162,1670
MICHOACÁN,MORELIA,85,1437,18,1540,0
MICHOACÁN,MORELIA,26,168,2,196,1786
MICHOACÁN,MORELIA,22,210,1,233,1786
MICHOACÁN,MORELIA,17,216,1,234,1786
MICHOACÁN,MORELIA,9,203,3,215,1812
MICHOACÁN,MORELIA,15,186,1,202,1811
MICHOACÁN,MORELIA,10,238,5,253,1599
MICHOACÁN,MORELIA,14,258,1,273,1598
MICHOACÁN,MORELIA,15,185,7,207,1484
MICHOACÁN,MORELIA,22,218,1,241,1483
MICHOACÁN,MORELIA,18,253,3,274,1727
MICHOACÁN,MORELIA,20,238,2,260,1727
MICHOACÁN,MORELIA,21,202,2,225,1518
MICHOACÁN,MORELIA,19,181,2,202,1518
MICHOACÁN,MORELIA,9,182,1,192,1518
MICHOACÁN,MORELIA,14,183,1,198,1517
MICHOACÁN,MORELIA,18,169,1,188,1382
MICHOACÁN,MORELIA,16,184,1,201,1381
MICHOACÁN,MORELIA,11,197,0,208,1381
MICHOACÁN,MORELIA,25,193,1,219,1472
MICHOACÁN,MORELIA,14,193,3,210,1472
MICHOACÁN,MORELIA,24,238,1,263,1722
MICHOACÁN,MORELIA,11,217,3,231,1721
MICHOACÁN,MORELIA,10,188,2,200,1514
MICHOACÁN,MORELIA,20,182,1,203,1514
MICHOACÁN,MORELIA,11,174,4,189,1705
MICHOACÁN,MORELIA,17,213,2,232,1704
MICHOACÁN,MORELIA,12,214,7,233,1704
MICHOACÁN,MORELIA,13,147,0,160,1182
MICHOACÁN,MORELIA,16,153,2,171,1182
MICHOACÁN,MORELIA,18,191,4,213,1895
MICHOACÁN,MORELIA,7,201,0,208,1894
MICHOACÁN,MORELIA,12,150,3,165,1473
MICHOACÁN,MORELIA,6,174,3,183,1473
MICHOACÁN,MORELIA,13,182,3,198,1472
MICHOACÁN,MORELIA,15,217,1,233,1897
MICHOACÁN,MORELIA,25,199,5,229,1897
MICHOACÁN,MORELIA,20,239,0,259,1804
MICHOACÁN,MORELIA,25,233,1,259,1803
MICHOACÁN,MORELIA,13,169,2,184,1354
MICHOACÁN,MORELIA,10,179,1,190,1354
MICHOACÁN,MORELIA,10,173,0,183,1354
MICHOACÁN,MORELIA,21,198,2,221,1419
MICHOACÁN,MORELIA,16,155,0,171,1419
MICHOACÁN,MORELIA,11,168,3,182,1418
MICHOACÁN,MORELIA,26,267,0,293,1760
MICHOACÁN,MORELIA,18,272,1,291,1759
MICHOACÁN,MORELIA,29,134,2,165,1610
MICHOACÁN,MORELIA,30,179,3,212,1610
MICHOACÁN,MORELIA,33,173,2,208,1610
MICHOACÁN,MORELIA,14,182,2,198,1609
MICHOACÁN,MORELIA,11,141,2,154,1791
MICHOACÁN,MORELIA,16,157,3,176,1791
MICHOACÁN,MORELIA,11,135,5,151,1791
MICHOACÁN,MORELIA,17,140,2,159,1791
MICHOACÁN,MORELIA,7,141,0,148,1791
MICHOACÁN,MORELIA,16,163,1,180,1791
MICHOACÁN,MORELIA,11,122,0,133,1790
MICHOACÁN,MORELIA,9,142,0,151,1636
MICHOACÁN,MORELIA,14,151,1,166,1636
MICHOACÁN,MORELIA,5,125,1,131,1636
MICHOACÁN,MORELIA,11,119,0,130,1635
MICHOACÁN,MORELIA,6,148,1,155,1600
MICHOACÁN,MORELIA,19,148,2,169,1599
MICHOACÁN,MORELIA,7,134,1,142,1398
MICHOACÁN,MORELIA,20,173,1,194,1398
MICHOACÁN,MORELIA,17,131,2,150,1398
MICHOACÁN,MORELIA,11,167,0,178,1417
MICHOACÁN,MORELIA,18,177,2,197,1416
MICHOACÁN,MORELIA,3,135,1,139,1347
MICHOACÁN,MORELIA,8,129,4,141,1347
MICHOACÁN,MORELIA,5,131,0,136,1347
MICHOACÁN,MORELIA,17,122,3,142,1335
MICHOACÁN,MORELIA,15,146,0,161,1335
MICHOACÁN,MORELIA,13,132,1,146,1335
MICHOACÁN,MORELIA,14,203,1,218,1822
MICHOACÁN,MORELIA,18,163,0,181,1821
MICHOACÁN,MORELIA,23,172,4,199,1889
MICHOACÁN,MORELIA,22,213,3,238,1888
MICHOACÁN,MORELIA,22,251,2,275,1869
MICHOACÁN,MORELIA,22,252,1,275,1869
MICHOACÁN,MORELIA,25,235,1,261,1869
MICHOACÁN,MORELIA,8,134,3,145,1486
MICHOACÁN,MORELIA,10,110,3,123,1486
MICHOACÁN,MORELIA,8,121,3,132,1485
MICHOACÁN,MORELIA,7,117,1,125,1485
MICHOACÁN,MORELIA,10,130,2,142,1834
MICHOACÁN,MORELIA,9,129,3,141,1834
MICHOACÁN,MORELIA,5,128,1,134,1834
MICHOACÁN,MORELIA,11,151,2,164,1834
MICHOACÁN,MORELIA,18,138,0,156,1834
MICHOACÁN,MORELIA,7,196,2,205,1603
MICHOACÁN,MORELIA,17,199,4,220,1603
MICHOACÁN,MORELIA,12,177,0,189,1603
MICHOACÁN,MORELIA,22,196,6,224,1668
MICHOACÁN,MORELIA,15,199,4,218,1668
MICHOACÁN,MORELIA,16,151,1,168,1984
MICHOACÁN,MORELIA,14,167,1,182,1984
MICHOACÁN,MORELIA,8,173,0,181,1984
MICHOACÁN,MORELIA,16,156,5,177,1984
MICHOACÁN,MORELIA,12,158,0,170,1983
MICHOACÁN,MORELIA,13,159,3,175,1983
MICHOACÁN,MORELIA,15,141,2,158,1983
MICHOACÁN,MORELIA,12,188,1,201,1796
MICHOACÁN,MORELIA,23,193,0,216,1796
MICHOACÁN,MORELIA,13,197,1,211,1795
MICHOACÁN,MORELIA,13,111,9,133,1626
MICHOACÁN,MORELIA,9,122,3,134,1626
MICHOACÁN,MORELIA,9,122,5,136,1626
MICHOACÁN,MORELIA,14,126,4,144,1625
MICHOACÁN,MORELIA,16,147,15,178,1803
MICHOACÁN,MORELIA,14,161,11,186,1802
MICHOACÁN,MORELIA,6,170,4,180,1722
MICHOACÁN,MORELIA,6,135,7,148,1721
MICHOACÁN,MORELIA,10,151,2,163,1721
MICHOACÁN,MORELIA,18,115,0,133,1679
MICHOACÁN,MORELIA,10,131,5,146,1679
MICHOACÁN,MORELIA,19,59,3,81,1596
MICHOACÁN,MORELIA,14,72,5,91,1596
MICHOACÁN,MORELIA,20,78,3,101,1792
MICHOACÁN,MORELIA,8,156,2,166,1758
MICHOACÁN,MORELIA,5,157,2,164,1758
MICHOACÁN,MORELIA,7,144,4,155,1758
MICHOACÁN,MORELIA,14,138,2,154,1758
MICHOACÁN,MORELIA,7,155,3,165,1758
MICHOACÁN,MORELIA,12,136,1,149,1757
MICHOACÁN,MORELIA,9,120,2,131,1757
MICHOACÁN,MORELIA,13,134,0,147,1757
MICHOACÁN,MORELIA,9,104,0,113,1793
MICHOACÁN,MORELIA,7,127,0,134,1792
MICHOACÁN,MORELIA,6,113,2,121,1792
MICHOACÁN,MORELIA,10,132,0,142,1792
MICHOACÁN,MORELIA,9,101,4,114,1806
MICHOACÁN,MORELIA,10,124,1,135,1806
MICHOACÁN,MORELIA,6,146,3,155,1806
MICHOACÁN,MORELIA,13,129,4,146,1806
MICHOACÁN,MORELIA,9,72,0,81,1250
MICHOACÁN,MORELIA,9,84,2,95,1249
MICHOACÁN,MORELIA,3,61,0,64,1025
MICHOACÁN,MORELIA,3,56,0,59,1025
MICHOACÁN,MORELIA,9,158,1,168,1617
MICHOACÁN,MORELIA,14,156,0,170,1617
MICHOACÁN,MORELIA,11,165,1,177,1616
MICHOACÁN,MORELIA,13,178,0,191,1616
MICHOACÁN,MORELIA,25,275,7,307,1979
MICHOACÁN,MORELIA,13,274,0,287,1978
MICHOACÁN,MORELIA,15,159,1,175,1768
MICHOACÁN,MORELIA,19,139,1,159,1767
MICHOACÁN,MORELIA,6,96,3,105,1828
MICHOACÁN,MORELIA,14,140,1,155,1828
MICHOACÁN,MORELIA,6,116,1,123,1827
MICHOACÁN,MORELIA,12,94,1,107,1115
MICHOACÁN,MORELIA,9,86,0,95,1114
MICHOACÁN,MORELIA,10,93,0,103,1446
MICHOACÁN,MORELIA,14,124,0,138,1446
MICHOACÁN,MORELIA,10,131,0,141,1445
MICHOACÁN,MORELIA,12,110,0,122,1667
MICHOACÁN,MORELIA,10,116,2,128,1667
MICHOACÁN,MORELIA,10,116,2,128,1444
MICHOACÁN,MORELIA,10,115,0,125,1443
MICHOACÁN,MORELIA,2,50,1,53,1262
MICHOACÁN,MORELIA,8,52,1,61,1262
MICHOACÁN,MORELIA,5,87,0,92,1759
MICHOACÁN,MORELIA,7,79,1,87,1759
MICHOACÁN,MORELIA,7,125,3,135,1961
MICHOACÁN,MORELIA,1,106,5,112,1961
MICHOACÁN,MORELIA,7,91,3,101,1604
MICHOACÁN,MORELIA,13,109,3,125,1604
MICHOACÁN,MORELIA,10,94,3,107,1604
MICHOACÁN,MORELIA,8,98,2,108,1342
MICHOACÁN,MORELIA,7,96,0,103,1341
MICHOACÁN,MORELIA,6,76,0,82,1401
MICHOACÁN,MORELIA,5,93,3,101,1400
MICHOACÁN,MORELIA,11,137,0,148,1345
MICHOACÁN,MORELIA,15,108,2,125,1345
MICHOACÁN,MORELIA,10,129,2,141,1058
MICHOACÁN,MORELIA,3,109,2,114,1057
MICHOACÁN,MORELIA,10,160,0,170,1928
MICHOACÁN,MORELIA,2,137,0,139,1928
MICHOACÁN,URUAPAN DEL PROGRESO,21,206,2,229,1896
MICHOACÁN,URUAPAN DEL PROGRESO,14,203,2,219,1896
MICHOACÁN,URUAPAN DEL PROGRESO,6,160,1,167,1718
MICHOACÁN,URUAPAN DEL PROGRESO,5,140,1,146,1717
MICHOACÁN,URUAPAN DEL PROGRESO,1,198,3,202,1919
MICHOACÁN,URUAPAN DEL PROGRESO,23,173,0,196,1918
MICHOACÁN,URUAPAN DEL PROGRESO,5,159,0,164,1554
MICHOACÁN,URUAPAN DEL PROGRESO,10,155,2,167,1554
MICHOACÁN,URUAPAN DEL PROGRESO,21,154,2,177,1761
MICHOACÁN,URUAPAN DEL PROGRESO,21,143,2,166,1760
MICHOACÁN,URUAPAN DEL PROGRESO,85,1270,14,1369,0
MICHOACÁN,URUAPAN DEL PROGRESO,17,246,4,267,1842
MICHOACÁN,URUAPAN DEL PROGRESO,15,243,2,260,1841
MICHOACÁN,URUAPAN DEL PROGRESO,10,169,4,183,1332
MICHOACÁN,URUAPAN DEL PROGRESO,10,181,4,195,1332
MICHOACÁN,URUAPAN DEL PROGRESO,18,181,4,203,1775
MICHOACÁN,URUAPAN DEL PROGRESO,5,162,0,167,1774
MICHOACÁN,URUAPAN DEL PROGRESO,11,173,8,192,2012
MICHOACÁN,URUAPAN DEL PROGRESO,7,177,3,187,2011
MICHOACÁN,URUAPAN DEL PROGRESO,4,103,1,108,1091
MICHOACÁN,URUAPAN DEL PROGRESO,2,118,1,121,1090
MICHOACÁN,URUAPAN DEL PROGRESO,7,166,6,179,1818
MICHOACÁN,URUAPAN DEL PROGRESO,5,161,2,168,1817
MICHOACÁN,URUAPAN DEL PROGRESO,27,243,4,274,1873
MICHOACÁN,URUAPAN DEL PROGRESO,32,270,4,306,1872
MICHOACÁN,URUAPAN DEL PROGRESO,149,21,2,172,1474
MICHOACÁN,URUAPAN DEL PROGRESO,13,168,2,183,1474
MICHOACÁN,URUAPAN DEL PROGRESO,11,175,4,190,1474
MICHOACÁN,URUAPAN DEL PROGRESO,14,178,3,195,1414
MICHOACÁN,URUAPAN DEL PROGRESO,25,179,4,208,1414
MICHOACÁN,URUAPAN DEL PROGRESO,20,135,0,155,1622
MICHOACÁN,URUAPAN DEL PROGRESO,14,160,0,174,1621
MICHOACÁN,URUAPAN DEL PROGRESO,14,117,0,131,1621
MICHOACÁN,URUAPAN DEL PROGRESO,17,115,1,133,1621
MICHOACÁN,URUAPAN DEL PROGRESO,10,123,3,136,1621
MICHOACÁN,URUAPAN DEL PROGRESO,17,203,3,223,1712
MICHOACÁN,URUAPAN DEL PROGRESO,17,198,2,217,1712
MICHOACÁN,URUAPAN DEL PROGRESO,30,185,4,219,1739
MICHOACÁN,URUAPAN DEL PROGRESO,20,196,3,219,1738
MICHOACÁN,URUAPAN DEL PROGRESO,10,165,0,175,1593
MICHOACÁN,URUAPAN DEL PROGRESO,9,181,2,192,1592
MICHOACÁN,URUAPAN DEL PROGRESO,15,134,1,150,1592
MICHOACÁN,URUAPAN DEL PROGRESO,23,149,0,172,1456
MICHOACÁN,URUAPAN DEL PROGRESO,24,145,0,169,1455
MICHOACÁN,URUAPAN DEL PROGRESO,36,145,1,182,1781
MICHOACÁN,URUAPAN DEL PROGRESO,30,161,2,193,1781
MICHOACÁN,URUAPAN DEL PROGRESO,14,182,3,199,1670
MICHOACÁN,URUAPAN DEL PROGRESO,15,160,3,178,1670
MICHOACÁN,URUAPAN DEL PROGRESO,21,241,1,263,1827
MICHOACÁN,URUAPAN DEL PROGRESO,15,234,4,253,1827
MICHOACÁN,URUAPAN DEL PROGRESO,16,128,0,144,1448
MICHOACÁN,URUAPAN DEL PROGRESO,24,139,1,164,1448
MICHOACÁN,URUAPAN DEL PROGRESO,18,160,0,178,1448
MICHOACÁN,URUAPAN DEL PROGRESO,18,131,1,150,1097
MICHOACÁN,URUAPAN DEL PROGRESO,13,100,0,113,1097
MICHOACÁN,URUAPAN DEL PROGRESO,16,164,2,182,1105
MICHOACÁN,URUAPAN DEL PROGRESO,12,128,1,141,1104
MICHOACÁN,URUAPAN DEL PROGRESO,8,181,2,191,1455
MICHOACÁN,URUAPAN DEL PROGRESO,10,186,2,198,1455
MICHOACÁN,URUAPAN DEL PROGRESO,6,171,2,179,1519
MICHOACÁN,URUAPAN DEL PROGRESO,9,155,2,166,1518
MICHOACÁN,URUAPAN DEL PROGRESO,18,202,1,221,1693
MICHOACÁN,URUAPAN DEL PROGRESO,22,154,1,177,1692
MICHOACÁN,URUAPAN DEL PROGRESO,28,140,3,171,1530
MICHOACÁN,URUAPAN DEL PROGRESO,19,125,5,149,1530
MICHOACÁN,URUAPAN DEL PROGRESO,25,183,0,208,1778
MICHOACÁN,URUAPAN DEL PROGRESO,28,150,2,180,1777
MICHOACÁN,URUAPAN DEL PROGRESO,12,139,2,153,1110
MICHOACÁN,URUAPAN DEL PROGRESO,10,161,0,171,1109
MICHOACÁN,URUAPAN DEL PROGRESO,19,184,2,205,1710
MICHOACÁN,URUAPAN DEL PROGRESO,18,175,0,193,1709
MICHOACÁN,URUAPAN DEL PROGRESO,14,118,0,132,1584
MICHOACÁN,URUAPAN DEL PROGRESO,6,122,5,133,1583
MICHOACÁN,URUAPAN DEL PROGRESO,7,95,2,104,1583
MICHOACÁN,URUAPAN DEL PROGRESO,15,117,4,136,1583
MICHOACÁN,URUAPAN DEL PROGRESO,12,178,0,190,1389
MICHOACÁN,URUAPAN DEL PROGRESO,20,180,2,202,1388
MICHOACÁN,URUAPAN DEL PROGRESO,20,210,6,236,1914
MICHOACÁN,URUAPAN DEL PROGRESO,27,177,6,210,1913
MICHOACÁN,URUAPAN DEL PROGRESO,21,249,2,272,1985
MICHOACÁN,URUAPAN DEL PROGRESO,20,197,2,219,1984
MICHOACÁN,URUAPAN DEL PROGRESO,9,179,0,188,1480
MICHOACÁN,URUAPAN DEL PROGRESO,171,16,4,191,1479
MICHOACÁN,URUAPAN DEL PROGRESO,25,178,7,210,1611
MICHOACÁN,URUAPAN DEL PROGRESO,25,172,4,201,1611
MICHOACÁN,URUAPAN DEL PROGRESO,19,133,5,157,1555
MICHOACÁN,URUAPAN DEL PROGRESO,14,135,0,149,1554
MICHOACÁN,URUAPAN DEL PROGRESO,22,142,2,166,1554
MICHOACÁN,URUAPAN DEL PROGRESO,11,129,3,143,1554
MICHOACÁN,URUAPAN DEL PROGRESO,15,138,6,159,1446
MICHOACÁN,URUAPAN DEL PROGRESO,11,154,4,169,1446
MICHOACÁN,URUAPAN DEL PROGRESO,17,155,2,174,1445
MICHOACÁN,URUAPAN DEL PROGRESO,31,171,1,203,1708
MICHOACÁN,URUAPAN DEL PROGRESO,23,190,1,214,1708
MICHOACÁN,URUAPAN DEL PROGRESO,79,178,3,260,1637
MICHOACÁN,URUAPAN DEL PROGRESO,26,190,4,220,1636
MICHOACÁN,URUAPAN DEL PROGRESO,24,144,2,170,1081
MICHOACÁN,URUAPAN DEL PROGRESO,15,141,2,158,1080
MICHOACÁN,URUAPAN DEL PROGRESO,21,203,0,224,1645
MICHOACÁN,URUAPAN DEL PROGRESO,16,178,6,200,1644
MICHOACÁN,URUAPAN DEL PROGRESO,14,159,9,182,1691
MICHOACÁN,URUAPAN DEL PROGRESO,9,159,3,171,1691
MICHOACÁN,URUAPAN DEL PROGRESO,8,147,2,157,1691
MICHOACÁN,URUAPAN DEL PROGRESO,12,143,2,157,1691
MICHOACÁN,URUAPAN DEL PROGRESO,8,167,2,177,1690
MICHOACÁN,URUAPAN DEL PROGRESO,20,165,2,187,1690
MICHOACÁN,URUAPAN DEL PROGRESO,7,121,2,130,1363
MICHOACÁN,URUAPAN DEL PROGRESO,10,104,4,118,1363
MICHOACÁN,URUAPAN DEL PROGRESO,13,125,0,138,1363
MICHOACÁN,URUAPAN DEL PROGRESO,21,137,1,159,1742
MICHOACÁN,URUAPAN DEL PROGRESO,32,137,0,169,1742
MICHOACÁN,URUAPAN DEL PROGRESO,26,139,2,167,1741
MICHOACÁN,URUAPAN DEL PROGRESO,30,144,4,178,1620
MICHOACÁN,URUAPAN DEL PROGRESO,30,148,0,178,1619
MICHOACÁN,URUAPAN DEL PROGRESO,19,173,2,194,1812
MICHOACÁN,URUAPAN DEL PROGRESO,15,155,1,171,1811
MICHOACÁN,URUAPAN DEL PROGRESO,14,119,3,136,1412
MICHOACÁN,URUAPAN DEL PROGRESO,10,137,1,148,1411
MICHOACÁN,URUAPAN DEL PROGRESO,9,157,3,169,1748
MICHOACÁN,URUAPAN DEL PROGRESO,10,120,8,138,1747
MICHOACÁN,URUAPAN DEL PROGRESO,19,275,3,297,1508
MICHOACÁN,URUAPAN DEL PROGRESO,22,276,1,299,1507
MICHOACÁN,URUAPAN DEL PROGRESO,26,210,5,241,1548
MICHOACÁN,URUAPAN DEL PROGRESO,27,212,4,243,1547
MICHOACÁN,URUAPAN DEL PROGRESO,18,247,4,269,1547
MICHOACÁN,URUAPAN DEL PROGRESO,30,218,5,253,1733
MICHOACÁN,URUAPAN DEL PROGRESO,31,198,10,239,1732
MICHOACÁN,URUAPAN DEL PROGRESO,17,119,1,137,1967
MICHOACÁN,URUAPAN DEL PROGRESO,16,114,2,132,1966
MICHOACÁN,URUAPAN DEL PROGRESO,24,188,1,213,1839
MICHOACÁN,URUAPAN DEL PROGRESO,18,160,2,180,1839
MICHOACÁN,URUAPAN DEL PROGRESO,18,186,0,204,1839
MICHOACÁN,URUAPAN DEL PROGRESO,7,190,3,200,1839
MICHOACÁN,URUAPAN DEL PROGRESO,23,187,3,213,1839
MICHOACÁN,URUAPAN DEL PROGRESO,12,225,1,238,1839
MICHOACÁN,URUAPAN DEL PROGRESO,15,176,1,192,1838
MICHOACÁN,URUAPAN DEL PROGRESO,6,150,2,158,1838
MICHOACÁN,URUAPAN DEL PROGRESO,18,162,0,180,1838
MICHOACÁN,URUAPAN DEL PROGRESO,9,240,1,250,1401
MICHOACÁN,URUAPAN DEL PROGRESO,12,278,2,292,1401
MICHOACÁN,URUAPAN DEL PROGRESO,15,299,1,315,1401
MICHOACÁN,URUAPAN DEL PROGRESO,3,186,6,195,1859
MICHOACÁN,URUAPAN DEL PROGRESO,2,167,8,177,1858
MICHOACÁN,URUAPAN DEL PROGRESO,1,78,3,82,1314
MICHOACÁN,URUAPAN DEL PROGRESO,2,82,2,86,1313
MICHOACÁN,URUAPAN DEL PROGRESO,9,207,4,220,1777
MICHOACÁN,URUAPAN DEL PROGRESO,4,170,0,174,1777
MICHOACÁN,URUAPAN DEL PROGRESO,10,205,5,220,1680
MICHOACÁN,URUAPAN DEL PROGRESO,1,157,1,159,1680
MICHOACÁN,URUAPAN DEL PROGRESO,7,127,4,138,1586
MICHOACÁN,URUAPAN DEL PROGRESO,8,83,2,93,1586
MICHOACÁN,URUAPAN DEL PROGRESO,12,143,0,155,1977
MICHOACÁN,URUAPAN DEL PROGRESO,8,155,2,165,1977
MICHOACÁN,URUAPAN DEL PROGRESO,13,95,0,108,1970
MICHOACÁN,URUAPAN DEL PROGRESO,17,111,2,130,1970
MICHOACÁN,URUAPAN DEL PROGRESO,4,92,1,97,1102
MICHOACÁN,URUAPAN DEL PROGRESO,14,103,3,120,1101
MICHOACÁN,MORELIA,7,179,3,189,1679
MICHOACÁN,MORELIA,11,176,3,190,1679
MICHOACÁN,MORELIA,15,114,5,134,1243
MICHOACÁN,MORELIA,16,126,1,143,1242
MICHOACÁN,MORELIA,25,184,2,211,1906
MICHOACÁN,MORELIA,10,196,0,206,1906
MICHOACÁN,MORELIA,14,98,2,114,1468
MICHOACÁN,MORELIA,11,89,2,102,1467
MICHOACÁN,MORELIA,11,105,6,122,1467
MICHOACÁN,MORELIA,9,97,1,107,1106
MICHOACÁN,MORELIA,6,119,3,128,1105
MICHOACÁN,MORELIA,3,134,4,141,1547
MICHOACÁN,MORELIA,13,120,2,135,1547
MICHOACÁN,MORELIA,14,128,4,146,1546
MICHOACÁN,MORELIA,13,136,2,151,1654
MICHOACÁN,MORELIA,9,132,5,146,1654
MICHOACÁN,MORELIA,23,233,2,258,1815
MICHOACÁN,MORELIA,21,218,0,239,1814
MICHOACÁN,MORELIA,19,128,2,149,1476
MICHOACÁN,MORELIA,19,140,2,161,1475
MICHOACÁN,MORELIA,8,154,0,162,1475
MICHOACÁN,MORELIA,22,187,5,214,1955
MICHOACÁN,MORELIA,19,181,4,204,1955
MICHOACÁN,MORELIA,16,185,3,204,1835
MICHOACÁN,MORELIA,19,196,1,216,1835
MICHOACÁN,MORELIA,15,165,2,182,1476
MICHOACÁN,MORELIA,17,186,1,204,1475
MICHOACÁN,MORELIA,16,142,0,158,1462
MICHOACÁN,MORELIA,16,155,1,172,1462
MICHOACÁN,MORELIA,17,158,2,177,1462
MICHOACÁN,MORELIA,7,136,4,147,1982
MICHOACÁN,MORELIA,8,143,3,154,1982
MICHOACÁN,MORELIA,11,153,2,166,1982
MICHOACÁN,MORELIA,5,145,4,154,1981
MICHOACÁN,MORELIA,10,118,2,130,1919
MICHOACÁN,MORELIA,15,153,2,170,1919
MICHOACÁN,MORELIA,9,112,0,121,1919
MICHOACÁN,MORELIA,18,164,4,186,1741
MICHOACÁN,MORELIA,21,158,2,181,1740
MICHOACÁN,MORELIA,26,164,3,193,1787
MICHOACÁN,MORELIA,30,174,4,208,1786
MICHOACÁN,MORELIA,20,194,6,220,1781
MICHOACÁN,MORELIA,14,205,4,223,1780
MICHOACÁN,MORELIA,13,193,4,210,1780
MICHOACÁN,MORELIA,18,180,4,202,1778
MICHOACÁN,MORELIA,18,165,1,184,1778
MICHOACÁN,MORELIA,33,140,2,175,1764
MICHOACÁN,MORELIA,26,153,1,180,1763
MICHOACÁN,MORELIA,27,178,0,205,1628
MICHOACÁN,MORELIA,24,167,0,191,1627
MICHOACÁN,MORELIA,16,128,1,145,1251
MICHOACÁN,MORELIA,14,98,0,112,1251
MICHOACÁN,MORELIA,18,152,1,171,1750
MICHOACÁN,MORELIA,23,148,3,174,1750
MICHOACÁN,MORELIA,24,125,1,150,1749
MICHOACÁN,MORELIA,30,224,5,259,1865
MICHOACÁN,MORELIA,15,206,2,223,1864
MICHOACÁN,MORELIA,26,154,1,181,1397
MICHOACÁN,MORELIA,20,164,4,188,1397
MICHOACÁN,MORELIA,15,146,2,163,1397
MICHOACÁN,MORELIA,15,161,2,178,1208
MICHOACÁN,MORELIA,13,138,1,152,1208
MICHOACÁN,MORELIA,25,164,1,190,1649
MICHOACÁN,MORELIA,18,165,0,183,1648
MICHOACÁN,MORELIA,10,129,1,140,1696
MICHOACÁN,MORELIA,12,146,2,160,1696
MICHOACÁN,MORELIA,9,136,1,146,1695
MICHOACÁN,MORELIA,30,167,2,199,1665
MICHOACÁN,MORELIA,12,167,0,179,1665
MICHOACÁN,MORELIA,22,110,4,136,1033
MICHOACÁN,MORELIA,6,100,2,108,1033
MICHOACÁN,MORELIA,11,111,2,124,1603
MICHOACÁN,MORELIA,15,124,2,141,1603
MICHOACÁN,MORELIA,7,74,3,84,1003
MICHOACÁN,MORELIA,8,67,1,76,1003
MICHOACÁN,MORELIA,10,91,0,101,1729
MICHOACÁN,MORELIA,20,88,0,108,1729
MICHOACÁN,MORELIA,12,100,1,113,1729
MICHOACÁN,MORELIA,15,111,0,126,1729
MICHOACÁN,MORELIA,27,79,0,106,1728
MICHOACÁN,MORELIA,15,117,0,132,1728
MICHOACÁN,MORELIA,18,83,0,101,1728
MICHOACÁN,MORELIA,26,84,1,111,1191
MICHOACÁN,MORELIA,13,81,0,94,1191
MICHOACÁN,MORELIA,29,219,3,251,1884
MICHOACÁN,MORELIA,21,178,2,201,1883
MICHOACÁN,MORELIA,23,177,2,202,1616
MICHOACÁN,MORELIA,19,173,0,192,1616
MICHOACÁN,MORELIA,15,141,2,158,1643
MICHOACÁN,MORELIA,16,151,4,171,1642
MICHOACÁN,MORELIA,8,148,1,157,1186
MICHOACÁN,MORELIA,6,132,0,138,1186
MICHOACÁN,MORELIA,18,195,4,217,1539
MICHOACÁN,MORELIA,18,179,2,199,1538
MICHOACÁN,MORELIA,24,214,1,239,1563
MICHOACÁN,MORELIA,27,205,5,237,1562
MICHOACÁN,MORELIA,16,85,1,102,1027
MICHOACÁN,MORELIA,12,115,0,127,1026
MICHOACÁN,MORELIA,19,153,2,174,1007
MICHOACÁN,MORELIA,18,184,1,203,1006
MICHOACÁN,MORELIA,20,178,1,199,1519
MICHOACÁN,MORELIA,22,193,3,218,1518
MICHOACÁN,MORELIA,20,157,0,177,1445
MICHOACÁN,MORELIA,18,164,2,184,1444
MICHOACÁN,MORELIA,24,156,2,182,1444
MICHOACÁN,MORELIA,16,135,2,153,1182
MICHOACÁN,MORELIA,18,151,3,172,1181
MICHOACÁN,MORELIA,25,210,3,238,1708
MICHOACÁN,MORELIA,29,213,3,245,1707
MICHOACÁN,MORELIA,11,230,2,243,1744
MICHOACÁN,MORELIA,30,210,3,243,1744
MICHOACÁN,MORELIA,14,121,4,139,1187
MICHOACÁN,MORELIA,17,156,2,175,1187
MICHOACÁN,MORELIA,17,177,0,194,1681
MICHOACÁN,MORELIA,26,178,0,204,1680
MICHOACÁN,MORELIA,37,168,5,210,1756
MICHOACÁN,MORELIA,19,162,2,183,1756
MICHOACÁN,MORELIA,19,153,2,174,1755
MICHOACÁN,MORELIA,141,1305,9,1455,0
MICHOACÁN,MORELIA,29,142,2,173,1861
MICHOACÁN,MORELIA,27,174,0,201,1860
MICHOACÁN,MORELIA,24,106,4,134,1084
MICHOACÁN,MORELIA,13,95,0,108,1084
MICHOACÁN,MORELIA,36,145,1,182,1890
MICHOACÁN,MORELIA,37,164,2,203,1889
MICHOACÁN,MORELIA,25,119,3,147,1373
MICHOACÁN,MORELIA,29,111,2,142,1372
MICHOACÁN,MORELIA,26,180,3,209,1871
MICHOACÁN,MORELIA,15,163,5,183,1870
MICHOACÁN,MORELIA,13,153,2,168,1907
MICHOACÁN,MORELIA,14,195,2,211,1906
MICHOACÁN,MORELIA,6,173,1,180,1906
MICHOACÁN,MORELIA,21,205,2,228,1707
MICHOACÁN,MORELIA,22,247,3,272,1706
MICHOACÁN,MORELIA,13,144,4,161,1236
MICHOACÁN,MORELIA,17,127,0,144,1235
MICHOACÁN,MORELIA,16,169,0,185,1444
MICHOACÁN,MORELIA,12,195,5,212,1444
MICHOACÁN,MORELIA,16,137,4,157,1839
MICHOACÁN,MORELIA,24,140,2,166,1839
MICHOACÁN,MORELIA,27,107,5,139,1838
MICHOACÁN,MORELIA,27,123,2,152,1838
MICHOACÁN,MORELIA,27,144,0,171,1854
MICHOACÁN,MORELIA,37,136,4,177,1854
MICHOACÁN,MORELIA,32,178,0,210,1833
MICHOACÁN,MORELIA,28,185,3,216,1832
MICHOACÁN,MORELIA,10,108,0,118,1599
MICHOACÁN,MORELIA,13,167,1,181,1598
MICHOACÁN,MORELIA,14,140,2,156,1598
MICHOACÁN,MORELIA,15,104,1,120,1598
MICHOACÁN,MORELIA,14,146,3,163,1558
MICHOACÁN,MORELIA,19,148,9,176,1558
MICHOACÁN,MORELIA,8,116,5,129,1468
MICHOACÁN,MORELIA,9,104,2,115,1467
MICHOACÁN,MORELIA,19,124,2,145,1418
MICHOACÁN,MORELIA,21,117,2,140,1418
MICHOACÁN,MORELIA,18,127,6,151,1418
MICHOACÁN,MORELIA,17,159,0,176,1832
MICHOACÁN,MORELIA,17,174,4,195,1832
MICHOACÁN,MORELIA,19,148,7,174,1832
MICHOACÁN,MORELIA,21,173,2,196,1831
MICHOACÁN,MORELIA,13,158,5,176,1831
MICHOACÁN,MORELIA,13,141,7,161,1549
MICHOACÁN,MORELIA,6,130,3,139,1549
MICHOACÁN,MORELIA,12,114,4,130,1549
MICHOACÁN,MORELIA,6,92,0,98,1469
MICHOACÁN,MORELIA,17,114,4,135,1469
MICHOACÁN,MORELIA,22,182,5,209,1563
MICHOACÁN,MORELIA,13,209,2,224,1563
MICHOACÁN,MORELIA,16,164,2,182,1562
MICHOACÁN,MORELIA,21,210,7,238,1874
MICHOACÁN,MORELIA,15,194,6,215,1874
MICHOACÁN,MORELIA,9,157,2,168,1955
MICHOACÁN,MORELIA,4,147,5,156,1954
MICHOACÁN,MORELIA,9,134,4,147,1954
MICHOACÁN,MORELIA,26,146,1,173,1725
MICHOACÁN,MORELIA,16,163,0,179,1725
MICHOACÁN,MORELIA,13,158,1,172,1725
MICHOACÁN,MORELIA,19,142,0,161,1725
MICHOACÁN,MORELIA,20,167,0,187,1725
MICHOACÁN,MORELIA,22,139,4,165,1724
MICHOACÁN,MORELIA,7,103,3,113,1978
MICHOACÁN,MORELIA,14,130,10,154,1978
MICHOACÁN,MORELIA,5,149,2,156,1977
MICHOACÁN,MORELIA,11,76,2,89,1378
MICHOACÁN,MORELIA,13,89,2,104,1377
MICHOACÁN,MORELIA,5,74,3,82,1377
MICHOACÁN,MORELIA,8,89,1,98,1574
MICHOACÁN,MORELIA,7,129,1,137,1398
MICHOACÁN,MORELIA,10,125,2,137,1398
MICHOACÁN,MORELIA,15,228,4,247,1908
MICHOACÁN,MORELIA,19,230,1,250,1908
MICHOACÁN,MORELIA,17,130,0,147,1416
MICHOACÁN,MORELIA,10,113,2,125,1415
MICHOACÁN,MORELIA,7,81,1,89,1747
MICHOACÁN,MORELIA,7,87,0,94,1747
MICHOACÁN,MORELIA,2,72,1,75,1746
MICHOACÁN,MORELIA,12,163,0,175,1562
MICHOACÁN,MORELIA,17,143,3,163,1562
MICHOACÁN,MORELIA,9,140,2,151,1562
MICHOACÁN,MORELIA,18,132,3,153,1562
MICHOACÁN,PATZCUARO,14,146,2,162,1557
MICHOACÁN,PATZCUARO,24,169,6,199,1556
MICHOACÁN,PATZCUARO,14,165,4,183,1595
MICHOACÁN,PATZCUARO,18,142,1,161,1594
MICHOACÁN,PATZCUARO,25,140,3,168,1101
MICHOACÁN,PATZCUARO,26,131,3,160,1101
MICHOACÁN,PATZCUARO,19,170,5,194,1489
MICHOACÁN,PATZCUARO,6,147,5,158,1489
MICHOACÁN,PATZCUARO,22,146,1,169,1489
MICHOACÁN,PATZCUARO,13,155,55,223,1470
MICHOACÁN,PATZCUARO,16,155,4,175,1470
MICHOACÁN,PATZCUARO,16,163,3,182,1727
MICHOACÁN,PATZCUARO,12,144,6,162,1727
MICHOACÁN,PATZCUARO,19,119,7,145,1458
MICHOACÁN,PATZCUARO,12,110,2,124,1457
MICHOACÁN,PATZCUARO,18,93,8,119,1785
MICHOACÁN,PATZCUARO,18,86,7,111,1785
MICHOACÁN,PATZCUARO,23,84,6,113,1487
MICHOACÁN,PATZCUARO,13,103,7,123,1487
MICHOACÁN,PATZCUARO,24,130,6,160,1928
MICHOACÁN,PATZCUARO,12,86,5,103,1928
MICHOACÁN,PATZCUARO,7,230,1,238,1816
MICHOACÁN,PATZCUARO,7,239,3,249,1816
MICHOACÁN,PATZCUARO,6,71,0,77,1538
MICHOACÁN,PATZCUARO,2,91,0,93,1538
MICHOACÁN,PATZCUARO,16,103,0,119,1830
MICHOACÁN,PATZCUARO,5,85,0,90,1830
MICHOACÁN,PATZCUARO,0,63,2,65,1357
MICHOACÁN,PATZCUARO,8,51,1,60,1356
MICHOACÁN,PATZCUARO,17,81,0,98,1542
MICHOACÁN,PATZCUARO,4,56,2,62,1541
MICHOACÁN,PATZCUARO,1,100,0,101,1496
MICHOACÁN,PATZCUARO,6,106,2,114,1496
MICHOACÁN,PATZCUARO,3,105,1,109,1495
MICHOACÁN,PATZCUARO,3,84,1,88,1415
MICHOACÁN,PATZCUARO,4,61,2,67,1414
MICHOACÁN,PATZCUARO,1,23,0,24,1307
MICHOACÁN,PATZCUARO,6,18,0,24,1307
MICHOACÁN,PATZCUARO,5,28,1,34,1306
MICHOACÁN,PATZCUARO,6,257,9,272,1727
MICHOACÁN,PATZCUARO,12,236,6,254,1727
MICHOACÁN,PATZCUARO,7,212,3,222,1349
MICHOACÁN,PATZCUARO,7,223,6,236,1348
MICHOACÁN,PATZCUARO,3,240,4,247,1348
MICHOACÁN,PATZCUARO,18,294,3,315,1725
MICHOACÁN,PATZCUARO,17,281,2,300,1724
MICHOACÁN,PATZCUARO,81,662,9,752,0
MICHOACÁN,PATZCUARO,14,167,1,182,1648
MICHOACÁN,PATZCUARO,11,153,3,167,1647
MICHOACÁN,PATZCUARO,11,212,3,226,1822
MICHOACÁN,PATZCUARO,14,201,5,220,1822
MICHOACÁN,PATZCUARO,15,170,5,190,1822
MICHOACÁN,PATZCUARO,8,160,0,168,1703
MICHOACÁN,PATZCUARO,4,140,3,147,1703
MICHOACÁN,PATZCUARO,10,148,4,162,1702
MICHOACÁN,PATZCUARO,10,147,2,159,1957
MICHOACÁN,PATZCUARO,10,171,3,184,1957
MICHOACÁN,PATZCUARO,18,213,1,232,1573
MICHOACÁN,PATZCUARO,17,205,3,225,1573
MICHOACÁN,PATZCUARO,13,167,2,182,1573
MICHOACÁN,PATZCUARO,19,181,2,202,1806
MICHOACÁN,PATZCUARO,13,156,3,172,1805
MICHOACÁN,PATZCUARO,8,129,1,138,1709
MICHOACÁN,PATZCUARO,4,167,1,172,1709
MICHOACÁN,PATZCUARO,12,172,1,185,1531
MICHOACÁN,PATZCUARO,12,184,4,200,1531
MICHOACÁN,PATZCUARO,4,147,0,151,1531
MICHOACÁN,PATZCUARO,12,106,3,121,1816
MICHOACÁN,PATZCUARO,12,118,1,131,1815
MICHOACÁN,PATZCUARO,7,95,2,104,1280
MICHOACÁN,PATZCUARO,9,421,16,446,1279
MICHOACÁN,PATZCUARO,17,139,7,163,1766
MICHOACÁN,PATZCUARO,14,118,9,141,1766
MICHOACÁN,PATZCUARO,12,130,2,144,1040
MICHOACÁN,PATZCUARO,11,115,4,130,1040
MICHOACÁN,PATZCUARO,9,165,4,178,1373
MICHOACÁN,PATZCUARO,15,110,6,131,1372
MICHOACÁN,PATZCUARO,5,124,3,132,1372
MICHOACÁN,PATZCUARO,4,245,5,254,1213
MICHOACÁN,PATZCUARO,1,245,7,253,1213
MICHOACÁN,PATZCUARO,10,101,5,116,1766
MICHOACÁN,PATZCUARO,14,81,2,97,1765
MICHOACÁN,PATZCUARO,6,108,4,118,1765
MICHOACÁN,PATZCUARO,13,109,5,127,1765
MICHOACÁN,PATZCUARO,14,263,6,283,1801
MICHOACÁN,PATZCUARO,7,217,1,225,1800
MICHOACÁN,PATZCUARO,20,174,7,201,1418
MICHOACÁN,PATZCUARO,20,220,3,243,1418
MICHOACÁN,PATZCUARO,21,186,12,219,1417
MICHOACÁN,PATZCUARO,23,248,9,280,1685
MICHOACÁN,PATZCUARO,32,296,12,340,1685
MICHOACÁN,PATZCUARO,26,239,11,276,1684
MICHOACÁN,PATZCUARO,28,257,15,300,1952
MICHOACÁN,PATZCUARO,22,266,22,310,1952
MICHOACÁN,PATZCUARO,25,261,18,304,1954
MICHOACÁN,PATZCUARO,19,266,18,303,1954
MICHOACÁN,PATZCUARO,18,189,7,214,1173
MICHOACÁN,PATZCUARO,19,164,8,191,1172
MICHOACÁN,PATZCUARO,13,103,2,118,1603
MICHOACÁN,PATZCUARO,22,150,10,182,1602
MICHOACÁN,PATZCUARO,0,0,0,0,1761
MICHOACÁN,PATZCUARO,0,0,0,0,1761
MICHOACÁN,PATZCUARO,12,63,1,76,1375
MICHOACÁN,PATZCUARO,30,96,6,132,1374
MICHOACÁN,PATZCUARO,11,62,3,76,1374
MICHOACÁN,PATZCUARO,15,39,7,61,1769
MICHOACÁN,PATZCUARO,3,49,6,58,1769
MICHOACÁN,PATZCUARO,3,40,2,45,1768
MICHOACÁN,PATZCUARO,7,39,3,49,1680
MICHOACÁN,PATZCUARO,6,52,4,62,1679
MICHOACÁN,PATZCUARO,11,167,2,180,1807
MICHOACÁN,PATZCUARO,10,211,0,221,1806
MICHOACÁN,PATZCUARO,5,73,1,79,1436
MICHOACÁN,PATZCUARO,3,107,1,111,1436
MICHOACÁN,PATZCUARO,11,133,4,148,1876
MICHOACÁN,PATZCUARO,8,164,4,176,1875
MICHOACÁN,PATZCUARO,5,137,1,143,1948
MICHOACÁN,PATZCUARO,5,100,4,109,1976
MICHOACÁN,PATZCUARO,7,172,0,179,1976
MICHOACÁN,PATZCUARO,2,121,1,124,1975
MICHOACÁN,PATZCUARO,3,118,3,124,1567
MICHOACÁN,PATZCUARO,3,103,0,106,1567
MICHOACÁN,PATZCUARO,4,189,3,196,1957
MICHOACÁN,PATZCUARO,7,183,3,193,1957
MICHOACÁN,PATZCUARO,16,176,8,200,1937
MICHOACÁN,PATZCUARO,19,132,7,158,1936
MICHOACÁN,PATZCUARO,0,42,1,43,1701
MICHOACÁN,PATZCUARO,7,42,1,50,1701
MICHOACÁN,PATZCUARO,3,34,0,37,1701
MICHOACÁN,PATZCUARO,11,27,1,39,1209
MICHOACÁN,PATZCUARO,14,27,0,41,1209
MICHOACÁN,PATZCUARO,8,53,2,63,1957
MICHOACÁN,PATZCUARO,4,93,4,101,1957
MICHOACÁN,PATZCUARO,2,92,2,96,1505
MICHOACÁN,PATZCUARO,4,82,4,90,1505
MICHOACÁN,PATZCUARO,6,105,1,112,1504
MICHOACÁN,PATZCUARO,3,38,0,41,1933
MICHOACÁN,PATZCUARO,10,34,1,45,1933
MICHOACÁN,PATZCUARO,5,272,0,277,1383
MICHOACÁN,PATZCUARO,7,269,3,279,1383
MICHOACÁN,PATZCUARO,6,287,0,293,1382
MICHOACÁN,PATZCUARO,9,185,0,194,1827
MICHOACÁN,PATZCUARO,5,205,1,211,1826
MICHOACÁN,PATZCUARO,2,218,2,222,1888
MICHOACÁN,PATZCUARO,7,245,3,255,1888
MICHOACÁN,PATZCUARO,7,183,4,194,1926
MICHOACÁN,PATZCUARO,2,181,2,185,1926
MICHOACÁN,PATZCUARO,10,250,3,263,1491
MICHOACÁN,PATZCUARO,12,237,1,250,1491
MICHOACÁN,PATZCUARO,7,206,2,215,1931
MICHOACÁN,PATZCUARO,5,170,4,179,1931
MICHOACÁN,PATZCUARO,5,192,1,198,1409
MICHOACÁN,PATZCUARO,4,154,7,165,1408
MICHOACÁN,PATZCUARO,12,231,4,247,1933
MICHOACÁN,PATZCUARO,13,277,1,291,1932
MICHOACÁN,PATZCUARO,8,295,9,312,1946
MICHOACÁN,PATZCUARO,3,258,7,268,1946
MICHOACÁN,PATZCUARO,46,870,52,968,1053
MICHOACÁN,PATZCUARO,36,955,54,1045,1053
MICHOACÁN,PATZCUARO,36,860,66,962,1159
MICHOACÁN,PATZCUARO,16,594,22,632,1158
MICHOACÁN,PATZCUARO,9,1087,7,1103,1868
MICHOACÁN,PATZCUARO,7,1266,6,1279,1867
MICHOACÁN,PATZCUARO,1,1133,11,1145,1456
MICHOACÁN,PATZCUARO,5,1069,8,1082,1456
MICHOACÁN,PATZCUARO,8,1078,3,1089,1348
MICHOACÁN,PATZCUARO,10,1061,7,1078,1348
MICHOACÁN,PATZCUARO,2,988,7,997,1261
MICHOACÁN,PATZCUARO,1,978,3,982,1260
MICHOACÁN,PATZCUARO,1,243,3,247,1665
MICHOACÁN,PATZCUARO,10,200,2,212,1665
MICHOACÁN,PATZCUARO,3,239,5,247,1830
MICHOACÁN,PATZCUARO,5,255,2,262,1829
MICHOACÁN,PATZCUARO,4,227,2,233,1571
MICHOACÁN,PATZCUARO,4,157,6,167,1570
MICHOACÁN,PATZCUARO,14,161,5,180,1663
MICHOACÁN,PATZCUARO,14,144,5,163,1663
MICHOACÁN,PATZCUARO,4,149,3,156,1539
MICHOACÁN,PATZCUARO,5,125,0,130,1539
MICHOACÁN,PATZCUARO,6,186,4,196,1539
MICHOACÁN,PATZCUARO,0,128,2,130,1538
MICHOACÁN,PATZCUARO,14,180,10,204,1552
MICHOACÁN,PATZCUARO,17,198,2,217,1551
MICHOACÁN,PATZCUARO,11,226,7,244,1713
MICHOACÁN,PATZCUARO,13,185,3,201,1713
MICHOACÁN,PATZCUARO,5,88,3,96,1483
MICHOACÁN,PATZCUARO,8,68,2,78,1482
MICHOACÁN,PATZCUARO,7,126,2,135,1116
MICHOACÁN,PATZCUARO,9,118,3,130,1115
MICHOACÁN,APATZINGAN DE LA CONSTITUCION,7,71,0,78,1845
MICHOACÁN,APATZINGAN DE LA CONSTITUCION,2,77,1,80,1845
MICHOACÁN,APATZINGAN DE LA CONSTITUCION,5,62,2,69,1845
MICHOACÁN,APATZINGAN DE LA CONSTITUCION,10,55,0,65,1845
MICHOACÁN,APATZINGAN DE LA CONSTITUCION,8,90,2,100,1889
MICHOACÁN,APATZINGAN DE LA CONSTITUCION,7,80,1,88,1889
MICHOACÁN,APATZINGAN DE LA CONSTITUCION,7,205,3,215,1941
MICHOACÁN,APATZINGAN DE LA CONSTITUCION,5,173,4,182,1941
MICHOACÁN,APATZINGAN DE LA CONSTITUCION,9,234,5,248,1963
MICHOACÁN,APATZINGAN DE LA CONSTITUCION,4,222,7,233,1963
MICHOACÁN,APATZINGAN DE LA CONSTITUCION,5,215,0,220,1934
MICHOACÁN,APATZINGAN DE LA CONSTITUCION,9,209,4,222,1934
MICHOACÁN,APATZINGAN DE LA CONSTITUCION,8,156,4,168,1299
MICHOACÁN,APATZINGAN DE LA CONSTITUCION,6,177,4,187,1299
MICHOACÁN,APATZINGAN DE LA CONSTITUCION,12,226,3,241,1491
MICHOACÁN,APATZINGAN DE LA CONSTITUCION,13,200,1,214,1491
MICHOACÁN,APATZINGAN DE LA CONSTITUCION,8,206,1,215,1490
MICHOACÁN,APATZINGAN DE LA CONSTITUCION,8,236,2,246,1951
MICHOACÁN,APATZINGAN DE LA CONSTITUCION,12,319,3,334,1950
MICHOACÁN,APATZINGAN DE LA CONSTITUCION,5,255,2,262,1678
MICHOACÁN,APATZINGAN DE LA CONSTITUCION,6,246,5,257,1678
MICHOACÁN,APATZINGAN DE LA CONSTITUCION,13,209,4,226,1506
MICHOACÁN,APATZINGAN DE LA CONSTITUCION,12,192,1,205,1506
MICHOACÁN,APATZINGAN DE LA CONSTITUCION,5,243,2,250,1885
MICHOACÁN,APATZINGAN DE LA CONSTITUCION,8,276,2,286,1884
MICHOACÁN,APATZINGAN DE LA CONSTITUCION,13,212,5,230,1846
MICHOACÁN,APATZINGAN DE LA CONSTITUCION,14,204,4,222,1846
MICHOACÁN,APATZINGAN DE LA CONSTITUCION,3,257,2,262,1968
MICHOACÁN,APATZINGAN DE LA CONSTITUCION,6,258,2,266,1967
MICHOACÁN,APATZINGAN DE LA CONSTITUCION,17,187,5,209,1222
MICHOACÁN,APATZINGAN DE LA CONSTITUCION,14,167,1,182,1222
MICHOACÁN,APATZINGAN DE LA CONSTITUCION,9,271,3,283,1874
MICHOACÁN,APATZINGAN DE LA CONSTITUCION,16,244,5,265,1874
MICHOACÁN,APATZINGAN DE LA CONSTITUCION,29,593,3,625,0
MICHOACÁN,APATZINGAN DE LA CONSTITUCION,8,289,3,300,2101
MICHOACÁN,APATZINGAN DE LA CONSTITUCION,6,292,3,301,2100
MICHOACÁN,APATZINGAN DE LA CONSTITUCION,9,166,2,177,1579
MICHOACÁN,APATZINGAN DE LA CONSTITUCION,7,213,2,222,1578
MICHOACÁN,APATZINGAN DE LA CONSTITUCION,10,189,6,205,1676
MICHOACÁN,APATZINGAN DE LA CONSTITUCION,9,214,1,224,1675
MICHOACÁN,APATZINGAN DE LA CONSTITUCION,4,285,4,293,1625
MICHOACÁN,APATZINGAN DE LA CONSTITUCION,15,244,4,263,1624
MICHOACÁN,APATZINGAN DE LA CONSTITUCION,6,224,0,230,1618
MICHOACÁN,APATZINGAN DE LA CONSTITUCION,7,224,5,236,1617
MICHOACÁN,APATZINGAN DE LA CONSTITUCION,3,175,4,182,1643
MICHOACÁN,APATZINGAN DE LA CONSTITUCION,2,166,5,173,1642
MICHOACÁN,APATZINGAN DE LA CONSTITUCION,8,228,3,239,1542
MICHOACÁN,APATZINGAN DE LA CONSTITUCION,15,244,2,261,1542
MICHOACÁN,APATZINGAN DE LA CONSTITUCION,7,243,2,252,1574
MICHOACÁN,APATZINGAN DE LA CONSTITUCION,7,206,3,216,1574
MICHOACÁN,APATZINGAN DE LA CONSTITUCION,7,283,3,293,1800
MICHOACÁN,APATZINGAN DE LA CONSTITUCION,11,240,8,259,1800
MICHOACÁN,APATZINGAN DE LA CONSTITUCION,3,243,2,248,1799
MICHOACÁN,APATZINGAN DE LA CONSTITUCION,11,249,4,264,1799
MICHOACÁN,APATZINGAN DE LA CONSTITUCION,2,103,5,110,1965
MICHOACÁN,APATZINGAN DE LA CONSTITUCION,7,104,3,114,1964
MICHOACÁN,APATZINGAN DE LA CONSTITUCION,6,136,2,144,1881
MICHOACÁN,APATZINGAN DE LA CONSTITUCION,5,134,2,141,1881
MICHOACÁN,APATZINGAN DE LA CONSTITUCION,6,227,5,238,1799
MICHOACÁN,APATZINGAN DE LA CONSTITUCION,6,221,4,231,1799
MICHOACÁN,APATZINGAN DE LA CONSTITUCION,5,164,2,171,1955
MICHOACÁN,APATZINGAN DE LA CONSTITUCION,7,165,3,175,1954
MICHOACÁN,APATZINGAN DE LA CONSTITUCION,11,261,3,275,1968
MICHOACÁN,APATZINGAN DE LA CONSTITUCION,8,262,0,270,1968
MICHOACÁN,APATZINGAN DE LA CONSTITUCION,7,425,0,432,2007
MICHOACÁN,APATZINGAN DE LA CONSTITUCION,9,243,4,256,1677
MICHOACÁN,APATZINGAN DE LA CONSTITUCION,7,251,1,259,1677
MICHOACÁN,APATZINGAN DE LA CONSTITUCION,1,140,2,143,1567
MICHOACÁN,APATZINGAN DE LA CONSTITUCION,5,155,0,160,1566
MICHOACÁN,APATZINGAN DE LA CONSTITUCION,20,565,10,595,1758
MICHOACÁN,APATZINGAN DE LA CONSTITUCION,17,542,11,570,1758
MICHOACÁN,APATZINGAN DE LA CONSTITUCION,9,227,5,241,1238
MICHOACÁN,APATZINGAN DE LA CONSTITUCION,12,303,6,321,1238
MICHOACÁN,APATZINGAN DE LA CONSTITUCION,11,135,5,151,1794
MICHOACÁN,APATZINGAN DE LA CONSTITUCION,4,151,1,156,1793
MICHOACÁN,APATZINGAN DE LA CONSTITUCION,7,136,2,145,1793
MICHOACÁN,APATZINGAN DE LA CONSTITUCION,9,131,3,143,1667
MICHOACÁN,APATZINGAN DE LA CONSTITUCION,3,137,1,141,1667
MICHOACÁN,APATZINGAN DE LA CONSTITUCION,7,135,0,142,1667
MICHOACÁN,APATZINGAN DE LA CONSTITUCION,3,157,0,160,1787
MICHOACÁN,APATZINGAN DE LA CONSTITUCION,5,178,0,183,1787
MICHOACÁN,APATZINGAN DE LA CONSTITUCION,4,89,1,94,1946
MICHOACÁN,APATZINGAN DE LA CONSTITUCION,6,66,1,73,1946
MICHOACÁN,APATZINGAN DE LA CONSTITUCION,2,128,3,133,2140
MICHOACÁN,APATZINGAN DE LA CONSTITUCION,10,113,4,127,2139
MICHOACÁN,APATZINGAN DE LA CONSTITUCION,7,123,3,133,1918
MICHOACÁN,APATZINGAN DE LA CONSTITUCION,7,109,2,118,1917
MICHOACÁN,APATZINGAN DE LA CONSTITUCION,4,92,0,96,2009
MICHOACÁN,APATZINGAN DE LA CONSTITUCION,2,106,0,108,2008
MICHOACÁN,APATZINGAN DE LA CONSTITUCION,10,267,2,279,1876
MICHOACÁN,APATZINGAN DE LA CONSTITUCION,6,265,1,272,1875
MICHOACÁN,APATZINGAN DE LA CONSTITUCION,11,293,4,308,1790
MICHOACÁN,APATZINGAN DE LA CONSTITUCION,12,276,2,290,1790
MICHOACÁN,APATZINGAN DE LA CONSTITUCION,6,230,3,239,1860
MICHOACÁN,APATZINGAN DE LA CONSTITUCION,5,226,2,233,1859
MICHOACÁN,APATZINGAN DE LA CONSTITUCION,10,78,2,90,1863
MICHOACÁN,APATZINGAN DE LA CONSTITUCION,9,90,0,99,1862
MICHOACÁN,APATZINGAN DE LA CONSTITUCION,11,35,1,47,1764
MICHOACÁN,APATZINGAN DE LA CONSTITUCION,4,56,2,62,1763
MICHOACÁN,APATZINGAN DE LA CONSTITUCION,13,95,0,108,1497
MICHOACÁN,APATZINGAN DE LA CONSTITUCION,10,78,0,88,1497
MICHOACÁN,APATZINGAN DE LA CONSTITUCION,11,76,1,88,1831
MICHOACÁN,APATZINGAN DE LA CONSTITUCION,4,77,2,83,1830
MICHOACÁN,APATZINGAN DE LA CONSTITUCION,9,130,2,141,1831
MICHOACÁN,APATZINGAN DE LA CONSTITUCION,8,142,1,151,1831
MICHOACÁN,APATZINGAN DE LA CONSTITUCION,5,75,1,81,1876
MICHOACÁN,APATZINGAN DE LA CONSTITUCION,6,80,0,86,1875
MICHOACÁN,APATZINGAN DE LA CONSTITUCION,15,169,3,187,1614
MICHOACÁN,APATZINGAN DE LA CONSTITUCION,16,151,0,167,1613
MICHOACÁN,APATZINGAN DE LA CONSTITUCION,21,177,3,201,2169
MICHOACÁN,APATZINGAN DE LA CONSTITUCION,14,187,4,205,2168
MICHOACÁN,APATZINGAN DE LA CONSTITUCION,6,128,1,135,1229
MICHOACÁN,APATZINGAN DE LA CONSTITUCION,8,119,2,129,1228
MICHOACÁN,APATZINGAN DE LA CONSTITUCION,5,82,2,89,1864
MICHOACÁN,APATZINGAN DE LA CONSTITUCION,6,69,0,75,1863
MICHOACÁN,APATZINGAN DE LA CONSTITUCION,2,45,0,47,1783
MICHOACÁN,APATZINGAN DE LA CONSTITUCION,2,38,0,40,1782
MICHOACÁN,APATZINGAN DE LA CONSTITUCION,2,50,1,53,1782
MICHOACÁN,APATZINGAN DE LA CONSTITUCION,1,73,0,74,1926
MICHOACÁN,APATZINGAN DE LA CONSTITUCION,5,61,1,67,1926
MICHOACÁN,APATZINGAN DE LA CONSTITUCION,6,116,0,122,2011
MICHOACÁN,APATZINGAN DE LA CONSTITUCION,8,116,0,124,2011
MICHOACÁN,APATZINGAN DE LA CONSTITUCION,9,148,1,158,1311
MICHOACÁN,APATZINGAN DE LA CONSTITUCION,8,122,3,133,1310
MICHOACÁN,APATZINGAN DE LA CONSTITUCION,4,65,1,70,1866
MICHOACÁN,APATZINGAN DE LA CONSTITUCION,2,45,0,47,1866
MICHOACÁN,APATZINGAN DE LA CONSTITUCION,3,56,0,59,1984
MICHOACÁN,APATZINGAN DE LA CONSTITUCION,3,31,1,35,1983
MICHOACÁN,APATZINGAN DE LA CONSTITUCION,12,54,0,66,1688
MICHOACÁN,APATZINGAN DE LA CONSTITUCION,6,83,0,89,1687
MICHOACÁN,APATZINGAN DE LA CONSTITUCION,5,63,1,69,1998
MICHOACÁN,APATZINGAN DE LA CONSTITUCION,1,56,0,57,1997
MICHOACÁN,APATZINGAN DE LA CONSTITUCION,3,167,0,170,1938
MICHOACÁN,APATZINGAN DE LA CONSTITUCION,3,134,1,138,1938
MICHOACÁN,APATZINGAN DE LA CONSTITUCION,3,22,1,26,1932
MICHOACÁN,APATZINGAN DE LA CONSTITUCION,4,25,2,31,1931
MICHOACÁN,APATZINGAN DE LA CONSTITUCION,8,150,0,158,1778
MICHOACÁN,APATZINGAN DE LA CONSTITUCION,10,128,0,138,1778
MICHOACÁN,APATZINGAN DE LA CONSTITUCION,1,115,1,117,1824
MICHOACÁN,APATZINGAN DE LA CONSTITUCION,7,120,0,127,1824
MICHOACÁN,APATZINGAN DE LA CONSTITUCION,4,117,2,123,1824
MICHOACÁN,APATZINGAN DE LA CONSTITUCION,3,104,2,109,1746
MICHOACÁN,APATZINGAN DE LA CONSTITUCION,10,107,1,118,1746
MICHOACÁN,APATZINGAN DE LA CONSTITUCION,1,72,0,73,1097
MICHOACÁN,APATZINGAN DE LA CONSTITUCION,2,62,1,65,1096
MICHOACÁN,APATZINGAN DE LA CONSTITUCION,1,60,0,61,1299
MICHOACÁN,APATZINGAN DE LA CONSTITUCION,0,98,1,99,1298
MORELOS,CUERNAVACA,12,212,2,226,1914
MORELOS,CUERNAVACA,15,220,3,238,1914
MORELOS,CUERNAVACA,21,181,0,202,1514
MORELOS,CUERNAVACA,14,252,1,267,1513
MORELOS,CUERNAVACA,26,280,3,309,2042
MORELOS,CUERNAVACA,20,266,8,294,1858
MORELOS,CUERNAVACA,9,259,3,271,1857
MORELOS,CUERNAVACA,11,235,7,253,1663
MORELOS,CUERNAVACA,16,271,2,289,1662
MORELOS,CUERNAVACA,16,259,5,280,2036
MORELOS,CUERNAVACA,26,270,1,297,2036
MORELOS,CUERNAVACA,14,166,8,188,1348
MORELOS,CUERNAVACA,14,179,2,195,1348
MORELOS,CUERNAVACA,14,157,4,175,1539
MORELOS,CUERNAVACA,20,148,3,171,1538
MORELOS,CUERNAVACA,20,193,7,220,1587
MORELOS,CUERNAVACA,12,229,2,243,1587
MORELOS,CUERNAVACA,17,226,6,249,1587
MORELOS,CUERNAVACA,8,194,2,204,1281
MORELOS,CUERNAVACA,21,174,15,210,1281
MORELOS,CUERNAVACA,19,260,8,287,1576
MORELOS,CUERNAVACA,15,221,3,239,1575
MORELOS,CUERNAVACA,29,223,4,256,1907
MORELOS,CUERNAVACA,18,224,3,245,1907
MORELOS,CUERNAVACA,10,192,1,203,1100
MORELOS,CUERNAVACA,22,165,0,187,1100
MORELOS,CUERNAVACA,29,315,11,355,1923
MORELOS,CUERNAVACA,32,290,4,326,1923
MORELOS,CUERNAVACA,47,277,4,328,2154
MORELOS,CUERNAVACA,25,308,2,335,2153
MORELOS,CUERNAVACA,17,231,5,253,1612
MORELOS,CUERNAVACA,43,234,1,278,1612
MORELOS,CUERNAVACA,31,201,3,235,1860
MORELOS,CUERNAVACA,19,185,5,209,1860
MORELOS,CUERNAVACA,21,182,5,208,1345
MORELOS,CUERNAVACA,15,206,0,221,1344
MORELOS,CUERNAVACA,26,248,1,275,1828
MORELOS,CUERNAVACA,21,290,5,316,1828
MORELOS,CUERNAVACA,15,178,4,197,1545
MORELOS,CUERNAVACA,19,161,2,182,1545
MORELOS,CUERNAVACA,28,150,3,181,1545
MORELOS,CUERNAVACA,139,1716,29,1884,0
MORELOS,CUERNAVACA,24,179,1,204,1369
MORELOS,CUERNAVACA,27,206,5,238,1368
MORELOS,CUERNAVACA,17,231,1,249,2131
MORELOS,CUERNAVACA,28,234,5,267,2131
MORELOS,CUERNAVACA,16,203,5,224,2131
MORELOS,CUERNAVACA,21,235,3,259,1907
MORELOS,CUERNAVACA,15,228,8,251,1907
MORELOS,CUERNAVACA,9,243,3,255,1906
MORELOS,CUERNAVACA,15,270,5,290,1906
MORELOS,CUERNAVACA,14,255,0,269,1819
MORELOS,CUERNAVACA,12,267,3,282,1819
MORELOS,CUERNAVACA,28,247,4,279,1937
MORELOS,CUERNAVACA,36,234,9,279,1937
MORELOS,CUERNAVACA,33,217,6,256,1541
MORELOS,CUERNAVACA,39,246,2,287,1541
MORELOS,CUERNAVACA,29,183,2,214,1745
MORELOS,CUERNAVACA,27,168,3,198,1744
MORELOS,CUERNAVACA,42,250,9,301,2158
MORELOS,CUERNAVACA,34,262,3,299,2157
MORELOS,CUERNAVACA,33,236,2,271,2157
MORELOS,CUERNAVACA,39,238,3,280,2157
MORELOS,CUERNAVACA,28,213,4,245,1797
MORELOS,CUERNAVACA,27,206,2,235,1796
MORELOS,CUERNAVACA,30,238,8,276,1790
MORELOS,CUERNAVACA,35,251,3,289,1789
MORELOS,CUERNAVACA,20,215,9,244,1682
MORELOS,CUERNAVACA,15,219,10,244,1682
MORELOS,CUERNAVACA,33,127,2,162,1962
MORELOS,CUERNAVACA,32,122,1,155,1962
MORELOS,CUERNAVACA,21,191,3,215,1182
MORELOS,CUERNAVACA,11,153,4,168,1182
MORELOS,CUERNAVACA,19,323,4,346,1863
MORELOS,CUERNAVACA,7,300,4,311,1863
MORELOS,CUERNAVACA,21,205,4,230,1548
MORELOS,CUERNAVACA,15,182,4,201,1548
MORELOS,CUERNAVACA,19,217,4,240,1547
MORELOS,CUERNAVACA,17,258,4,279,1293
MORELOS,CUERNAVACA,13,242,3,258,1293
MORELOS,CUERNAVACA,10,225,1,236,1635
MORELOS,CUERNAVACA,23,217,1,241,1635
MORELOS,CUERNAVACA,11,224,3,238,1635
MORELOS,CUERNAVACA,18,245,0,263,1635
MORELOS,CUERNAVACA,25,188,3,216,1313
MORELOS,CUERNAVACA,19,190,3,212,1313
MORELOS,CUERNAVACA,15,208,4,227,1770
MORELOS,CUERNAVACA,13,222,5,240,1770
MORELOS,CUERNAVACA,23,190,2,215,1866
MORELOS,CUERNAVACA,15,229,1,245,1866
MORELOS,CUERNAVACA,17,260,5,282,1805
MORELOS,CUERNAVACA,17,230,7,254,1805
MORELOS,CUERNAVACA,21,171,4,196,1240
MORELOS,CUERNAVACA,22,165,2,189,1239
MORELOS,CUERNAVACA,27,224,3,254,1939
MORELOS,CUERNAVACA,26,233,1,260,1938
MORELOS,CUERNAVACA,20,138,1,159,1097
MORELOS,CUERNAVACA,24,155,4,183,1096
MORELOS,CUERNAVACA,42,151,2,195,1765
MORELOS,CUERNAVACA,60,152,6,218,1764
MORELOS,CUERNAVACA,44,293,11,348,1763
MORELOS,CUERNAVACA,26,277,3,306,1763
MORELOS,CUERNAVACA,20,278,11,309,1671
MORELOS,CUERNAVACA,24,284,4,312,1670
MORELOS,CUERNAVACA,23,303,5,331,1928
MORELOS,CUERNAVACA,32,307,2,341,1927
MORELOS,CUERNAVACA,21,276,3,300,1552
MORELOS,CUERNAVACA,22,290,3,315,1551
MORELOS,CUERNAVACA,37,250,5,292,1787
MORELOS,CUERNAVACA,25,246,12,283,1787
MORELOS,CUERNAVACA,33,227,4,264,1851
MORELOS,CUERNAVACA,37,233,3,273,1851
MORELOS,CUERNAVACA,19,191,8,218,1905
MORELOS,CUERNAVACA,17,229,8,254,1905
MORELOS,CUERNAVACA,14,268,7,289,1875
MORELOS,CUERNAVACA,13,303,9,325,1875
MORELOS,CUERNAVACA,34,274,4,312,1767
MORELOS,CUERNAVACA,27,283,3,313,1767
MORELOS,CUERNAVACA,39,240,4,283,1901
MORELOS,CUERNAVACA,21,238,3,262,1900
MORELOS,CUERNAVACA,9,190,5,204,1502
MORELOS,CUERNAVACA,10,239,1,250,1502
MORELOS,CUERNAVACA,30,249,8,287,1479
MORELOS,CUERNAVACA,22,256,4,282,1478
MORELOS,CUERNAVACA,16,233,3,252,1731
MORELOS,CUERNAVACA,24,252,6,282,1731
MORELOS,CUERNAVACA,24,293,1,318,1898
MORELOS,CUERNAVACA,24,277,7,308,1898
MORELOS,CUERNAVACA,21,189,2,212,1674
MORELOS,CUERNAVACA,26,189,3,218,1673
MORELOS,CUERNAVACA,29,204,0,233,1766
MORELOS,CUERNAVACA,19,228,4,251,1765
MORELOS,CUERNAVACA,33,238,2,273,1765
MORELOS,CUERNAVACA,21,253,3,277,1732
MORELOS,CUERNAVACA,24,263,2,289,1732
MORELOS,CUERNAVACA,24,284,5,313,1866
MORELOS,CUERNAVACA,25,303,3,331,1865
MORELOS,CUERNAVACA,11,323,9,343,1806
MORELOS,CUERNAVACA,23,304,1,328,1805
MORELOS,CUERNAVACA,26,185,4,215,1528
MORELOS,CUERNAVACA,26,172,1,199,1528
MORELOS,CUERNAVACA,28,210,10,248,1745
MORELOS,CUERNAVACA,39,197,9,245,1744
MORELOS,CUERNAVACA,13,208,3,224,1513
MORELOS,CUERNAVACA,8,256,7,271,1512
MORELOS,CUERNAVACA,6,200,3,209,1566
MORELOS,CUERNAVACA,16,202,8,226,1565
MORELOS,CUERNAVACA,15,215,5,235,1565
MORELOS,CUERNAVACA,17,245,6,268,1792
MORELOS,CUERNAVACA,24,254,6,284,1792
MORELOS,CUERNAVACA,21,283,4,308,1753
MORELOS,CUERNAVACA,21,286,2,309,1753
MORELOS,CUERNAVACA,44,294,4,342,2065
MORELOS,CUERNAVACA,12,254,5,271,1350
MORELOS,CUERNAVACA,16,244,4,264,1349
MORELOS,CUERNAVACA,8,238,5,251,1389
MORELOS,CUERNAVACA,11,180,8,199,1388
MORELOS,CUERNAVACA,16,409,11,436,2044
MORELOS,CUERNAVACA,24,189,1,214,1762
MORELOS,CUERNAVACA,28,181,2,211,1762
MORELOS,CUERNAVACA,23,204,4,231,1891
MORELOS,CUERNAVACA,40,230,3,273,1891
MORELOS,CUERNAVACA,19,223,5,247,1329
MORELOS,CUERNAVACA,18,222,3,243,1329
MORELOS,CUERNAVACA,12,265,4,281,1804
MORELOS,CUERNAVACA,13,284,4,301,1803
MORELOS,CUERNAVACA,18,260,7,285,1933
MORELOS,CUERNAVACA,26,282,4,312,1932
MORELOS,CUERNAVACA,21,183,7,211,1306
MORELOS,CUERNAVACA,23,192,4,219,1306
MORELOS,CUERNAVACA,27,318,10,355,1953
MORELOS,CUERNAVACA,18,184,4,206,1518
MORELOS,CUERNAVACA,13,205,1,219,1517
MORELOS,CUERNAVACA,29,147,3,179,1539
MORELOS,CUERNAVACA,29,143,6,178,1539
MORELOS,CUERNAVACA,29,205,2,236,1591
MORELOS,CUERNAVACA,18,270,2,290,1591
MORELOS,CUERNAVACA,29,235,2,266,1904
MORELOS,CUERNAVACA,23,245,5,273,1904
MORELOS,CUERNAVACA,3,74,1,78,1035
MORELOS,CUERNAVACA,30,155,3,188,1578
MORELOS,CUERNAVACA,21,178,4,203,1577
MORELOS,JIUTEPEC,5,182,2,189,1444
MORELOS,JIUTEPEC,8,149,2,159,1444
MORELOS,JIUTEPEC,4,172,2,178,1443
MORELOS,JIUTEPEC,9,239,6,254,1515
MORELOS,JIUTEPEC,15,187,0,202,1515
MORELOS,JIUTEPEC,6,94,2,102,1101
MORELOS,JIUTEPEC,11,125,1,137,1100
MORELOS,JIUTEPEC,19,166,4,189,1433
MORELOS,JIUTEPEC,21,161,2,184,1432
MORELOS,JIUTEPEC,9,186,0,195,1432
MORELOS,JIUTEPEC,8,191,5,204,1597
MORELOS,JIUTEPEC,9,190,3,202,1596
MORELOS,JIUTEPEC,7,190,1,198,1596
MORELOS,JIUTEPEC,12,165,9,186,1596
MORELOS,JIUTEPEC,6,226,6,238,1681
MORELOS,JIUTEPEC,5,177,4,186,1681
MORELOS,JIUTEPEC,17,218,2,237,1681
MORELOS,JIUTEPEC,10,208,3,221,1680
MORELOS,JIUTEPEC,11,234,6,251,1684
MORELOS,JIUTEPEC,5,194,3,202,1683
MORELOS,JIUTEPEC,8,216,1,225,1683
MORELOS,JIUTEPEC,10,238,4,252,1683
MORELOS,JIUTEPEC,7,213,2,222,1683
MORELOS,JIUTEPEC,238,12,3,253,1680
MORELOS,JIUTEPEC,12,216,9,237,1679
MORELOS,JIUTEPEC,13,193,3,209,1679
MORELOS,JIUTEPEC,6,197,5,208,1679
MORELOS,JIUTEPEC,9,135,2,146,1545
MORELOS,JIUTEPEC,19,157,3,179,1545
MORELOS,JIUTEPEC,3,158,2,163,1544
MORELOS,JIUTEPEC,98,1268,13,1379,0
MORELOS,JIUTEPEC,16,227,4,247,1442
MORELOS,JIUTEPEC,17,194,5,216,1442
MORELOS,JIUTEPEC,13,195,4,212,1892
MORELOS,JIUTEPEC,14,208,7,229,1891
MORELOS,JIUTEPEC,13,187,2,202,1891
MORELOS,JIUTEPEC,13,186,3,202,1891
MORELOS,JIUTEPEC,17,223,3,243,1295
MORELOS,JIUTEPEC,14,186,1,201,1295
MORELOS,JIUTEPEC,14,233,1,248,1170
MORELOS,JIUTEPEC,8,186,1,195,1170
MORELOS,JIUTEPEC,14,285,3,302,1473
MORELOS,JIUTEPEC,10,251,1,262,1472
MORELOS,JIUTEPEC,21,264,1,286,1886
MORELOS,JIUTEPEC,18,240,2,260,1886
MORELOS,JIUTEPEC,27,240,1,268,1885
MORELOS,JIUTEPEC,25,239,5,269,1885
MORELOS,JIUTEPEC,19,274,7,300,1885
MORELOS,JIUTEPEC,15,288,1,304,1559
MORELOS,JIUTEPEC,11,259,11,281,1558
MORELOS,JIUTEPEC,14,281,1,296,1558
MORELOS,JIUTEPEC,17,272,1,290,1414
MORELOS,JIUTEPEC,28,213,4,245,1413
MORELOS,JIUTEPEC,18,229,6,253,1413
MORELOS,JIUTEPEC,23,331,1,355,1833
MORELOS,JIUTEPEC,24,310,5,339,1832
MORELOS,JIUTEPEC,13,340,6,359,1832
MORELOS,JIUTEPEC,26,326,13,365,1955
MORELOS,JIUTEPEC,24,368,3,395,1955
MORELOS,JIUTEPEC,17,327,5,349,1955
MORELOS,JIUTEPEC,12,198,2,212,999
MORELOS,JIUTEPEC,16,178,4,198,999
MORELOS,JIUTEPEC,23,136,3,162,728
MORELOS,JIUTEPEC,32,239,6,277,1450
MORELOS,JIUTEPEC,21,224,3,248,1204
MORELOS,JIUTEPEC,19,187,3,209,1204
MORELOS,JIUTEPEC,18,268,1,287,1156
MORELOS,JIUTEPEC,28,241,4,273,1156
MORELOS,JIUTEPEC,14,225,4,243,1360
MORELOS,JIUTEPEC,14,273,5,292,1359
MORELOS,JIUTEPEC,18,258,5,281,1538
MORELOS,JIUTEPEC,9,254,4,267,1537
MORELOS,JIUTEPEC,18,264,2,284,1537
MORELOS,JIUTEPEC,14,216,5,235,1292
MORELOS,JIUTEPEC,25,204,3,232,1292
MORELOS,JIUTEPEC,31,233,4,268,994
MORELOS,JIUTEPEC,20,205,2,227,994
MORELOS,JIUTEPEC,14,241,1,256,1341
MORELOS,JIUTEPEC,18,237,4,259,1341
MORELOS,JIUTEPEC,19,237,3,259,1340
MORELOS,JIUTEPEC,12,263,2,277,1581
MORELOS,JIUTEPEC,13,232,0,245,1580
MORELOS,JIUTEPEC,11,272,9,292,1803
MORELOS,JIUTEPEC,11,285,3,299,1803
MORELOS,JIUTEPEC,6,237,1,244,1802
MORELOS,JIUTEPEC,6,240,2,248,1657
MORELOS,JIUTEPEC,7,228,2,237,1656
MORELOS,JIUTEPEC,8,238,1,247,1249
MORELOS,JIUTEPEC,10,264,3,277,1248
MORELOS,JIUTEPEC,12,279,5,296,1516
MORELOS,JIUTEPEC,11,249,0,260,1495
MORELOS,JIUTEPEC,28,264,3,295,1720
MORELOS,JIUTEPEC,15,200,5,220,1153
MORELOS,JIUTEPEC,16,174,3,193,1153
MORELOS,JIUTEPEC,24,271,4,299,1417
MORELOS,JIUTEPEC,22,249,2,273,1417
MORELOS,JIUTEPEC,35,356,3,394,2075
MORELOS,JIUTEPEC,23,263,4,290,1919
MORELOS,JIUTEPEC,20,272,5,297,1919
MORELOS,JIUTEPEC,26,310,3,339,1918
MORELOS,JIUTEPEC,39,412,3,454,1957
MORELOS,JIUTEPEC,6,191,3,200,1055
MORELOS,JIUTEPEC,5,195,2,202,1054
MORELOS,JIUTEPEC,18,227,1,246,1667
MORELOS,JIUTEPEC,13,233,2,248,1666
MORELOS,JIUTEPEC,18,146,1,165,997
MORELOS,JIUTEPEC,12,135,2,149,997
MORELOS,JIUTEPEC,27,296,4,327,1925
MORELOS,JIUTEPEC,23,295,7,325,1924
MORELOS,JIUTEPEC,28,316,2,346,1924
MORELOS,JIUTEPEC,22,263,4,289,1538
MORELOS,JIUTEPEC,22,267,2,291,1538
MORELOS,JIUTEPEC,31,391,0,422,2087
MORELOS,JIUTEPEC,23,164,2,189,1544
MORELOS,JIUTEPEC,15,180,0,195,1544
MORELOS,JIUTEPEC,21,162,1,184,1544
MORELOS,JIUTEPEC,19,170,2,191,1544
MORELOS,JIUTEPEC,32,268,7,307,1833
MORELOS,JIUTEPEC,23,272,4,299,1833
MORELOS,JIUTEPEC,34,350,2,386,1832
MORELOS,JIUTEPEC,19,246,2,267,1588
MORELOS,JIUTEPEC,14,257,2,273,1587
MORELOS,JIUTEPEC,20,322,12,354,1791
MORELOS,JIUTEPEC,12,330,5,347,1790
MORELOS,JIUTEPEC,18,253,6,277,1738
MORELOS,JIUTEPEC,19,264,6,289,1738
MORELOS,JIUTEPEC,27,275,2,304,1737
MORELOS,JIUTEPEC,14,266,7,287,1737
MORELOS,JIUTEPEC,10,232,3,245,1630
MORELOS,JIUTEPEC,10,234,2,246,1630
MORELOS,JIUTEPEC,7,234,3,244,1630
MORELOS,JIUTEPEC,6,242,2,250,1630
MORELOS,JIUTEPEC,13,216,1,230,1492
MORELOS,JIUTEPEC,18,232,2,252,1491
MORELOS,JIUTEPEC,12,223,1,236,1491
MORELOS,JIUTEPEC,12,274,5,291,1624
MORELOS,JIUTEPEC,12,250,2,264,1624
MORELOS,JIUTEPEC,14,237,5,256,1624
MORELOS,JIUTEPEC,6,178,5,189,1332
MORELOS,JIUTEPEC,10,167,3,180,1331
MORELOS,JIUTEPEC,11,221,1,233,1727
MORELOS,JIUTEPEC,17,243,8,268,1726
MORELOS,JIUTEPEC,16,154,4,174,986
MORELOS,JIUTEPEC,16,281,7,304,1846
MORELOS,JIUTEPEC,26,231,1,258,1628
MORELOS,JIUTEPEC,19,240,5,264,1628
MORELOS,JIUTEPEC,9,220,3,232,1393
MORELOS,JIUTEPEC,4,219,8,231,1393
MORELOS,JIUTEPEC,8,192,8,208,1393
MORELOS,JIUTEPEC,11,301,3,315,1921
MORELOS,JIUTEPEC,11,308,6,325,1921
MORELOS,JIUTEPEC,7,238,8,253,1643
MORELOS,JIUTEPEC,9,236,3,248,1643
MORELOS,JIUTEPEC,8,202,6,216,1643
MORELOS,JIUTEPEC,7,239,4,250,1643
MORELOS,JIUTEPEC,7,260,3,270,1987
MORELOS,JIUTEPEC,4,259,3,266,1986
MORELOS,JIUTEPEC,12,304,3,319,1609
MORELOS,JIUTEPEC,11,304,1,316,1608
MORELOS,JIUTEPEC,13,181,2,196,1634
MORELOS,JIUTEPEC,0,178,5,183,1633
MORELOS,JIUTEPEC,12,269,2,283,1677
MORELOS,JIUTEPEC,18,274,6,298,1399
MORELOS,JIUTEPEC,13,244,3,260,1399
MORELOS,JIUTEPEC,13,199,3,215,1398
MORELOS,JIUTEPEC,17,258,1,276,1253
MORELOS,JIUTEPEC,15,231,2,248,1252
MORELOS,JIUTEPEC,5,340,3,348,1871
MORELOS,JIUTEPEC,14,288,2,304,1870
MORELOS,JIUTEPEC,8,368,2,378,1870
MORELOS,JIUTEPEC,3,232,4,239,1293
MORELOS,JIUTEPEC,11,280,3,294,1974
MORELOS,JIUTEPEC,12,334,4,350,1973
MORELOS,JIUTEPEC,9,294,1,304,1189
MORELOS,JIUTEPEC,3,287,2,292,1189
MORELOS,JIUTEPEC,3,256,3,262,1182
MORELOS,JIUTEPEC,6,256,1,263,1181
MORELOS,JIUTEPEC,15,157,5,177,1497
MORELOS,JIUTEPEC,10,225,2,237,1497
MORELOS,JIUTEPEC,12,232,4,248,1576
MORELOS,JIUTEPEC,11,259,6,276,1575
MORELOS,JIUTEPEC,22,249,1,272,1409
MORELOS,JIUTEPEC,33,236,5,274,1408
MORELOS,JIUTEPEC,10,220,5,235,1630
MORELOS,JIUTEPEC,26,231,6,263,1629
MORELOS,JIUTEPEC,12,211,3,226,1629
MORELOS,JIUTEPEC,28,368,4,400,1952
MORELOS,JIUTEPEC,23,324,4,351,1951
MORELOS,JIUTEPEC,16,142,3,161,1098
MORELOS,JIUTEPEC,20,151,0,171,1098
MORELOS,CUAUTLA,9,484,7,500,2014
MORELOS,CUAUTLA,4,448,1,453,2077
MORELOS,CUAUTLA,5,375,2,382,2077
MORELOS,CUAUTLA,5,388,2,395,2076
MORELOS,CUAUTLA,6,406,8,420,2076
MORELOS,CUAUTLA,11,439,2,452,1936
MORELOS,CUAUTLA,9,422,4,435,1936
MORELOS,CUAUTLA,15,430,6,451,1936
MORELOS,CUAUTLA,9,438,3,450,1968
MORELOS,CUAUTLA,7,494,6,507,1810
MORELOS,CUAUTLA,11,417,7,435,1810
MORELOS,CUAUTLA,9,309,4,322,1517
MORELOS,CUAUTLA,8,291,8,307,1517
MORELOS,CUAUTLA,3,291,1,295,1138
MORELOS,CUAUTLA,8,329,2,339,1138
MORELOS,CUAUTLA,23,363,7,393,1917
MORELOS,CUAUTLA,9,411,4,424,1751
MORELOS,CUAUTLA,10,421,3,434,1751
MORELOS,CUAUTLA,10,212,2,224,1620
MORELOS,CUAUTLA,16,186,1,203,1620
MORELOS,CUAUTLA,10,377,2,389,1989
MORELOS,CUAUTLA,18,409,2,429,1988
MORELOS,CUAUTLA,24,381,4,409,1988
MORELOS,CUAUTLA,20,382,7,409,2033
MORELOS,CUAUTLA,19,376,6,401,2032
MORELOS,CUAUTLA,9,191,5,205,1445
MORELOS,CUAUTLA,9,189,5,203,1444
MORELOS,CUAUTLA,9,252,4,265,1388
MORELOS,CUAUTLA,11,256,0,267,1880
MORELOS,CUAUTLA,4,244,2,250,1880
MORELOS,CUAUTLA,10,199,3,212,1244
MORELOS,CUAUTLA,16,201,1,218,1243
MORELOS,CUAUTLA,7,389,7,403,2108
MORELOS,CUAUTLA,13,418,1,432,2107
MORELOS,CUAUTLA,3,236,6,245,1590
MORELOS,CUAUTLA,7,385,10,402,2124
MORELOS,CUAUTLA,12,358,3,373,1924
MORELOS,CUAUTLA,12,297,2,311,1706
MORELOS,CUAUTLA,7,263,2,272,1705
MORELOS,CUAUTLA,13,411,9,433,1679
MORELOS,CUAUTLA,10,361,2,373,1263
MORELOS,CUAUTLA,12,436,0,448,1957
MORELOS,CUAUTLA,3,233,0,236,1991
MORELOS,CUAUTLA,3,326,5,334,1991
MORELOS,CUAUTLA,10,553,9,572,1937
MORELOS,CUAUTLA,4,283,4,291,1777
MORELOS,CUAUTLA,8,269,3,280,1777
MORELOS,CUAUTLA,5,221,1,227,1776
MORELOS,CUAUTLA,5,421,5,431,1620
MORELOS,CUAUTLA,9,327,2,338,1668
MORELOS,CUAUTLA,11,344,3,358,1668
MORELOS,CUAUTLA,6,348,5,359,1667
MORELOS,CUAUTLA,14,398,1,413,1829
MORELOS,CUAUTLA,10,376,1,387,1828
MORELOS,CUAUTLA,15,379,4,398,1828
MORELOS,CUAUTLA,8,490,5,503,2026
MORELOS,CUAUTLA,10,378,3,391,2026
MORELOS,CUAUTLA,12,482,7,501,2026
MORELOS,CUAUTLA,17,346,3,366,2028
MORELOS,CUAUTLA,14,352,3,369,2027
MORELOS,CUAUTLA,14,260,1,275,1399
MORELOS,CUAUTLA,7,256,2,265,1399
MORELOS,CUAUTLA,118,1517,7,1642,0
MORELOS,CUAUTLA,12,382,4,398,1810
MORELOS,CUAUTLA,12,355,2,369,1810
MORELOS,CUAUTLA,6,342,6,354,1810
MORELOS,CUAUTLA,19,333,5,357,1810
MORELOS,CUAUTLA,10,329,1,340,1938
MORELOS,CUAUTLA,16,357,3,376,1937
MORELOS,CUAUTLA,11,364,3,378,1937
MORELOS,CUAUTLA,13,329,5,347,2111
MORELOS,CUAUTLA,16,332,2,350,2111
MORELOS,CUAUTLA,15,314,1,330,1866
MORELOS,CUAUTLA,11,335,3,349,1865
MORELOS,CUAUTLA,21,348,2,371,1941
MORELOS,CUAUTLA,19,377,3,399,1941
MORELOS,CUAUTLA,17,370,3,390,1941
MORELOS,CUAUTLA,16,369,1,386,1941
MORELOS,CUAUTLA,15,313,4,332,1902
MORELOS,CUAUTLA,13,368,4,385,1901
MORELOS,CUAUTLA,17,306,0,323,1901
MORELOS,CUAUTLA,16,324,0,340,1796
MORELOS,CUAUTLA,19,312,0,331,1795
MORELOS,CUAUTLA,18,347,0,365,1795
MORELOS,CUAUTLA,14,350,2,366,1870
MORELOS,CUAUTLA,16,310,0,326,1869
MORELOS,CUAUTLA,17,321,2,340,1869
MORELOS,CUAUTLA,28,435,1,464,1997
MORELOS,CUAUTLA,23,384,3,410,1996
MORELOS,CUAUTLA,12,295,7,314,1799
MORELOS,CUAUTLA,13,325,3,341,1799
MORELOS,CUAUTLA,8,289,6,303,1799
MORELOS,CUAUTLA,18,382,5,405,1853
MORELOS,CUAUTLA,8,379,2,389,1853
MORELOS,CUAUTLA,14,356,1,371,1809
MORELOS,CUAUTLA,21,370,2,393,1808
MORELOS,CUAUTLA,13,336,3,352,1808
MORELOS,CUAUTLA,6,388,3,397,2057
MORELOS,CUAUTLA,31,330,4,365,2057
MORELOS,CUAUTLA,21,345,2,368,2057
MORELOS,CUAUTLA,7,241,4,252,1616
MORELOS,CUAUTLA,8,250,4,262,1616
MORELOS,CUAUTLA,14,284,0,298,1837
MORELOS,CUAUTLA,12,295,2,309,1836
MORELOS,CUAUTLA,12,288,2,302,1836
MORELOS,CUAUTLA,16,284,3,303,1806
MORELOS,CUAUTLA,23,311,4,338,1806
MORELOS,CUAUTLA,21,452,1,474,2026
MORELOS,CUAUTLA,10,416,9,435,2025
MORELOS,CUAUTLA,14,409,4,427,2025
MORELOS,CUAUTLA,23,294,3,320,1951
MORELOS,CUAUTLA,22,293,1,316,1951
MORELOS,CUAUTLA,19,378,2,399,1965
MORELOS,CUAUTLA,17,391,0,408,1965
MORELOS,CUAUTLA,26,397,2,425,1964
MORELOS,CUAUTLA,11,337,10,358,2122
MORELOS,CUAUTLA,13,303,2,318,2121
MORELOS,CUAUTLA,12,419,4,435,2000
MORELOS,CUAUTLA,19,373,8,400,2000
MORELOS,CUAUTLA,20,391,2,413,2000
MORELOS,CUAUTLA,19,365,4,388,2095
MORELOS,CUAUTLA,12,336,2,350,2095
MORELOS,CUAUTLA,18,370,3,391,2095
MORELOS,CUAUTLA,13,413,3,429,2135
MORELOS,CUAUTLA,5,361,2,368,2135
MORELOS,CUAUTLA,9,350,0,359,2135
MORELOS,CUAUTLA,10,202,4,216,1316
MORELOS,CUAUTLA,14,229,1,244,1316
MORELOS,CUAUTLA,8,192,4,204,1101
MORELOS,CUAUTLA,13,191,0,204,1101
MORELOS,CUAUTLA,20,597,8,625,2112
MORELOS,CUAUTLA,17,550,3,570,2111
MORELOS,CUAUTLA,7,571,4,582,2111
MORELOS,CUAUTLA,7,354,3,364,1340
MORELOS,CUAUTLA,9,362,2,373,1340
MORELOS,CUAUTLA,22,437,1,460,1824
MORELOS,CUAUTLA,278,6,1,285,1383
MORELOS,CUAUTLA,9,321,3,333,1382
MORELOS,CUAUTLA,8,476,6,490,1957
MORELOS,CUAUTLA,10,471,5,486,1956
MORELOS,CUAUTLA,17,532,7,556,1886
MORELOS,CUAUTLA,18,582,2,602,1886
MORELOS,CUAUTLA,12,354,2,368,1914
MORELOS,CUAUTLA,9,378,2,389,1913
MORELOS,CUAUTLA,12,381,3,396,1913
MORELOS,CUAUTLA,13,327,7,347,1858
MORELOS,CUAUTLA,12,406,4,422,1857
MORELOS,CUAUTLA,13,339,2,354,2058
MORELOS,CUAUTLA,20,368,10,398,2058
MORELOS,CUAUTLA,18,398,7,423,1923
MORELOS,CUAUTLA,9,445,8,462,1923
MORELOS,CUAUTLA,19,362,3,384,1699
MORELOS,CUAUTLA,11,316,2,329,1349
MORELOS,CUAUTLA,12,351,2,365,1940
MORELOS,CUAUTLA,10,340,2,352,1939
MORELOS,CUAUTLA,12,400,4,416,1878
MORELOS,CUAUTLA,14,396,2,412,1878
MORELOS,CUAUTLA,7,184,4,195,1877
MORELOS,CUAUTLA,8,384,9,401,1879
MORELOS,CUAUTLA,17,373,4,394,1878
MORELOS,CUAUTLA,319,5,2,326,1680
MORELOS,CUAUTLA,7,344,5,356,1680
MORELOS,JOJUTLA,3,442,0,445,1883
MORELOS,JOJUTLA,11,406,5,422,1883
MORELOS,JOJUTLA,4,299,3,306,1680
MORELOS,JOJUTLA,6,240,2,248,1679
MORELOS,JOJUTLA,13,285,4,302,1308
MORELOS,JOJUTLA,16,317,2,335,1307
MORELOS,JOJUTLA,14,346,3,363,1821
MORELOS,JOJUTLA,14,348,33,395,1820
MORELOS,JOJUTLA,8,262,8,278,1386
MORELOS,JOJUTLA,2,253,0,255,1386
MORELOS,JOJUTLA,15,279,6,300,1393
MORELOS,JOJUTLA,6,267,4,277,1392
MORELOS,JOJUTLA,2,293,9,304,1429
MORELOS,JOJUTLA,14,277,7,298,1429
MORELOS,JOJUTLA,26,457,3,486,1833
MORELOS,JOJUTLA,18,480,5,503,1833
MORELOS,JOJUTLA,15,410,2,427,1845
MORELOS,JOJUTLA,21,401,8,430,1844
MORELOS,JOJUTLA,20,377,6,403,1887
MORELOS,JOJUTLA,24,419,4,447,1886
MORELOS,JOJUTLA,92,1183,17,1292,0
MORELOS,JOJUTLA,21,352,1,374,1597
MORELOS,JOJUTLA,9,376,4,389,1597
MORELOS,JOJUTLA,11,347,4,362,1750
MORELOS,JOJUTLA,18,331,4,353,1749
MORELOS,JOJUTLA,34,580,6,620,2054
MORELOS,JOJUTLA,12,226,3,241,1358
MORELOS,JOJUTLA,18,272,2,292,1357
MORELOS,JOJUTLA,18,365,11,394,1794
MORELOS,JOJUTLA,23,433,6,462,1793
MORELOS,JOJUTLA,24,430,2,456,1793
MORELOS,JOJUTLA,14,421,3,438,1975
MORELOS,JOJUTLA,16,418,6,440,1975
MORELOS,JOJUTLA,19,432,3,454,1975
MORELOS,JOJUTLA,15,391,9,415,2029
MORELOS,JOJUTLA,4,350,3,357,2029
MORELOS,JOJUTLA,14,330,6,350,2038
MORELOS,JOJUTLA,10,327,7,344,2038
MORELOS,JOJUTLA,17,320,4,341,1567
MORELOS,JOJUTLA,26,332,7,365,1566
MORELOS,JOJUTLA,18,302,3,323,1972
MORELOS,JOJUTLA,11,276,4,291,1972
MORELOS,JOJUTLA,11,457,3,471,1343
MORELOS,JOJUTLA,16,475,3,494,1342
MORELOS,JOJUTLA,14,558,9,581,1712
MORELOS,JOJUTLA,19,536,5,560,1712
MORELOS,JOJUTLA,18,725,9,752,2070
MORELOS,JOJUTLA,17,631,11,659,2122
MORELOS,JOJUTLA,15,577,5,597,2121
MORELOS,JOJUTLA,19,519,8,546,2102
MORELOS,JOJUTLA,11,493,17,521,2101
MORELOS,JOJUTLA,18,575,7,600,1907
MORELOS,JOJUTLA,9,535,4,548,1907
MORELOS,JOJUTLA,7,321,0,328,1445
MORELOS,JOJUTLA,9,341,9,359,1445
MORELOS,JOJUTLA,7,308,4,319,1445
MORELOS,JOJUTLA,10,340,3,353,1777
MORELOS,JOJUTLA,5,343,1,349,1777
MORELOS,JOJUTLA,5,301,4,310,1625
MORELOS,JOJUTLA,7,272,2,281,1624
MORELOS,JOJUTLA,9,258,5,272,1555
MORELOS,JOJUTLA,14,306,4,324,1555
MORELOS,JOJUTLA,13,422,2,437,1760
MORELOS,JOJUTLA,22,384,4,410,1760
MORELOS,JOJUTLA,7,353,4,364,1574
MORELOS,JOJUTLA,9,378,5,392,1574
MORELOS,JOJUTLA,11,330,5,346,1573
MORELOS,JOJUTLA,7,344,1,352,1775
MORELOS,JOJUTLA,14,305,1,320,1774
MORELOS,JOJUTLA,7,323,4,334,1774
MORELOS,JOJUTLA,4,182,2,188,1409
MORELOS,JOJUTLA,4,184,0,188,1408
MORELOS,JOJUTLA,2,459,2,463,2063
MORELOS,JOJUTLA,1,258,1,260,1526
MORELOS,JOJUTLA,2,267,2,271,1526
MORELOS,JOJUTLA,7,282,0,289,1525
MORELOS,JOJUTLA,2,293,3,298,1773
MORELOS,JOJUTLA,6,315,1,322,1773
MORELOS,JOJUTLA,5,309,1,315,1815
MORELOS,JOJUTLA,8,332,1,341,1815
MORELOS,JOJUTLA,3,141,1,145,1150
MORELOS,JOJUTLA,3,175,3,181,1149
MORELOS,JOJUTLA,18,454,1,473,1951
MORELOS,JOJUTLA,6,413,0,419,1950
MORELOS,JOJUTLA,7,179,2,188,1263
MORELOS,JOJUTLA,6,153,2,161,1263
MORELOS,JOJUTLA,17,240,5,262,1506
MORELOS,JOJUTLA,20,238,1,259,1505
MORELOS,JOJUTLA,8,235,2,245,1505
MORELOS,JOJUTLA,21,326,5,352,2006
MORELOS,JOJUTLA,14,302,2,318,2005
MORELOS,JOJUTLA,53,165,5,223,1970
MORELOS,JOJUTLA,14,230,0,244,2083
MORELOS,JOJUTLA,7,235,1,243,2082
MORELOS,JOJUTLA,11,233,5,249,2082
MORELOS,JOJUTLA,17,217,4,238,2082
MORELOS,JOJUTLA,19,302,3,324,1834
MORELOS,JOJUTLA,16,256,4,276,1833
MORELOS,JOJUTLA,12,288,7,307,1716
MORELOS,JOJUTLA,15,313,4,332,1716
MORELOS,JOJUTLA,24,212,2,238,1952
MORELOS,JOJUTLA,11,196,1,208,1951
MORELOS,JOJUTLA,11,294,7,312,1658
MORELOS,JOJUTLA,18,286,4,308,1658
MORELOS,JOJUTLA,13,206,4,223,1691
MORELOS,JOJUTLA,14,208,3,225,1690
MORELOS,JOJUTLA,8,240,1,249,1810
MORELOS,JOJUTLA,16,221,3,240,1809
MORELOS,JOJUTLA,16,274,4,294,1925
MORELOS,JOJUTLA,13,328,7,348,1925
MORELOS,JOJUTLA,14,186,1,201,1526
MORELOS,JOJUTLA,21,237,3,261,1526
MORELOS,JOJUTLA,13,198,2,213,1526
MORELOS,JOJUTLA,12,267,4,283,1647
MORELOS,JOJUTLA,12,238,7,257,1647
MORELOS,JOJUTLA,32,165,3,200,1549
MORELOS,JOJUTLA,17,187,5,209,1549
MORELOS,JOJUTLA,11,286,5,302,1933
MORELOS,JOJUTLA,6,265,1,272,1933
MORELOS,JOJUTLA,26,303,3,332,1737
MORELOS,JOJUTLA,7,308,2,317,1737
MORELOS,JOJUTLA,8,254,4,266,1571
MORELOS,JOJUTLA,12,273,10,295,1570
MORELOS,JOJUTLA,14,250,5,269,1560
MORELOS,JOJUTLA,18,284,4,306,1560
MORELOS,JOJUTLA,5,213,3,221,1154
MORELOS,JOJUTLA,8,209,1,218,1154
MORELOS,JOJUTLA,8,242,4,254,1771
MORELOS,JOJUTLA,9,244,1,254,1770
MORELOS,JOJUTLA,10,257,5,272,1641
MORELOS,JOJUTLA,10,275,1,286,1641
MORELOS,JOJUTLA,5,215,5,225,1394
MORELOS,JOJUTLA,7,235,2,244,1393
MORELOS,JOJUTLA,7,187,2,196,1137
MORELOS,JOJUTLA,10,219,4,233,1136
MORELOS,JOJUTLA,8,195,8,211,1536
MORELOS,JOJUTLA,9,192,7,208,1535
MORELOS,JOJUTLA,10,136,4,150,1460
MORELOS,JOJUTLA,15,130,4,149,1460
MORELOS,JOJUTLA,82,1060,5,1147,1544
MORELOS,JOJUTLA,36,1102,1,1139,1544
MORELOS,JOJUTLA,6,401,5,412,1465
MORELOS,JOJUTLA,19,438,2,459,1465
MORELOS,JOJUTLA,4,337,1,342,1778
MORELOS,JOJUTLA,8,295,6,309,1778
MORELOS,JOJUTLA,6,213,3,222,1453
MORELOS,JOJUTLA,8,244,3,255,1452
MORELOS,JOJUTLA,15,391,3,409,1903
MORELOS,JOJUTLA,11,422,1,434,1903
MORELOS,JOJUTLA,15,472,2,489,1900
MORELOS,JOJUTLA,18,439,9,466,1899
MORELOS,JOJUTLA,7,374,2,383,1926
MORELOS,JOJUTLA,7,394,0,401,1926
MORELOS,JOJUTLA,9,330,6,345,1974
MORELOS,JOJUTLA,2,544,2,548,1732
MORELOS,JOJUTLA,8,488,8,504,1731
MORELOS,JOJUTLA,9,428,3,440,1792
MORELOS,JOJUTLA,7,433,4,444,1791
MORELOS,JOJUTLA,10,370,1,381,1398
MORELOS,JOJUTLA,14,362,4,380,1397
MORELOS,JOJUTLA,13,367,2,382,1506
MORELOS,JOJUTLA,6,352,4,362,1505
MORELOS,JOJUTLA,7,356,6,369,1505
MORELOS,JOJUTLA,9,368,4,381,1630
MORELOS,JOJUTLA,9,376,2,387,1629
MORELOS,JOJUTLA,12,318,1,331,1108
MORELOS,JOJUTLA,13,324,1,338,1107
MORELOS,JOJUTLA,6,322,2,330,1330
MORELOS,JOJUTLA,15,305,3,323,1329
MORELOS,JOJUTLA,11,438,2,451,1943
MORELOS,JOJUTLA,5,455,3,463,1942
MORELOS,JOJUTLA,14,383,3,400,1896
MORELOS,JOJUTLA,1,420,4,425,1896
MORELOS,JOJUTLA,5,307,3,315,1293
MORELOS,JOJUTLA,3,277,3,283,1292
MORELOS,JOJUTLA,8,172,2,182,2155
MORELOS,JOJUTLA,8,154,3,165,2154
MORELOS,YAUTEPEC,7,311,7,325,1553
MORELOS,YAUTEPEC,10,259,2,271,1553
MORELOS,YAUTEPEC,9,254,3,266,1552
MORELOS,YAUTEPEC,2,300,4,306,1552
MORELOS,YAUTEPEC,5,445,1,451,1635
MORELOS,YAUTEPEC,15,418,1,434,1634
MORELOS,YAUTEPEC,17,240,3,260,1243
MORELOS,YAUTEPEC,10,232,4,246,1242
MORELOS,YAUTEPEC,7,201,3,211,1374
MORELOS,YAUTEPEC,8,213,0,221,1374
MORELOS,YAUTEPEC,3,215,2,220,1373
MORELOS,YAUTEPEC,24,72,0,96,1138
MORELOS,YAUTEPEC,21,79,0,100,1138
MORELOS,YAUTEPEC,12,278,5,295,1744
MORELOS,YAUTEPEC,5,260,3,268,1744
MORELOS,YAUTEPEC,7,267,1,275,1743
MORELOS,YAUTEPEC,20,313,6,339,2169
MORELOS,YAUTEPEC,19,240,4,263,1298
MORELOS,YAUTEPEC,16,241,1,258,1298
MORELOS,YAUTEPEC,15,206,5,226,1758
MORELOS,YAUTEPEC,8,216,2,226,1757
MORELOS,YAUTEPEC,25,166,1,192,1254
MORELOS,YAUTEPEC,18,185,1,204,1254
MORELOS,YAUTEPEC,5,411,2,418,1960
MORELOS,YAUTEPEC,11,398,5,414,1959
MORELOS,YAUTEPEC,10,297,3,310,1952
MORELOS,YAUTEPEC,8,352,8,368,1952
MORELOS,YAUTEPEC,14,366,3,383,1944
MORELOS,YAUTEPEC,12,360,2,374,1944
MORELOS,YAUTEPEC,15,401,3,419,2034
MORELOS,YAUTEPEC,29,422,5,456,1964
MORELOS,YAUTEPEC,462,29,7,498,1963
MORELOS,YAUTEPEC,13,454,7,474,1679
MORELOS,YAUTEPEC,12,427,4,443,1679
MORELOS,YAUTEPEC,5,234,1,240,1416
MORELOS,YAUTEPEC,6,279,3,288,1415
MORELOS,YAUTEPEC,7,286,2,295,1415
MORELOS,YAUTEPEC,19,302,8,329,1640
MORELOS,YAUTEPEC,18,357,3,378,1640
MORELOS,YAUTEPEC,12,342,9,363,1640
MORELOS,YAUTEPEC,16,395,10,421,1556
MORELOS,YAUTEPEC,20,427,4,451,1555
MORELOS,YAUTEPEC,27,309,9,345,2022
MORELOS,YAUTEPEC,21,369,2,392,1821
MORELOS,YAUTEPEC,18,358,3,379,1821
MORELOS,YAUTEPEC,12,338,2,352,2153
MORELOS,YAUTEPEC,14,366,0,380,2153
MORELOS,YAUTEPEC,22,342,4,368,2153
MORELOS,YAUTEPEC,11,283,7,301,1612
MORELOS,YAUTEPEC,6,261,1,268,1612
MORELOS,YAUTEPEC,7,240,0,247,1722
MORELOS,YAUTEPEC,13,257,3,273,1722
MORELOS,YAUTEPEC,6,221,2,229,1722
MORELOS,YAUTEPEC,9,228,4,241,1722
MORELOS,YAUTEPEC,4,215,6,225,1866
MORELOS,YAUTEPEC,3,199,5,207,1866
MORELOS,YAUTEPEC,7,257,3,267,1570
MORELOS,YAUTEPEC,3,253,3,259,1570
MORELOS,YAUTEPEC,7,269,2,278,1569
MORELOS,YAUTEPEC,19,377,4,400,2061
MORELOS,YAUTEPEC,21,180,0,201,1641
MORELOS,YAUTEPEC,13,215,2,230,1641
MORELOS,YAUTEPEC,13,215,8,236,1641
MORELOS,YAUTEPEC,17,295,4,316,1914
MORELOS,YAUTEPEC,18,218,3,239,1914
MORELOS,YAUTEPEC,15,231,4,250,1624
MORELOS,YAUTEPEC,19,226,1,246,1623
MORELOS,YAUTEPEC,17,291,5,313,1804
MORELOS,YAUTEPEC,353,16,4,373,1804
MORELOS,YAUTEPEC,14,329,3,346,1803
MORELOS,YAUTEPEC,21,316,2,339,1719
MORELOS,YAUTEPEC,17,333,4,354,1718
MORELOS,YAUTEPEC,13,363,4,380,1595
MORELOS,YAUTEPEC,13,371,2,386,1594
MORELOS,YAUTEPEC,5,359,4,368,1594
MORELOS,YAUTEPEC,16,339,1,356,1489
MORELOS,YAUTEPEC,8,331,6,345,1489
MORELOS,YAUTEPEC,9,170,2,181,1135
MORELOS,YAUTEPEC,3,159,0,162,1134
MORELOS,YAUTEPEC,10,251,6,267,1345
MORELOS,YAUTEPEC,2,258,1,261,1344
MORELOS,YAUTEPEC,5,234,4,243,1344
MORELOS,YAUTEPEC,6,215,2,223,1555
MORELOS,YAUTEPEC,6,192,1,199,1555
MORELOS,YAUTEPEC,8,181,1,190,1555
MORELOS,YAUTEPEC,10,316,9,335,1982
MORELOS,YAUTEPEC,14,304,9,327,1981
MORELOS,YAUTEPEC,11,279,5,295,1742
MORELOS,YAUTEPEC,9,258,10,277,1742
MORELOS,YAUTEPEC,7,276,4,287,1741
MORELOS,YAUTEPEC,9,303,4,316,1815
MORELOS,YAUTEPEC,17,291,1,309,1814
MORELOS,YAUTEPEC,12,243,5,260,1383
MORELOS,YAUTEPEC,11,248,4,263,1382
MORELOS,YAUTEPEC,9,221,4,234,1382
MORELOS,YAUTEPEC,18,388,3,409,1667
MORELOS,YAUTEPEC,20,387,4,411,1667
MORELOS,YAUTEPEC,20,364,3,387,1571
MORELOS,YAUTEPEC,18,364,3,385,1571
MORELOS,YAUTEPEC,18,321,7,346,1773
MORELOS,YAUTEPEC,13,298,3,314,1773
MORELOS,YAUTEPEC,14,273,5,292,1423
MORELOS,YAUTEPEC,11,324,3,338,1422
MORELOS,YAUTEPEC,13,289,6,308,1422
MORELOS,YAUTEPEC,5,159,1,165,1093
MORELOS,YAUTEPEC,6,209,5,220,1093
MORELOS,YAUTEPEC,16,260,1,277,1653
MORELOS,YAUTEPEC,15,259,2,276,1653
MORELOS,YAUTEPEC,13,235,4,252,1652
MORELOS,YAUTEPEC,12,220,3,235,1652
MORELOS,YAUTEPEC,8,223,4,235,1414
MORELOS,YAUTEPEC,14,209,5,228,1413
MORELOS,YAUTEPEC,12,277,8,297,1618
MORELOS,YAUTEPEC,6,260,8,274,1618
MORELOS,YAUTEPEC,13,166,2,181,1465
MORELOS,YAUTEPEC,10,180,1,191,1465
MORELOS,YAUTEPEC,7,185,1,193,1464
MORELOS,YAUTEPEC,7,186,6,199,1761
MORELOS,YAUTEPEC,11,268,1,280,1760
MORELOS,YAUTEPEC,10,284,1,295,1124
MORELOS,YAUTEPEC,4,346,4,354,1123
MORELOS,YAUTEPEC,17,414,1,432,1982
MORELOS,YAUTEPEC,8,271,6,285,1754
MORELOS,YAUTEPEC,17,262,2,281,1754
MORELOS,YAUTEPEC,11,284,4,299,1947
MORELOS,YAUTEPEC,7,283,8,298,1947
MORELOS,YAUTEPEC,21,290,3,314,1932
MORELOS,YAUTEPEC,129,1050,10,1189,0
MORELOS,YAUTEPEC,10,295,3,308,1378
MORELOS,YAUTEPEC,7,286,1,294,1378
MORELOS,YAUTEPEC,10,169,2,181,1350
MORELOS,YAUTEPEC,10,188,2,200,1349
MORELOS,YAUTEPEC,9,253,2,264,1391
MORELOS,YAUTEPEC,11,243,0,254,1390
MORELOS,YAUTEPEC,12,242,2,256,1476
MORELOS,YAUTEPEC,11,242,5,258,1476
MORELOS,YAUTEPEC,10,207,3,220,1179
MORELOS,YAUTEPEC,9,217,0,226,1178
MORELOS,YAUTEPEC,9,249,2,260,1622
MORELOS,YAUTEPEC,2,264,3,269,1621
MORELOS,YAUTEPEC,3,246,2,251,1621
MORELOS,YAUTEPEC,10,313,3,326,1955
MORELOS,YAUTEPEC,11,373,1,385,1955
MORELOS,YAUTEPEC,7,243,3,253,1955
MORELOS,YAUTEPEC,13,216,3,232,1955
MORELOS,YAUTEPEC,10,266,1,277,1378
MORELOS,YAUTEPEC,12,275,1,288,1378
MORELOS,YAUTEPEC,7,273,3,283,1378
MORELOS,YAUTEPEC,11,209,0,220,1465
MORELOS,YAUTEPEC,20,266,0,286,1465
MORELOS,YAUTEPEC,6,241,2,249,1055
MORELOS,YAUTEPEC,5,212,1,218,1054
MORELOS,YAUTEPEC,7,194,1,202,1523
MORELOS,YAUTEPEC,4,192,1,197,1523
MORELOS,YAUTEPEC,11,263,6,280,1676
MORELOS,YAUTEPEC,15,238,3,256,1675
MORELOS,YAUTEPEC,13,281,0,294,1933
MORELOS,YAUTEPEC,7,294,2,303,1654
MORELOS,YAUTEPEC,12,290,0,302,1653
MORELOS,YAUTEPEC,7,193,3,203,1796
MORELOS,YAUTEPEC,5,246,3,254,1795
MORELOS,YAUTEPEC,11,190,0,201,1757
MORELOS,YAUTEPEC,16,413,6,435,1521
MORELOS,YAUTEPEC,11,453,0,464,1521
MORELOS,YAUTEPEC,15,472,11,498,1443
MORELOS,YAUTEPEC,7,520,0,527,1443
MORELOS,YAUTEPEC,3,560,5,568,1443
MORELOS,YAUTEPEC,16,579,12,607,1784
MORELOS,YAUTEPEC,17,611,12,640,1783
MORELOS,YAUTEPEC,16,623,13,652,1783
MORELOS,YAUTEPEC,15,469,1,485,1584
MORELOS,YAUTEPEC,7,399,3,409,1583
MORELOS,YAUTEPEC,5,461,2,468,1448
MORELOS,YAUTEPEC,6,483,6,495,1447
MORELOS,YAUTEPEC,14,291,4,309,1802
MORELOS,YAUTEPEC,17,285,3,305,1802
NAYARIT,SANTIAGO IXCUINTLA,16,301,1,318,1306
NAYARIT,SANTIAGO IXCUINTLA,8,270,6,284,1306
NAYARIT,SANTIAGO IXCUINTLA,10,343,18,371,1305
NAYARIT,SANTIAGO IXCUINTLA,11,439,15,465,1888
NAYARIT,SANTIAGO IXCUINTLA,13,491,13,517,1887
NAYARIT,SANTIAGO IXCUINTLA,16,451,9,476,1874
NAYARIT,SANTIAGO IXCUINTLA,13,472,5,490,1874
NAYARIT,SANTIAGO IXCUINTLA,12,239,1,252,1304
NAYARIT,SANTIAGO IXCUINTLA,8,301,0,309,1304
NAYARIT,SANTIAGO IXCUINTLA,6,306,4,316,1304
NAYARIT,SANTIAGO IXCUINTLA,17,536,10,563,1714
NAYARIT,SANTIAGO IXCUINTLA,7,379,20,406,1305
NAYARIT,SANTIAGO IXCUINTLA,5,345,8,358,1305
NAYARIT,SANTIAGO IXCUINTLA,5,366,17,388,1305
NAYARIT,SANTIAGO IXCUINTLA,9,555,6,570,1813
NAYARIT,SANTIAGO IXCUINTLA,5,590,4,599,1813
NAYARIT,SANTIAGO IXCUINTLA,8,500,11,519,1378
NAYARIT,SANTIAGO IXCUINTLA,7,453,7,467,1377
NAYARIT,SANTIAGO IXCUINTLA,19,513,18,550,1416
NAYARIT,SANTIAGO IXCUINTLA,25,456,7,488,1416
NAYARIT,SANTIAGO IXCUINTLA,19,469,12,500,1416
NAYARIT,SANTIAGO IXCUINTLA,29,654,8,691,1803
NAYARIT,SANTIAGO IXCUINTLA,44,644,18,706,1803
NAYARIT,SANTIAGO IXCUINTLA,13,235,12,260,1535
NAYARIT,SANTIAGO IXCUINTLA,10,159,14,183,1535
NAYARIT,SANTIAGO IXCUINTLA,10,282,22,314,1929
NAYARIT,SANTIAGO IXCUINTLA,17,297,19,333,1928
NAYARIT,SANTIAGO IXCUINTLA,21,120,6,147,1507
NAYARIT,SANTIAGO IXCUINTLA,24,145,174,343,1506
NAYARIT,SANTIAGO IXCUINTLA,22,143,3,168,1838
NAYARIT,SANTIAGO IXCUINTLA,20,179,13,212,1837
NAYARIT,SANTIAGO IXCUINTLA,8,374,13,395,1401
NAYARIT,SANTIAGO IXCUINTLA,14,343,5,362,1401
NAYARIT,SANTIAGO IXCUINTLA,7,255,5,267,1015
NAYARIT,SANTIAGO IXCUINTLA,8,202,3,213,1015
NAYARIT,SANTIAGO IXCUINTLA,17,407,3,427,1754
NAYARIT,SANTIAGO IXCUINTLA,8,291,4,303,1753
NAYARIT,SANTIAGO IXCUINTLA,14,349,8,371,1438
NAYARIT,SANTIAGO IXCUINTLA,8,375,4,387,1438
NAYARIT,SANTIAGO IXCUINTLA,12,312,8,332,1438
NAYARIT,SANTIAGO IXCUINTLA,11,367,7,385,1900
NAYARIT,SANTIAGO IXCUINTLA,11,411,9,431,1899
NAYARIT,SANTIAGO IXCUINTLA,10,357,8,375,1848
NAYARIT,SANTIAGO IXCUINTLA,8,351,11,370,1848
NAYARIT,SANTIAGO IXCUINTLA,14,347,8,369,1801
NAYARIT,SANTIAGO IXCUINTLA,11,338,7,356,1801
NAYARIT,SANTIAGO IXCUINTLA,3,452,3,458,1545
NAYARIT,SANTIAGO IXCUINTLA,12,442,7,461,1544
NAYARIT,SANTIAGO IXCUINTLA,0,423,0,423,1544
NAYARIT,SANTIAGO IXCUINTLA,9,567,13,589,1796
NAYARIT,SANTIAGO IXCUINTLA,5,552,8,565,1796
NAYARIT,SANTIAGO IXCUINTLA,3,546,8,557,1795
NAYARIT,SANTIAGO IXCUINTLA,12,416,9,437,1893
NAYARIT,SANTIAGO IXCUINTLA,9,425,6,440,1892
NAYARIT,SANTIAGO IXCUINTLA,14,420,11,445,1892
NAYARIT,SANTIAGO IXCUINTLA,7,369,17,393,1481
NAYARIT,SANTIAGO IXCUINTLA,7,377,2,386,1481
NAYARIT,SANTIAGO IXCUINTLA,14,402,2,418,1481
NAYARIT,SANTIAGO IXCUINTLA,3,368,13,384,1481
NAYARIT,SANTIAGO IXCUINTLA,9,313,6,328,1367
NAYARIT,SANTIAGO IXCUINTLA,6,327,4,337,1367
NAYARIT,SANTIAGO IXCUINTLA,11,327,1,339,1367
NAYARIT,SANTIAGO IXCUINTLA,20,296,20,336,1334
NAYARIT,SANTIAGO IXCUINTLA,29,344,22,395,1334
NAYARIT,SANTIAGO IXCUINTLA,10,205,7,222,1293
NAYARIT,SANTIAGO IXCUINTLA,11,197,4,212,1292
NAYARIT,SANTIAGO IXCUINTLA,12,214,0,226,1292
NAYARIT,SANTIAGO IXCUINTLA,8,351,2,361,1463
NAYARIT,SANTIAGO IXCUINTLA,16,300,2,318,1462
NAYARIT,SANTIAGO IXCUINTLA,13,279,2,294,1462
NAYARIT,SANTIAGO IXCUINTLA,9,440,10,459,1903
NAYARIT,SANTIAGO IXCUINTLA,5,459,8,472,1902
NAYARIT,SANTIAGO IXCUINTLA,6,322,2,330,1303
NAYARIT,SANTIAGO IXCUINTLA,5,378,3,386,1303
NAYARIT,SANTIAGO IXCUINTLA,8,365,1,374,1303
NAYARIT,SANTIAGO IXCUINTLA,7,289,9,305,1350
NAYARIT,SANTIAGO IXCUINTLA,9,257,1,267,1350
NAYARIT,SANTIAGO IXCUINTLA,2,297,1,300,1286
NAYARIT,SANTIAGO IXCUINTLA,8,293,3,304,1286
NAYARIT,SANTIAGO IXCUINTLA,10,312,8,330,1285
NAYARIT,SANTIAGO IXCUINTLA,10,364,1,375,1871
NAYARIT,SANTIAGO IXCUINTLA,6,357,6,369,1871
NAYARIT,SANTIAGO IXCUINTLA,10,290,6,306,1287
NAYARIT,SANTIAGO IXCUINTLA,8,312,4,324,1286
NAYARIT,SANTIAGO IXCUINTLA,13,304,4,321,1286
NAYARIT,SANTIAGO IXCUINTLA,14,275,2,291,1444
NAYARIT,SANTIAGO IXCUINTLA,11,298,3,312,1444
NAYARIT,SANTIAGO IXCUINTLA,7,290,3,300,1444
NAYARIT,SANTIAGO IXCUINTLA,6,279,5,290,1443
NAYARIT,SANTIAGO IXCUINTLA,6,237,4,247,1884
NAYARIT,SANTIAGO IXCUINTLA,8,255,1,264,1884
NAYARIT,SANTIAGO IXCUINTLA,0,246,28,274,1884
NAYARIT,SANTIAGO IXCUINTLA,12,391,4,407,1598
NAYARIT,SANTIAGO IXCUINTLA,12,363,1,376,1597
NAYARIT,SANTIAGO IXCUINTLA,15,391,5,411,1597
NAYARIT,SANTIAGO IXCUINTLA,47,949,15,1011,0
NAYARIT,SANTIAGO IXCUINTLA,9,243,5,257,1517
NAYARIT,SANTIAGO IXCUINTLA,1,272,2,275,1517
NAYARIT,SANTIAGO IXCUINTLA,2,267,0,269,1517
NAYARIT,SANTIAGO IXCUINTLA,0,448,3,451,1660
NAYARIT,SANTIAGO IXCUINTLA,1,404,5,410,1660
NAYARIT,SANTIAGO IXCUINTLA,3,379,4,386,1659
NAYARIT,SANTIAGO IXCUINTLA,4,431,8,443,1691
NAYARIT,SANTIAGO IXCUINTLA,9,444,8,461,1691
NAYARIT,SANTIAGO IXCUINTLA,7,398,7,412,1690
NAYARIT,SANTIAGO IXCUINTLA,5,269,3,277,1639
NAYARIT,SANTIAGO IXCUINTLA,0,266,4,270,1638
NAYARIT,SANTIAGO IXCUINTLA,6,278,6,290,1638
NAYARIT,SANTIAGO IXCUINTLA,8,464,5,477,1475
NAYARIT,SANTIAGO IXCUINTLA,6,446,10,462,1475
NAYARIT,SANTIAGO IXCUINTLA,9,433,4,446,1475
NAYARIT,SANTIAGO IXCUINTLA,7,482,3,492,1475
NAYARIT,SANTIAGO IXCUINTLA,4,403,2,409,1748
NAYARIT,SANTIAGO IXCUINTLA,7,366,5,378,1747
NAYARIT,SANTIAGO IXCUINTLA,5,386,1,392,1747
NAYARIT,SANTIAGO IXCUINTLA,4,220,12,236,1535
NAYARIT,SANTIAGO IXCUINTLA,4,251,3,258,1535
NAYARIT,SANTIAGO IXCUINTLA,11,365,1,377,1828
NAYARIT,SANTIAGO IXCUINTLA,14,329,5,348,1828
NAYARIT,SANTIAGO IXCUINTLA,2,332,5,339,1827
NAYARIT,SANTIAGO IXCUINTLA,7,340,7,354,1464
NAYARIT,SANTIAGO IXCUINTLA,6,318,3,327,1464
NAYARIT,SANTIAGO IXCUINTLA,8,304,4,316,1464
NAYARIT,SANTIAGO IXCUINTLA,11,324,3,338,1463
NAYARIT,SANTIAGO IXCUINTLA,4,270,4,278,1440
NAYARIT,SANTIAGO IXCUINTLA,5,260,7,272,1440
NAYARIT,SANTIAGO IXCUINTLA,0,264,6,270,1440
NAYARIT,SANTIAGO IXCUINTLA,5,371,6,382,1726
NAYARIT,SANTIAGO IXCUINTLA,4,310,2,316,1726
NAYARIT,SANTIAGO IXCUINTLA,4,331,7,342,1726
NAYARIT,SANTIAGO IXCUINTLA,10,488,1,499,1683
NAYARIT,SANTIAGO IXCUINTLA,6,444,2,452,1682
NAYARIT,SANTIAGO IXCUINTLA,9,439,9,457,1682
NAYARIT,SANTIAGO IXCUINTLA,1,477,11,489,1768
NAYARIT,SANTIAGO IXCUINTLA,5,433,8,446,1768
NAYARIT,SANTIAGO IXCUINTLA,6,362,3,371,1538
NAYARIT,SANTIAGO IXCUINTLA,2,357,3,362,1538
NAYARIT,SANTIAGO IXCUINTLA,2,379,1,382,1538
NAYARIT,SANTIAGO IXCUINTLA,6,419,4,429,1556
NAYARIT,SANTIAGO IXCUINTLA,0,405,0,405,1556
NAYARIT,SANTIAGO IXCUINTLA,5,439,6,450,1556
NAYARIT,SANTIAGO IXCUINTLA,1,403,0,404,1661
NAYARIT,SANTIAGO IXCUINTLA,3,377,2,382,1660
NAYARIT,SANTIAGO IXCUINTLA,0,535,7,542,1891
NAYARIT,SANTIAGO IXCUINTLA,4,602,3,609,1890
NAYARIT,SANTIAGO IXCUINTLA,5,273,9,287,970
NAYARIT,SANTIAGO IXCUINTLA,5,275,2,282,970
NAYARIT,SANTIAGO IXCUINTLA,0,339,2,341,1014
NAYARIT,SANTIAGO IXCUINTLA,7,332,1,340,1013
NAYARIT,SANTIAGO IXCUINTLA,5,456,5,466,1413
NAYARIT,SANTIAGO IXCUINTLA,2,417,4,423,1412
NAYARIT,SANTIAGO IXCUINTLA,1,480,3,484,1412
NAYARIT,SANTIAGO IXCUINTLA,11,478,2,491,1212
NAYARIT,SANTIAGO IXCUINTLA,11,409,7,427,1212
NAYARIT,SANTIAGO IXCUINTLA,1,578,3,582,1477
NAYARIT,SANTIAGO IXCUINTLA,0,540,3,543,1477
NAYARIT,SANTIAGO IXCUINTLA,4,514,5,523,1477
NAYARIT,SANTIAGO IXCUINTLA,4,556,3,563,1476
NAYARIT,SANTIAGO IXCUINTLA,13,541,4,558,1464
NAYARIT,SANTIAGO IXCUINTLA,11,500,7,518,1463
NAYARIT,SANTIAGO IXCUINTLA,10,517,3,530,1463
NAYARIT,SANTIAGO IXCUINTLA,5,371,6,382,1424
NAYARIT,SANTIAGO IXCUINTLA,6,364,4,374,1424
NAYARIT,SANTIAGO IXCUINTLA,5,532,4,541,1827
NAYARIT,SANTIAGO IXCUINTLA,4,567,4,575,1827
NAYARIT,SANTIAGO IXCUINTLA,66,380,29,475,1736
NAYARIT,SANTIAGO IXCUINTLA,47,317,20,384,1736
NAYARIT,SANTIAGO IXCUINTLA,50,374,22,446,1736
NAYARIT,TEPIC,12,273,3,288,1735
NAYARIT,TEPIC,18,281,5,304,1735
NAYARIT,TEPIC,12,284,1,297,1735
NAYARIT,TEPIC,20,334,5,359,1928
NAYARIT,TEPIC,22,320,8,350,1928
NAYARIT,TEPIC,11,228,2,241,1406
NAYARIT,TEPIC,9,206,3,218,1406
NAYARIT,TEPIC,7,193,2,202,1640
NAYARIT,TEPIC,6,231,2,239,1639
NAYARIT,TEPIC,9,204,0,213,1639
NAYARIT,TEPIC,18,271,1,290,1790
NAYARIT,TEPIC,20,265,2,287,1789
NAYARIT,TEPIC,26,290,2,318,1789
NAYARIT,TEPIC,18,307,3,328,1652
NAYARIT,TEPIC,29,321,3,353,1651
NAYARIT,TEPIC,13,405,1,419,1788
NAYARIT,TEPIC,10,378,6,394,1788
NAYARIT,TEPIC,18,270,3,291,1618
NAYARIT,TEPIC,12,265,5,282,1617
NAYARIT,TEPIC,7,290,4,301,1617
NAYARIT,TEPIC,18,293,2,313,1769
NAYARIT,TEPIC,16,332,3,351,1769
NAYARIT,TEPIC,20,309,8,337,1768
NAYARIT,TEPIC,15,344,5,364,1945
NAYARIT,TEPIC,10,337,7,354,1944
NAYARIT,TEPIC,18,329,1,348,1758
NAYARIT,TEPIC,20,322,2,344,1758
NAYARIT,TEPIC,10,217,2,229,1428
NAYARIT,TEPIC,8,212,2,222,1428
NAYARIT,TEPIC,10,220,0,230,1428
NAYARIT,TEPIC,18,310,1,329,1585
NAYARIT,TEPIC,24,303,5,332,1585
NAYARIT,TEPIC,24,278,4,306,1584
NAYARIT,TEPIC,20,306,0,326,1474
NAYARIT,TEPIC,28,325,0,353,1473
NAYARIT,TEPIC,16,235,2,253,1210
NAYARIT,TEPIC,22,238,1,261,1210
NAYARIT,TEPIC,28,270,2,300,1940
NAYARIT,TEPIC,21,296,4,321,1940
NAYARIT,TEPIC,26,294,1,321,1517
NAYARIT,TEPIC,22,301,15,338,1516
NAYARIT,TEPIC,27,284,4,315,1516
NAYARIT,TEPIC,45,262,1,308,1758
NAYARIT,TEPIC,42,258,0,300,1758
NAYARIT,TEPIC,32,222,0,254,1555
NAYARIT,TEPIC,43,245,1,289,1555
NAYARIT,TEPIC,26,317,2,345,1789
NAYARIT,TEPIC,30,293,2,325,1788
NAYARIT,TEPIC,29,276,1,306,1518
NAYARIT,TEPIC,25,295,4,324,1517
NAYARIT,TEPIC,14,263,0,277,1517
NAYARIT,TEPIC,14,279,0,293,1586
NAYARIT,TEPIC,11,321,7,339,1586
NAYARIT,TEPIC,17,246,4,267,1515
NAYARIT,TEPIC,15,258,2,275,1514
NAYARIT,TEPIC,15,278,2,295,1471
NAYARIT,TEPIC,8,267,3,278,1471
NAYARIT,TEPIC,19,195,1,215,1480
NAYARIT,TEPIC,11,238,3,252,1479
NAYARIT,TEPIC,24,217,1,242,1143
NAYARIT,TEPIC,28,199,1,228,1142
NAYARIT,TEPIC,8,235,7,250,1664
NAYARIT,TEPIC,13,230,2,245,1663
NAYARIT,TEPIC,11,211,2,224,1663
NAYARIT,TEPIC,13,328,3,344,1973
NAYARIT,TEPIC,12,318,4,334,1973
NAYARIT,TEPIC,90,1754,9,1853,0
NAYARIT,TEPIC,19,192,5,216,1114
NAYARIT,TEPIC,24,183,2,209,1113
NAYARIT,TEPIC,26,302,2,330,1636
NAYARIT,TEPIC,14,324,1,339,1635
NAYARIT,TEPIC,26,249,3,278,1759
NAYARIT,TEPIC,41,264,2,307,1758
NAYARIT,TEPIC,15,222,1,238,1357
NAYARIT,TEPIC,21,216,3,240,1356
NAYARIT,TEPIC,17,224,5,246,1356
NAYARIT,TEPIC,24,344,8,376,1857
NAYARIT,TEPIC,21,374,2,397,1856
NAYARIT,TEPIC,24,343,7,374,1853
NAYARIT,TEPIC,24,315,0,339,1853
NAYARIT,TEPIC,22,297,3,322,1708
NAYARIT,TEPIC,13,310,3,326,1708
NAYARIT,TEPIC,27,206,0,233,1546
NAYARIT,TEPIC,34,234,3,271,1546
NAYARIT,TEPIC,28,220,1,249,1546
NAYARIT,TEPIC,11,228,4,243,1314
NAYARIT,TEPIC,16,245,2,263,1314
NAYARIT,TEPIC,284,19,5,308,1494
NAYARIT,TEPIC,17,303,1,321,1493
NAYARIT,TEPIC,25,232,2,259,1406
NAYARIT,TEPIC,20,247,2,269,1406
NAYARIT,TEPIC,10,247,4,261,1405
NAYARIT,TEPIC,12,326,6,344,1751
NAYARIT,TEPIC,12,343,7,362,1750
NAYARIT,TEPIC,11,290,4,305,1750
NAYARIT,TEPIC,23,178,0,201,1069
NAYARIT,TEPIC,19,190,3,212,1069
NAYARIT,TEPIC,12,260,4,276,1833
NAYARIT,TEPIC,28,295,6,329,1833
NAYARIT,TEPIC,26,260,4,290,1832
NAYARIT,TEPIC,23,250,3,276,1905
NAYARIT,TEPIC,10,281,5,296,1904
NAYARIT,TEPIC,18,250,4,272,1482
NAYARIT,TEPIC,16,277,4,297,1482
NAYARIT,TEPIC,12,250,1,263,1482
NAYARIT,TEPIC,21,349,1,371,1964
NAYARIT,TEPIC,17,349,4,370,1963
NAYARIT,TEPIC,6,263,2,271,1727
NAYARIT,TEPIC,8,257,5,270,1727
NAYARIT,TEPIC,17,283,2,302,1361
NAYARIT,TEPIC,17,300,4,321,1360
NAYARIT,TEPIC,10,301,11,322,1633
NAYARIT,TEPIC,7,337,8,352,1633
NAYARIT,TEPIC,8,371,7,386,1540
NAYARIT,TEPIC,11,368,5,384,1540
NAYARIT,TEPIC,5,374,2,381,1539
NAYARIT,TEPIC,6,321,6,333,1539
NAYARIT,TEPIC,6,211,1,218,1322
NAYARIT,TEPIC,10,212,7,229,1321
NAYARIT,TEPIC,9,345,12,366,1391
NAYARIT,TEPIC,9,328,3,340,1391
NAYARIT,TEPIC,6,220,2,228,1834
NAYARIT,TEPIC,1,213,4,218,1834
NAYARIT,TEPIC,11,337,7,355,1805
NAYARIT,TEPIC,8,231,2,241,1900
NAYARIT,TEPIC,7,216,4,227,1899
NAYARIT,TEPIC,7,197,1,205,1899
NAYARIT,TEPIC,2,195,4,201,1899
NAYARIT,TEPIC,6,178,1,185,1899
NAYARIT,TEPIC,8,216,1,225,1899
NAYARIT,TEPIC,11,218,7,236,1899
NAYARIT,TEPIC,6,233,14,253,1290
NAYARIT,TEPIC,6,204,4,214,1290
NAYARIT,TEPIC,10,191,2,203,1289
NAYARIT,TEPIC,7,213,3,223,1328
NAYARIT,TEPIC,5,166,2,173,1327
NAYARIT,TEPIC,7,216,2,225,1327
NAYARIT,TEPIC,6,172,3,181,1035
NAYARIT,TEPIC,7,146,5,158,1034
NAYARIT,TEPIC,10,219,7,236,1513
NAYARIT,TEPIC,3,227,6,236,1512
NAYARIT,TEPIC,12,331,5,348,1673
NAYARIT,TEPIC,11,313,7,331,1673
NAYARIT,TEPIC,12,196,4,212,1386
NAYARIT,TEPIC,12,191,0,203,1386
NAYARIT,TEPIC,10,200,2,212,1386
NAYARIT,TEPIC,14,204,4,222,1304
NAYARIT,TEPIC,9,235,3,247,1303
NAYARIT,TEPIC,10,268,5,283,1960
NAYARIT,TEPIC,14,300,3,317,1960
NAYARIT,TEPIC,13,284,1,298,1760
NAYARIT,TEPIC,17,274,2,293,1760
NAYARIT,TEPIC,16,234,1,251,1357
NAYARIT,TEPIC,21,216,2,239,1357
NAYARIT,TEPIC,21,226,0,247,1356
NAYARIT,TEPIC,4,185,3,192,1322
NAYARIT,TEPIC,10,190,0,200,1322
NAYARIT,TEPIC,12,202,0,214,1322
NAYARIT,TEPIC,8,159,0,167,1472
NAYARIT,TEPIC,12,163,0,175,1472
NAYARIT,TEPIC,9,182,3,194,1471
NAYARIT,TEPIC,12,284,4,300,1634
NAYARIT,TEPIC,16,293,2,311,1634
NAYARIT,TEPIC,14,254,6,274,1406
NAYARIT,TEPIC,14,221,2,237,1406
NAYARIT,TEPIC,22,173,1,196,1146
NAYARIT,TEPIC,16,171,1,188,1146
NAYARIT,TEPIC,24,357,0,381,1539
NAYARIT,TEPIC,24,284,0,308,1538
NAYARIT,TEPIC,25,263,4,292,1659
NAYARIT,TEPIC,22,305,1,328,1659
NAYARIT,TEPIC,13,280,2,295,1773
NAYARIT,TEPIC,11,334,1,346,1773
NAYARIT,TEPIC,12,285,1,298,1773
NAYARIT,TEPIC,11,281,5,297,1773
NAYARIT,TEPIC,27,307,0,334,1848
NAYARIT,TEPIC,24,281,2,307,1847
NAYARIT,TEPIC,40,268,0,308,1660
NAYARIT,TEPIC,38,241,2,281,1660
NAYARIT,TEPIC,30,264,3,297,1659
NAYARIT,TEPIC,11,209,0,220,1332
NAYARIT,TEPIC,13,232,1,246,1331
NAYARIT,TEPIC,20,298,1,319,1858
NAYARIT,TEPIC,20,262,1,283,1858
NAYARIT,TEPIC,20,284,0,304,1858
NAYARIT,TEPIC,7,199,0,206,1482
NAYARIT,TEPIC,8,194,0,202,1481
NAYARIT,TEPIC,6,192,2,200,1481
NAYARIT,TEPIC,197,17,2,216,1524
NAYARIT,TEPIC,11,210,3,224,1524
NAYARIT,TEPIC,5,202,1,208,1524
NAYARIT,TEPIC,7,183,2,192,1548
NAYARIT,TEPIC,4,163,0,167,1547
NAYARIT,TEPIC,5,182,1,188,1547
NAYARIT,TEPIC,17,267,4,288,1527
NAYARIT,TEPIC,13,267,3,283,1527
NAYARIT,TEPIC,16,218,2,236,1526
NAYARIT,TEPIC,19,183,2,204,1446
NAYARIT,TEPIC,15,190,0,205,1445
NAYARIT,TEPIC,23,192,0,215,1445
NAYARIT,COMPOSTELA,11,446,9,466,1771
NAYARIT,COMPOSTELA,15,392,9,416,1770
NAYARIT,COMPOSTELA,21,408,11,440,1833
NAYARIT,COMPOSTELA,21,418,10,449,1833
NAYARIT,COMPOSTELA,8,338,6,352,1117
NAYARIT,COMPOSTELA,6,325,7,338,1116
NAYARIT,COMPOSTELA,8,340,2,350,1447
NAYARIT,COMPOSTELA,13,335,4,352,1446
NAYARIT,COMPOSTELA,20,380,8,408,1935
NAYARIT,COMPOSTELA,30,432,14,476,1935
NAYARIT,COMPOSTELA,9,262,11,282,1261
NAYARIT,COMPOSTELA,12,232,6,250,1261
NAYARIT,COMPOSTELA,10,296,3,309,1400
NAYARIT,COMPOSTELA,19,309,4,332,1399
NAYARIT,COMPOSTELA,10,271,8,289,1438
NAYARIT,COMPOSTELA,8,214,2,224,1438
NAYARIT,COMPOSTELA,9,255,7,271,1438
NAYARIT,COMPOSTELA,7,305,6,318,1371
NAYARIT,COMPOSTELA,1,287,3,291,1370
NAYARIT,COMPOSTELA,13,137,1,151,1424
NAYARIT,COMPOSTELA,4,146,2,152,1424
NAYARIT,COMPOSTELA,15,165,0,180,1424
NAYARIT,COMPOSTELA,9,302,5,316,2054
NAYARIT,COMPOSTELA,9,297,4,310,2053
NAYARIT,COMPOSTELA,15,244,3,262,1490
NAYARIT,COMPOSTELA,10,285,3,298,1490
NAYARIT,COMPOSTELA,11,238,4,253,1489
NAYARIT,COMPOSTELA,10,304,4,318,1548
NAYARIT,COMPOSTELA,17,287,2,306,1548
NAYARIT,COMPOSTELA,16,365,7,388,1866
NAYARIT,COMPOSTELA,10,360,4,374,1865
NAYARIT,COMPOSTELA,7,205,3,215,1797
NAYARIT,COMPOSTELA,6,225,1,232,1796
NAYARIT,COMPOSTELA,8,231,1,240,1796
NAYARIT,COMPOSTELA,11,260,2,273,1926
NAYARIT,COMPOSTELA,4,245,2,251,1926
NAYARIT,COMPOSTELA,11,245,1,257,1926
NAYARIT,COMPOSTELA,75,994,4,1073,0
NAYARIT,COMPOSTELA,13,178,0,191,1676
NAYARIT,COMPOSTELA,8,180,0,188,1676
NAYARIT,COMPOSTELA,3,164,0,167,1676
NAYARIT,COMPOSTELA,6,196,2,204,1980
NAYARIT,COMPOSTELA,1,168,10,179,1980
NAYARIT,COMPOSTELA,4,179,0,183,1979
NAYARIT,COMPOSTELA,10,208,3,221,1979
NAYARIT,COMPOSTELA,8,222,4,234,1979
NAYARIT,COMPOSTELA,5,181,1,187,1979
NAYARIT,COMPOSTELA,7,171,2,180,1854
NAYARIT,COMPOSTELA,4,186,1,191,1854
NAYARIT,COMPOSTELA,9,185,1,195,1854
NAYARIT,COMPOSTELA,1,171,1,173,1853
NAYARIT,COMPOSTELA,3,212,0,215,1541
NAYARIT,COMPOSTELA,9,211,2,222,1540
NAYARIT,COMPOSTELA,15,171,0,186,1943
NAYARIT,COMPOSTELA,6,195,1,202,1943
NAYARIT,COMPOSTELA,4,205,4,213,1942
NAYARIT,COMPOSTELA,3,169,5,177,1942
NAYARIT,COMPOSTELA,9,187,1,197,1942
NAYARIT,COMPOSTELA,7,169,1,177,1942
NAYARIT,COMPOSTELA,9,187,4,200,1942
NAYARIT,COMPOSTELA,9,187,1,197,1942
NAYARIT,COMPOSTELA,4,163,4,171,1942
NAYARIT,COMPOSTELA,18,233,1,252,2063
NAYARIT,COMPOSTELA,9,242,3,254,2063
NAYARIT,COMPOSTELA,3,192,4,199,1419
NAYARIT,COMPOSTELA,4,180,2,186,1419
NAYARIT,COMPOSTELA,6,168,3,177,1419
NAYARIT,COMPOSTELA,15,171,4,190,1556
NAYARIT,COMPOSTELA,11,157,1,169,1556
NAYARIT,COMPOSTELA,5,169,2,176,1556
NAYARIT,COMPOSTELA,12,389,14,415,1914
NAYARIT,COMPOSTELA,9,365,10,384,1913
NAYARIT,COMPOSTELA,18,290,2,310,1420
NAYARIT,COMPOSTELA,18,291,5,314,1420
NAYARIT,COMPOSTELA,25,281,12,318,1419
NAYARIT,COMPOSTELA,11,297,3,311,1579
NAYARIT,COMPOSTELA,14,285,4,303,1578
NAYARIT,COMPOSTELA,13,299,4,316,1578
NAYARIT,COMPOSTELA,13,309,7,329,1598
NAYARIT,COMPOSTELA,13,336,1,350,1598
NAYARIT,COMPOSTELA,30,304,1,335,1597
NAYARIT,COMPOSTELA,4,320,1,325,1359
NAYARIT,COMPOSTELA,3,313,2,318,1358
NAYARIT,COMPOSTELA,6,496,7,509,2004
NAYARIT,COMPOSTELA,12,537,11,560,2004
NAYARIT,COMPOSTELA,5,342,5,352,1976
NAYARIT,COMPOSTELA,4,348,5,357,1975
NAYARIT,COMPOSTELA,4,308,1,313,1392
NAYARIT,COMPOSTELA,2,288,5,295,1392
NAYARIT,COMPOSTELA,8,301,3,312,1391
NAYARIT,COMPOSTELA,9,396,7,412,1985
NAYARIT,COMPOSTELA,5,382,5,392,1985
NAYARIT,COMPOSTELA,4,338,8,350,1497
NAYARIT,COMPOSTELA,7,337,5,349,1497
NAYARIT,COMPOSTELA,3,318,3,324,1496
NAYARIT,COMPOSTELA,3,281,2,286,1719
NAYARIT,COMPOSTELA,3,277,5,285,1718
NAYARIT,COMPOSTELA,3,212,4,219,1487
NAYARIT,COMPOSTELA,1,243,2,246,1487
NAYARIT,COMPOSTELA,4,305,2,311,1487
NAYARIT,COMPOSTELA,10,266,5,281,1831
NAYARIT,COMPOSTELA,9,292,4,305,1830
NAYARIT,COMPOSTELA,11,244,4,259,1931
NAYARIT,COMPOSTELA,8,286,3,297,1930
NAYARIT,COMPOSTELA,6,210,2,218,1200
NAYARIT,COMPOSTELA,3,224,1,228,1199
NAYARIT,COMPOSTELA,13,215,5,233,1537
NAYARIT,COMPOSTELA,10,255,5,270,1536
NAYARIT,COMPOSTELA,9,295,4,308,2066
NAYARIT,COMPOSTELA,9,306,1,316,2065
NAYARIT,COMPOSTELA,15,238,1,254,1619
NAYARIT,COMPOSTELA,5,232,3,240,1619
NAYARIT,COMPOSTELA,13,195,2,210,1619
NAYARIT,COMPOSTELA,22,291,3,316,1746
NAYARIT,COMPOSTELA,18,310,5,333,1746
NAYARIT,COMPOSTELA,4,187,3,194,1374
NAYARIT,COMPOSTELA,5,198,2,205,1374
NAYARIT,COMPOSTELA,3,191,0,194,1373
NAYARIT,COMPOSTELA,1,63,3,67,1277
NAYARIT,COMPOSTELA,3,63,0,66,1276
NAYARIT,COMPOSTELA,28,443,18,489,1611
NAYARIT,COMPOSTELA,18,495,12,525,1611
NAYARIT,COMPOSTELA,9,501,11,521,1610
NAYARIT,COMPOSTELA,19,349,6,374,1438
NAYARIT,COMPOSTELA,26,325,12,363,1438
NAYARIT,COMPOSTELA,19,412,21,452,1367
NAYARIT,COMPOSTELA,13,363,13,389,1367
NAYARIT,COMPOSTELA,14,518,7,539,1526
NAYARIT,COMPOSTELA,14,552,13,579,1525
NAYARIT,COMPOSTELA,21,393,9,423,1351
NAYARIT,COMPOSTELA,32,379,5,416,1351
NAYARIT,COMPOSTELA,28,336,5,369,1351
NAYARIT,COMPOSTELA,7,280,1,288,1183
NAYARIT,COMPOSTELA,5,310,6,321,1183
NAYARIT,COMPOSTELA,16,221,11,248,1488
NAYARIT,COMPOSTELA,17,232,10,259,1487
NAYARIT,COMPOSTELA,11,334,10,355,1884
NAYARIT,COMPOSTELA,14,362,8,384,1884
NAYARIT,COMPOSTELA,2,235,5,242,1474
NAYARIT,COMPOSTELA,6,261,11,278,1474
NAYARIT,COMPOSTELA,11,260,5,276,1473
NAYARIT,COMPOSTELA,15,283,5,303,1703
NAYARIT,COMPOSTELA,11,314,9,334,1703
NAYARIT,COMPOSTELA,8,309,1,318,1382
NAYARIT,COMPOSTELA,9,326,7,342,1381
NAYARIT,COMPOSTELA,8,340,1,349,1381
NAYARIT,COMPOSTELA,27,321,2,350,1863
NAYARIT,COMPOSTELA,27,276,1,304,1863
NAYARIT,COMPOSTELA,21,322,2,345,1862
NAYARIT,COMPOSTELA,27,286,6,319,1467
NAYARIT,COMPOSTELA,21,290,3,314,1467
NAYARIT,COMPOSTELA,20,264,1,285,1467
NAYARIT,COMPOSTELA,15,291,1,307,1785
NAYARIT,COMPOSTELA,17,221,5,243,1784
NAYARIT,COMPOSTELA,13,259,2,274,1784
NAYARIT,COMPOSTELA,8,257,0,265,1784
NAYARIT,COMPOSTELA,5,257,3,265,1784
NAYARIT,COMPOSTELA,14,305,3,322,1638
NAYARIT,COMPOSTELA,16,292,2,310,1637
NAYARIT,COMPOSTELA,18,294,5,317,1637
NAYARIT,COMPOSTELA,12,348,4,364,1888
NAYARIT,COMPOSTELA,9,347,4,360,1887
NAYARIT,COMPOSTELA,15,300,6,321,1887
NAYARIT,COMPOSTELA,20,398,11,429,1982
NAYARIT,COMPOSTELA,14,434,4,452,1982
NAYARIT,COMPOSTELA,19,372,4,395,1658
NAYARIT,COMPOSTELA,12,330,3,345,1658
NAYARIT,COMPOSTELA,4,407,4,415,1416
NAYARIT,COMPOSTELA,10,374,12,396,1415
NAYARIT,COMPOSTELA,12,321,5,338,1599
NAYARIT,COMPOSTELA,8,316,7,331,1598
NAYARIT,COMPOSTELA,6,204,2,212,1182
NAYARIT,COMPOSTELA,15,212,1,228,1182
NAYARIT,COMPOSTELA,36,362,10,408,1411
NAYARIT,COMPOSTELA,17,286,4,307,1410
NAYARIT,COMPOSTELA,24,271,2,297,1243
NAYARIT,COMPOSTELA,14,267,5,286,1243
NAYARIT,COMPOSTELA,10,194,1,205,1801
NAYARIT,COMPOSTELA,11,197,0,208,1801
NAYARIT,COMPOSTELA,6,226,2,234,1820
NAYARIT,COMPOSTELA,12,238,4,254,1819
NAYARIT,COMPOSTELA,5,246,2,253,1819
NAYARIT,COMPOSTELA,12,265,3,280,2075
NAYARIT,COMPOSTELA,17,264,2,283,2074
NAYARIT,COMPOSTELA,20,180,1,201,1686
NAYARIT,COMPOSTELA,11,188,0,199,1685
NAYARIT,COMPOSTELA,13,193,2,208,1560
NAYARIT,COMPOSTELA,19,171,0,190,1559
NAYARIT,COMPOSTELA,14,178,0,192,1833
NAYARIT,COMPOSTELA,16,160,0,176,1833
NAYARIT,COMPOSTELA,19,154,2,175,1833
NUEVO LEÓN,SANTA CATARINA,18,141,7,166,1694
NUEVO LEÓN,SANTA CATARINA,15,138,2,155,1693
NUEVO LEÓN,SANTA CATARINA,18,124,4,146,1469
NUEVO LEÓN,SANTA CATARINA,8,123,2,133,1469
NUEVO LEÓN,SANTA CATARINA,23,177,6,206,1697
NUEVO LEÓN,SANTA CATARINA,21,162,2,185,1697
NUEVO LEÓN,SANTA CATARINA,26,155,0,181,1853
NUEVO LEÓN,SANTA CATARINA,21,175,4,200,1852
NUEVO LEÓN,SANTA CATARINA,18,127,0,145,1763
NUEVO LEÓN,SANTA CATARINA,16,115,1,132,1763
NUEVO LEÓN,SANTA CATARINA,31,180,3,214,1588
NUEVO LEÓN,SANTA CATARINA,1,174,2,177,1587
NUEVO LEÓN,SANTA CATARINA,20,210,10,240,1897
NUEVO LEÓN,SANTA CATARINA,16,191,2,209,1896
NUEVO LEÓN,SANTA CATARINA,23,104,0,127,1591
NUEVO LEÓN,SANTA CATARINA,27,63,1,91,1590
NUEVO LEÓN,SANTA CATARINA,22,85,2,109,1590
NUEVO LEÓN,SANTA CATARINA,33,61,0,94,1035
NUEVO LEÓN,SANTA CATARINA,38,56,1,95,1035
NUEVO LEÓN,SANTA CATARINA,60,118,1,179,1721
NUEVO LEÓN,SANTA CATARINA,49,165,0,214,1721
NUEVO LEÓN,SANTA CATARINA,83,113,1,197,1804
NUEVO LEÓN,SANTA CATARINA,70,106,0,176,1804
NUEVO LEÓN,SANTA CATARINA,53,46,0,99,1358
NUEVO LEÓN,SANTA CATARINA,41,33,1,75,1358
NUEVO LEÓN,SANTA CATARINA,46,36,0,82,1357
NUEVO LEÓN,SANTA CATARINA,168,46,4,218,1897
NUEVO LEÓN,SANTA CATARINA,158,45,1,204,1896
NUEVO LEÓN,SANTA CATARINA,160,34,0,194,1476
NUEVO LEÓN,SANTA CATARINA,152,34,2,188,1476
NUEVO LEÓN,SANTA CATARINA,160,22,2,184,1475
NUEVO LEÓN,SANTA CATARINA,123,31,2,156,1536
NUEVO LEÓN,SANTA CATARINA,164,28,4,196,1536
NUEVO LEÓN,SANTA CATARINA,146,29,2,177,1536
NUEVO LEÓN,SANTA CATARINA,57,75,1,133,1724
NUEVO LEÓN,SANTA CATARINA,75,74,3,152,1724
NUEVO LEÓN,SANTA CATARINA,160,20,0,180,1688
NUEVO LEÓN,SANTA CATARINA,136,25,0,161,1687
NUEVO LEÓN,SANTA CATARINA,148,18,1,167,1687
NUEVO LEÓN,SANTA CATARINA,152,28,1,181,1660
NUEVO LEÓN,SANTA CATARINA,122,22,0,144,1660
NUEVO LEÓN,SANTA CATARINA,128,22,0,150,1659
NUEVO LEÓN,SANTA CATARINA,173,37,0,210,1812
NUEVO LEÓN,SANTA CATARINA,178,30,0,208,1812
NUEVO LEÓN,SANTA CATARINA,180,24,0,204,1744
NUEVO LEÓN,SANTA CATARINA,196,25,1,222,1744
NUEVO LEÓN,SANTA CATARINA,170,35,1,206,1825
NUEVO LEÓN,SANTA CATARINA,160,16,0,176,1824
NUEVO LEÓN,SANTA CATARINA,69,66,1,136,1387
NUEVO LEÓN,SANTA CATARINA,71,68,2,141,1387
NUEVO LEÓN,SANTA CATARINA,77,78,2,157,1386
NUEVO LEÓN,SANTA CATARINA,122,21,0,143,1351
NUEVO LEÓN,SANTA CATARINA,97,24,1,122,1350
NUEVO LEÓN,SANTA CATARINA,149,36,3,188,1812
NUEVO LEÓN,SANTA CATARINA,142,28,1,171,1812
NUEVO LEÓN,SANTA CATARINA,216,36,0,252,1919
NUEVO LEÓN,SANTA CATARINA,187,28,0,215,1918
NUEVO LEÓN,SANTA CATARINA,206,23,0,229,1830
NUEVO LEÓN,SANTA CATARINA,163,29,2,194,1829
NUEVO LEÓN,SANTA CATARINA,91,18,0,109,1382
NUEVO LEÓN,SANTA CATARINA,97,15,1,113,1381
NUEVO LEÓN,SANTA CATARINA,114,23,0,137,1381
NUEVO LEÓN,SANTA CATARINA,124,31,1,156,1590
NUEVO LEÓN,SANTA CATARINA,123,43,0,166,1589
NUEVO LEÓN,SANTA CATARINA,166,23,0,189,1390
NUEVO LEÓN,SANTA CATARINA,183,19,1,203,1390
NUEVO LEÓN,SANTA CATARINA,156,17,1,174,1390
NUEVO LEÓN,SANTA CATARINA,22,149,1,172,1923
NUEVO LEÓN,SANTA CATARINA,23,172,0,195,1923
NUEVO LEÓN,SANTA CATARINA,8,129,0,137,1922
NUEVO LEÓN,SANTA CATARINA,16,120,1,137,1670
NUEVO LEÓN,SANTA CATARINA,14,107,2,123,1670
NUEVO LEÓN,SANTA CATARINA,12,126,0,138,1670
NUEVO LEÓN,SANTA CATARINA,15,118,1,134,1669
NUEVO LEÓN,SANTA CATARINA,38,110,0,148,1788
NUEVO LEÓN,SANTA CATARINA,33,129,0,162,1788
NUEVO LEÓN,SANTA CATARINA,26,114,0,140,1788
NUEVO LEÓN,SANTA CATARINA,26,114,0,140,1788
NUEVO LEÓN,SANTA CATARINA,41,106,1,148,1787
NUEVO LEÓN,SANTA CATARINA,35,102,0,137,1787
NUEVO LEÓN,SANTA CATARINA,19,111,0,130,1895
NUEVO LEÓN,SANTA CATARINA,26,158,2,186,1895
NUEVO LEÓN,SANTA CATARINA,23,132,2,157,1895
NUEVO LEÓN,SANTA CATARINA,23,161,2,186,1608
NUEVO LEÓN,SANTA CATARINA,26,177,1,204,1607
NUEVO LEÓN,SANTA CATARINA,26,111,3,140,1672
NUEVO LEÓN,SANTA CATARINA,15,109,0,124,1671
NUEVO LEÓN,SANTA CATARINA,20,129,0,149,1671
NUEVO LEÓN,SANTA CATARINA,18,123,1,142,1671
NUEVO LEÓN,SANTA CATARINA,18,112,0,130,1671
NUEVO LEÓN,SANTA CATARINA,3,110,2,115,1240
NUEVO LEÓN,SANTA CATARINA,4,90,2,96,1239
NUEVO LEÓN,SANTA CATARINA,23,87,1,111,1336
NUEVO LEÓN,SANTA CATARINA,8,74,3,85,1336
NUEVO LEÓN,SANTA CATARINA,8,72,1,81,1336
NUEVO LEÓN,SANTA CATARINA,16,98,2,116,1362
NUEVO LEÓN,SANTA CATARINA,11,96,3,110,1362
NUEVO LEÓN,SANTA CATARINA,12,109,0,121,1362
NUEVO LEÓN,SANTA CATARINA,6,74,3,83,1044
NUEVO LEÓN,SANTA CATARINA,17,84,1,102,1043
NUEVO LEÓN,SANTA CATARINA,7,78,1,86,1188
NUEVO LEÓN,SANTA CATARINA,15,87,3,105,1188
NUEVO LEÓN,SANTA CATARINA,36,145,0,181,1292
NUEVO LEÓN,SANTA CATARINA,36,145,3,184,1291
NUEVO LEÓN,SANTA CATARINA,7,76,4,87,1074
NUEVO LEÓN,SANTA CATARINA,9,94,4,107,1073
NUEVO LEÓN,SANTA CATARINA,9,179,5,193,1758
NUEVO LEÓN,SANTA CATARINA,7,183,5,195,1758
NUEVO LEÓN,SANTA CATARINA,38,140,2,180,1759
NUEVO LEÓN,SANTA CATARINA,27,157,0,184,1758
NUEVO LEÓN,SANTA CATARINA,16,213,1,230,1750
NUEVO LEÓN,SANTA CATARINA,18,235,4,257,1750
NUEVO LEÓN,SANTA CATARINA,40,193,1,234,1441
NUEVO LEÓN,SANTA CATARINA,28,176,2,206,1441
NUEVO LEÓN,SANTA CATARINA,43,158,1,202,1441
NUEVO LEÓN,SANTA CATARINA,24,196,2,222,1414
NUEVO LEÓN,SANTA CATARINA,19,169,1,189,1414
NUEVO LEÓN,SANTA CATARINA,9,165,0,174,1599
NUEVO LEÓN,SANTA CATARINA,14,161,3,178,1598
NUEVO LEÓN,SANTA CATARINA,18,186,2,206,1525
NUEVO LEÓN,SANTA CATARINA,19,173,2,194,1525
NUEVO LEÓN,SANTA CATARINA,11,146,2,159,1898
NUEVO LEÓN,SANTA CATARINA,9,128,2,139,1897
NUEVO LEÓN,SANTA CATARINA,6,125,1,132,1398
NUEVO LEÓN,SANTA CATARINA,16,126,4,146,1398
NUEVO LEÓN,SANTA CATARINA,9,115,2,126,1397
NUEVO LEÓN,SANTA CATARINA,13,152,2,167,1710
NUEVO LEÓN,SANTA CATARINA,16,141,2,159,1710
NUEVO LEÓN,SANTA CATARINA,35,148,1,184,1598
NUEVO LEÓN,SANTA CATARINA,41,128,3,172,1597
NUEVO LEÓN,SANTA CATARINA,24,143,1,168,1597
NUEVO LEÓN,SANTA CATARINA,121,555,6,682,0
NUEVO LEÓN,SANTA CATARINA,27,120,1,148,1164
NUEVO LEÓN,SANTA CATARINA,23,132,2,157,1164
NUEVO LEÓN,SANTA CATARINA,24,139,0,163,1831
NUEVO LEÓN,SANTA CATARINA,31,150,2,183,1830
NUEVO LEÓN,SANTA CATARINA,18,149,3,170,1830
NUEVO LEÓN,SANTA CATARINA,2,108,0,110,1750
NUEVO LEÓN,SANTA CATARINA,6,141,1,148,1749
NUEVO LEÓN,SANTA CATARINA,13,112,0,125,1766
NUEVO LEÓN,SANTA CATARINA,12,138,0,150,1766
NUEVO LEÓN,SANTA CATARINA,19,143,0,162,1765
NUEVO LEÓN,SANTA CATARINA,17,157,1,175,1765
NUEVO LEÓN,SANTA CATARINA,20,148,0,168,1765
NUEVO LEÓN,SANTA CATARINA,18,125,1,144,1765
NUEVO LEÓN,SANTA CATARINA,16,137,0,153,1765
NUEVO LEÓN,SANTA CATARINA,19,134,0,153,1415
NUEVO LEÓN,SANTA CATARINA,20,137,3,160,1414
NUEVO LEÓN,SANTA CATARINA,15,144,1,160,1414
NUEVO LEÓN,SANTA CATARINA,18,132,0,150,1576
NUEVO LEÓN,SANTA CATARINA,24,116,4,144,1576
NUEVO LEÓN,SANTA CATARINA,32,116,4,152,1576
NUEVO LEÓN,SANTA CATARINA,19,135,1,155,1576
NUEVO LEÓN,SANTA CATARINA,12,85,1,98,1078
NUEVO LEÓN,SANTA CATARINA,6,110,0,116,1077
NUEVO LEÓN,SANTA CATARINA,9,206,11,226,1879
NUEVO LEÓN,SANTA CATARINA,8,208,0,216,1879
NUEVO LEÓN,SANTA CATARINA,23,119,3,145,1687
NUEVO LEÓN,SANTA CATARINA,23,136,0,159,1687
NUEVO LEÓN,SANTA CATARINA,27,111,0,138,1687
NUEVO LEÓN,SANTA CATARINA,32,123,2,157,1686
NUEVO LEÓN,SANTA CATARINA,43,90,2,135,1544
NUEVO LEÓN,SANTA CATARINA,36,123,4,163,1543
NUEVO LEÓN,SANTA CATARINA,31,90,1,122,1543
NUEVO LEÓN,SANTA CATARINA,28,211,0,239,1838
NUEVO LEÓN,SANTA CATARINA,48,203,3,254,1838
NUEVO LEÓN,SANTA CATARINA,13,177,0,190,1552
NUEVO LEÓN,SANTA CATARINA,20,186,3,209,1552
NUEVO LEÓN,SANTA CATARINA,22,145,8,175,1551
NUEVO LEÓN,SANTA CATARINA,8,167,3,178,1823
NUEVO LEÓN,SANTA CATARINA,17,173,0,190,1823
NUEVO LEÓN,SANTA CATARINA,28,143,3,174,1893
NUEVO LEÓN,SANTA CATARINA,40,128,3,171,1892
NUEVO LEÓN,SANTA CATARINA,34,164,1,199,1720
NUEVO LEÓN,SANTA CATARINA,31,151,2,184,1720
NUEVO LEÓN,SANTA CATARINA,31,168,5,204,1720
NUEVO LEÓN,SANTA CATARINA,27,125,0,152,1138
NUEVO LEÓN,SANTA CATARINA,19,113,0,132,1137
NUEVO LEÓN,SANTA CATARINA,21,190,1,212,1728
NUEVO LEÓN,SANTA CATARINA,21,198,1,220,1728
NUEVO LEÓN,SANTA CATARINA,19,136,3,158,1534
NUEVO LEÓN,SANTA CATARINA,21,140,0,161,1534
NUEVO LEÓN,SANTA CATARINA,27,182,1,210,1497
NUEVO LEÓN,SANTA CATARINA,15,214,1,230,1497
NUEVO LEÓN,SANTA CATARINA,12,137,1,150,1724
NUEVO LEÓN,SANTA CATARINA,17,176,1,194,1724
NUEVO LEÓN,SANTA CATARINA,14,168,7,189,1364
NUEVO LEÓN,SANTA CATARINA,9,214,4,227,1363
NUEVO LEÓN,SANTA CATARINA,25,84,1,110,1378
NUEVO LEÓN,SANTA CATARINA,38,58,0,96,1377
NUEVO LEÓN,SANTA CATARINA,35,74,0,109,1377
NUEVO LEÓN,SANTA CATARINA,25,117,0,142,1319
NUEVO LEÓN,SANTA CATARINA,31,113,1,145,1318
NUEVO LEÓN,SANTA CATARINA,22,111,3,136,1318
NUEVO LEÓN,SANTA CATARINA,13,99,0,112,1408
NUEVO LEÓN,SANTA CATARINA,7,83,1,91,1407
NUEVO LEÓN,SANTA CATARINA,11,76,2,89,1407
NUEVO LEÓN,SANTA CATARINA,12,89,0,101,1369
NUEVO LEÓN,SANTA CATARINA,2,115,0,117,1369
NUEVO LEÓN,SANTA CATARINA,11,102,0,113,1369
NUEVO LEÓN,SANTA CATARINA,12,107,0,119,1412
NUEVO LEÓN,SANTA CATARINA,15,104,1,120,1412
NUEVO LEÓN,SANTA CATARINA,22,83,0,105,1405
NUEVO LEÓN,SANTA CATARINA,17,72,0,89,1405
NUEVO LEÓN,SANTA CATARINA,16,85,0,101,1404
NUEVO LEÓN,SANTA CATARINA,20,102,0,122,1491
NUEVO LEÓN,SANTA CATARINA,27,118,2,147,1490
NUEVO LEÓN,SANTA CATARINA,24,128,1,153,1793
NUEVO LEÓN,SANTA CATARINA,38,118,2,158,1792
NUEVO LEÓN,SANTA CATARINA,13,95,1,109,1349
NUEVO LEÓN,SANTA CATARINA,6,99,0,105,1348
NUEVO LEÓN,APODACA,16,119,0,135,1721
NUEVO LEÓN,APODACA,22,135,1,158,1721
NUEVO LEÓN,APODACA,9,119,2,130,1721
NUEVO LEÓN,APODACA,17,135,0,152,1722
NUEVO LEÓN,APODACA,7,136,0,143,1721
NUEVO LEÓN,APODACA,18,147,3,168,1721
NUEVO LEÓN,APODACA,6,142,0,148,1721
NUEVO LEÓN,APODACA,19,189,1,209,1687
NUEVO LEÓN,APODACA,12,137,2,151,1687
NUEVO LEÓN,APODACA,26,163,2,191,1686
NUEVO LEÓN,APODACA,12,168,1,181,1686
NUEVO LEÓN,APODACA,9,134,1,144,1470
NUEVO LEÓN,APODACA,12,127,0,139,1470
NUEVO LEÓN,APODACA,13,135,1,149,1469
NUEVO LEÓN,APODACA,21,152,1,174,1847
NUEVO LEÓN,APODACA,18,164,1,183,1846
NUEVO LEÓN,APODACA,24,151,1,176,1846
NUEVO LEÓN,APODACA,13,149,0,162,1846
NUEVO LEÓN,APODACA,19,131,1,151,1622
NUEVO LEÓN,APODACA,14,143,1,158,1622
NUEVO LEÓN,APODACA,19,145,1,165,1890
NUEVO LEÓN,APODACA,23,191,0,214,1890
NUEVO LEÓN,APODACA,13,138,1,152,1813
NUEVO LEÓN,APODACA,11,126,0,137,1812
NUEVO LEÓN,APODACA,8,166,2,176,1580
NUEVO LEÓN,APODACA,11,158,3,172,1579
NUEVO LEÓN,APODACA,12,199,2,213,1948
NUEVO LEÓN,APODACA,14,186,1,201,1947
NUEVO LEÓN,APODACA,23,123,2,148,1493
NUEVO LEÓN,APODACA,37,113,0,150,1493
NUEVO LEÓN,APODACA,28,110,1,139,1493
NUEVO LEÓN,APODACA,14,156,2,172,1294
NUEVO LEÓN,APODACA,11,171,0,182,1294
NUEVO LEÓN,APODACA,22,157,1,180,1956
NUEVO LEÓN,APODACA,25,165,0,190,1956
NUEVO LEÓN,APODACA,19,173,2,194,1955
NUEVO LEÓN,APODACA,16,165,1,182,1955
NUEVO LEÓN,APODACA,21,174,1,196,1955
NUEVO LEÓN,APODACA,11,232,2,245,1960
NUEVO LEÓN,APODACA,18,180,4,202,1858
NUEVO LEÓN,APODACA,16,180,0,196,1858
NUEVO LEÓN,APODACA,12,154,1,167,1490
NUEVO LEÓN,APODACA,16,164,4,184,1489
NUEVO LEÓN,APODACA,26,183,2,211,1981
NUEVO LEÓN,APODACA,20,193,1,214,1981
NUEVO LEÓN,APODACA,13,185,2,200,1640
NUEVO LEÓN,APODACA,9,187,1,197,1640
NUEVO LEÓN,APODACA,16,158,1,175,1334
NUEVO LEÓN,APODACA,16,190,1,207,1333
NUEVO LEÓN,APODACA,11,148,0,159,1333
NUEVO LEÓN,APODACA,32,121,0,153,1439
NUEVO LEÓN,APODACA,29,122,3,154,1438
NUEVO LEÓN,APODACA,9,241,3,253,1422
NUEVO LEÓN,APODACA,7,237,4,248,1421
NUEVO LEÓN,APODACA,21,183,1,205,1734
NUEVO LEÓN,APODACA,23,204,2,229,1733
NUEVO LEÓN,APODACA,19,197,2,218,1733
NUEVO LEÓN,APODACA,23,137,0,160,1539
NUEVO LEÓN,APODACA,21,137,0,158,1539
NUEVO LEÓN,APODACA,14,128,0,142,1539
NUEVO LEÓN,APODACA,25,133,1,159,1539
NUEVO LEÓN,APODACA,42,138,0,180,1935
NUEVO LEÓN,APODACA,25,125,0,150,1935
NUEVO LEÓN,APODACA,24,124,1,149,1934
NUEVO LEÓN,APODACA,28,126,1,155,1934
NUEVO LEÓN,APODACA,21,137,2,160,1934
NUEVO LEÓN,APODACA,25,132,1,158,1934
NUEVO LEÓN,APODACA,18,162,2,182,1495
NUEVO LEÓN,APODACA,27,163,4,194,1494
NUEVO LEÓN,APODACA,24,130,0,154,1281
NUEVO LEÓN,APODACA,14,130,0,144,1280
NUEVO LEÓN,APODACA,30,97,1,128,1675
NUEVO LEÓN,APODACA,24,136,0,160,1674
NUEVO LEÓN,APODACA,31,80,1,112,1814
NUEVO LEÓN,APODACA,30,96,0,126,1814
NUEVO LEÓN,APODACA,21,84,1,106,1814
NUEVO LEÓN,APODACA,25,107,1,133,1814
NUEVO LEÓN,APODACA,23,111,0,134,1814
NUEVO LEÓN,APODACA,40,94,0,134,1814
NUEVO LEÓN,APODACA,33,115,0,148,1813
NUEVO LEÓN,APODACA,35,107,2,144,1283
NUEVO LEÓN,APODACA,16,96,0,112,1283
NUEVO LEÓN,APODACA,73,99,0,172,1956
NUEVO LEÓN,APODACA,60,127,0,187,1955
NUEVO LEÓN,APODACA,24,200,1,225,1924
NUEVO LEÓN,APODACA,22,188,5,215,1923
NUEVO LEÓN,APODACA,37,91,1,129,1592
NUEVO LEÓN,APODACA,25,91,0,116,1591
NUEVO LEÓN,APODACA,23,120,0,143,1591
NUEVO LEÓN,APODACA,13,123,1,137,1841
NUEVO LEÓN,APODACA,15,147,1,163,1840
NUEVO LEÓN,APODACA,3,162,2,167,1764
NUEVO LEÓN,APODACA,3,150,3,156,1763
NUEVO LEÓN,APODACA,6,153,2,161,1885
NUEVO LEÓN,APODACA,6,170,3,179,1884
NUEVO LEÓN,APODACA,5,131,4,140,1162
NUEVO LEÓN,APODACA,2,130,6,138,1162
NUEVO LEÓN,APODACA,7,122,2,131,1482
NUEVO LEÓN,APODACA,2,153,7,162,1481
NUEVO LEÓN,APODACA,7,134,2,143,1331
NUEVO LEÓN,APODACA,0,110,2,112,1331
NUEVO LEÓN,APODACA,11,130,0,141,1539
NUEVO LEÓN,APODACA,12,131,1,144,1539
NUEVO LEÓN,APODACA,14,144,1,159,1539
NUEVO LEÓN,APODACA,3,102,0,105,1689
NUEVO LEÓN,APODACA,4,107,0,111,1689
NUEVO LEÓN,APODACA,4,144,2,150,1706
NUEVO LEÓN,APODACA,9,149,0,158,1705
NUEVO LEÓN,APODACA,32,183,4,219,1604
NUEVO LEÓN,APODACA,38,160,2,200,1604
NUEVO LEÓN,APODACA,29,144,3,176,1604
NUEVO LEÓN,APODACA,19,152,2,173,1604
NUEVO LEÓN,APODACA,32,178,5,215,1604
NUEVO LEÓN,APODACA,14,106,0,120,1514
NUEVO LEÓN,APODACA,15,101,0,116,1514
NUEVO LEÓN,APODACA,13,95,0,108,1513
NUEVO LEÓN,APODACA,20,101,1,122,1513
NUEVO LEÓN,APODACA,36,84,0,120,1446
NUEVO LEÓN,APODACA,37,97,1,135,1446
NUEVO LEÓN,APODACA,17,130,1,148,1628
NUEVO LEÓN,APODACA,14,159,2,175,1628
NUEVO LEÓN,APODACA,10,140,4,154,1627
NUEVO LEÓN,APODACA,7,152,4,163,1326
NUEVO LEÓN,APODACA,5,171,2,178,1326
NUEVO LEÓN,APODACA,27,244,2,273,1882
NUEVO LEÓN,APODACA,23,277,3,303,1882
NUEVO LEÓN,APODACA,13,102,1,116,1800
NUEVO LEÓN,APODACA,15,126,1,142,1799
NUEVO LEÓN,APODACA,18,127,2,147,1799
NUEVO LEÓN,APODACA,11,99,1,111,1799
NUEVO LEÓN,APODACA,105,476,1,582,0
NUEVO LEÓN,APODACA,10,89,1,100,1869
NUEVO LEÓN,APODACA,12,82,2,96,1868
NUEVO LEÓN,APODACA,7,100,1,108,1868
NUEVO LEÓN,APODACA,14,130,0,144,1444
NUEVO LEÓN,APODACA,15,123,0,138,1444
NUEVO LEÓN,APODACA,24,132,1,157,1443
NUEVO LEÓN,APODACA,18,145,1,164,1505
NUEVO LEÓN,APODACA,20,147,1,168,1505
NUEVO LEÓN,APODACA,29,113,0,142,1559
NUEVO LEÓN,APODACA,25,116,0,141,1558
NUEVO LEÓN,APODACA,16,155,1,172,1611
NUEVO LEÓN,APODACA,15,162,2,179,1610
NUEVO LEÓN,APODACA,14,108,2,124,1380
NUEVO LEÓN,APODACA,17,94,0,111,1380
NUEVO LEÓN,APODACA,21,112,0,133,1379
NUEVO LEÓN,APODACA,17,120,1,138,1426
NUEVO LEÓN,APODACA,10,118,3,131,1425
NUEVO LEÓN,APODACA,18,118,3,139,1425
NUEVO LEÓN,APODACA,9,117,1,127,1857
NUEVO LEÓN,APODACA,7,126,0,133,1857
NUEVO LEÓN,APODACA,8,98,0,106,1857
NUEVO LEÓN,APODACA,6,110,1,117,1857
NUEVO LEÓN,APODACA,15,96,0,111,1697
NUEVO LEÓN,APODACA,7,114,0,121,1696
NUEVO LEÓN,APODACA,2,113,0,115,1416
NUEVO LEÓN,APODACA,9,97,0,106,1415
NUEVO LEÓN,APODACA,5,83,1,89,1415
NUEVO LEÓN,APODACA,7,94,1,102,1327
NUEVO LEÓN,APODACA,8,94,2,104,1326
NUEVO LEÓN,APODACA,22,99,0,121,1326
NUEVO LEÓN,APODACA,19,119,0,138,1349
NUEVO LEÓN,APODACA,12,95,0,107,1349
NUEVO LEÓN,APODACA,10,103,0,113,1348
NUEVO LEÓN,APODACA,25,111,0,136,1638
NUEVO LEÓN,APODACA,16,125,1,142,1638
NUEVO LEÓN,APODACA,10,81,0,91,1357
NUEVO LEÓN,APODACA,11,84,0,95,1357
NUEVO LEÓN,APODACA,8,66,2,76,1357
NUEVO LEÓN,APODACA,12,138,0,150,1627
NUEVO LEÓN,APODACA,25,114,2,141,1626
NUEVO LEÓN,APODACA,12,119,0,131,1163
NUEVO LEÓN,APODACA,14,134,0,148,1163
NUEVO LEÓN,APODACA,9,109,1,119,1328
NUEVO LEÓN,APODACA,6,139,0,145,1327
NUEVO LEÓN,APODACA,18,92,0,110,1184
NUEVO LEÓN,APODACA,16,121,0,137,1183
NUEVO LEÓN,APODACA,23,115,1,139,1528
NUEVO LEÓN,APODACA,16,164,2,182,1528
NUEVO LEÓN,APODACA,21,187,2,210,1887
NUEVO LEÓN,APODACA,13,208,1,222,1887
NUEVO LEÓN,APODACA,24,106,0,130,1597
NUEVO LEÓN,APODACA,26,155,0,181,1597
NUEVO LEÓN,APODACA,20,112,0,132,1572
NUEVO LEÓN,APODACA,16,145,0,161,1572
NUEVO LEÓN,APODACA,16,141,0,157,1572
NUEVO LEÓN,APODACA,27,69,0,96,1207
NUEVO LEÓN,APODACA,23,80,0,103,1207
NUEVO LEÓN,APODACA,8,160,0,168,1528
NUEVO LEÓN,APODACA,12,117,0,129,1528
NUEVO LEÓN,APODACA,10,121,2,133,1528
NUEVO LEÓN,APODACA,27,106,0,133,1411
NUEVO LEÓN,APODACA,30,88,0,118,1410
NUEVO LEÓN,APODACA,21,95,0,116,1410
NUEVO LEÓN,APODACA,28,167,0,195,1922
NUEVO LEÓN,APODACA,22,153,0,175,1921
NUEVO LEÓN,APODACA,32,145,1,178,1789
NUEVO LEÓN,APODACA,34,129,1,164,1789
NUEVO LEÓN,APODACA,19,131,1,151,1346
NUEVO LEÓN,APODACA,16,108,1,125,1346
NUEVO LEÓN,APODACA,19,103,1,123,1346
NUEVO LEÓN,APODACA,9,80,0,89,1117
NUEVO LEÓN,APODACA,7,92,2,101,1117
NUEVO LEÓN,APODACA,19,157,2,178,1764
NUEVO LEÓN,APODACA,154,27,1,182,1763
NUEVO LEÓN,APODACA,20,102,0,122,1046
NUEVO LEÓN,APODACA,13,98,0,111,1046
NUEVO LEÓN,APODACA,15,175,0,190,1881
NUEVO LEÓN,APODACA,19,171,0,190,1880
NUEVO LEÓN,APODACA,18,176,1,195,1880
NUEVO LEÓN,APODACA,7,125,0,132,1500
NUEVO LEÓN,APODACA,15,137,0,152,1500
NUEVO LEÓN,APODACA,13,145,1,159,1510
NUEVO LEÓN,APODACA,21,153,1,175,1509
NUEVO LEÓN,APODACA,19,152,3,174,1623
NUEVO LEÓN,APODACA,14,153,5,172,1622
NUEVO LEÓN,APODACA,11,157,1,169,1622
NUEVO LEÓN,APODACA,2,179,0,181,1713
NUEVO LEÓN,APODACA,1,137,1,139,1712
NUEVO LEÓN,APODACA,3,136,0,139,1712
NUEVO LEÓN,APODACA,4,136,0,140,1712
NUEVO LEÓN,APODACA,6,85,0,91,1336
NUEVO LEÓN,APODACA,2,103,0,105,1336
NUEVO LEÓN,APODACA,7,128,0,135,1317
NUEVO LEÓN,APODACA,4,95,0,99,1316
NUEVO LEÓN,APODACA,6,156,1,163,1858
NUEVO LEÓN,APODACA,5,142,0,147,1858
NUEVO LEÓN,APODACA,5,153,0,158,1858
NUEVO LEÓN,APODACA,8,130,0,138,1857
NUEVO LEÓN,GRAL. ESCOBEDO,12,176,2,190,1497
NUEVO LEÓN,GRAL. ESCOBEDO,6,152,5,163,1497
NUEVO LEÓN,GRAL. ESCOBEDO,13,156,4,173,1497
NUEVO LEÓN,GRAL. ESCOBEDO,8,129,4,141,1742
NUEVO LEÓN,GRAL. ESCOBEDO,2,152,0,154,1742
NUEVO LEÓN,GRAL. ESCOBEDO,13,155,2,170,1742
NUEVO LEÓN,GRAL. ESCOBEDO,10,143,2,155,1742
NUEVO LEÓN,GRAL. ESCOBEDO,6,132,2,140,1742
NUEVO LEÓN,GRAL. ESCOBEDO,11,122,1,134,1742
NUEVO LEÓN,GRAL. ESCOBEDO,7,137,4,148,1741
NUEVO LEÓN,GRAL. ESCOBEDO,8,222,1,231,1841
NUEVO LEÓN,GRAL. ESCOBEDO,10,226,5,241,1841
NUEVO LEÓN,GRAL. ESCOBEDO,7,191,5,203,1686
NUEVO LEÓN,GRAL. ESCOBEDO,7,199,2,208,1685
NUEVO LEÓN,GRAL. ESCOBEDO,5,155,6,166,1135
NUEVO LEÓN,GRAL. ESCOBEDO,10,164,2,176,1135
NUEVO LEÓN,GRAL. ESCOBEDO,12,129,0,141,1644
NUEVO LEÓN,GRAL. ESCOBEDO,15,142,2,159,1644
NUEVO LEÓN,GRAL. ESCOBEDO,15,128,3,146,1644
NUEVO LEÓN,GRAL. ESCOBEDO,25,147,0,172,1644
NUEVO LEÓN,GRAL. ESCOBEDO,25,158,1,184,1643
NUEVO LEÓN,GRAL. ESCOBEDO,145,1342,13,1500,0
NUEVO LEÓN,GRAL. ESCOBEDO,18,120,1,139,1341
NUEVO LEÓN,GRAL. ESCOBEDO,28,106,0,134,1341
NUEVO LEÓN,GRAL. ESCOBEDO,19,95,1,115,1340
NUEVO LEÓN,GRAL. ESCOBEDO,15,175,9,199,1902
NUEVO LEÓN,GRAL. ESCOBEDO,5,190,5,200,1902
NUEVO LEÓN,GRAL. ESCOBEDO,7,181,1,189,1901
NUEVO LEÓN,GRAL. ESCOBEDO,20,254,3,277,1935
NUEVO LEÓN,GRAL. ESCOBEDO,17,311,6,334,1934
NUEVO LEÓN,GRAL. ESCOBEDO,26,157,0,183,1481
NUEVO LEÓN,GRAL. ESCOBEDO,18,119,1,138,1481
NUEVO LEÓN,GRAL. ESCOBEDO,21,114,1,136,1480
NUEVO LEÓN,GRAL. ESCOBEDO,12,163,1,176,1583
NUEVO LEÓN,GRAL. ESCOBEDO,19,171,0,190,1583
NUEVO LEÓN,GRAL. ESCOBEDO,9,155,1,165,1582
NUEVO LEÓN,GRAL. ESCOBEDO,21,157,5,183,1426
NUEVO LEÓN,GRAL. ESCOBEDO,30,130,1,161,1426
NUEVO LEÓN,GRAL. ESCOBEDO,30,152,1,183,1425
NUEVO LEÓN,GRAL. ESCOBEDO,31,249,4,284,1604
NUEVO LEÓN,GRAL. ESCOBEDO,28,255,0,283,1604
NUEVO LEÓN,GRAL. ESCOBEDO,19,249,4,272,1604
NUEVO LEÓN,GRAL. ESCOBEDO,15,182,1,198,1297
NUEVO LEÓN,GRAL. ESCOBEDO,12,172,1,185,1296
NUEVO LEÓN,GRAL. ESCOBEDO,39,167,2,208,1499
NUEVO LEÓN,GRAL. ESCOBEDO,31,168,1,200,1499
NUEVO LEÓN,GRAL. ESCOBEDO,41,182,0,223,1498
NUEVO LEÓN,GRAL. ESCOBEDO,6,193,1,200,1747
NUEVO LEÓN,GRAL. ESCOBEDO,19,207,3,229,1746
NUEVO LEÓN,GRAL. ESCOBEDO,16,112,0,128,1201
NUEVO LEÓN,GRAL. ESCOBEDO,23,96,2,121,1201
NUEVO LEÓN,GRAL. ESCOBEDO,29,127,4,160,1356
NUEVO LEÓN,GRAL. ESCOBEDO,26,132,3,161,1356
NUEVO LEÓN,GRAL. ESCOBEDO,21,155,3,179,1355
NUEVO LEÓN,GRAL. ESCOBEDO,27,143,0,170,1583
NUEVO LEÓN,GRAL. ESCOBEDO,23,155,1,179,1582
NUEVO LEÓN,GRAL. ESCOBEDO,22,163,1,186,1582
NUEVO LEÓN,GRAL. ESCOBEDO,30,190,1,221,1729
NUEVO LEÓN,GRAL. ESCOBEDO,38,178,2,218,1728
NUEVO LEÓN,GRAL. ESCOBEDO,40,175,1,216,1728
NUEVO LEÓN,GRAL. ESCOBEDO,21,147,0,168,1505
NUEVO LEÓN,GRAL. ESCOBEDO,24,122,0,146,1505
NUEVO LEÓN,GRAL. ESCOBEDO,25,139,1,165,1505
NUEVO LEÓN,GRAL. ESCOBEDO,20,153,0,173,1504
NUEVO LEÓN,GRAL. ESCOBEDO,26,282,4,312,1661
NUEVO LEÓN,GRAL. ESCOBEDO,25,250,3,278,1660
NUEVO LEÓN,GRAL. ESCOBEDO,12,167,1,180,1261
NUEVO LEÓN,GRAL. ESCOBEDO,12,180,0,192,1260
NUEVO LEÓN,GRAL. ESCOBEDO,13,206,3,222,1572
NUEVO LEÓN,GRAL. ESCOBEDO,21,183,2,206,1571
NUEVO LEÓN,GRAL. ESCOBEDO,15,186,3,204,1850
NUEVO LEÓN,GRAL. ESCOBEDO,15,188,1,204,1850
NUEVO LEÓN,GRAL. ESCOBEDO,16,185,3,204,1850
NUEVO LEÓN,GRAL. ESCOBEDO,11,161,1,173,1850
NUEVO LEÓN,GRAL. ESCOBEDO,20,172,1,193,1672
NUEVO LEÓN,GRAL. ESCOBEDO,10,150,1,161,1671
NUEVO LEÓN,GRAL. ESCOBEDO,16,152,2,170,1851
NUEVO LEÓN,GRAL. ESCOBEDO,17,171,3,191,1851
NUEVO LEÓN,GRAL. ESCOBEDO,12,190,4,206,1851
NUEVO LEÓN,GRAL. ESCOBEDO,24,177,3,204,1851
NUEVO LEÓN,GRAL. ESCOBEDO,15,128,0,143,1161
NUEVO LEÓN,GRAL. ESCOBEDO,12,136,2,150,1160
NUEVO LEÓN,GRAL. ESCOBEDO,14,223,3,240,1300
NUEVO LEÓN,GRAL. ESCOBEDO,13,202,8,223,1300
NUEVO LEÓN,GRAL. ESCOBEDO,27,298,2,327,1620
NUEVO LEÓN,GRAL. ESCOBEDO,15,295,5,315,1619
NUEVO LEÓN,GRAL. ESCOBEDO,15,176,5,196,1636
NUEVO LEÓN,GRAL. ESCOBEDO,18,195,0,213,1636
NUEVO LEÓN,GRAL. ESCOBEDO,14,196,4,214,1636
NUEVO LEÓN,GRAL. ESCOBEDO,7,166,0,173,1636
NUEVO LEÓN,GRAL. ESCOBEDO,18,236,8,262,1313
NUEVO LEÓN,GRAL. ESCOBEDO,12,184,3,199,1312
NUEVO LEÓN,GRAL. ESCOBEDO,10,152,1,163,1667
NUEVO LEÓN,GRAL. ESCOBEDO,10,127,4,141,1666
NUEVO LEÓN,GRAL. ESCOBEDO,10,148,3,161,1666
NUEVO LEÓN,GRAL. ESCOBEDO,6,131,1,138,1666
NUEVO LEÓN,GRAL. ESCOBEDO,18,147,1,166,1666
NUEVO LEÓN,GRAL. ESCOBEDO,11,117,1,129,1666
NUEVO LEÓN,GRAL. ESCOBEDO,17,260,3,280,1421
NUEVO LEÓN,GRAL. ESCOBEDO,11,267,0,278,1420
NUEVO LEÓN,GRAL. ESCOBEDO,16,232,1,249,1606
NUEVO LEÓN,GRAL. ESCOBEDO,11,235,2,248,1606
NUEVO LEÓN,GRAL. ESCOBEDO,15,217,4,236,1605
NUEVO LEÓN,GRAL. ESCOBEDO,24,144,1,169,1762
NUEVO LEÓN,GRAL. ESCOBEDO,43,147,4,194,1762
NUEVO LEÓN,GRAL. ESCOBEDO,38,154,1,193,1762
NUEVO LEÓN,GRAL. ESCOBEDO,47,155,1,203,1762
NUEVO LEÓN,GRAL. ESCOBEDO,25,139,5,169,1762
NUEVO LEÓN,GRAL. ESCOBEDO,33,147,1,181,1762
NUEVO LEÓN,GRAL. ESCOBEDO,43,133,5,181,1762
NUEVO LEÓN,GRAL. ESCOBEDO,43,145,0,188,1710
NUEVO LEÓN,GRAL. ESCOBEDO,38,123,1,162,1709
NUEVO LEÓN,GRAL. ESCOBEDO,40,128,2,170,1709
NUEVO LEÓN,GRAL. ESCOBEDO,9,146,3,158,1534
NUEVO LEÓN,GRAL. ESCOBEDO,8,153,0,161,1533
NUEVO LEÓN,GRAL. ESCOBEDO,9,179,2,190,1921
NUEVO LEÓN,GRAL. ESCOBEDO,15,182,0,197,1920
NUEVO LEÓN,GRAL. ESCOBEDO,12,237,4,253,1979
NUEVO LEÓN,GRAL. ESCOBEDO,19,227,1,247,1978
NUEVO LEÓN,GRAL. ESCOBEDO,14,124,0,138,1427
NUEVO LEÓN,GRAL. ESCOBEDO,5,134,0,139,1427
NUEVO LEÓN,GRAL. ESCOBEDO,4,145,0,149,1427
NUEVO LEÓN,GRAL. ESCOBEDO,5,117,0,122,1330
NUEVO LEÓN,GRAL. ESCOBEDO,3,107,1,111,1330
NUEVO LEÓN,GRAL. ESCOBEDO,4,87,1,92,1330
NUEVO LEÓN,GRAL. ESCOBEDO,14,131,3,148,1597
NUEVO LEÓN,GRAL. ESCOBEDO,7,125,1,133,1596
NUEVO LEÓN,GRAL. ESCOBEDO,9,170,2,181,1974
NUEVO LEÓN,GRAL. ESCOBEDO,15,112,2,129,1458
NUEVO LEÓN,GRAL. ESCOBEDO,10,99,0,109,1457
NUEVO LEÓN,GRAL. ESCOBEDO,9,99,2,110,1457
NUEVO LEÓN,GRAL. ESCOBEDO,7,253,1,261,1543
NUEVO LEÓN,GRAL. ESCOBEDO,7,165,1,173,1542
NUEVO LEÓN,GRAL. ESCOBEDO,5,126,1,132,1059
NUEVO LEÓN,GRAL. ESCOBEDO,5,102,1,108,1059
NUEVO LEÓN,GRAL. ESCOBEDO,18,185,1,204,1580
NUEVO LEÓN,GRAL. ESCOBEDO,10,176,2,188,1580
NUEVO LEÓN,GRAL. ESCOBEDO,13,181,2,196,1698
NUEVO LEÓN,GRAL. ESCOBEDO,12,184,0,196,1698
NUEVO LEÓN,GRAL. ESCOBEDO,31,186,0,217,1795
NUEVO LEÓN,GRAL. ESCOBEDO,24,195,0,219,1795
NUEVO LEÓN,GRAL. ESCOBEDO,11,200,0,211,1924
NUEVO LEÓN,GRAL. ESCOBEDO,6,193,2,201,1924
NUEVO LEÓN,GRAL. ESCOBEDO,9,208,2,219,1924
NUEVO LEÓN,GRAL. ESCOBEDO,10,120,2,132,1008
NUEVO LEÓN,GRAL. ESCOBEDO,4,108,1,113,1007
NUEVO LEÓN,GRAL. ESCOBEDO,54,76,0,130,1839
NUEVO LEÓN,GRAL. ESCOBEDO,55,93,0,148,1839
NUEVO LEÓN,GRAL. ESCOBEDO,65,65,1,131,1330
NUEVO LEÓN,GRAL. ESCOBEDO,92,70,2,164,1329
NUEVO LEÓN,GRAL. ESCOBEDO,71,70,1,142,1697
NUEVO LEÓN,GRAL. ESCOBEDO,88,87,0,175,1697
NUEVO LEÓN,GRAL. ESCOBEDO,58,89,0,147,1696
NUEVO LEÓN,GRAL. ESCOBEDO,43,68,0,111,1394
NUEVO LEÓN,GRAL. ESCOBEDO,53,74,1,128,1394
NUEVO LEÓN,GRAL. ESCOBEDO,79,64,1,144,1394
NUEVO LEÓN,GRAL. ESCOBEDO,5,113,2,120,1347
NUEVO LEÓN,GRAL. ESCOBEDO,9,83,1,93,1346
NUEVO LEÓN,GRAL. ESCOBEDO,6,57,2,65,1049
NUEVO LEÓN,GRAL. ESCOBEDO,4,71,1,76,1048
NUEVO LEÓN,GRAL. ESCOBEDO,11,112,1,124,1099
NUEVO LEÓN,GRAL. ESCOBEDO,8,86,0,94,1099
NUEVO LEÓN,GRAL. ESCOBEDO,2,100,1,103,1070
NUEVO LEÓN,GRAL. ESCOBEDO,4,89,2,95,1069
NUEVO LEÓN,GRAL. ESCOBEDO,8,105,1,114,1067
NUEVO LEÓN,GRAL. ESCOBEDO,0,112,0,112,1067
NUEVO LEÓN,GRAL. ESCOBEDO,4,94,0,98,1132
NUEVO LEÓN,GRAL. ESCOBEDO,4,102,1,107,1131
NUEVO LEÓN,GRAL. ESCOBEDO,4,90,1,95,1072
NUEVO LEÓN,GRAL. ESCOBEDO,4,93,1,98,1071
NUEVO LEÓN,GRAL. ESCOBEDO,4,112,0,116,1393
NUEVO LEÓN,GRAL. ESCOBEDO,2,111,0,113,1393
NUEVO LEÓN,GRAL. ESCOBEDO,2,100,1,103,1393
NUEVO LEÓN,GRAL. ESCOBEDO,22,163,2,187,1548
NUEVO LEÓN,GRAL. ESCOBEDO,24,162,2,188,1547
NUEVO LEÓN,GRAL. ESCOBEDO,19,101,4,124,1568
NUEVO LEÓN,GRAL. ESCOBEDO,17,101,3,121,1567
NUEVO LEÓN,GRAL. ESCOBEDO,37,143,1,181,1693
NUEVO LEÓN,GRAL. ESCOBEDO,34,126,0,160,1692
NUEVO LEÓN,GRAL. ESCOBEDO,21,166,1,188,1451
NUEVO LEÓN,GRAL. ESCOBEDO,22,175,1,198,1451
NUEVO LEÓN,GRAL. ESCOBEDO,16,143,0,159,1455
NUEVO LEÓN,GRAL. ESCOBEDO,18,145,0,163,1455
NUEVO LEÓN,GRAL. ESCOBEDO,29,107,0,136,1617
NUEVO LEÓN,GRAL. ESCOBEDO,29,102,0,131,1616
NUEVO LEÓN,GRAL. ESCOBEDO,37,138,0,175,1388
NUEVO LEÓN,GRAL. ESCOBEDO,26,143,1,170,1388
NUEVO LEÓN,GRAL. ESCOBEDO,17,192,2,211,1960
NUEVO LEÓN,GRAL. ESCOBEDO,28,204,0,232,1960
NUEVO LEÓN,GRAL. ESCOBEDO,4,144,1,149,1396
NUEVO LEÓN,GRAL. ESCOBEDO,9,164,2,175,1396
NUEVO LEÓN,GRAL. ESCOBEDO,10,155,4,169,1583
NUEVO LEÓN,GRAL. ESCOBEDO,15,162,4,181,1583
NUEVO LEÓN,GRAL. ESCOBEDO,6,134,0,140,1958
NUEVO LEÓN,GRAL. ESCOBEDO,3,127,2,132,1958
NUEVO LEÓN,GRAL. ESCOBEDO,6,130,2,138,1104
NUEVO LEÓN,GRAL. ESCOBEDO,8,108,0,116,1103
NUEVO LEÓN,GRAL. ESCOBEDO,3,99,0,102,1767
NUEVO LEÓN,GRAL. ESCOBEDO,9,129,5,143,1767
NUEVO LEÓN,GRAL. ESCOBEDO,2,99,0,101,1700
NUEVO LEÓN,GRAL. ESCOBEDO,5,94,1,100,1700
NUEVO LEÓN,GRAL. ESCOBEDO,1,89,0,90,1699
NUEVO LEÓN,GRAL. ESCOBEDO,1,91,0,92,1384
NUEVO LEÓN,GRAL. ESCOBEDO,5,78,4,87,1384
NUEVO LEÓN,GRAL. ESCOBEDO,3,77,2,82,1384
NUEVO LEÓN,GRAL. ESCOBEDO,2,131,0,133,1963
NUEVO LEÓN,GRAL. ESCOBEDO,4,132,2,138,1963
NUEVO LEÓN,SAN NICOLAS DE LOS GARZA,11,108,2,121,1157
NUEVO LEÓN,SAN NICOLAS DE LOS GARZA,11,129,4,144,1156
NUEVO LEÓN,SAN NICOLAS DE LOS GARZA,14,198,1,213,1507
NUEVO LEÓN,SAN NICOLAS DE LOS GARZA,11,192,1,204,1506
NUEVO LEÓN,SAN NICOLAS DE LOS GARZA,45,114,0,159,1353
NUEVO LEÓN,SAN NICOLAS DE LOS GARZA,43,89,2,134,1353
NUEVO LEÓN,SAN NICOLAS DE LOS GARZA,69,133,0,202,1436
NUEVO LEÓN,SAN NICOLAS DE LOS GARZA,46,113,4,163,1436
NUEVO LEÓN,SAN NICOLAS DE LOS GARZA,52,165,0,217,1498
NUEVO LEÓN,SAN NICOLAS DE LOS GARZA,48,155,3,206,1498
NUEVO LEÓN,SAN NICOLAS DE LOS GARZA,49,155,1,205,1719
NUEVO LEÓN,SAN NICOLAS DE LOS GARZA,61,151,1,213,1718
NUEVO LEÓN,SAN NICOLAS DE LOS GARZA,61,139,1,201,1500
NUEVO LEÓN,SAN NICOLAS DE LOS GARZA,58,139,1,198,1499
NUEVO LEÓN,SAN NICOLAS DE LOS GARZA,44,126,1,171,1352
NUEVO LEÓN,SAN NICOLAS DE LOS GARZA,42,114,0,156,1352
NUEVO LEÓN,SAN NICOLAS DE LOS GARZA,30,125,5,160,1352
NUEVO LEÓN,SAN NICOLAS DE LOS GARZA,17,165,3,185,1379
NUEVO LEÓN,SAN NICOLAS DE LOS GARZA,27,198,1,226,1378
NUEVO LEÓN,SAN NICOLAS DE LOS GARZA,15,143,4,162,1409
NUEVO LEÓN,SAN NICOLAS DE LOS GARZA,10,148,4,162,1409
NUEVO LEÓN,SAN NICOLAS DE LOS GARZA,37,164,2,203,1521
NUEVO LEÓN,SAN NICOLAS DE LOS GARZA,25,167,0,192,1521
NUEVO LEÓN,SAN NICOLAS DE LOS GARZA,23,175,5,203,1520
NUEVO LEÓN,SAN NICOLAS DE LOS GARZA,43,152,3,198,1704
NUEVO LEÓN,SAN NICOLAS DE LOS GARZA,31,157,1,189,1704
NUEVO LEÓN,SAN NICOLAS DE LOS GARZA,41,122,0,163,1478
NUEVO LEÓN,SAN NICOLAS DE LOS GARZA,33,111,1,145,1478
NUEVO LEÓN,SAN NICOLAS DE LOS GARZA,27,128,2,157,1478
NUEVO LEÓN,SAN NICOLAS DE LOS GARZA,75,171,4,250,1815
NUEVO LEÓN,SAN NICOLAS DE LOS GARZA,60,179,1,240,1814
NUEVO LEÓN,SAN NICOLAS DE LOS GARZA,95,78,1,174,1736
NUEVO LEÓN,SAN NICOLAS DE LOS GARZA,95,87,0,182,1736
NUEVO LEÓN,SAN NICOLAS DE LOS GARZA,105,85,2,192,1736
NUEVO LEÓN,SAN NICOLAS DE LOS GARZA,99,99,0,198,1719
NUEVO LEÓN,SAN NICOLAS DE LOS GARZA,81,107,1,189,1719
NUEVO LEÓN,SAN NICOLAS DE LOS GARZA,92,111,1,204,1718
NUEVO LEÓN,SAN NICOLAS DE LOS GARZA,33,209,3,245,1886
NUEVO LEÓN,SAN NICOLAS DE LOS GARZA,34,175,4,213,1886
NUEVO LEÓN,SAN NICOLAS DE LOS GARZA,25,135,2,162,1448
NUEVO LEÓN,SAN NICOLAS DE LOS GARZA,18,156,3,177,1448
NUEVO LEÓN,SAN NICOLAS DE LOS GARZA,35,141,0,176,1448
NUEVO LEÓN,SAN NICOLAS DE LOS GARZA,44,192,2,238,1886
NUEVO LEÓN,SAN NICOLAS DE LOS GARZA,32,226,1,259,1886
NUEVO LEÓN,SAN NICOLAS DE LOS GARZA,36,141,1,178,1413
NUEVO LEÓN,SAN NICOLAS DE LOS GARZA,30,188,2,220,1412
NUEVO LEÓN,SAN NICOLAS DE LOS GARZA,28,152,2,182,1412
NUEVO LEÓN,SAN NICOLAS DE LOS GARZA,27,162,3,192,1777
NUEVO LEÓN,SAN NICOLAS DE LOS GARZA,37,180,3,220,1776
NUEVO LEÓN,SAN NICOLAS DE LOS GARZA,19,149,0,168,1533
NUEVO LEÓN,SAN NICOLAS DE LOS GARZA,21,130,1,152,1532
NUEVO LEÓN,SAN NICOLAS DE LOS GARZA,6,135,0,141,1369
NUEVO LEÓN,SAN NICOLAS DE LOS GARZA,10,127,2,139,1369
NUEVO LEÓN,SAN NICOLAS DE LOS GARZA,43,191,0,234,1911
NUEVO LEÓN,SAN NICOLAS DE LOS GARZA,40,135,2,177,1911
NUEVO LEÓN,SAN NICOLAS DE LOS GARZA,41,187,1,229,1712
NUEVO LEÓN,SAN NICOLAS DE LOS GARZA,37,201,1,239,1712
NUEVO LEÓN,SAN NICOLAS DE LOS GARZA,13,176,3,192,1757
NUEVO LEÓN,SAN NICOLAS DE LOS GARZA,20,185,7,212,1757
NUEVO LEÓN,SAN NICOLAS DE LOS GARZA,65,131,2,198,1744
NUEVO LEÓN,SAN NICOLAS DE LOS GARZA,60,145,4,209,1744
NUEVO LEÓN,SAN NICOLAS DE LOS GARZA,82,118,1,201,1628
NUEVO LEÓN,SAN NICOLAS DE LOS GARZA,79,134,0,213,1628
NUEVO LEÓN,SAN NICOLAS DE LOS GARZA,68,113,1,182,1628
NUEVO LEÓN,SAN NICOLAS DE LOS GARZA,123,79,1,203,1798
NUEVO LEÓN,SAN NICOLAS DE LOS GARZA,79,67,2,148,1797
NUEVO LEÓN,SAN NICOLAS DE LOS GARZA,77,137,1,215,1654
NUEVO LEÓN,SAN NICOLAS DE LOS GARZA,74,120,0,194,1653
NUEVO LEÓN,SAN NICOLAS DE LOS GARZA,64,121,2,187,1899
NUEVO LEÓN,SAN NICOLAS DE LOS GARZA,44,150,0,194,1899
NUEVO LEÓN,SAN NICOLAS DE LOS GARZA,73,155,1,229,1918
NUEVO LEÓN,SAN NICOLAS DE LOS GARZA,99,161,1,261,1918
NUEVO LEÓN,SAN NICOLAS DE LOS GARZA,53,177,2,232,1486
NUEVO LEÓN,SAN NICOLAS DE LOS GARZA,48,174,1,223,1485
NUEVO LEÓN,SAN NICOLAS DE LOS GARZA,45,169,1,215,1599
NUEVO LEÓN,SAN NICOLAS DE LOS GARZA,35,180,0,215,1599
NUEVO LEÓN,SAN NICOLAS DE LOS GARZA,38,145,0,183,1556
NUEVO LEÓN,SAN NICOLAS DE LOS GARZA,32,160,3,195,1556
NUEVO LEÓN,SAN NICOLAS DE LOS GARZA,22,156,0,178,1514
NUEVO LEÓN,SAN NICOLAS DE LOS GARZA,26,165,2,193,1514
NUEVO LEÓN,SAN NICOLAS DE LOS GARZA,8,181,4,193,1551
NUEVO LEÓN,SAN NICOLAS DE LOS GARZA,8,190,4,202,1551
NUEVO LEÓN,SAN NICOLAS DE LOS GARZA,17,179,5,201,1644
NUEVO LEÓN,SAN NICOLAS DE LOS GARZA,18,198,2,218,1644
NUEVO LEÓN,SAN NICOLAS DE LOS GARZA,16,184,2,202,1725
NUEVO LEÓN,SAN NICOLAS DE LOS GARZA,24,167,1,192,1725
NUEVO LEÓN,SAN NICOLAS DE LOS GARZA,20,171,3,194,1610
NUEVO LEÓN,SAN NICOLAS DE LOS GARZA,19,152,0,171,1610
NUEVO LEÓN,SAN NICOLAS DE LOS GARZA,63,160,1,224,1725
NUEVO LEÓN,SAN NICOLAS DE LOS GARZA,58,194,1,253,1725
NUEVO LEÓN,SAN NICOLAS DE LOS GARZA,50,104,0,154,1390
NUEVO LEÓN,SAN NICOLAS DE LOS GARZA,55,101,0,156,1389
NUEVO LEÓN,SAN NICOLAS DE LOS GARZA,89,91,0,180,1562
NUEVO LEÓN,SAN NICOLAS DE LOS GARZA,125,93,1,219,1561
NUEVO LEÓN,SAN NICOLAS DE LOS GARZA,76,80,2,158,1363
NUEVO LEÓN,SAN NICOLAS DE LOS GARZA,90,95,1,186,1362
NUEVO LEÓN,SAN NICOLAS DE LOS GARZA,34,100,0,134,1597
NUEVO LEÓN,SAN NICOLAS DE LOS GARZA,39,108,1,148,1597
NUEVO LEÓN,SAN NICOLAS DE LOS GARZA,34,76,35,145,1597
NUEVO LEÓN,SAN NICOLAS DE LOS GARZA,33,103,0,136,1597
NUEVO LEÓN,SAN NICOLAS DE LOS GARZA,46,151,3,200,1481
NUEVO LEÓN,SAN NICOLAS DE LOS GARZA,51,156,3,210,1480
NUEVO LEÓN,SAN NICOLAS DE LOS GARZA,27,169,2,198,1480
NUEVO LEÓN,SAN NICOLAS DE LOS GARZA,72,129,1,202,1515
NUEVO LEÓN,SAN NICOLAS DE LOS GARZA,36,157,3,196,1515
NUEVO LEÓN,SAN NICOLAS DE LOS GARZA,33,123,3,159,1514
NUEVO LEÓN,SAN NICOLAS DE LOS GARZA,33,135,2,170,1613
NUEVO LEÓN,SAN NICOLAS DE LOS GARZA,52,148,1,201,1612
NUEVO LEÓN,SAN NICOLAS DE LOS GARZA,45,147,2,194,1612
NUEVO LEÓN,SAN NICOLAS DE LOS GARZA,30,166,1,197,1466
NUEVO LEÓN,SAN NICOLAS DE LOS GARZA,22,158,1,181,1466
NUEVO LEÓN,SAN NICOLAS DE LOS GARZA,26,180,1,207,1769
NUEVO LEÓN,SAN NICOLAS DE LOS GARZA,16,178,1,195,1768
NUEVO LEÓN,SAN NICOLAS DE LOS GARZA,7,174,4,185,1484
NUEVO LEÓN,SAN NICOLAS DE LOS GARZA,13,164,0,177,1484
NUEVO LEÓN,SAN NICOLAS DE LOS GARZA,17,182,1,200,1431
NUEVO LEÓN,SAN NICOLAS DE LOS GARZA,21,201,2,224,1431
NUEVO LEÓN,SAN NICOLAS DE LOS GARZA,12,184,1,197,1511
NUEVO LEÓN,SAN NICOLAS DE LOS GARZA,17,185,4,206,1510
NUEVO LEÓN,SAN NICOLAS DE LOS GARZA,17,159,3,179,1814
NUEVO LEÓN,SAN NICOLAS DE LOS GARZA,18,176,2,196,1814
NUEVO LEÓN,SAN NICOLAS DE LOS GARZA,18,219,2,239,1816
NUEVO LEÓN,SAN NICOLAS DE LOS GARZA,8,225,1,234,1816
NUEVO LEÓN,SAN NICOLAS DE LOS GARZA,23,151,0,174,1528
NUEVO LEÓN,SAN NICOLAS DE LOS GARZA,19,170,1,190,1527
NUEVO LEÓN,SAN NICOLAS DE LOS GARZA,38,150,1,189,1383
NUEVO LEÓN,SAN NICOLAS DE LOS GARZA,44,115,2,161,1382
NUEVO LEÓN,SAN NICOLAS DE LOS GARZA,30,117,0,147,1382
NUEVO LEÓN,SAN NICOLAS DE LOS GARZA,35,152,1,188,1315
NUEVO LEÓN,SAN NICOLAS DE LOS GARZA,32,107,2,141,1315
NUEVO LEÓN,SAN NICOLAS DE LOS GARZA,36,104,0,140,1314
NUEVO LEÓN,SAN NICOLAS DE LOS GARZA,66,132,1,199,1946
NUEVO LEÓN,SAN NICOLAS DE LOS GARZA,71,125,2,198,1946
NUEVO LEÓN,SAN NICOLAS DE LOS GARZA,8,240,6,254,1904
NUEVO LEÓN,SAN NICOLAS DE LOS GARZA,9,240,5,254,1903
NUEVO LEÓN,SAN NICOLAS DE LOS GARZA,8,260,5,273,1617
NUEVO LEÓN,SAN NICOLAS DE LOS GARZA,9,243,3,255,1616
NUEVO LEÓN,SAN NICOLAS DE LOS GARZA,17,217,5,239,1771
NUEVO LEÓN,SAN NICOLAS DE LOS GARZA,4,217,6,227,1770
NUEVO LEÓN,SAN NICOLAS DE LOS GARZA,40,174,4,218,1871
NUEVO LEÓN,SAN NICOLAS DE LOS GARZA,41,179,3,223,1871
NUEVO LEÓN,SAN NICOLAS DE LOS GARZA,39,125,2,166,1208
NUEVO LEÓN,SAN NICOLAS DE LOS GARZA,36,125,3,164,1207
NUEVO LEÓN,SAN NICOLAS DE LOS GARZA,9,179,3,191,1611
NUEVO LEÓN,SAN NICOLAS DE LOS GARZA,16,179,5,200,1610
NUEVO LEÓN,SAN NICOLAS DE LOS GARZA,6,198,1,205,1628
NUEVO LEÓN,SAN NICOLAS DE LOS GARZA,12,197,2,211,1627
NUEVO LEÓN,SAN NICOLAS DE LOS GARZA,13,186,5,204,1569
NUEVO LEÓN,SAN NICOLAS DE LOS GARZA,16,179,17,212,1568
NUEVO LEÓN,SAN NICOLAS DE LOS GARZA,6,166,3,175,1506
NUEVO LEÓN,SAN NICOLAS DE LOS GARZA,7,177,6,190,1505
NUEVO LEÓN,SAN NICOLAS DE LOS GARZA,20,278,4,302,1896
NUEVO LEÓN,SAN NICOLAS DE LOS GARZA,24,270,2,296,1895
NUEVO LEÓN,SAN NICOLAS DE LOS GARZA,12,171,1,184,1283
NUEVO LEÓN,SAN NICOLAS DE LOS GARZA,12,177,6,195,1283
NUEVO LEÓN,SAN NICOLAS DE LOS GARZA,16,263,1,280,1769
NUEVO LEÓN,SAN NICOLAS DE LOS GARZA,18,262,6,286,1768
NUEVO LEÓN,SAN NICOLAS DE LOS GARZA,20,228,2,250,1866
NUEVO LEÓN,SAN NICOLAS DE LOS GARZA,10,191,0,201,1865
NUEVO LEÓN,SAN NICOLAS DE LOS GARZA,4,170,1,175,1178
NUEVO LEÓN,SAN NICOLAS DE LOS GARZA,4,183,2,189,1177
NUEVO LEÓN,SAN NICOLAS DE LOS GARZA,11,208,3,222,1368
NUEVO LEÓN,SAN NICOLAS DE LOS GARZA,11,192,6,209,1368
NUEVO LEÓN,SAN NICOLAS DE LOS GARZA,19,181,3,203,1476
NUEVO LEÓN,SAN NICOLAS DE LOS GARZA,19,221,1,241,1476
NUEVO LEÓN,SAN NICOLAS DE LOS GARZA,20,153,1,174,1407
NUEVO LEÓN,SAN NICOLAS DE LOS GARZA,17,190,3,210,1406
NUEVO LEÓN,SAN NICOLAS DE LOS GARZA,31,141,2,174,1406
NUEVO LEÓN,SAN NICOLAS DE LOS GARZA,46,150,4,200,1456
NUEVO LEÓN,SAN NICOLAS DE LOS GARZA,47,182,1,230,1455
NUEVO LEÓN,SAN NICOLAS DE LOS GARZA,18,146,2,166,1482
NUEVO LEÓN,SAN NICOLAS DE LOS GARZA,17,117,1,135,1482
NUEVO LEÓN,SAN NICOLAS DE LOS GARZA,32,183,2,217,1573
NUEVO LEÓN,SAN NICOLAS DE LOS GARZA,29,226,1,256,1573
NUEVO LEÓN,SAN NICOLAS DE LOS GARZA,44,165,2,211,1951
NUEVO LEÓN,SAN NICOLAS DE LOS GARZA,41,190,3,234,1950
NUEVO LEÓN,SAN NICOLAS DE LOS GARZA,41,146,0,187,1679
NUEVO LEÓN,SAN NICOLAS DE LOS GARZA,43,125,2,170,1679
NUEVO LEÓN,SAN NICOLAS DE LOS GARZA,51,238,2,291,1799
NUEVO LEÓN,SAN NICOLAS DE LOS GARZA,36,269,2,307,1798
NUEVO LEÓN,SAN NICOLAS DE LOS GARZA,20,209,3,232,1442
NUEVO LEÓN,SAN NICOLAS DE LOS GARZA,14,192,2,208,1442
NUEVO LEÓN,SAN NICOLAS DE LOS GARZA,19,198,8,225,1441
NUEVO LEÓN,SAN NICOLAS DE LOS GARZA,48,145,0,193,1561
NUEVO LEÓN,SAN NICOLAS DE LOS GARZA,39,124,1,164,1561
NUEVO LEÓN,SAN NICOLAS DE LOS GARZA,19,129,1,149,1432
NUEVO LEÓN,SAN NICOLAS DE LOS GARZA,12,128,1,141,1432
NUEVO LEÓN,SAN NICOLAS DE LOS GARZA,47,106,0,153,1513
NUEVO LEÓN,SAN NICOLAS DE LOS GARZA,36,126,0,162,1513
NUEVO LEÓN,SAN NICOLAS DE LOS GARZA,25,138,0,163,1512
NUEVO LEÓN,SAN NICOLAS DE LOS GARZA,44,106,1,151,1753
NUEVO LEÓN,SAN NICOLAS DE LOS GARZA,47,103,1,151,1753
NUEVO LEÓN,SAN NICOLAS DE LOS GARZA,41,90,0,131,1752
NUEVO LEÓN,SAN NICOLAS DE LOS GARZA,24,92,1,117,1118
NUEVO LEÓN,SAN NICOLAS DE LOS GARZA,22,89,0,111,1118
NUEVO LEÓN,SAN NICOLAS DE LOS GARZA,32,164,7,203,1443
NUEVO LEÓN,SAN NICOLAS DE LOS GARZA,29,146,0,175,1442
NUEVO LEÓN,SAN NICOLAS DE LOS GARZA,20,235,1,256,1502
NUEVO LEÓN,SAN NICOLAS DE LOS GARZA,20,231,1,252,1501
NUEVO LEÓN,SAN NICOLAS DE LOS GARZA,25,215,0,240,1771
NUEVO LEÓN,SAN NICOLAS DE LOS GARZA,31,191,0,222,1770
NUEVO LEÓN,SAN NICOLAS DE LOS GARZA,41,140,1,182,1617
NUEVO LEÓN,SAN NICOLAS DE LOS GARZA,38,105,1,144,1617
NUEVO LEÓN,SAN NICOLAS DE LOS GARZA,37,105,3,145,1616
NUEVO LEÓN,SAN NICOLAS DE LOS GARZA,28,166,1,195,1564
NUEVO LEÓN,SAN NICOLAS DE LOS GARZA,35,166,2,203,1564
NUEVO LEÓN,SAN NICOLAS DE LOS GARZA,22,146,0,168,1707
NUEVO LEÓN,SAN NICOLAS DE LOS GARZA,12,158,0,170,1706
NUEVO LEÓN,SAN NICOLAS DE LOS GARZA,39,113,1,153,1485
NUEVO LEÓN,SAN NICOLAS DE LOS GARZA,43,132,0,175,1485
NUEVO LEÓN,SAN NICOLAS DE LOS GARZA,48,118,1,167,1484
NUEVO LEÓN,SAN NICOLAS DE LOS GARZA,68,322,1,391,0
NUEVO LEÓN,SAN NICOLAS DE LOS GARZA,57,184,18,259,1876
NUEVO LEÓN,SAN NICOLAS DE LOS GARZA,40,191,0,231,1875
NUEVO LEÓN,SAN NICOLAS DE LOS GARZA,39,159,0,198,1456
NUEVO LEÓN,SAN NICOLAS DE LOS GARZA,40,156,2,198,1455
NUEVO LEÓN,SAN NICOLAS DE LOS GARZA,51,164,2,217,1455
NUEVO LEÓN,SAN NICOLAS DE LOS GARZA,34,89,0,123,1022
NUEVO LEÓN,SAN NICOLAS DE LOS GARZA,22,80,0,102,1021
NUEVO LEÓN,SAN NICOLAS DE LOS GARZA,24,186,1,211,1799
NUEVO LEÓN,SAN NICOLAS DE LOS GARZA,22,139,3,164,1798
NUEVO LEÓN,SAN NICOLAS DE LOS GARZA,49,90,1,140,1666
NUEVO LEÓN,SAN NICOLAS DE LOS GARZA,59,115,1,175,1665
NUEVO LEÓN,SAN NICOLAS DE LOS GARZA,15,157,3,175,1546
NUEVO LEÓN,SAN NICOLAS DE LOS GARZA,15,155,6,176,1545
NUEVO LEÓN,SAN NICOLAS DE LOS GARZA,12,187,4,203,1545
NUEVO LEÓN,MONTERREY,17,199,3,219,1436
NUEVO LEÓN,MONTERREY,11,237,7,255,1436
NUEVO LEÓN,MONTERREY,19,157,4,180,1087
NUEVO LEÓN,MONTERREY,14,138,4,156,1086
NUEVO LEÓN,MONTERREY,21,218,0,239,1668
NUEVO LEÓN,MONTERREY,29,212,3,244,1667
NUEVO LEÓN,MONTERREY,27,218,1,246,1667
NUEVO LEÓN,MONTERREY,27,226,0,253,1882
NUEVO LEÓN,MONTERREY,22,242,5,269,1881
NUEVO LEÓN,MONTERREY,18,197,4,219,1910
NUEVO LEÓN,MONTERREY,18,221,2,241,1910
NUEVO LEÓN,MONTERREY,11,224,1,236,1713
NUEVO LEÓN,MONTERREY,10,252,11,273,1713
NUEVO LEÓN,MONTERREY,10,221,3,234,1963
NUEVO LEÓN,MONTERREY,6,155,4,165,1172
NUEVO LEÓN,MONTERREY,3,163,3,169,1172
NUEVO LEÓN,MONTERREY,13,171,6,190,1751
NUEVO LEÓN,MONTERREY,7,196,10,213,1751
NUEVO LEÓN,MONTERREY,8,203,7,218,1879
NUEVO LEÓN,MONTERREY,17,243,4,264,1879
NUEVO LEÓN,MONTERREY,12,105,2,119,1034
NUEVO LEÓN,MONTERREY,10,124,1,135,1033
NUEVO LEÓN,MONTERREY,6,181,0,187,1895
NUEVO LEÓN,MONTERREY,8,188,4,200,1894
NUEVO LEÓN,MONTERREY,9,150,0,159,1065
NUEVO LEÓN,MONTERREY,9,146,0,155,1065
NUEVO LEÓN,MONTERREY,6,91,2,99,1124
NUEVO LEÓN,MONTERREY,2,102,2,106,1123
NUEVO LEÓN,MONTERREY,11,177,4,192,1661
NUEVO LEÓN,MONTERREY,11,145,1,157,1660
NUEVO LEÓN,MONTERREY,19,179,1,199,1920
NUEVO LEÓN,MONTERREY,24,155,2,181,1920
NUEVO LEÓN,MONTERREY,21,147,6,174,1919
NUEVO LEÓN,MONTERREY,17,140,1,158,1681
NUEVO LEÓN,MONTERREY,13,162,2,177,1681
NUEVO LEÓN,MONTERREY,5,109,2,116,1002
NUEVO LEÓN,MONTERREY,5,98,0,103,1001
NUEVO LEÓN,MONTERREY,8,101,6,115,993
NUEVO LEÓN,MONTERREY,6,90,2,98,992
NUEVO LEÓN,MONTERREY,12,102,2,116,1016
NUEVO LEÓN,MONTERREY,10,79,0,89,1016
NUEVO LEÓN,MONTERREY,19,181,8,208,1919
NUEVO LEÓN,MONTERREY,8,172,3,183,1918
NUEVO LEÓN,MONTERREY,33,403,4,440,0
NUEVO LEÓN,MONTERREY,12,175,3,190,1841
NUEVO LEÓN,MONTERREY,10,173,6,189,1841
NUEVO LEÓN,MONTERREY,9,130,1,140,1435
NUEVO LEÓN,MONTERREY,5,98,1,104,1435
NUEVO LEÓN,MONTERREY,8,86,2,96,1231
NUEVO LEÓN,MONTERREY,4,106,2,112,1231
NUEVO LEÓN,MONTERREY,6,194,3,203,1842
NUEVO LEÓN,MONTERREY,5,200,3,208,1842
NUEVO LEÓN,MONTERREY,11,127,1,139,1339
NUEVO LEÓN,MONTERREY,8,124,2,134,1339
NUEVO LEÓN,MONTERREY,9,113,2,124,1338
NUEVO LEÓN,MONTERREY,9,87,1,97,1171
NUEVO LEÓN,MONTERREY,2,115,0,117,1171
NUEVO LEÓN,MONTERREY,18,250,1,269,1946
NUEVO LEÓN,MONTERREY,28,247,0,275,1964
NUEVO LEÓN,MONTERREY,12,84,0,96,1022
NUEVO LEÓN,MONTERREY,4,93,0,97,1021
NUEVO LEÓN,MONTERREY,8,94,2,104,1136
NUEVO LEÓN,MONTERREY,12,130,1,143,1135
NUEVO LEÓN,MONTERREY,19,210,2,231,1744
NUEVO LEÓN,MONTERREY,22,235,0,257,1744
NUEVO LEÓN,MONTERREY,6,124,3,133,1096
NUEVO LEÓN,MONTERREY,6,120,3,129,1096
NUEVO LEÓN,MONTERREY,8,158,4,170,1806
NUEVO LEÓN,MONTERREY,5,131,0,136,1805
NUEVO LEÓN,MONTERREY,8,143,2,153,1748
NUEVO LEÓN,MONTERREY,10,155,2,167,1748
NUEVO LEÓN,MONTERREY,12,176,0,188,1937
NUEVO LEÓN,MONTERREY,9,182,1,192,1936
NUEVO LEÓN,MONTERREY,15,164,1,180,1257
NUEVO LEÓN,MONTERREY,11,179,1,191,1256
NUEVO LEÓN,MONTERREY,17,180,0,197,1561
NUEVO LEÓN,MONTERREY,15,180,0,195,1561
NUEVO LEÓN,MONTERREY,6,206,9,221,1920
NUEVO LEÓN,MONTERREY,11,227,5,243,1920
NUEVO LEÓN,MONTERREY,16,214,3,233,1825
NUEVO LEÓN,MONTERREY,13,232,7,252,1824
NUEVO LEÓN,MONTERREY,17,188,2,207,1358
NUEVO LEÓN,MONTERREY,10,165,5,180,1357
NUEVO LEÓN,MONTERREY,13,181,1,195,1357
NUEVO LEÓN,MONTERREY,5,133,3,141,1056
NUEVO LEÓN,MONTERREY,2,138,1,141,1056
NUEVO LEÓN,MONTERREY,9,160,3,172,1288
NUEVO LEÓN,MONTERREY,8,186,2,196,1287
NUEVO LEÓN,MONTERREY,6,101,1,108,1335
NUEVO LEÓN,MONTERREY,6,104,3,113,1335
NUEVO LEÓN,MONTERREY,24,269,8,301,1768
NUEVO LEÓN,MONTERREY,26,294,7,327,1767
NUEVO LEÓN,MONTERREY,24,214,3,241,1608
NUEVO LEÓN,MONTERREY,18,236,0,254,1608
NUEVO LEÓN,MONTERREY,16,297,9,322,1846
NUEVO LEÓN,MONTERREY,16,286,1,303,1845
NUEVO LEÓN,MONTERREY,9,207,2,218,1905
NUEVO LEÓN,MONTERREY,4,223,7,234,1904
NUEVO LEÓN,MONTERREY,6,114,0,120,1107
NUEVO LEÓN,MONTERREY,0,131,0,131,1106
NUEVO LEÓN,MONTERREY,8,253,1,262,1921
NUEVO LEÓN,MONTERREY,7,217,2,226,1920
NUEVO LEÓN,MONTERREY,8,222,0,230,1967
NUEVO LEÓN,MONTERREY,6,223,8,237,1966
NUEVO LEÓN,MONTERREY,9,153,6,168,1092
NUEVO LEÓN,MONTERREY,7,154,1,162,1092
NUEVO LEÓN,MONTERREY,7,163,4,174,1676
NUEVO LEÓN,MONTERREY,10,157,7,174,1676
NUEVO LEÓN,MONTERREY,16,190,2,208,1541
NUEVO LEÓN,MONTERREY,9,235,3,247,1541
NUEVO LEÓN,MONTERREY,19,207,7,233,1821
NUEVO LEÓN,MONTERREY,21,185,3,209,1821
NUEVO LEÓN,MONTERREY,13,310,8,331,1795
NUEVO LEÓN,MONTERREY,11,295,6,312,1794
NUEVO LEÓN,MONTERREY,6,214,8,228,1708
NUEVO LEÓN,MONTERREY,11,254,1,266,1708
NUEVO LEÓN,MONTERREY,9,232,5,246,1757
NUEVO LEÓN,MONTERREY,10,245,10,265,1757
NUEVO LEÓN,MONTERREY,13,218,2,233,1596
NUEVO LEÓN,MONTERREY,12,208,2,222,1596
NUEVO LEÓN,MONTERREY,4,162,2,168,1746
NUEVO LEÓN,MONTERREY,16,180,0,196,1745
NUEVO LEÓN,MONTERREY,10,115,4,129,1855
NUEVO LEÓN,MONTERREY,7,112,1,120,1855
NUEVO LEÓN,MONTERREY,6,113,0,119,1855
NUEVO LEÓN,MONTERREY,6,115,0,121,1855
NUEVO LEÓN,MONTERREY,2,132,0,134,1855
NUEVO LEÓN,MONTERREY,9,111,1,121,1855
NUEVO LEÓN,MONTERREY,6,112,4,122,1854
NUEVO LEÓN,MONTERREY,6,119,2,127,1854
NUEVO LEÓN,MONTERREY,16,90,2,108,1203
NUEVO LEÓN,MONTERREY,7,94,0,101,1202
NUEVO LEÓN,MONTERREY,13,130,2,145,1709
NUEVO LEÓN,MONTERREY,15,125,1,141,1709
NUEVO LEÓN,MONTERREY,9,115,0,124,1709
NUEVO LEÓN,MONTERREY,9,119,2,130,1708
NUEVO LEÓN,MONTERREY,25,131,0,156,1173
NUEVO LEÓN,MONTERREY,21,129,2,152,1173
NUEVO LEÓN,MONTERREY,15,113,1,129,1414
NUEVO LEÓN,MONTERREY,16,122,0,138,1413
NUEVO LEÓN,MONTERREY,19,131,1,151,1413
NUEVO LEÓN,MONTERREY,18,130,0,148,1511
NUEVO LEÓN,MONTERREY,22,121,1,144,1511
NUEVO LEÓN,MONTERREY,36,139,0,175,1511
NUEVO LEÓN,MONTERREY,22,119,0,141,1476
NUEVO LEÓN,MONTERREY,19,106,0,125,1476
NUEVO LEÓN,MONTERREY,28,125,0,153,1476
NUEVO LEÓN,MONTERREY,7,106,2,115,1432
NUEVO LEÓN,MONTERREY,9,85,0,94,1431
NUEVO LEÓN,MONTERREY,13,90,1,104,1431
NUEVO LEÓN,MONTERREY,12,129,0,141,1950
NUEVO LEÓN,MONTERREY,18,118,1,137,1950
NUEVO LEÓN,MONTERREY,8,125,2,135,1950
NUEVO LEÓN,MONTERREY,12,128,0,140,1826
NUEVO LEÓN,MONTERREY,9,153,1,163,1826
NUEVO LEÓN,MONTERREY,6,126,1,133,1825
NUEVO LEÓN,MONTERREY,39,113,3,155,1789
NUEVO LEÓN,MONTERREY,34,105,0,139,1788
NUEVO LEÓN,MONTERREY,41,113,0,154,1788
NUEVO LEÓN,MONTERREY,23,111,0,134,1788
NUEVO LEÓN,MONTERREY,32,142,0,174,1788
NUEVO LEÓN,MONTERREY,30,130,0,160,1788
NUEVO LEÓN,MONTERREY,37,118,1,156,1788
NUEVO LEÓN,MONTERREY,22,160,3,185,1432
NUEVO LEÓN,MONTERREY,23,172,3,198,1431
NUEVO LEÓN,MONTERREY,58,136,3,197,1669
NUEVO LEÓN,MONTERREY,56,167,2,225,1668
NUEVO LEÓN,MONTERREY,42,87,1,130,1042
NUEVO LEÓN,MONTERREY,44,93,0,137,1042
NUEVO LEÓN,MONTERREY,22,107,0,129,1027
NUEVO LEÓN,MONTERREY,30,123,2,155,1027
NUEVO LEÓN,MONTERREY,40,155,3,198,1475
NUEVO LEÓN,MONTERREY,163,28,0,191,1394
NUEVO LEÓN,MONTERREY,22,184,0,206,1394
NUEVO LEÓN,MONTERREY,24,207,2,233,1393
NUEVO LEÓN,MONTERREY,72,132,6,210,1450
NUEVO LEÓN,MONTERREY,62,130,1,193,1449
NUEVO LEÓN,MONTERREY,23,221,2,246,1556
NUEVO LEÓN,MONTERREY,29,191,3,223,1556
NUEVO LEÓN,MONTERREY,93,202,2,297,1955
NUEVO LEÓN,MONTERREY,29,98,0,127,1024
NUEVO LEÓN,MONTERREY,33,103,0,136,1023
NUEVO LEÓN,MONTERREY,55,192,3,250,1737
NUEVO LEÓN,MONTERREY,50,148,1,199,1736
NUEVO LEÓN,MONTERREY,28,224,0,252,1677
NUEVO LEÓN,MONTERREY,21,233,0,254,1677
NUEVO LEÓN,MONTERREY,35,181,1,217,1538
NUEVO LEÓN,MONTERREY,41,187,2,230,1538
NUEVO LEÓN,MONTERREY,83,96,0,179,1533
NUEVO LEÓN,MONTERREY,91,108,1,200,1533
NUEVO LEÓN,MONTERREY,109,89,1,199,1532
NUEVO LEÓN,MONTERREY,105,112,2,219,1826
NUEVO LEÓN,MONTERREY,100,119,1,220,1826
NUEVO LEÓN,MONTERREY,63,155,3,221,1457
NUEVO LEÓN,MONTERREY,47,175,0,222,1457
NUEVO LEÓN,MONTERREY,177,52,2,231,1456
NUEVO LEÓN,MONTERREY,158,62,0,220,1574
NUEVO LEÓN,MONTERREY,160,63,3,226,1574
NUEVO LEÓN,MONTERREY,119,65,0,184,1574
NUEVO LEÓN,MONTERREY,175,56,1,232,1573
NUEVO LEÓN,MONTERREY,136,44,1,181,1402
NUEVO LEÓN,MONTERREY,119,71,0,190,1401
NUEVO LEÓN,MONTERREY,81,56,1,138,1117
NUEVO LEÓN,MONTERREY,61,69,0,130,1117
NUEVO LEÓN,MONTERREY,93,120,0,213,1324
NUEVO LEÓN,MONTERREY,71,79,0,150,1324
NUEVO LEÓN,MONTERREY,17,103,1,121,1365
NUEVO LEÓN,MONTERREY,14,152,2,168,1365
NUEVO LEÓN,MONTERREY,4,139,1,144,1205
NUEVO LEÓN,MONTERREY,7,142,0,149,1204
NUEVO LEÓN,MONTERREY,27,207,3,237,1808
NUEVO LEÓN,MONTERREY,48,230,1,279,1807
NUEVO LEÓN,MONTERREY,20,177,3,200,1325
NUEVO LEÓN,MONTERREY,21,152,1,174,1324
NUEVO LEÓN,MONTERREY,29,166,1,196,1324
NUEVO LEÓN,MONTERREY,92,59,0,151,1137
NUEVO LEÓN,MONTERREY,71,50,3,124,1137
NUEVO LEÓN,MONTERREY,68,158,0,226,1770
NUEVO LEÓN,MONTERREY,161,68,2,231,1635
NUEVO LEÓN,MONTERREY,144,63,1,208,1635
NUEVO LEÓN,MONTERREY,200,44,1,245,1712
NUEVO LEÓN,MONTERREY,174,52,0,226,1711
NUEVO LEÓN,MONTERREY,149,32,1,182,1449
NUEVO LEÓN,MONTERREY,163,33,0,196,1449
NUEVO LEÓN,MONTERREY,143,34,1,178,1448
NUEVO LEÓN,MONTERREY,200,61,0,261,1657
NUEVO LEÓN,MONTERREY,200,57,1,258,1657
NUEVO LEÓN,MONTERREY,71,85,0,156,1398
NUEVO LEÓN,MONTERREY,62,86,0,148,1397
NUEVO LEÓN,MONTERREY,173,57,2,232,1889
NUEVO LEÓN,MONTERREY,132,74,2,208,1889
NUEVO LEÓN,MONTERREY,143,52,0,195,1719
NUEVO LEÓN,MONTERREY,177,52,3,232,1719
NUEVO LEÓN,MONTERREY,156,75,2,233,1719
NUEVO LEÓN,MONTERREY,182,54,0,236,1719
NUEVO LEÓN,MONTERREY,92,31,2,125,1020
NUEVO LEÓN,MONTERREY,80,60,0,140,1020
NUEVO LEÓN,MONTERREY,37,94,0,131,1171
NUEVO LEÓN,MONTERREY,31,94,1,126,1170
NUEVO LEÓN,MONTERREY,70,152,0,222,1965
NUEVO LEÓN,MONTERREY,64,63,0,127,1088
NUEVO LEÓN,MONTERREY,60,69,0,129,1088
NUEVO LEÓN,MONTERREY,29,113,1,143,1137
NUEVO LEÓN,MONTERREY,28,102,2,132,1136
NUEVO LEÓN,MONTERREY,79,41,1,121,996
NUEVO LEÓN,MONTERREY,84,42,1,127,996
NUEVO LEÓN,MONTERREY,7,129,2,138,1512
NUEVO LEÓN,MONTERREY,5,139,0,144,1511
NUEVO LEÓN,MONTERREY,8,116,1,125,1516
NUEVO LEÓN,MONTERREY,21,122,2,145,1516
NUEVO LEÓN,MONTERREY,13,141,4,158,1516
NUEVO LEÓN,MONTERREY,12,120,2,134,1515
NUEVO LEÓN,MONTERREY,10,179,1,190,1751
NUEVO LEÓN,MONTERREY,6,176,2,184,1751
NUEVO LEÓN,MONTERREY,10,175,4,189,1751
NUEVO LEÓN,MONTERREY,14,174,2,190,1551
NUEVO LEÓN,MONTERREY,5,170,3,178,1551
NUEVO LEÓN,MONTERREY,9,206,7,222,1861
NUEVO LEÓN,MONTERREY,8,247,8,263,1861
NUEVO LEÓN,MONTERREY,13,254,7,274,1911
NUEVO LEÓN,MONTERREY,5,245,8,258,1910
NUEVO LEÓN,MONTERREY,37,138,1,176,1587
NUEVO LEÓN,MONTERREY,34,121,1,156,1586
NUEVO LEÓN,MONTERREY,14,189,0,203,1508
NUEVO LEÓN,MONTERREY,14,175,1,190,1508
NUEVO LEÓN,MONTERREY,21,168,3,192,1508
NUEVO LEÓN,MONTERREY,17,158,3,178,1508
NUEVO LEÓN,MONTERREY,17,148,0,165,1508
NUEVO LEÓN,MONTERREY,22,155,1,178,1508
NUEVO LEÓN,MONTERREY,22,166,1,189,1508
NUEVO LEÓN,MONTERREY,34,237,4,275,1686
NUEVO LEÓN,MONTERREY,35,220,2,257,1686
NUEVO LEÓN,MONTERREY,35,244,1,280,1726
NUEVO LEÓN,MONTERREY,45,251,2,298,1725
NUEVO LEÓN,MONTERREY,48,168,3,219,1870
NUEVO LEÓN,MONTERREY,52,187,1,240,1869
NUEVO LEÓN,MONTERREY,25,161,3,189,1021
NUEVO LEÓN,MONTERREY,18,166,2,186,1020
NUEVO LEÓN,MONTERREY,73,83,0,156,1596
NUEVO LEÓN,MONTERREY,62,102,2,166,1596
NUEVO LEÓN,MONTERREY,67,77,2,146,1595
NUEVO LEÓN,MONTERREY,76,96,1,173,1595
NUEVO LEÓN,MONTERREY,69,99,0,168,1826
NUEVO LEÓN,MONTERREY,86,113,2,201,1826
NUEVO LEÓN,MONTERREY,87,81,1,169,1826
NUEVO LEÓN,MONTERREY,67,104,2,173,1826
NUEVO LEÓN,MONTERREY,20,232,3,255,1468
NUEVO LEÓN,MONTERREY,22,248,3,273,1572
NUEVO LEÓN,MONTERREY,25,229,2,256,1572
NUEVO LEÓN,MONTERREY,19,237,3,259,1571
NUEVO LEÓN,MONTERREY,38,176,2,216,1488
NUEVO LEÓN,MONTERREY,34,180,2,216,1549
NUEVO LEÓN,MONTERREY,33,183,0,216,1549
NUEVO LEÓN,MONTERREY,32,168,2,202,1548
NUEVO LEÓN,MONTERREY,35,283,1,319,1621
NUEVO LEÓN,MONTERREY,30,229,2,261,1455
NUEVO LEÓN,MONTERREY,36,253,2,291,1455
NUEVO LEÓN,MONTERREY,1,214,2,217,1410
NUEVO LEÓN,MONTERREY,12,196,1,209,1410
NUEVO LEÓN,MONTERREY,14,194,7,215,1409
NUEVO LEÓN,MONTERREY,63,171,2,236,1660
NUEVO LEÓN,MONTERREY,42,158,1,201,1660
NUEVO LEÓN,MONTERREY,38,178,1,217,1660
NUEVO LEÓN,MONTERREY,45,168,4,217,1660
NUEVO LEÓN,MONTERREY,28,275,2,305,1607
NUEVO LEÓN,MONTERREY,9,164,2,175,1007
NUEVO LEÓN,MONTERREY,15,156,2,173,1007
NUEVO LEÓN,MONTERREY,142,371,2,515,0
NUEVO LEÓN,MONTERREY,18,295,4,317,1827
NUEVO LEÓN,MONTERREY,15,256,5,276,1826
NUEVO LEÓN,MONTERREY,10,185,4,199,1574
NUEVO LEÓN,MONTERREY,14,169,4,187,1574
NUEVO LEÓN,MONTERREY,7,179,6,192,1574
NUEVO LEÓN,MONTERREY,10,185,2,197,1574
NUEVO LEÓN,MONTERREY,26,156,1,183,1550
NUEVO LEÓN,MONTERREY,12,141,1,154,1550
NUEVO LEÓN,MONTERREY,19,150,2,171,1549
NUEVO LEÓN,MONTERREY,35,204,4,243,1604
NUEVO LEÓN,MONTERREY,17,180,4,201,1603
NUEVO LEÓN,MONTERREY,47,245,1,293,1894
NUEVO LEÓN,MONTERREY,41,220,4,265,1893
NUEVO LEÓN,MONTERREY,19,215,2,236,1600
NUEVO LEÓN,MONTERREY,17,212,2,231,1600
NUEVO LEÓN,MONTERREY,18,228,0,246,1599
NUEVO LEÓN,MONTERREY,129,56,2,187,1911
NUEVO LEÓN,MONTERREY,122,56,3,181,1910
NUEVO LEÓN,MONTERREY,109,45,0,154,1910
NUEVO LEÓN,MONTERREY,98,46,0,144,1483
NUEVO LEÓN,MONTERREY,121,48,1,170,1483
NUEVO LEÓN,MONTERREY,167,46,1,214,1770
NUEVO LEÓN,MONTERREY,170,75,1,246,1769
NUEVO LEÓN,MONTERREY,68,117,0,185,1582
NUEVO LEÓN,MONTERREY,60,117,1,178,1582
NUEVO LEÓN,MONTERREY,61,232,3,296,1773
NUEVO LEÓN,MONTERREY,71,221,1,293,1773
NUEVO LEÓN,MONTERREY,59,237,5,301,1773
NUEVO LEÓN,MONTERREY,15,178,0,193,1674
NUEVO LEÓN,MONTERREY,26,143,5,174,1674
NUEVO LEÓN,MONTERREY,12,153,2,167,1673
NUEVO LEÓN,MONTERREY,26,140,2,168,1171
NUEVO LEÓN,MONTERREY,25,118,2,145,1171
NUEVO LEÓN,MONTERREY,24,176,3,203,1817
NUEVO LEÓN,MONTERREY,15,199,2,216,1817
NUEVO LEÓN,MONTERREY,36,235,4,275,1859
NUEVO LEÓN,MONTERREY,28,167,5,200,1361
NUEVO LEÓN,MONTERREY,24,169,1,194,1360
NUEVO LEÓN,MONTERREY,19,185,0,204,1360
NUEVO LEÓN,MONTERREY,48,161,3,212,1396
NUEVO LEÓN,MONTERREY,53,152,1,206,1396
NUEVO LEÓN,MONTERREY,45,164,1,210,1395
NUEVO LEÓN,MONTERREY,42,114,1,157,1052
NUEVO LEÓN,MONTERREY,40,97,1,138,1051
NUEVO LEÓN,MONTERREY,128,135,3,266,1894
NUEVO LEÓN,MONTERREY,108,127,5,240,1893
NUEVO LEÓN,MONTERREY,127,128,1,256,1893
NUEVO LEÓN,MONTERREY,75,112,2,189,1459
NUEVO LEÓN,MONTERREY,61,125,0,186,1458
NUEVO LEÓN,MONTERREY,29,196,6,231,1743
NUEVO LEÓN,MONTERREY,24,193,1,218,1743
NUEVO LEÓN,MONTERREY,43,142,0,185,1421
NUEVO LEÓN,MONTERREY,17,157,0,174,1421
NUEVO LEÓN,MONTERREY,39,141,0,180,1420
NUEVO LEÓN,MONTERREY,25,159,2,186,1500
NUEVO LEÓN,MONTERREY,28,208,0,236,1499
NUEVO LEÓN,MONTERREY,32,188,2,222,1499
NUEVO LEÓN,MONTERREY,27,193,6,226,1587
NUEVO LEÓN,MONTERREY,16,206,7,229,1587
NUEVO LEÓN,MONTERREY,34,213,3,250,1586
NUEVO LEÓN,MONTERREY,19,252,2,273,1915
NUEVO LEÓN,MONTERREY,12,195,3,210,1680
NUEVO LEÓN,MONTERREY,11,206,2,219,1680
NUEVO LEÓN,MONTERREY,19,248,16,283,1919
NUEVO LEÓN,MONTERREY,19,269,1,289,1918
NUEVO LEÓN,MONTERREY,17,184,5,206,1499
NUEVO LEÓN,MONTERREY,11,174,7,192,1499
NUEVO LEÓN,MONTERREY,30,166,4,200,1884
NUEVO LEÓN,MONTERREY,20,213,0,233,1883
NUEVO LEÓN,MONTERREY,104,67,1,172,1892
NUEVO LEÓN,MONTERREY,67,69,1,137,1892
NUEVO LEÓN,MONTERREY,55,72,1,128,1574
NUEVO LEÓN,MONTERREY,67,54,1,122,1574
NUEVO LEÓN,MONTERREY,72,56,1,129,1573
NUEVO LEÓN,MONTERREY,57,53,0,110,1573
NUEVO LEÓN,MONTERREY,43,73,1,117,1481
NUEVO LEÓN,MONTERREY,61,77,2,140,1481
NUEVO LEÓN,MONTERREY,58,50,3,111,1798
NUEVO LEÓN,MONTERREY,68,72,0,140,1798
NUEVO LEÓN,MONTERREY,57,42,1,100,1531
NUEVO LEÓN,MONTERREY,75,45,0,120,1531
NUEVO LEÓN,MONTERREY,58,32,0,90,1531
NUEVO LEÓN,MONTERREY,75,50,1,126,1531
NUEVO LEÓN,MONTERREY,55,32,0,87,1433
NUEVO LEÓN,MONTERREY,54,40,0,94,1432
NUEVO LEÓN,MONTERREY,56,29,5,90,1432
NUEVO LEÓN,GARCIA,8,155,3,166,1205
NUEVO LEÓN,GARCIA,17,149,4,170,1205
NUEVO LEÓN,GARCIA,20,142,5,167,2049
NUEVO LEÓN,GARCIA,14,145,3,162,2048
NUEVO LEÓN,GARCIA,10,173,1,184,1464
NUEVO LEÓN,GARCIA,11,162,3,176,1463
NUEVO LEÓN,GARCIA,10,155,5,170,1463
NUEVO LEÓN,GARCIA,9,111,0,120,1383
NUEVO LEÓN,GARCIA,7,126,4,137,1383
NUEVO LEÓN,GARCIA,6,236,9,251,1466
NUEVO LEÓN,GARCIA,10,191,4,205,1466
NUEVO LEÓN,GARCIA,4,115,3,122,1432
NUEVO LEÓN,GARCIA,10,149,2,161,1431
NUEVO LEÓN,GARCIA,1,125,0,126,1431
NUEVO LEÓN,GARCIA,16,221,4,241,1602
NUEVO LEÓN,GARCIA,7,236,4,247,1601
NUEVO LEÓN,GARCIA,2,110,4,116,1790
NUEVO LEÓN,GARCIA,4,145,1,150,1790
NUEVO LEÓN,GARCIA,9,121,0,130,1790
NUEVO LEÓN,GARCIA,6,124,0,130,1789
NUEVO LEÓN,GARCIA,7,121,0,128,1789
NUEVO LEÓN,GARCIA,7,104,0,111,1789
NUEVO LEÓN,GARCIA,16,120,2,138,1368
NUEVO LEÓN,GARCIA,8,120,2,130,1367
NUEVO LEÓN,GARCIA,6,86,0,92,1953
NUEVO LEÓN,GARCIA,7,105,6,118,1953
NUEVO LEÓN,GARCIA,6,110,2,118,1953
NUEVO LEÓN,GARCIA,2,94,1,97,1953
NUEVO LEÓN,GARCIA,10,96,0,106,1953
NUEVO LEÓN,GARCIA,6,97,1,104,1952
NUEVO LEÓN,GARCIA,112,4,2,118,1952
NUEVO LEÓN,GARCIA,6,93,0,99,1952
NUEVO LEÓN,GARCIA,2,87,1,90,1952
NUEVO LEÓN,GARCIA,7,108,1,116,1963
NUEVO LEÓN,GARCIA,6,111,0,117,1963
NUEVO LEÓN,GARCIA,14,94,2,110,1963
NUEVO LEÓN,GARCIA,3,97,1,101,1963
NUEVO LEÓN,GARCIA,3,96,1,100,1963
NUEVO LEÓN,GARCIA,6,96,2,104,1963
NUEVO LEÓN,GARCIA,10,92,2,104,1963
NUEVO LEÓN,GARCIA,3,94,1,98,1962
NUEVO LEÓN,GARCIA,18,118,4,140,1958
NUEVO LEÓN,GARCIA,7,116,0,123,1958
NUEVO LEÓN,GARCIA,12,117,0,129,1957
NUEVO LEÓN,GARCIA,6,156,2,164,1893
NUEVO LEÓN,GARCIA,8,177,2,187,1892
NUEVO LEÓN,GARCIA,4,146,2,152,1892
NUEVO LEÓN,GARCIA,6,188,2,196,1892
NUEVO LEÓN,GARCIA,11,162,2,175,1892
NUEVO LEÓN,GARCIA,4,177,2,183,1892
NUEVO LEÓN,GARCIA,7,153,3,163,1892
NUEVO LEÓN,GARCIA,5,176,3,184,1892
NUEVO LEÓN,GARCIA,3,151,0,154,1892
NUEVO LEÓN,GARCIA,6,239,8,253,1862
NUEVO LEÓN,GARCIA,14,274,5,293,1862
NUEVO LEÓN,GARCIA,12,246,4,262,1862
NUEVO LEÓN,GARCIA,21,267,3,291,1862
NUEVO LEÓN,GARCIA,12,236,5,253,1862
NUEVO LEÓN,GARCIA,6,267,6,279,1862
NUEVO LEÓN,GARCIA,11,237,2,250,1861
NUEVO LEÓN,GARCIA,24,320,5,349,1727
NUEVO LEÓN,GARCIA,31,274,13,318,1727
NUEVO LEÓN,GARCIA,12,297,4,313,1727
NUEVO LEÓN,GARCIA,5,306,4,315,1764
NUEVO LEÓN,GARCIA,7,108,0,115,1718
NUEVO LEÓN,GARCIA,13,107,1,121,1718
NUEVO LEÓN,GARCIA,5,83,1,89,1717
NUEVO LEÓN,GARCIA,7,232,6,245,2020
NUEVO LEÓN,GARCIA,16,197,4,217,2020
NUEVO LEÓN,GARCIA,8,158,2,168,1406
NUEVO LEÓN,GARCIA,4,174,1,179,1405
NUEVO LEÓN,GARCIA,8,155,4,167,1405
NUEVO LEÓN,GARCIA,2,194,6,202,1516
NUEVO LEÓN,GARCIA,3,209,0,212,1516
NUEVO LEÓN,GARCIA,8,164,4,176,1516
NUEVO LEÓN,GARCIA,19,82,25,126,1424
NUEVO LEÓN,GARCIA,15,210,3,228,1668
NUEVO LEÓN,GARCIA,10,182,0,192,1668
NUEVO LEÓN,GARCIA,4,201,3,208,1667
NUEVO LEÓN,GARCIA,19,163,1,183,1940
NUEVO LEÓN,GARCIA,25,215,3,243,1610
NUEVO LEÓN,GARCIA,11,203,2,216,1610
NUEVO LEÓN,GARCIA,23,193,2,218,1609
NUEVO LEÓN,GARCIA,16,188,1,205,1609
NUEVO LEÓN,GARCIA,18,188,4,210,1698
NUEVO LEÓN,GARCIA,20,184,4,208,1698
NUEVO LEÓN,GARCIA,12,184,3,199,1698
NUEVO LEÓN,GARCIA,15,262,2,279,2010
NUEVO LEÓN,GARCIA,8,231,0,239,2010
NUEVO LEÓN,GARCIA,15,284,1,300,2009
NUEVO LEÓN,GARCIA,14,205,3,222,1599
NUEVO LEÓN,GARCIA,14,202,1,217,1599
NUEVO LEÓN,GARCIA,9,193,3,205,1599
NUEVO LEÓN,GARCIA,6,191,1,198,1599
NUEVO LEÓN,GARCIA,11,199,6,216,2022
NUEVO LEÓN,GARCIA,9,211,3,223,2022
NUEVO LEÓN,GARCIA,9,185,5,199,2022
NUEVO LEÓN,GARCIA,8,163,1,172,1485
NUEVO LEÓN,GARCIA,11,149,5,165,1485
NUEVO LEÓN,GARCIA,13,179,1,193,1763
NUEVO LEÓN,GARCIA,10,154,1,165,1762
NUEVO LEÓN,GARCIA,10,92,1,103,1265
NUEVO LEÓN,GARCIA,4,92,2,98,1264
NUEVO LEÓN,GARCIA,6,142,3,151,1139
NUEVO LEÓN,GARCIA,6,158,2,166,1138
NUEVO LEÓN,GARCIA,11,310,3,324,1867
NUEVO LEÓN,GARCIA,13,352,5,370,1866
NUEVO LEÓN,GARCIA,6,175,1,182,1627
NUEVO LEÓN,GARCIA,11,150,1,162,1627
NUEVO LEÓN,GARCIA,9,139,0,148,1627
NUEVO LEÓN,GARCIA,3,148,2,153,1627
NUEVO LEÓN,GARCIA,6,141,1,148,1626
NUEVO LEÓN,GARCIA,3,165,3,171,1611
NUEVO LEÓN,GARCIA,13,189,2,204,1611
NUEVO LEÓN,GARCIA,10,166,0,176,1610
NUEVO LEÓN,GARCIA,7,229,4,240,1871
NUEVO LEÓN,GARCIA,8,218,1,227,1870
NUEVO LEÓN,GARCIA,9,225,1,235,1870
NUEVO LEÓN,GARCIA,10,198,0,208,1870
NUEVO LEÓN,GARCIA,9,237,2,248,1790
NUEVO LEÓN,GARCIA,7,208,1,216,1790
NUEVO LEÓN,GARCIA,7,184,3,194,1789
NUEVO LEÓN,GARCIA,6,226,2,234,1789
NUEVO LEÓN,GARCIA,5,249,0,254,1945
NUEVO LEÓN,GARCIA,8,229,1,238,1945
NUEVO LEÓN,GARCIA,9,205,0,214,1944
NUEVO LEÓN,GARCIA,12,219,0,231,1825
NUEVO LEÓN,GARCIA,10,188,1,199,1825
NUEVO LEÓN,GARCIA,10,208,0,218,1824
NUEVO LEÓN,GARCIA,4,143,1,148,1016
NUEVO LEÓN,GARCIA,9,126,2,137,1016
NUEVO LEÓN,GARCIA,9,175,2,186,1785
NUEVO LEÓN,GARCIA,9,169,1,179,1785
NUEVO LEÓN,GARCIA,2,199,1,202,1785
NUEVO LEÓN,GARCIA,8,190,0,198,1785
NUEVO LEÓN,GARCIA,7,146,29,182,1785
NUEVO LEÓN,GARCIA,7,176,0,183,1785
NUEVO LEÓN,GARCIA,7,203,3,213,1785
NUEVO LEÓN,GARCIA,3,122,0,125,1606
NUEVO LEÓN,GARCIA,6,83,0,89,1606
NUEVO LEÓN,GARCIA,4,117,0,121,1606
NUEVO LEÓN,GARCIA,5,205,1,211,1665
NUEVO LEÓN,GARCIA,4,193,4,201,1665
NUEVO LEÓN,GARCIA,12,201,0,213,1665
NUEVO LEÓN,GARCIA,6,154,5,165,2140
NUEVO LEÓN,GARCIA,4,137,1,142,2140
NUEVO LEÓN,GARCIA,8,144,0,152,1826
NUEVO LEÓN,GARCIA,3,148,0,151,1826
NUEVO LEÓN,GARCIA,7,124,0,131,1825
NUEVO LEÓN,GARCIA,9,114,2,125,1913
NUEVO LEÓN,GARCIA,9,113,0,122,1913
NUEVO LEÓN,GARCIA,13,121,1,135,1912
NUEVO LEÓN,GARCIA,9,95,0,104,1912
NUEVO LEÓN,GARCIA,9,165,0,174,1585
NUEVO LEÓN,GARCIA,4,172,2,178,1585
NUEVO LEÓN,GARCIA,4,177,3,184,1584
NUEVO LEÓN,GARCIA,5,142,1,148,1817
NUEVO LEÓN,GARCIA,4,150,1,155,1817
NUEVO LEÓN,GARCIA,12,148,0,160,1816
NUEVO LEÓN,GARCIA,6,137,1,144,1816
NUEVO LEÓN,GARCIA,22,130,0,152,2174
NUEVO LEÓN,GARCIA,5,140,0,145,2174
NUEVO LEÓN,GARCIA,7,117,1,125,2174
NUEVO LEÓN,GARCIA,13,134,0,147,1708
NUEVO LEÓN,GARCIA,18,131,0,149,1708
NUEVO LEÓN,GARCIA,19,135,2,156,1707
NUEVO LEÓN,GARCIA,19,205,5,229,1613
NUEVO LEÓN,GARCIA,15,189,2,206,1612
NUEVO LEÓN,GARCIA,10,174,1,185,2023
NUEVO LEÓN,GARCIA,7,154,1,162,2023
NUEVO LEÓN,GARCIA,10,152,2,164,2023
NUEVO LEÓN,GARCIA,7,145,1,153,2022
NUEVO LEÓN,GARCIA,49,108,3,160,1768
NUEVO LEÓN,GARCIA,39,148,0,187,1768
NUEVO LEÓN,GARCIA,32,134,2,168,1768
NUEVO LEÓN,GARCIA,28,183,2,213,1919
NUEVO LEÓN,GARCIA,28,181,2,211,1919
NUEVO LEÓN,GARCIA,15,172,2,189,1919
NUEVO LEÓN,GARCIA,47,91,4,142,1637
NUEVO LEÓN,GARCIA,54,87,0,141,1637
NUEVO LEÓN,GARCIA,45,87,1,133,1637
NUEVO LEÓN,GARCIA,32,88,0,120,1637
NUEVO LEÓN,GARCIA,47,85,5,137,1636
NUEVO LEÓN,GARCIA,34,212,4,250,1907
NUEVO LEÓN,GARCIA,44,190,4,238,1906
NUEVO LEÓN,GARCIA,44,197,1,242,1906
NUEVO LEÓN,GARCIA,45,109,5,159,1664
NUEVO LEÓN,GARCIA,69,94,0,163,1664
NUEVO LEÓN,GARCIA,37,114,3,154,1664
NUEVO LEÓN,GARCIA,55,116,0,171,1663
NUEVO LEÓN,GARCIA,216,8,0,224,2022
NUEVO LEÓN,GARCIA,10,219,2,231,2022
NUEVO LEÓN,GARCIA,7,236,0,243,2022
NUEVO LEÓN,GARCIA,16,196,1,213,1951
NUEVO LEÓN,GARCIA,8,203,0,211,1950
NUEVO LEÓN,GARCIA,6,194,0,200,1836
NUEVO LEÓN,GARCIA,6,157,0,163,1835
NUEVO LEÓN,GARCIA,9,169,0,178,1835
NUEVO LEÓN,GARCIA,5,205,0,210,1792
NUEVO LEÓN,GARCIA,12,190,2,204,1791
NUEVO LEÓN,GARCIA,2,144,0,146,1185
NUEVO LEÓN,GARCIA,7,124,0,131,1185
NUEVO LEÓN,GARCIA,8,170,1,179,2072
NUEVO LEÓN,GARCIA,11,178,1,190,2071
NUEVO LEÓN,GARCIA,5,138,4,147,1488
NUEVO LEÓN,GARCIA,4,135,3,142,1487
NUEVO LEÓN,GARCIA,11,125,0,136,1544
NUEVO LEÓN,GARCIA,14,116,0,130,1543
NUEVO LEÓN,GARCIA,0,143,1,144,1705
NUEVO LEÓN,GARCIA,4,186,3,193,1705
NUEVO LEÓN,GARCIA,96,476,1,573,0
NUEVO LEÓN,GARCIA,7,152,3,162,1291
NUEVO LEÓN,GARCIA,13,128,0,141,1291
NUEVO LEÓN,GARCIA,8,111,0,119,1555
NUEVO LEÓN,GARCIA,2,116,0,118,1555
NUEVO LEÓN,GARCIA,1,110,3,114,1555
NUEVO LEÓN,GARCIA,1,129,0,130,1483
NUEVO LEÓN,GARCIA,1,116,0,117,1483
NUEVO LEÓN,GARCIA,3,89,0,92,1366
NUEVO LEÓN,GARCIA,3,88,2,93,1366
NUEVO LEÓN,GARCIA,7,99,0,106,1366
NUEVO LEÓN,GARCIA,12,174,4,190,1530
NUEVO LEÓN,GARCIA,11,153,2,166,1529
NUEVO LEÓN,GARCIA,10,146,2,158,1529
NUEVO LEÓN,GARCIA,1,138,4,143,1112
NUEVO LEÓN,GARCIA,4,109,3,116,1112
NUEVO LEÓN,GARCIA,11,120,0,131,1752
NUEVO LEÓN,GARCIA,3,94,0,97,1752
NUEVO LEÓN,GARCIA,4,112,0,116,1751
NUEVO LEÓN,GARCIA,1,79,0,80,1751
NUEVO LEÓN,GARCIA,16,109,0,125,1715
NUEVO LEÓN,GARCIA,8,88,1,97,1714
NUEVO LEÓN,GARCIA,8,100,0,108,1714
NUEVO LEÓN,GARCIA,5,80,0,85,1714
NUEVO LEÓN,GARCIA,4,176,2,182,1625
NUEVO LEÓN,GARCIA,7,179,4,190,1624
NUEVO LEÓN,GARCIA,3,107,1,111,1519
NUEVO LEÓN,GARCIA,10,124,3,137,1518
NUEVO LEÓN,GARCIA,10,120,2,132,1518
NUEVO LEÓN,GARCIA,7,143,0,150,1944
NUEVO LEÓN,GARCIA,8,160,0,168,1944
NUEVO LEÓN,GARCIA,8,142,0,150,1943
NUEVO LEÓN,GARCIA,8,157,0,165,1943
NUEVO LEÓN,GARCIA,7,174,3,184,1932
NUEVO LEÓN,GARCIA,5,181,3,189,1932
NUEVO LEÓN,GARCIA,7,194,0,201,1932
NUEVO LEÓN,GARCIA,6,152,0,158,1761
NUEVO LEÓN,GARCIA,2,131,1,134,1761
NUEVO LEÓN,GARCIA,2,120,1,123,1747
NUEVO LEÓN,GARCIA,5,150,0,155,1747
NUEVO LEÓN,GARCIA,4,127,3,134,1746
NUEVO LEÓN,GARCIA,7,171,1,179,1746
NUEVO LEÓN,GARCIA,4,183,0,187,1936
NUEVO LEÓN,GARCIA,8,176,1,185,1936
NUEVO LEÓN,GARCIA,8,176,0,184,1936
NUEVO LEÓN,GARCIA,5,168,2,175,1944
NUEVO LEÓN,GARCIA,7,121,1,129,1944
NUEVO LEÓN,GARCIA,5,109,2,116,1943
NUEVO LEÓN,GARCIA,5,110,0,115,1830
NUEVO LEÓN,GARCIA,6,122,1,129,1830
NUEVO LEÓN,GARCIA,6,123,1,130,1829
NUEVO LEÓN,GARCIA,4,116,0,120,1954
NUEVO LEÓN,GARCIA,7,142,1,150,1953
NUEVO LEÓN,GARCIA,3,113,0,116,1953
NUEVO LEÓN,GARCIA,6,149,2,157,1953
NUEVO LEÓN,GUADALUPE,12,139,0,151,1925
NUEVO LEÓN,GUADALUPE,17,188,3,208,1925
NUEVO LEÓN,GUADALUPE,13,122,2,137,1924
NUEVO LEÓN,GUADALUPE,15,135,0,150,1924
NUEVO LEÓN,GUADALUPE,10,102,0,112,1846
NUEVO LEÓN,GUADALUPE,15,128,2,145,1846
NUEVO LEÓN,GUADALUPE,16,111,0,127,1846
NUEVO LEÓN,GUADALUPE,5,105,0,110,1845
NUEVO LEÓN,GUADALUPE,10,112,0,122,1845
NUEVO LEÓN,GUADALUPE,27,149,0,176,1829
NUEVO LEÓN,GUADALUPE,15,141,1,157,1828
NUEVO LEÓN,GUADALUPE,19,152,1,172,1828
NUEVO LEÓN,GUADALUPE,19,141,1,161,1828
NUEVO LEÓN,GUADALUPE,24,205,3,232,1907
NUEVO LEÓN,GUADALUPE,24,164,2,190,1906
NUEVO LEÓN,GUADALUPE,4,236,1,241,1884
NUEVO LEÓN,GUADALUPE,15,181,4,200,1883
NUEVO LEÓN,GUADALUPE,26,154,0,180,1805
NUEVO LEÓN,GUADALUPE,24,163,0,187,1805
NUEVO LEÓN,GUADALUPE,12,158,0,170,1804
NUEVO LEÓN,GUADALUPE,18,133,0,151,1391
NUEVO LEÓN,GUADALUPE,32,108,0,140,1391
NUEVO LEÓN,GUADALUPE,15,117,0,132,1391
NUEVO LEÓN,GUADALUPE,20,166,1,187,1895
NUEVO LEÓN,GUADALUPE,25,168,1,194,1894
NUEVO LEÓN,GUADALUPE,22,182,0,204,1894
NUEVO LEÓN,GUADALUPE,20,174,0,194,1894
NUEVO LEÓN,GUADALUPE,41,161,0,202,1894
NUEVO LEÓN,GUADALUPE,8,173,3,184,1410
NUEVO LEÓN,GUADALUPE,1,178,3,182,1410
NUEVO LEÓN,GUADALUPE,12,172,1,185,1474
NUEVO LEÓN,GUADALUPE,9,184,2,195,1473
NUEVO LEÓN,GUADALUPE,13,223,4,240,1638
NUEVO LEÓN,GUADALUPE,5,207,7,219,1638
NUEVO LEÓN,GUADALUPE,16,204,1,221,1761
NUEVO LEÓN,GUADALUPE,19,198,2,219,1760
NUEVO LEÓN,GUADALUPE,9,125,1,135,1361
NUEVO LEÓN,GUADALUPE,24,135,1,160,1360
NUEVO LEÓN,GUADALUPE,19,133,1,153,1360
NUEVO LEÓN,GUADALUPE,36,123,2,161,1445
NUEVO LEÓN,GUADALUPE,43,128,2,173,1444
NUEVO LEÓN,GUADALUPE,25,108,2,135,1444
NUEVO LEÓN,GUADALUPE,15,194,1,210,1374
NUEVO LEÓN,GUADALUPE,9,187,3,199,1374
NUEVO LEÓN,GUADALUPE,5,205,1,211,1373
NUEVO LEÓN,GUADALUPE,37,117,1,155,1780
NUEVO LEÓN,GUADALUPE,38,136,0,174,1780
NUEVO LEÓN,GUADALUPE,41,120,0,161,1780
NUEVO LEÓN,GUADALUPE,26,114,0,140,1780
NUEVO LEÓN,GUADALUPE,57,164,0,221,1557
NUEVO LEÓN,GUADALUPE,61,139,0,200,1557
NUEVO LEÓN,GUADALUPE,36,115,2,153,1556
NUEVO LEÓN,GUADALUPE,86,126,1,213,1849
NUEVO LEÓN,GUADALUPE,65,129,1,195,1848
NUEVO LEÓN,GUADALUPE,47,122,0,169,1546
NUEVO LEÓN,GUADALUPE,59,132,1,192,1546
NUEVO LEÓN,GUADALUPE,31,163,1,195,1565
NUEVO LEÓN,GUADALUPE,18,153,0,171,1565
NUEVO LEÓN,GUADALUPE,27,225,3,255,1681
NUEVO LEÓN,GUADALUPE,27,243,1,271,1680
NUEVO LEÓN,GUADALUPE,1,96,3,100,1206
NUEVO LEÓN,GUADALUPE,0,91,3,94,1206
NUEVO LEÓN,GUADALUPE,3,187,3,193,1778
NUEVO LEÓN,GUADALUPE,7,170,3,180,1778
NUEVO LEÓN,GUADALUPE,26,125,3,154,1834
NUEVO LEÓN,GUADALUPE,21,126,0,147,1833
NUEVO LEÓN,GUADALUPE,29,124,2,155,1833
NUEVO LEÓN,GUADALUPE,26,117,0,143,1833
NUEVO LEÓN,GUADALUPE,22,145,2,169,1625
NUEVO LEÓN,GUADALUPE,16,137,5,158,1624
NUEVO LEÓN,GUADALUPE,19,147,2,168,1624
NUEVO LEÓN,GUADALUPE,33,183,1,217,1539
NUEVO LEÓN,GUADALUPE,38,195,3,236,1539
NUEVO LEÓN,GUADALUPE,12,232,5,249,1799
NUEVO LEÓN,GUADALUPE,15,229,2,246,1798
NUEVO LEÓN,GUADALUPE,6,203,0,209,1726
NUEVO LEÓN,GUADALUPE,11,225,5,241,1726
NUEVO LEÓN,GUADALUPE,11,162,3,176,1856
NUEVO LEÓN,GUADALUPE,13,165,6,184,1855
NUEVO LEÓN,GUADALUPE,14,220,5,239,1780
NUEVO LEÓN,GUADALUPE,9,208,2,219,1780
NUEVO LEÓN,GUADALUPE,26,196,3,225,1674
NUEVO LEÓN,GUADALUPE,17,208,0,225,1674
NUEVO LEÓN,GUADALUPE,24,188,0,212,1673
NUEVO LEÓN,GUADALUPE,9,179,23,211,1484
NUEVO LEÓN,GUADALUPE,16,184,1,201,1483
NUEVO LEÓN,GUADALUPE,10,181,0,191,1483
NUEVO LEÓN,GUADALUPE,11,255,2,268,1476
NUEVO LEÓN,GUADALUPE,19,255,4,278,1476
NUEVO LEÓN,GUADALUPE,15,283,2,300,1475
NUEVO LEÓN,GUADALUPE,18,262,7,287,1472
NUEVO LEÓN,GUADALUPE,1,263,2,266,1471
NUEVO LEÓN,GUADALUPE,17,242,6,265,1830
NUEVO LEÓN,GUADALUPE,17,228,3,248,1829
NUEVO LEÓN,GUADALUPE,18,121,1,140,1648
NUEVO LEÓN,GUADALUPE,20,120,2,142,1648
NUEVO LEÓN,GUADALUPE,15,110,0,125,1648
NUEVO LEÓN,GUADALUPE,23,110,1,134,1647
NUEVO LEÓN,GUADALUPE,14,110,3,127,1647
NUEVO LEÓN,GUADALUPE,20,173,3,196,1714
NUEVO LEÓN,GUADALUPE,24,175,3,202,1714
NUEVO LEÓN,GUADALUPE,12,190,3,205,1455
NUEVO LEÓN,GUADALUPE,14,174,2,190,1455
NUEVO LEÓN,GUADALUPE,10,190,1,201,1455
NUEVO LEÓN,GUADALUPE,31,158,0,189,1885
NUEVO LEÓN,GUADALUPE,35,179,1,215,1885
NUEVO LEÓN,GUADALUPE,7,145,5,157,1742
NUEVO LEÓN,GUADALUPE,17,127,1,145,1742
NUEVO LEÓN,GUADALUPE,16,129,2,147,1742
NUEVO LEÓN,GUADALUPE,11,144,1,156,1741
NUEVO LEÓN,GUADALUPE,7,127,1,135,1741
NUEVO LEÓN,GUADALUPE,6,104,3,113,1523
NUEVO LEÓN,GUADALUPE,1,109,2,112,1523
NUEVO LEÓN,GUADALUPE,9,110,1,120,1523
NUEVO LEÓN,GUADALUPE,18,137,2,157,1054
NUEVO LEÓN,GUADALUPE,18,131,6,155,1053
NUEVO LEÓN,GUADALUPE,22,217,2,241,1604
NUEVO LEÓN,GUADALUPE,11,197,5,213,1604
NUEVO LEÓN,GUADALUPE,41,318,1,360,0
NUEVO LEÓN,GUADALUPE,13,174,0,187,1595
NUEVO LEÓN,GUADALUPE,12,165,2,179,1594
NUEVO LEÓN,GUADALUPE,12,134,1,147,1230
NUEVO LEÓN,GUADALUPE,8,129,3,140,1230
NUEVO LEÓN,GUADALUPE,18,114,1,133,1205
NUEVO LEÓN,GUADALUPE,10,129,1,140,1204
NUEVO LEÓN,GUADALUPE,10,182,2,194,1116
NUEVO LEÓN,GUADALUPE,8,135,1,144,1116
NUEVO LEÓN,GUADALUPE,9,140,4,153,1697
NUEVO LEÓN,GUADALUPE,7,146,1,154,1697
NUEVO LEÓN,GUADALUPE,9,149,0,158,1697
NUEVO LEÓN,GUADALUPE,11,130,1,142,1696
NUEVO LEÓN,GUADALUPE,14,112,0,126,1696
NUEVO LEÓN,GUADALUPE,20,142,2,164,1516
NUEVO LEÓN,GUADALUPE,14,138,1,153,1516
NUEVO LEÓN,GUADALUPE,16,123,0,139,1767
NUEVO LEÓN,GUADALUPE,16,133,0,149,1767
NUEVO LEÓN,GUADALUPE,15,135,0,150,1767
NUEVO LEÓN,GUADALUPE,17,131,0,148,1614
NUEVO LEÓN,GUADALUPE,3,162,0,165,1613
NUEVO LEÓN,GUADALUPE,7,111,2,120,1075
NUEVO LEÓN,GUADALUPE,6,105,1,112,1074
NUEVO LEÓN,GUADALUPE,33,139,1,173,1955
NUEVO LEÓN,GUADALUPE,28,130,0,158,1954
NUEVO LEÓN,GUADALUPE,20,140,0,160,1833
NUEVO LEÓN,GUADALUPE,18,163,2,183,1833
NUEVO LEÓN,GUADALUPE,7,110,0,117,1508
NUEVO LEÓN,GUADALUPE,13,122,0,135,1507
NUEVO LEÓN,GUADALUPE,13,130,3,146,1818
NUEVO LEÓN,GUADALUPE,14,141,1,156,1818
NUEVO LEÓN,GUADALUPE,14,119,0,133,1818
NUEVO LEÓN,GUADALUPE,21,112,0,133,1352
NUEVO LEÓN,GUADALUPE,21,111,0,132,1352
NUEVO LEÓN,GUADALUPE,16,93,0,109,1352
NUEVO LEÓN,GUADALUPE,16,88,0,104,1474
NUEVO LEÓN,GUADALUPE,14,94,0,108,1473
NUEVO LEÓN,GUADALUPE,12,94,0,106,1473
NUEVO LEÓN,GUADALUPE,13,124,0,137,1591
NUEVO LEÓN,GUADALUPE,11,116,3,130,1590
NUEVO LEÓN,GUADALUPE,6,103,0,109,1770
NUEVO LEÓN,GUADALUPE,15,116,1,132,1770
NUEVO LEÓN,GUADALUPE,23,159,0,182,1942
NUEVO LEÓN,GUADALUPE,22,135,1,158,1941
NUEVO LEÓN,GUADALUPE,23,93,1,117,1128
NUEVO LEÓN,GUADALUPE,14,89,2,105,1127
NUEVO LEÓN,GUADALUPE,14,120,0,134,1360
NUEVO LEÓN,GUADALUPE,10,113,2,125,1360
NUEVO LEÓN,GUADALUPE,13,85,0,98,1359
NUEVO LEÓN,GUADALUPE,10,152,3,165,1805
NUEVO LEÓN,GUADALUPE,11,148,1,160,1804
NUEVO LEÓN,GUADALUPE,7,110,1,118,1800
NUEVO LEÓN,GUADALUPE,9,120,1,130,1799
NUEVO LEÓN,GUADALUPE,7,138,2,147,1799
NUEVO LEÓN,GUADALUPE,13,157,0,170,1594
NUEVO LEÓN,GUADALUPE,17,162,2,181,1594
NUEVO LEÓN,GUADALUPE,16,210,1,227,1537
NUEVO LEÓN,GUADALUPE,20,183,1,204,1537
NUEVO LEÓN,GUADALUPE,24,94,0,118,1125
NUEVO LEÓN,GUADALUPE,7,101,1,109,1124
NUEVO LEÓN,GUADALUPE,21,116,0,137,1449
NUEVO LEÓN,GUADALUPE,21,88,1,110,1449
NUEVO LEÓN,GUADALUPE,18,104,1,123,1389
NUEVO LEÓN,GUADALUPE,19,129,0,148,1389
NUEVO LEÓN,GUADALUPE,16,117,1,134,1389
NUEVO LEÓN,GUADALUPE,20,125,0,145,1410
NUEVO LEÓN,GUADALUPE,20,146,1,167,1409
NUEVO LEÓN,GUADALUPE,14,138,0,152,1409
NUEVO LEÓN,GUADALUPE,15,154,0,169,1583
NUEVO LEÓN,GUADALUPE,14,174,2,190,1582
NUEVO LEÓN,GUADALUPE,0,45,0,45,1055
NUEVO LEÓN,GUADALUPE,5,72,0,77,1055
NUEVO LEÓN,GUADALUPE,13,188,1,202,1865
NUEVO LEÓN,GUADALUPE,15,176,0,191,1864
NUEVO LEÓN,GUADALUPE,33,72,0,105,1100
NUEVO LEÓN,GUADALUPE,27,78,0,105,1100
NUEVO LEÓN,GUADALUPE,25,161,1,187,1224
NUEVO LEÓN,GUADALUPE,24,150,1,175,1223
NUEVO LEÓN,GUADALUPE,27,149,3,179,1435
NUEVO LEÓN,GUADALUPE,45,165,0,210,1434
NUEVO LEÓN,GUADALUPE,34,149,2,185,1434
NUEVO LEÓN,LINARES,3,51,0,54,977
NUEVO LEÓN,LINARES,7,60,0,67,976
NUEVO LEÓN,LINARES,3,91,2,96,1869
NUEVO LEÓN,LINARES,4,96,5,105,1869
NUEVO LEÓN,LINARES,3,87,2,92,1869
NUEVO LEÓN,LINARES,6,64,0,70,1360
NUEVO LEÓN,LINARES,3,63,0,66,1359
NUEVO LEÓN,LINARES,14,111,2,127,1453
NUEVO LEÓN,LINARES,17,108,0,125,1452
NUEVO LEÓN,LINARES,27,101,3,131,1604
NUEVO LEÓN,LINARES,24,84,4,112,1604
NUEVO LEÓN,LINARES,20,59,1,80,1177
NUEVO LEÓN,LINARES,25,50,2,77,1176
NUEVO LEÓN,LINARES,11,76,0,87,1499
NUEVO LEÓN,LINARES,10,57,3,70,1499
NUEVO LEÓN,LINARES,5,55,0,60,1499
NUEVO LEÓN,LINARES,12,65,0,77,1498
NUEVO LEÓN,LINARES,9,108,1,118,1333
NUEVO LEÓN,LINARES,13,85,3,101,1333
NUEVO LEÓN,LINARES,8,102,1,111,1333
NUEVO LEÓN,LINARES,7,40,2,49,1051
NUEVO LEÓN,LINARES,7,61,2,70,1050
NUEVO LEÓN,LINARES,3,105,3,111,1590
NUEVO LEÓN,LINARES,2,110,4,116,1590
NUEVO LEÓN,LINARES,4,88,6,98,1645
NUEVO LEÓN,LINARES,5,128,3,136,1645
NUEVO LEÓN,LINARES,11,160,6,177,1446
NUEVO LEÓN,LINARES,10,159,11,180,1445
NUEVO LEÓN,LINARES,5,37,0,42,1455
NUEVO LEÓN,LINARES,1,90,2,93,1455
NUEVO LEÓN,LINARES,8,168,3,179,1828
NUEVO LEÓN,LINARES,10,207,3,220,1827
NUEVO LEÓN,LINARES,7,136,3,146,1560
NUEVO LEÓN,LINARES,13,138,2,153,1560
NUEVO LEÓN,LINARES,9,133,4,146,1874
NUEVO LEÓN,LINARES,16,124,1,141,1874
NUEVO LEÓN,LINARES,16,116,0,132,1873
NUEVO LEÓN,LINARES,3,81,1,85,1357
NUEVO LEÓN,LINARES,6,73,1,80,1356
NUEVO LEÓN,LINARES,5,70,0,75,1356
NUEVO LEÓN,LINARES,4,191,1,196,1576
NUEVO LEÓN,LINARES,3,139,2,144,1575
NUEVO LEÓN,LINARES,12,130,2,144,1575
NUEVO LEÓN,LINARES,7,171,5,183,1404
NUEVO LEÓN,LINARES,8,147,3,158,1403
NUEVO LEÓN,LINARES,6,165,2,173,1961
NUEVO LEÓN,LINARES,4,149,1,154,1960
NUEVO LEÓN,LINARES,8,177,5,190,1960
NUEVO LEÓN,LINARES,6,115,1,122,1266
NUEVO LEÓN,LINARES,1,102,0,103,1266
NUEVO LEÓN,LINARES,4,62,0,66,1151
NUEVO LEÓN,LINARES,2,75,3,80,1150
NUEVO LEÓN,LINARES,5,99,4,108,1351
NUEVO LEÓN,LINARES,7,132,3,142,1350
NUEVO LEÓN,LINARES,7,104,10,121,1788
NUEVO LEÓN,LINARES,4,106,2,112,1787
NUEVO LEÓN,LINARES,7,203,8,218,1874
NUEVO LEÓN,LINARES,1,54,1,56,1382
NUEVO LEÓN,LINARES,1,76,0,77,1382
NUEVO LEÓN,LINARES,7,67,0,74,1309
NUEVO LEÓN,LINARES,4,86,0,90,1309
NUEVO LEÓN,LINARES,13,118,1,132,1560
NUEVO LEÓN,LINARES,6,95,1,102,1559
NUEVO LEÓN,LINARES,5,191,3,199,1396
NUEVO LEÓN,LINARES,14,127,3,144,1396
NUEVO LEÓN,LINARES,4,150,2,156,1395
NUEVO LEÓN,LINARES,14,256,5,275,1912
NUEVO LEÓN,LINARES,16,208,3,227,1911
NUEVO LEÓN,LINARES,2,56,1,59,1337
NUEVO LEÓN,LINARES,3,55,0,58,1336
NUEVO LEÓN,LINARES,0,23,0,23,1336
NUEVO LEÓN,LINARES,5,57,4,66,1731
NUEVO LEÓN,LINARES,2,62,0,64,1730
NUEVO LEÓN,LINARES,5,64,0,69,1730
NUEVO LEÓN,LINARES,2,159,1,162,1570
NUEVO LEÓN,LINARES,6,134,4,144,1570
NUEVO LEÓN,LINARES,2,208,2,212,1379
NUEVO LEÓN,LINARES,2,97,0,99,1379
NUEVO LEÓN,LINARES,6,199,2,207,1378
NUEVO LEÓN,LINARES,7,155,2,164,1020
NUEVO LEÓN,LINARES,6,166,6,178,1020
NUEVO LEÓN,LINARES,8,62,5,75,1631
NUEVO LEÓN,LINARES,8,94,3,105,1630
NUEVO LEÓN,LINARES,1,62,0,63,1000
NUEVO LEÓN,LINARES,1,69,4,74,999
NUEVO LEÓN,LINARES,6,200,2,208,1912
NUEVO LEÓN,LINARES,14,190,3,207,1911
NUEVO LEÓN,LINARES,17,72,0,89,1428
NUEVO LEÓN,LINARES,4,85,2,91,1427
NUEVO LEÓN,LINARES,10,73,0,83,1427
NUEVO LEÓN,LINARES,4,80,1,85,1276
NUEVO LEÓN,LINARES,5,79,3,87,1275
NUEVO LEÓN,LINARES,4,70,0,74,1398
NUEVO LEÓN,LINARES,9,77,1,87,1397
NUEVO LEÓN,LINARES,5,73,1,79,1397
NUEVO LEÓN,LINARES,4,34,1,39,1018
NUEVO LEÓN,LINARES,2,44,0,46,1018
NUEVO LEÓN,LINARES,15,43,0,58,997
NUEVO LEÓN,LINARES,9,52,3,64,996
NUEVO LEÓN,LINARES,7,63,1,71,1373
NUEVO LEÓN,LINARES,4,83,1,88,1372
NUEVO LEÓN,LINARES,4,132,2,138,1277
NUEVO LEÓN,LINARES,4,96,1,101,1276
NUEVO LEÓN,LINARES,13,147,11,171,1422
NUEVO LEÓN,LINARES,10,180,1,191,1421
NUEVO LEÓN,LINARES,6,82,1,89,1497
NUEVO LEÓN,LINARES,11,84,2,97,1497
NUEVO LEÓN,LINARES,0,103,1,104,1496
NUEVO LEÓN,LINARES,5,108,1,114,1550
NUEVO LEÓN,LINARES,5,84,2,91,1549
NUEVO LEÓN,LINARES,14,186,11,211,1586
NUEVO LEÓN,LINARES,9,172,6,187,1586
NUEVO LEÓN,LINARES,14,141,1,156,1891
NUEVO LEÓN,LINARES,5,157,3,165,1891
NUEVO LEÓN,LINARES,6,127,1,134,1378
NUEVO LEÓN,LINARES,6,140,0,146,1377
NUEVO LEÓN,LINARES,5,117,1,123,1377
NUEVO LEÓN,LINARES,9,114,2,125,1627
NUEVO LEÓN,LINARES,1,106,0,107,1627
NUEVO LEÓN,LINARES,9,123,2,134,1627
NUEVO LEÓN,LINARES,8,118,5,131,1549
NUEVO LEÓN,LINARES,21,146,1,168,1548
NUEVO LEÓN,LINARES,10,148,2,160,1548
NUEVO LEÓN,LINARES,23,158,0,181,1403
NUEVO LEÓN,LINARES,18,137,2,157,1402
NUEVO LEÓN,LINARES,18,164,0,182,1402
NUEVO LEÓN,LINARES,21,140,2,163,1753
NUEVO LEÓN,LINARES,21,160,1,182,1753
NUEVO LEÓN,LINARES,40,332,9,381,0
NUEVO LEÓN,LINARES,5,124,1,130,1973
NUEVO LEÓN,LINARES,6,117,3,126,1973
NUEVO LEÓN,LINARES,25,160,4,189,1767
NUEVO LEÓN,LINARES,22,148,4,174,1767
NUEVO LEÓN,LINARES,33,152,4,189,1862
NUEVO LEÓN,LINARES,31,184,1,216,1861
NUEVO LEÓN,LINARES,24,104,1,129,1517
NUEVO LEÓN,LINARES,21,133,2,156,1516
NUEVO LEÓN,LINARES,4,116,6,126,1546
NUEVO LEÓN,LINARES,8,113,3,124,1546
NUEVO LEÓN,LINARES,4,105,1,110,1967
NUEVO LEÓN,LINARES,8,113,2,123,1966
NUEVO LEÓN,LINARES,7,128,2,137,1966
NUEVO LEÓN,LINARES,4,132,19,155,1626
NUEVO LEÓN,LINARES,8,117,6,131,1625
NUEVO LEÓN,LINARES,11,200,2,213,1671
NUEVO LEÓN,LINARES,13,204,6,223,1671
NUEVO LEÓN,LINARES,1,60,0,61,1119
NUEVO LEÓN,LINARES,7,65,0,72,1118
NUEVO LEÓN,LINARES,6,106,0,112,1323
NUEVO LEÓN,LINARES,2,78,1,81,1323
NUEVO LEÓN,LINARES,4,59,2,65,1429
NUEVO LEÓN,LINARES,2,99,2,103,1429
NUEVO LEÓN,LINARES,2,67,3,72,1428
NUEVO LEÓN,LINARES,16,172,5,193,1902
NUEVO LEÓN,LINARES,9,232,6,247,1701
NUEVO LEÓN,LINARES,4,239,4,247,1701
NUEVO LEÓN,LINARES,11,144,2,157,1462
NUEVO LEÓN,LINARES,10,142,0,152,1461
NUEVO LEÓN,LINARES,7,233,3,243,1943
NUEVO LEÓN,LINARES,18,240,1,259,1942
NUEVO LEÓN,LINARES,33,196,4,233,1700
NUEVO LEÓN,LINARES,26,197,9,232,1699
NUEVO LEÓN,LINARES,6,143,2,151,1899
NUEVO LEÓN,LINARES,17,147,3,167,1898
NUEVO LEÓN,LINARES,27,165,0,192,1857
NUEVO LEÓN,LINARES,27,147,2,176,1857
NUEVO LEÓN,LINARES,10,116,3,129,1529
NUEVO LEÓN,LINARES,2,117,3,122,1529
NUEVO LEÓN,LINARES,7,111,1,119,1528
NUEVO LEÓN,LINARES,39,160,4,203,1830
NUEVO LEÓN,LINARES,43,166,1,210,1829
NUEVO LEÓN,LINARES,15,156,1,172,1703
NUEVO LEÓN,LINARES,14,139,0,153,1703
NUEVO LEÓN,LINARES,5,119,1,125,1703
NUEVO LEÓN,LINARES,5,101,0,106,1784
NUEVO LEÓN,LINARES,3,92,2,97,1783
NUEVO LEÓN,LINARES,6,94,2,102,1783
NUEVO LEÓN,LINARES,5,98,1,104,1490
NUEVO LEÓN,LINARES,1,97,1,99,1490
NUEVO LEÓN,LINARES,11,196,2,209,1877
NUEVO LEÓN,LINARES,6,147,9,162,1876
NUEVO LEÓN,LINARES,13,81,9,103,1945
NUEVO LEÓN,LINARES,17,208,0,225,1968
NUEVO LEÓN,LINARES,24,182,1,207,1968
NUEVO LEÓN,LINARES,19,161,1,181,1968
NUEVO LEÓN,LINARES,13,93,2,108,1786
NUEVO LEÓN,LINARES,8,77,0,85,1785
NUEVO LEÓN,LINARES,1,63,1,65,1639
NUEVO LEÓN,LINARES,5,82,1,88,1638
NUEVO LEÓN,LINARES,10,62,1,73,1495
NUEVO LEÓN,LINARES,8,71,3,82,1495
NUEVO LEÓN,LINARES,1,36,1,38,1146
NUEVO LEÓN,LINARES,2,28,0,30,1145
NUEVO LEÓN,LINARES,14,92,1,107,1508
NUEVO LEÓN,LINARES,5,54,2,61,1508
NUEVO LEÓN,LINARES,38,88,2,128,1646
NUEVO LEÓN,LINARES,46,107,3,156,1645
NUEVO LEÓN,LINARES,26,110,1,137,1489
NUEVO LEÓN,LINARES,38,129,2,169,1488
NUEVO LEÓN,LINARES,29,128,0,157,1488
NUEVO LEÓN,LINARES,31,134,1,166,1286
NUEVO LEÓN,LINARES,18,125,1,144,1286
NUEVO LEÓN,LINARES,13,76,1,90,1784
NUEVO LEÓN,LINARES,6,72,0,78,1783
NUEVO LEÓN,LINARES,24,110,0,134,1414
NUEVO LEÓN,LINARES,21,137,0,158,1414
NUEVO LEÓN,LINARES,21,156,0,177,1413
NUEVO LEÓN,LINARES,35,93,0,128,1947
NUEVO LEÓN,LINARES,33,103,1,137,1946
NUEVO LEÓN,LINARES,31,134,1,166,1752
NUEVO LEÓN,LINARES,19,118,2,139,1751
NUEVO LEÓN,LINARES,24,135,2,161,1751
NUEVO LEÓN,LINARES,59,57,0,116,1542
NUEVO LEÓN,LINARES,73,72,4,149,1542
NUEVO LEÓN,LINARES,52,74,2,128,1541
NUEVO LEÓN,LINARES,37,44,1,82,1346
NUEVO LEÓN,LINARES,48,69,3,120,1345
NUEVO LEÓN,LINARES,34,56,1,91,1345
NUEVO LEÓN,LINARES,30,98,0,128,1639
NUEVO LEÓN,LINARES,50,80,0,130,1639
NUEVO LEÓN,LINARES,29,74,1,104,1638
NUEVO LEÓN,MONTERREY,12,127,4,143,1853
NUEVO LEÓN,MONTERREY,21,129,0,150,1853
NUEVO LEÓN,MONTERREY,26,116,1,143,1852
NUEVO LEÓN,MONTERREY,37,92,1,130,1315
NUEVO LEÓN,MONTERREY,23,98,1,122,1314
NUEVO LEÓN,MONTERREY,37,91,1,129,1314
NUEVO LEÓN,MONTERREY,38,122,4,164,1499
NUEVO LEÓN,MONTERREY,35,115,2,152,1499
NUEVO LEÓN,MONTERREY,28,136,3,167,1498
NUEVO LEÓN,MONTERREY,51,154,1,206,1753
NUEVO LEÓN,MONTERREY,53,126,0,179,1753
NUEVO LEÓN,MONTERREY,185,1738,7,1930,0
NUEVO LEÓN,MONTERREY,30,150,0,180,1468
NUEVO LEÓN,MONTERREY,30,108,3,141,1468
NUEVO LEÓN,MONTERREY,18,168,0,186,1468
NUEVO LEÓN,MONTERREY,62,161,1,224,1901
NUEVO LEÓN,MONTERREY,59,140,1,200,1901
NUEVO LEÓN,MONTERREY,54,173,3,230,1901
NUEVO LEÓN,MONTERREY,22,97,0,119,1818
NUEVO LEÓN,MONTERREY,32,106,0,138,1818
NUEVO LEÓN,MONTERREY,15,194,4,213,1685
NUEVO LEÓN,MONTERREY,17,195,2,214,1685
NUEVO LEÓN,MONTERREY,24,182,7,213,1575
NUEVO LEÓN,MONTERREY,22,151,0,173,1574
NUEVO LEÓN,MONTERREY,17,202,3,222,1934
NUEVO LEÓN,MONTERREY,13,189,13,215,1933
NUEVO LEÓN,MONTERREY,2,104,0,106,1433
NUEVO LEÓN,MONTERREY,6,105,3,114,1433
NUEVO LEÓN,MONTERREY,6,177,2,185,1909
NUEVO LEÓN,MONTERREY,10,187,4,201,1908
NUEVO LEÓN,MONTERREY,22,168,3,193,1587
NUEVO LEÓN,MONTERREY,27,179,1,207,1587
NUEVO LEÓN,MONTERREY,26,149,0,175,1587
NUEVO LEÓN,MONTERREY,25,130,2,157,1376
NUEVO LEÓN,MONTERREY,28,116,0,144,1376
NUEVO LEÓN,MONTERREY,27,144,1,172,1375
NUEVO LEÓN,MONTERREY,38,177,0,215,1782
NUEVO LEÓN,MONTERREY,32,145,1,178,1782
NUEVO LEÓN,MONTERREY,30,154,1,185,1781
NUEVO LEÓN,MONTERREY,27,171,0,198,1781
NUEVO LEÓN,MONTERREY,59,189,4,252,1842
NUEVO LEÓN,MONTERREY,45,202,5,252,1842
NUEVO LEÓN,MONTERREY,58,143,2,203,1575
NUEVO LEÓN,MONTERREY,41,129,0,170,1574
NUEVO LEÓN,MONTERREY,44,141,0,185,1574
NUEVO LEÓN,MONTERREY,24,120,1,145,1434
NUEVO LEÓN,MONTERREY,28,131,0,159,1433
NUEVO LEÓN,MONTERREY,26,159,0,185,1433
NUEVO LEÓN,MONTERREY,57,168,1,226,1679
NUEVO LEÓN,MONTERREY,42,191,0,233,1679
NUEVO LEÓN,MONTERREY,23,170,0,193,1918
NUEVO LEÓN,MONTERREY,51,188,1,240,1917
NUEVO LEÓN,MONTERREY,60,154,0,214,1756
NUEVO LEÓN,MONTERREY,62,182,1,245,1755
NUEVO LEÓN,MONTERREY,63,114,1,178,1447
NUEVO LEÓN,MONTERREY,71,121,0,192,1447
NUEVO LEÓN,MONTERREY,62,116,1,179,1446
NUEVO LEÓN,MONTERREY,39,103,0,142,1552
NUEVO LEÓN,MONTERREY,39,121,1,161,1551
NUEVO LEÓN,MONTERREY,50,119,2,171,1551
NUEVO LEÓN,MONTERREY,153,75,1,229,1580
NUEVO LEÓN,MONTERREY,70,168,0,238,1579
NUEVO LEÓN,MONTERREY,75,101,0,176,1443
NUEVO LEÓN,MONTERREY,73,109,2,184,1442
NUEVO LEÓN,MONTERREY,105,79,1,185,1750
NUEVO LEÓN,MONTERREY,95,92,0,187,1749
NUEVO LEÓN,MONTERREY,118,88,1,207,1749
NUEVO LEÓN,MONTERREY,153,112,0,265,1849
NUEVO LEÓN,MONTERREY,143,99,0,242,1848
NUEVO LEÓN,MONTERREY,180,84,1,265,1880
NUEVO LEÓN,MONTERREY,162,89,1,252,1879
NUEVO LEÓN,MONTERREY,70,136,1,207,1471
NUEVO LEÓN,MONTERREY,38,129,3,170,1470
NUEVO LEÓN,MONTERREY,60,96,1,157,1648
NUEVO LEÓN,MONTERREY,23,101,0,124,1648
NUEVO LEÓN,MONTERREY,62,66,0,128,1745
NUEVO LEÓN,MONTERREY,61,68,0,129,1744
NUEVO LEÓN,MONTERREY,83,70,0,153,1647
NUEVO LEÓN,MONTERREY,80,79,3,162,1647
NUEVO LEÓN,MONTERREY,66,85,6,157,1646
NUEVO LEÓN,MONTERREY,71,121,2,194,1754
NUEVO LEÓN,MONTERREY,60,128,2,190,1754
NUEVO LEÓN,MONTERREY,64,109,3,176,1817
NUEVO LEÓN,MONTERREY,43,143,2,188,1816
NUEVO LEÓN,MONTERREY,5,122,1,128,1691
NUEVO LEÓN,MONTERREY,10,123,1,134,1690
NUEVO LEÓN,MONTERREY,36,160,4,200,1770
NUEVO LEÓN,MONTERREY,33,152,3,188,1770
NUEVO LEÓN,MONTERREY,21,224,3,248,1961
NUEVO LEÓN,MONTERREY,67,98,0,165,1352
NUEVO LEÓN,MONTERREY,57,128,3,188,1352
NUEVO LEÓN,MONTERREY,113,131,0,244,1514
NUEVO LEÓN,MONTERREY,98,115,6,219,1514
NUEVO LEÓN,MONTERREY,72,146,2,220,1519
NUEVO LEÓN,MONTERREY,141,46,1,188,1519
NUEVO LEÓN,MONTERREY,50,173,1,224,1712
NUEVO LEÓN,MONTERREY,42,148,0,190,1711
NUEVO LEÓN,MONTERREY,10,218,1,229,1961
NUEVO LEÓN,MONTERREY,29,140,2,171,1710
NUEVO LEÓN,MONTERREY,9,106,1,116,1709
NUEVO LEÓN,MONTERREY,11,106,4,121,1633
NUEVO LEÓN,MONTERREY,12,126,0,138,1633
NUEVO LEÓN,MONTERREY,11,147,2,160,1644
NUEVO LEÓN,MONTERREY,11,165,1,177,1643
NUEVO LEÓN,MONTERREY,5,86,2,93,1933
NUEVO LEÓN,MONTERREY,7,95,4,106,1932
NUEVO LEÓN,MONTERREY,9,103,1,113,1237
NUEVO LEÓN,MONTERREY,11,112,3,126,1237
NUEVO LEÓN,MONTERREY,12,127,9,148,1573
NUEVO LEÓN,MONTERREY,6,139,4,149,1573
NUEVO LEÓN,MONTERREY,126,103,5,234,1756
NUEVO LEÓN,MONTERREY,137,96,1,234,1756
NUEVO LEÓN,MONTERREY,90,92,0,182,1354
NUEVO LEÓN,MONTERREY,89,74,0,163,1354
NUEVO LEÓN,MONTERREY,9,105,0,114,1015
NUEVO LEÓN,MONTERREY,13,87,2,102,1015
NUEVO LEÓN,MONTERREY,49,160,6,215,1810
NUEVO LEÓN,MONTERREY,50,151,1,202,1809
NUEVO LEÓN,MONTERREY,15,133,1,149,1967
NUEVO LEÓN,MONTERREY,13,141,0,154,1967
NUEVO LEÓN,MONTERREY,22,145,3,170,1845
NUEVO LEÓN,MONTERREY,32,168,2,202,1845
NUEVO LEÓN,MONTERREY,13,138,0,151,1795
NUEVO LEÓN,MONTERREY,12,112,2,126,1795
NUEVO LEÓN,MONTERREY,60,96,3,159,1554
NUEVO LEÓN,MONTERREY,34,110,7,151,1553
NUEVO LEÓN,MONTERREY,22,181,2,205,1874
NUEVO LEÓN,MONTERREY,20,185,2,207,1874
NUEVO LEÓN,MONTERREY,156,31,0,187,1785
NUEVO LEÓN,MONTERREY,152,45,1,198,1784
NUEVO LEÓN,MONTERREY,98,142,1,241,1733
NUEVO LEÓN,MONTERREY,94,164,0,258,1732
NUEVO LEÓN,MONTERREY,157,105,1,263,1684
NUEVO LEÓN,MONTERREY,149,129,1,279,1683
NUEVO LEÓN,MONTERREY,184,95,0,279,1564
NUEVO LEÓN,MONTERREY,174,99,1,274,1563
NUEVO LEÓN,MONTERREY,112,87,3,202,1422
NUEVO LEÓN,MONTERREY,98,94,3,195,1421
NUEVO LEÓN,MONTERREY,75,85,0,160,1218
NUEVO LEÓN,MONTERREY,60,86,0,146,1218
NUEVO LEÓN,MONTERREY,103,120,4,227,1910
NUEVO LEÓN,MONTERREY,115,113,4,232,1909
NUEVO LEÓN,MONTERREY,134,46,3,183,1889
NUEVO LEÓN,MONTERREY,119,71,3,193,1889
NUEVO LEÓN,MONTERREY,101,67,1,169,1888
NUEVO LEÓN,MONTERREY,120,95,2,217,1944
NUEVO LEÓN,MONTERREY,99,65,0,164,1273
NUEVO LEÓN,MONTERREY,95,67,2,164,1272
NUEVO LEÓN,MONTERREY,158,95,0,253,1797
NUEVO LEÓN,MONTERREY,142,120,2,264,1797
NUEVO LEÓN,MONTERREY,51,67,1,119,1650
NUEVO LEÓN,MONTERREY,34,62,1,97,1649
NUEVO LEÓN,MONTERREY,108,40,0,148,1754
NUEVO LEÓN,MONTERREY,100,36,0,136,1754
NUEVO LEÓN,MONTERREY,122,52,0,174,1754
NUEVO LEÓN,MONTERREY,95,41,1,137,1754
NUEVO LEÓN,MONTERREY,94,30,1,125,1754
NUEVO LEÓN,MONTERREY,94,42,1,137,1753
NUEVO LEÓN,MONTERREY,94,37,1,132,1753
NUEVO LEÓN,MONTERREY,6,148,0,154,1869
NUEVO LEÓN,MONTERREY,16,153,3,172,1868
NUEVO LEÓN,MONTERREY,16,63,1,80,1771
NUEVO LEÓN,MONTERREY,17,82,0,99,1771
NUEVO LEÓN,MONTERREY,15,76,0,91,1770
NUEVO LEÓN,MONTERREY,5,77,1,83,1730
NUEVO LEÓN,MONTERREY,7,95,2,104,1729
NUEVO LEÓN,MONTERREY,79,56,1,136,1838
NUEVO LEÓN,MONTERREY,65,51,0,116,1837
NUEVO LEÓN,MONTERREY,63,49,1,113,1837
NUEVO LEÓN,MONTERREY,97,59,1,157,1780
NUEVO LEÓN,MONTERREY,98,59,2,159,1780
NUEVO LEÓN,MONTERREY,81,60,0,141,1780
NUEVO LEÓN,MONTERREY,42,114,4,160,1154
NUEVO LEÓN,MONTERREY,46,105,2,153,1154
NUEVO LEÓN,MONTERREY,26,146,0,172,1435
NUEVO LEÓN,MONTERREY,22,142,2,166,1434
NUEVO LEÓN,MONTERREY,32,159,1,192,1911
NUEVO LEÓN,MONTERREY,18,212,1,231,1911
NUEVO LEÓN,MONTERREY,21,145,3,169,1412
NUEVO LEÓN,MONTERREY,12,188,4,204,1412
NUEVO LEÓN,MONTERREY,4,167,1,172,1412
NUEVO LEÓN,MONTERREY,20,124,2,146,1401
NUEVO LEÓN,MONTERREY,15,131,1,147,1401
NUEVO LEÓN,MONTERREY,15,122,1,138,1400
NUEVO LEÓN,MONTERREY,10,234,4,248,1879
NUEVO LEÓN,MONTERREY,14,228,2,244,1879
NUEVO LEÓN,MONTERREY,21,152,2,175,1614
NUEVO LEÓN,MONTERREY,10,151,1,162,1614
NUEVO LEÓN,MONTERREY,26,181,3,210,1500
NUEVO LEÓN,MONTERREY,18,214,1,233,1500
NUEVO LEÓN,MONTERREY,20,284,6,310,1937
NUEVO LEÓN,MONTERREY,20,242,6,268,1936
NUEVO LEÓN,MONTERREY,60,107,2,169,1309
NUEVO LEÓN,MONTERREY,43,154,2,199,1309
NUEVO LEÓN,MONTERREY,54,146,2,202,1724
NUEVO LEÓN,MONTERREY,68,162,3,233,1724
NUEVO LEÓN,MONTERREY,26,191,2,219,1718
NUEVO LEÓN,MONTERREY,36,200,4,240,1718
NUEVO LEÓN,GUADALUPE,46,106,2,154,1837
NUEVO LEÓN,GUADALUPE,61,120,1,182,1836
NUEVO LEÓN,GUADALUPE,54,108,1,163,1836
NUEVO LEÓN,GUADALUPE,10,220,3,233,1506
NUEVO LEÓN,GUADALUPE,14,228,5,247,1505
NUEVO LEÓN,GUADALUPE,18,142,1,161,1031
NUEVO LEÓN,GUADALUPE,16,111,0,127,1030
NUEVO LEÓN,GUADALUPE,16,172,4,192,1301
NUEVO LEÓN,GUADALUPE,12,201,2,215,1300
NUEVO LEÓN,GUADALUPE,32,248,5,285,1770
NUEVO LEÓN,GUADALUPE,23,245,1,269,1769
NUEVO LEÓN,GUADALUPE,43,219,1,263,1952
NUEVO LEÓN,GUADALUPE,58,211,0,269,1952
NUEVO LEÓN,GUADALUPE,43,185,0,228,1921
NUEVO LEÓN,GUADALUPE,30,187,0,217,1921
NUEVO LEÓN,GUADALUPE,35,208,1,244,1553
NUEVO LEÓN,GUADALUPE,25,180,1,206,1552
NUEVO LEÓN,GUADALUPE,36,210,4,250,1788
NUEVO LEÓN,GUADALUPE,34,219,1,254,1787
NUEVO LEÓN,GUADALUPE,20,245,1,266,1727
NUEVO LEÓN,GUADALUPE,41,234,0,275,1726
NUEVO LEÓN,GUADALUPE,40,187,1,228,1606
NUEVO LEÓN,GUADALUPE,29,199,2,230,1605
NUEVO LEÓN,GUADALUPE,22,194,2,218,1605
NUEVO LEÓN,GUADALUPE,40,206,1,247,1784
NUEVO LEÓN,GUADALUPE,47,183,0,230,1783
NUEVO LEÓN,GUADALUPE,22,198,0,220,1500
NUEVO LEÓN,GUADALUPE,17,181,1,199,1499
NUEVO LEÓN,GUADALUPE,30,194,1,225,1486
NUEVO LEÓN,GUADALUPE,23,159,0,182,1486
NUEVO LEÓN,GUADALUPE,32,193,1,226,1485
NUEVO LEÓN,GUADALUPE,18,151,5,174,1094
NUEVO LEÓN,GUADALUPE,19,131,0,150,1094
NUEVO LEÓN,GUADALUPE,55,91,1,147,1695
NUEVO LEÓN,GUADALUPE,67,99,0,166,1694
NUEVO LEÓN,GUADALUPE,65,109,0,174,1694
NUEVO LEÓN,GUADALUPE,61,189,1,251,1791
NUEVO LEÓN,GUADALUPE,51,179,5,235,1790
NUEVO LEÓN,GUADALUPE,28,222,0,250,1795
NUEVO LEÓN,GUADALUPE,33,203,1,237,1794
NUEVO LEÓN,GUADALUPE,30,202,3,235,1821
NUEVO LEÓN,GUADALUPE,26,201,4,231,1820
NUEVO LEÓN,GUADALUPE,24,191,1,216,1820
NUEVO LEÓN,GUADALUPE,59,151,0,210,1559
NUEVO LEÓN,GUADALUPE,59,178,1,238,1559
NUEVO LEÓN,GUADALUPE,55,162,0,217,1559
NUEVO LEÓN,GUADALUPE,95,95,0,190,1405
NUEVO LEÓN,GUADALUPE,85,76,1,162,1405
NUEVO LEÓN,GUADALUPE,17,133,3,153,1209
NUEVO LEÓN,GUADALUPE,8,115,1,124,1208
NUEVO LEÓN,GUADALUPE,43,94,1,138,1091
NUEVO LEÓN,GUADALUPE,36,86,3,125,1091
NUEVO LEÓN,GUADALUPE,152,86,0,238,1821
NUEVO LEÓN,GUADALUPE,181,73,0,254,1821
NUEVO LEÓN,GUADALUPE,231,91,0,322,1760
NUEVO LEÓN,GUADALUPE,210,75,0,285,1759
NUEVO LEÓN,GUADALUPE,231,73,0,304,1772
NUEVO LEÓN,GUADALUPE,224,73,1,298,1772
NUEVO LEÓN,GUADALUPE,33,208,2,243,1835
NUEVO LEÓN,GUADALUPE,37,196,2,235,1835
NUEVO LEÓN,GUADALUPE,37,142,1,180,1428
NUEVO LEÓN,GUADALUPE,58,143,1,202,1427
NUEVO LEÓN,GUADALUPE,59,179,1,239,1869
NUEVO LEÓN,GUADALUPE,54,173,3,230,1869
NUEVO LEÓN,GUADALUPE,184,50,1,235,1869
NUEVO LEÓN,GUADALUPE,29,147,1,177,1643
NUEVO LEÓN,GUADALUPE,42,167,3,212,1642
NUEVO LEÓN,GUADALUPE,43,97,0,140,1519
NUEVO LEÓN,GUADALUPE,34,104,2,140,1518
NUEVO LEÓN,GUADALUPE,52,129,0,181,1455
NUEVO LEÓN,GUADALUPE,41,120,0,161,1454
NUEVO LEÓN,GUADALUPE,40,136,0,176,1713
NUEVO LEÓN,GUADALUPE,47,148,1,196,1713
NUEVO LEÓN,GUADALUPE,13,259,2,274,1542
NUEVO LEÓN,GUADALUPE,18,215,3,236,1541
NUEVO LEÓN,GUADALUPE,20,212,0,232,1661
NUEVO LEÓN,GUADALUPE,28,224,0,252,1661
NUEVO LEÓN,GUADALUPE,23,195,0,218,1603
NUEVO LEÓN,GUADALUPE,36,187,1,224,1602
NUEVO LEÓN,GUADALUPE,10,151,1,162,1571
NUEVO LEÓN,GUADALUPE,14,161,2,177,1571
NUEVO LEÓN,GUADALUPE,10,163,1,174,1570
NUEVO LEÓN,GUADALUPE,16,169,3,188,1263
NUEVO LEÓN,GUADALUPE,12,169,2,183,1263
NUEVO LEÓN,GUADALUPE,17,277,7,301,1814
NUEVO LEÓN,GUADALUPE,24,300,1,325,1814
NUEVO LEÓN,GUADALUPE,22,201,3,226,1800
NUEVO LEÓN,GUADALUPE,20,203,4,227,1800
NUEVO LEÓN,GUADALUPE,17,240,2,259,1528
NUEVO LEÓN,GUADALUPE,17,224,3,244,1527
NUEVO LEÓN,GUADALUPE,20,144,0,164,1221
NUEVO LEÓN,GUADALUPE,18,146,2,166,1221
NUEVO LEÓN,GUADALUPE,8,214,1,223,1592
NUEVO LEÓN,GUADALUPE,20,226,2,248,1592
NUEVO LEÓN,GUADALUPE,11,257,1,269,1546
NUEVO LEÓN,GUADALUPE,22,253,2,277,1546
NUEVO LEÓN,GUADALUPE,12,238,1,251,1586
NUEVO LEÓN,GUADALUPE,5,245,4,254,1585
NUEVO LEÓN,GUADALUPE,15,199,1,215,1515
NUEVO LEÓN,GUADALUPE,18,171,2,191,1515
NUEVO LEÓN,GUADALUPE,16,209,4,229,1461
NUEVO LEÓN,GUADALUPE,19,197,3,219,1460
NUEVO LEÓN,GUADALUPE,30,165,0,195,1291
NUEVO LEÓN,GUADALUPE,21,157,0,178,1290
NUEVO LEÓN,GUADALUPE,6,206,0,212,1539
NUEVO LEÓN,GUADALUPE,6,213,3,222,1538
NUEVO LEÓN,GUADALUPE,31,254,2,287,1932
NUEVO LEÓN,GUADALUPE,22,241,8,271,1931
NUEVO LEÓN,GUADALUPE,23,192,2,217,1853
NUEVO LEÓN,GUADALUPE,21,216,4,241,1853
NUEVO LEÓN,GUADALUPE,12,247,8,267,1508
NUEVO LEÓN,GUADALUPE,9,246,2,257,1507
NUEVO LEÓN,GUADALUPE,14,179,0,193,1486
NUEVO LEÓN,GUADALUPE,11,190,0,201,1485
NUEVO LEÓN,GUADALUPE,21,178,0,199,1823
NUEVO LEÓN,GUADALUPE,18,170,3,191,1823
NUEVO LEÓN,GUADALUPE,32,142,2,176,1822
NUEVO LEÓN,GUADALUPE,24,150,1,175,1822
NUEVO LEÓN,GUADALUPE,32,135,1,168,1822
NUEVO LEÓN,GUADALUPE,24,183,0,207,1726
NUEVO LEÓN,GUADALUPE,29,181,1,211,1726
NUEVO LEÓN,GUADALUPE,39,138,2,179,1805
NUEVO LEÓN,GUADALUPE,56,147,1,204,1805
NUEVO LEÓN,GUADALUPE,40,114,1,155,1805
NUEVO LEÓN,GUADALUPE,48,116,1,165,1805
NUEVO LEÓN,GUADALUPE,51,128,2,181,1804
NUEVO LEÓN,GUADALUPE,21,227,1,249,1404
NUEVO LEÓN,GUADALUPE,24,234,2,260,1404
NUEVO LEÓN,GUADALUPE,29,151,1,181,1411
NUEVO LEÓN,GUADALUPE,24,173,1,198,1410
NUEVO LEÓN,GUADALUPE,28,140,1,169,1410
NUEVO LEÓN,GUADALUPE,12,152,2,166,1729
NUEVO LEÓN,GUADALUPE,21,186,1,208,1729
NUEVO LEÓN,GUADALUPE,20,254,4,278,1916
NUEVO LEÓN,GUADALUPE,17,253,11,281,1915
NUEVO LEÓN,GUADALUPE,9,125,0,134,1145
NUEVO LEÓN,GUADALUPE,3,140,1,144,1144
NUEVO LEÓN,GUADALUPE,77,453,2,532,0
NUEVO LEÓN,GUADALUPE,12,158,2,172,1300
NUEVO LEÓN,GUADALUPE,12,171,1,184,1299
NUEVO LEÓN,GUADALUPE,14,229,5,248,1756
NUEVO LEÓN,GUADALUPE,12,202,5,219,1756
NUEVO LEÓN,GUADALUPE,43,203,2,248,1846
NUEVO LEÓN,GUADALUPE,34,180,1,215,1845
NUEVO LEÓN,GUADALUPE,30,139,0,169,1198
NUEVO LEÓN,GUADALUPE,28,153,0,181,1197
NUEVO LEÓN,GUADALUPE,19,250,2,271,1545
NUEVO LEÓN,GUADALUPE,16,233,1,250,1544
NUEVO LEÓN,GUADALUPE,23,247,2,272,1802
NUEVO LEÓN,GUADALUPE,37,239,1,277,1802
NUEVO LEÓN,GUADALUPE,15,169,3,187,1448
NUEVO LEÓN,GUADALUPE,29,158,8,195,1448
NUEVO LEÓN,GUADALUPE,9,249,2,260,1805
NUEVO LEÓN,GUADALUPE,9,244,7,260,1804
NUEVO LEÓN,GUADALUPE,10,216,4,230,1705
NUEVO LEÓN,GUADALUPE,13,230,2,245,1704
NUEVO LEÓN,GUADALUPE,30,270,8,308,1947
NUEVO LEÓN,GUADALUPE,24,272,4,300,1946
NUEVO LEÓN,GUADALUPE,27,165,1,193,1726
NUEVO LEÓN,GUADALUPE,35,154,1,190,1725
NUEVO LEÓN,GUADALUPE,6,207,1,214,1562
NUEVO LEÓN,GUADALUPE,19,214,1,234,1561
NUEVO LEÓN,GUADALUPE,31,109,1,141,1621
NUEVO LEÓN,GUADALUPE,27,129,3,159,1621
NUEVO LEÓN,GUADALUPE,33,112,2,147,1620
NUEVO LEÓN,GUADALUPE,12,194,6,212,1693
NUEVO LEÓN,GUADALUPE,10,229,5,244,1692
NUEVO LEÓN,GUADALUPE,29,212,3,244,1802
NUEVO LEÓN,GUADALUPE,34,228,2,264,1802
NUEVO LEÓN,GUADALUPE,13,130,1,144,1590
NUEVO LEÓN,GUADALUPE,18,151,0,169,1590
NUEVO LEÓN,GUADALUPE,4,105,1,110,1734
NUEVO LEÓN,GUADALUPE,8,98,2,108,1734
NUEVO LEÓN,GUADALUPE,7,152,6,165,1603
NUEVO LEÓN,GUADALUPE,10,129,5,144,1603
NUEVO LEÓN,GUADALUPE,7,143,0,150,1132
NUEVO LEÓN,GUADALUPE,13,125,1,139,1131
NUEVO LEÓN,GUADALUPE,9,181,3,193,1670
NUEVO LEÓN,GUADALUPE,8,164,8,180,1669
NUEVO LEÓN,GUADALUPE,25,211,3,239,1630
NUEVO LEÓN,GUADALUPE,13,248,1,262,1630
NUEVO LEÓN,GUADALUPE,32,125,0,157,1672
NUEVO LEÓN,GUADALUPE,18,173,1,192,1672
NUEVO LEÓN,GUADALUPE,33,133,1,167,1672
NUEVO LEÓN,GUADALUPE,30,151,0,181,1672
NUEVO LEÓN,GUADALUPE,12,148,0,160,1144
NUEVO LEÓN,GUADALUPE,16,138,0,154,1143
NUEVO LEÓN,GUADALUPE,21,194,0,215,1616
NUEVO LEÓN,GUADALUPE,17,236,2,255,1616
NUEVO LEÓN,GUADALUPE,20,160,0,180,1702
NUEVO LEÓN,GUADALUPE,18,165,2,185,1702
NUEVO LEÓN,GUADALUPE,20,180,2,202,1797
NUEVO LEÓN,GUADALUPE,20,174,2,196,1797
NUEVO LEÓN,GUADALUPE,18,165,1,184,1796
NUEVO LEÓN,GUADALUPE,3,180,2,185,1451
NUEVO LEÓN,GUADALUPE,12,183,1,196,1450
NUEVO LEÓN,GUADALUPE,4,99,2,105,1045
NUEVO LEÓN,GUADALUPE,12,119,3,134,1044
NUEVO LEÓN,GUADALUPE,28,136,0,164,1456
NUEVO LEÓN,GUADALUPE,20,167,0,187,1456
NUEVO LEÓN,GUADALUPE,17,153,3,173,1862
NUEVO LEÓN,GUADALUPE,14,168,0,182,1862
NUEVO LEÓN,GUADALUPE,14,155,2,171,1861
NUEVO LEÓN,BENITO JUAREZ,5,113,0,118,1538
NUEVO LEÓN,BENITO JUAREZ,26,117,1,144,1538
NUEVO LEÓN,BENITO JUAREZ,14,111,1,126,1537
NUEVO LEÓN,BENITO JUAREZ,5,113,2,120,1345
NUEVO LEÓN,BENITO JUAREZ,7,146,1,154,1344
NUEVO LEÓN,BENITO JUAREZ,6,159,1,166,1344
NUEVO LEÓN,BENITO JUAREZ,13,203,3,219,1607
NUEVO LEÓN,BENITO JUAREZ,9,230,5,244,1606
NUEVO LEÓN,BENITO JUAREZ,11,236,3,250,1545
NUEVO LEÓN,BENITO JUAREZ,5,260,1,266,1544
NUEVO LEÓN,BENITO JUAREZ,7,264,4,275,1544
NUEVO LEÓN,BENITO JUAREZ,7,197,5,209,1760
NUEVO LEÓN,BENITO JUAREZ,8,242,3,253,1759
NUEVO LEÓN,BENITO JUAREZ,19,139,0,158,1889
NUEVO LEÓN,BENITO JUAREZ,20,207,1,228,1888
NUEVO LEÓN,BENITO JUAREZ,22,203,1,226,1758
NUEVO LEÓN,BENITO JUAREZ,19,237,3,259,1757
NUEVO LEÓN,BENITO JUAREZ,16,247,0,263,1446
NUEVO LEÓN,BENITO JUAREZ,13,278,3,294,1446
NUEVO LEÓN,BENITO JUAREZ,2,121,2,125,1690
NUEVO LEÓN,BENITO JUAREZ,7,97,2,106,1689
NUEVO LEÓN,BENITO JUAREZ,0,102,1,103,1441
NUEVO LEÓN,BENITO JUAREZ,1,102,1,104,1440
NUEVO LEÓN,BENITO JUAREZ,7,102,0,109,1832
NUEVO LEÓN,BENITO JUAREZ,3,131,3,137,1832
NUEVO LEÓN,BENITO JUAREZ,12,132,2,146,1643
NUEVO LEÓN,BENITO JUAREZ,3,123,1,127,1643
NUEVO LEÓN,BENITO JUAREZ,8,96,2,106,1328
NUEVO LEÓN,BENITO JUAREZ,3,58,1,62,1328
NUEVO LEÓN,BENITO JUAREZ,5,159,2,166,1078
NUEVO LEÓN,BENITO JUAREZ,4,161,0,165,1077
NUEVO LEÓN,BENITO JUAREZ,2,54,0,56,1381
NUEVO LEÓN,BENITO JUAREZ,7,57,2,66,1381
NUEVO LEÓN,BENITO JUAREZ,2,69,1,72,1381
NUEVO LEÓN,BENITO JUAREZ,1,112,3,116,1108
NUEVO LEÓN,BENITO JUAREZ,10,104,0,114,1107
NUEVO LEÓN,BENITO JUAREZ,8,95,2,105,1924
NUEVO LEÓN,BENITO JUAREZ,8,114,1,123,1924
NUEVO LEÓN,BENITO JUAREZ,2,82,0,84,1923
NUEVO LEÓN,BENITO JUAREZ,9,153,3,165,1700
NUEVO LEÓN,BENITO JUAREZ,14,145,0,159,1699
NUEVO LEÓN,BENITO JUAREZ,10,162,4,176,1699
NUEVO LEÓN,BENITO JUAREZ,9,133,0,142,1716
NUEVO LEÓN,BENITO JUAREZ,5,136,1,142,1715
NUEVO LEÓN,BENITO JUAREZ,8,123,0,131,1715
NUEVO LEÓN,BENITO JUAREZ,5,123,0,128,1715
NUEVO LEÓN,BENITO JUAREZ,17,180,0,197,1754
NUEVO LEÓN,BENITO JUAREZ,21,158,1,180,1754
NUEVO LEÓN,BENITO JUAREZ,10,129,0,139,1397
NUEVO LEÓN,BENITO JUAREZ,9,110,1,120,1396
NUEVO LEÓN,BENITO JUAREZ,6,101,1,108,1396
NUEVO LEÓN,BENITO JUAREZ,18,125,2,145,1636
NUEVO LEÓN,BENITO JUAREZ,14,90,0,104,1636
NUEVO LEÓN,BENITO JUAREZ,8,125,2,135,1635
NUEVO LEÓN,BENITO JUAREZ,0,140,1,141,1764
NUEVO LEÓN,BENITO JUAREZ,3,154,1,158,1764
NUEVO LEÓN,BENITO JUAREZ,3,79,1,83,1451
NUEVO LEÓN,BENITO JUAREZ,1,64,0,65,1450
NUEVO LEÓN,BENITO JUAREZ,7,140,0,147,1954
NUEVO LEÓN,BENITO JUAREZ,12,141,2,155,1954
NUEVO LEÓN,BENITO JUAREZ,2,122,0,124,1954
NUEVO LEÓN,BENITO JUAREZ,11,117,2,130,1688
NUEVO LEÓN,BENITO JUAREZ,5,142,0,147,1687
NUEVO LEÓN,BENITO JUAREZ,5,140,2,147,1687
NUEVO LEÓN,BENITO JUAREZ,2,109,0,111,1877
NUEVO LEÓN,BENITO JUAREZ,1,94,2,97,1876
NUEVO LEÓN,BENITO JUAREZ,5,100,0,105,1876
NUEVO LEÓN,BENITO JUAREZ,2,88,0,90,1876
NUEVO LEÓN,BENITO JUAREZ,2,125,0,127,1876
NUEVO LEÓN,BENITO JUAREZ,3,92,0,95,1876
NUEVO LEÓN,BENITO JUAREZ,0,93,0,93,1876
NUEVO LEÓN,BENITO JUAREZ,0,101,1,102,1876
NUEVO LEÓN,BENITO JUAREZ,3,69,0,72,1876
NUEVO LEÓN,BENITO JUAREZ,2,112,3,117,1876
NUEVO LEÓN,BENITO JUAREZ,2,92,0,94,1876
NUEVO LEÓN,BENITO JUAREZ,0,91,0,91,1658
NUEVO LEÓN,BENITO JUAREZ,5,83,0,88,1657
NUEVO LEÓN,BENITO JUAREZ,9,82,0,91,1657
NUEVO LEÓN,BENITO JUAREZ,7,110,2,119,1517
NUEVO LEÓN,BENITO JUAREZ,7,120,1,128,1516
NUEVO LEÓN,BENITO JUAREZ,4,107,0,111,1516
NUEVO LEÓN,BENITO JUAREZ,8,117,0,125,1869
NUEVO LEÓN,BENITO JUAREZ,9,113,0,122,1868
NUEVO LEÓN,BENITO JUAREZ,9,117,0,126,1868
NUEVO LEÓN,BENITO JUAREZ,2,90,3,95,1436
NUEVO LEÓN,BENITO JUAREZ,4,89,1,94,1435
NUEVO LEÓN,BENITO JUAREZ,0,119,1,120,1856
NUEVO LEÓN,BENITO JUAREZ,8,116,0,124,1856
NUEVO LEÓN,BENITO JUAREZ,6,97,1,104,1891
NUEVO LEÓN,BENITO JUAREZ,6,110,0,116,1890
NUEVO LEÓN,BENITO JUAREZ,2,85,1,88,1890
NUEVO LEÓN,BENITO JUAREZ,4,85,0,89,1890
NUEVO LEÓN,BENITO JUAREZ,4,127,0,131,1654
NUEVO LEÓN,BENITO JUAREZ,5,139,1,145,1654
NUEVO LEÓN,BENITO JUAREZ,5,114,1,120,1653
NUEVO LEÓN,BENITO JUAREZ,7,84,2,93,1954
NUEVO LEÓN,BENITO JUAREZ,11,105,0,116,1953
NUEVO LEÓN,BENITO JUAREZ,13,134,2,149,1968
NUEVO LEÓN,BENITO JUAREZ,4,145,0,149,1968
NUEVO LEÓN,BENITO JUAREZ,4,113,2,119,1565
NUEVO LEÓN,BENITO JUAREZ,6,119,0,125,1565
NUEVO LEÓN,BENITO JUAREZ,6,117,0,123,1564
NUEVO LEÓN,BENITO JUAREZ,3,147,0,150,2122
NUEVO LEÓN,BENITO JUAREZ,2,159,0,161,2122
NUEVO LEÓN,BENITO JUAREZ,5,93,0,98,1672
NUEVO LEÓN,BENITO JUAREZ,4,84,2,90,1671
NUEVO LEÓN,BENITO JUAREZ,3,88,0,91,1671
NUEVO LEÓN,BENITO JUAREZ,10,156,0,166,1709
NUEVO LEÓN,BENITO JUAREZ,10,157,1,168,1708
NUEVO LEÓN,BENITO JUAREZ,17,107,0,124,1328
NUEVO LEÓN,BENITO JUAREZ,23,130,0,153,1328
NUEVO LEÓN,BENITO JUAREZ,21,120,1,142,1327
NUEVO LEÓN,BENITO JUAREZ,11,83,1,95,1531
NUEVO LEÓN,BENITO JUAREZ,13,84,0,97,1531
NUEVO LEÓN,BENITO JUAREZ,7,89,0,96,1531
NUEVO LEÓN,BENITO JUAREZ,13,134,0,147,1685
NUEVO LEÓN,BENITO JUAREZ,7,133,0,140,1685
NUEVO LEÓN,BENITO JUAREZ,14,97,2,113,1637
NUEVO LEÓN,BENITO JUAREZ,8,104,1,113,1636
NUEVO LEÓN,BENITO JUAREZ,9,128,0,137,1149
NUEVO LEÓN,BENITO JUAREZ,7,110,0,117,1149
NUEVO LEÓN,BENITO JUAREZ,4,110,2,116,1875
NUEVO LEÓN,BENITO JUAREZ,9,119,1,129,1875
NUEVO LEÓN,BENITO JUAREZ,3,91,2,96,1557
NUEVO LEÓN,BENITO JUAREZ,8,83,4,95,1557
NUEVO LEÓN,BENITO JUAREZ,2,85,4,91,1556
NUEVO LEÓN,BENITO JUAREZ,12,122,0,134,1512
NUEVO LEÓN,BENITO JUAREZ,3,106,0,109,1512
NUEVO LEÓN,BENITO JUAREZ,5,86,0,91,1421
NUEVO LEÓN,BENITO JUAREZ,6,85,1,92,1420
NUEVO LEÓN,BENITO JUAREZ,7,82,1,90,1062
NUEVO LEÓN,BENITO JUAREZ,2,75,0,77,1061
NUEVO LEÓN,BENITO JUAREZ,1,92,1,94,1902
NUEVO LEÓN,BENITO JUAREZ,3,79,0,82,1902
NUEVO LEÓN,BENITO JUAREZ,1,68,0,69,1902
NUEVO LEÓN,BENITO JUAREZ,6,102,2,110,1464
NUEVO LEÓN,BENITO JUAREZ,4,136,1,141,1463
NUEVO LEÓN,BENITO JUAREZ,7,112,2,121,1542
NUEVO LEÓN,BENITO JUAREZ,9,99,2,110,1541
NUEVO LEÓN,BENITO JUAREZ,6,90,2,98,1541
NUEVO LEÓN,BENITO JUAREZ,5,118,0,123,1470
NUEVO LEÓN,BENITO JUAREZ,8,124,0,132,1470
NUEVO LEÓN,BENITO JUAREZ,1,99,6,106,1542
NUEVO LEÓN,BENITO JUAREZ,6,117,0,123,1541
NUEVO LEÓN,BENITO JUAREZ,7,78,1,86,1574
NUEVO LEÓN,BENITO JUAREZ,3,79,0,82,1574
NUEVO LEÓN,BENITO JUAREZ,5,88,0,93,1574
NUEVO LEÓN,BENITO JUAREZ,6,81,0,87,1573
NUEVO LEÓN,BENITO JUAREZ,6,102,4,112,1052
NUEVO LEÓN,BENITO JUAREZ,3,85,0,88,1051
NUEVO LEÓN,BENITO JUAREZ,6,139,2,147,1757
NUEVO LEÓN,BENITO JUAREZ,3,151,1,155,1756
NUEVO LEÓN,BENITO JUAREZ,7,105,1,113,1380
NUEVO LEÓN,BENITO JUAREZ,7,109,1,117,1380
NUEVO LEÓN,BENITO JUAREZ,6,96,0,102,1380
NUEVO LEÓN,BENITO JUAREZ,7,88,2,97,1364
NUEVO LEÓN,BENITO JUAREZ,0,85,3,88,1364
NUEVO LEÓN,BENITO JUAREZ,2,97,1,100,1363
NUEVO LEÓN,BENITO JUAREZ,8,140,0,148,1454
NUEVO LEÓN,BENITO JUAREZ,3,127,0,130,1453
NUEVO LEÓN,BENITO JUAREZ,3,64,1,68,1356
NUEVO LEÓN,BENITO JUAREZ,8,77,1,86,1356
NUEVO LEÓN,BENITO JUAREZ,10,76,0,86,1356
NUEVO LEÓN,BENITO JUAREZ,7,89,1,97,1700
NUEVO LEÓN,BENITO JUAREZ,10,107,1,118,1700
NUEVO LEÓN,BENITO JUAREZ,7,98,3,108,1700
NUEVO LEÓN,BENITO JUAREZ,3,85,1,89,1700
NUEVO LEÓN,BENITO JUAREZ,4,90,0,94,1699
NUEVO LEÓN,BENITO JUAREZ,3,103,1,107,1699
NUEVO LEÓN,BENITO JUAREZ,4,87,0,91,1555
NUEVO LEÓN,BENITO JUAREZ,2,103,0,105,1554
NUEVO LEÓN,BENITO JUAREZ,6,74,0,80,1554
NUEVO LEÓN,BENITO JUAREZ,3,82,0,85,1525
NUEVO LEÓN,BENITO JUAREZ,4,79,0,83,1525
NUEVO LEÓN,BENITO JUAREZ,3,106,0,109,1227
NUEVO LEÓN,BENITO JUAREZ,5,92,0,97,1226
NUEVO LEÓN,BENITO JUAREZ,6,136,1,143,1942
NUEVO LEÓN,BENITO JUAREZ,9,122,0,131,1941
NUEVO LEÓN,BENITO JUAREZ,4,132,0,136,1941
NUEVO LEÓN,BENITO JUAREZ,13,159,0,172,1882
NUEVO LEÓN,BENITO JUAREZ,11,175,1,187,1882
NUEVO LEÓN,BENITO JUAREZ,7,116,0,123,1461
NUEVO LEÓN,BENITO JUAREZ,6,93,1,100,1460
NUEVO LEÓN,BENITO JUAREZ,6,111,0,117,1537
NUEVO LEÓN,BENITO JUAREZ,6,106,0,112,1536
NUEVO LEÓN,BENITO JUAREZ,7,100,0,107,1536
NUEVO LEÓN,BENITO JUAREZ,8,103,0,111,1536
NUEVO LEÓN,BENITO JUAREZ,25,129,2,156,1700
NUEVO LEÓN,BENITO JUAREZ,13,155,0,168,1700
NUEVO LEÓN,BENITO JUAREZ,11,120,1,132,1481
NUEVO LEÓN,BENITO JUAREZ,13,133,0,146,1481
NUEVO LEÓN,BENITO JUAREZ,12,147,2,161,1481
NUEVO LEÓN,BENITO JUAREZ,0,57,0,57,1583
NUEVO LEÓN,BENITO JUAREZ,1,73,1,75,1583
NUEVO LEÓN,BENITO JUAREZ,5,119,1,125,1468
NUEVO LEÓN,BENITO JUAREZ,0,106,0,106,1467
NUEVO LEÓN,BENITO JUAREZ,6,97,0,103,1467
NUEVO LEÓN,BENITO JUAREZ,8,94,3,105,1466
NUEVO LEÓN,BENITO JUAREZ,1,61,0,62,1348
NUEVO LEÓN,BENITO JUAREZ,6,59,0,65,1347
NUEVO LEÓN,BENITO JUAREZ,2,69,2,73,1347
NUEVO LEÓN,BENITO JUAREZ,4,94,1,99,1273
NUEVO LEÓN,BENITO JUAREZ,3,87,4,94,1272
NUEVO LEÓN,BENITO JUAREZ,3,128,1,132,1943
NUEVO LEÓN,BENITO JUAREZ,4,155,1,160,1942
NUEVO LEÓN,BENITO JUAREZ,3,74,0,77,1170
NUEVO LEÓN,BENITO JUAREZ,6,69,1,76,1170
NUEVO LEÓN,BENITO JUAREZ,4,147,2,153,1126
NUEVO LEÓN,BENITO JUAREZ,10,170,1,181,1126
NUEVO LEÓN,BENITO JUAREZ,6,181,0,187,1465
NUEVO LEÓN,BENITO JUAREZ,5,212,0,217,1465
NUEVO LEÓN,BENITO JUAREZ,17,175,0,192,1124
NUEVO LEÓN,BENITO JUAREZ,8,167,1,176,1123
NUEVO LEÓN,BENITO JUAREZ,18,310,0,328,1411
NUEVO LEÓN,BENITO JUAREZ,14,304,0,318,1411
NUEVO LEÓN,BENITO JUAREZ,11,177,2,190,1911
NUEVO LEÓN,BENITO JUAREZ,23,180,1,204,1911
NUEVO LEÓN,BENITO JUAREZ,89,1132,12,1233,0
NUEVO LEÓN,BENITO JUAREZ,10,113,0,123,1505
NUEVO LEÓN,BENITO JUAREZ,6,107,0,113,1505
NUEVO LEÓN,BENITO JUAREZ,3,93,0,96,1364
NUEVO LEÓN,BENITO JUAREZ,4,88,0,92,1364
NUEVO LEÓN,BENITO JUAREZ,3,103,0,106,1364
NUEVO LEÓN,BENITO JUAREZ,13,97,4,114,1446
NUEVO LEÓN,BENITO JUAREZ,8,110,3,121,1446
NUEVO LEÓN,BENITO JUAREZ,4,91,0,95,1445
NUEVO LEÓN,BENITO JUAREZ,6,119,4,129,1305
NUEVO LEÓN,BENITO JUAREZ,7,139,3,149,1304
NUEVO LEÓN,BENITO JUAREZ,8,95,0,103,1440
NUEVO LEÓN,BENITO JUAREZ,7,79,0,86,1440
NUEVO LEÓN,BENITO JUAREZ,6,100,1,107,1275
NUEVO LEÓN,BENITO JUAREZ,8,107,0,115,1274
NUEVO LEÓN,BENITO JUAREZ,5,114,0,119,1032
NUEVO LEÓN,BENITO JUAREZ,8,95,0,103,1032
NUEVO LEÓN,BENITO JUAREZ,11,105,1,117,1813
NUEVO LEÓN,BENITO JUAREZ,6,113,0,119,1813
NUEVO LEÓN,BENITO JUAREZ,9,135,2,146,1426
NUEVO LEÓN,BENITO JUAREZ,7,133,2,142,1425
NUEVO LEÓN,BENITO JUAREZ,11,137,0,148,1982
NUEVO LEÓN,BENITO JUAREZ,7,128,0,135,1982
NUEVO LEÓN,BENITO JUAREZ,3,81,0,84,1514
NUEVO LEÓN,BENITO JUAREZ,2,82,1,85,1514
NUEVO LEÓN,BENITO JUAREZ,2,71,0,73,1199
NUEVO LEÓN,BENITO JUAREZ,7,68,0,75,1199
NUEVO LEÓN,BENITO JUAREZ,3,95,0,98,1776
NUEVO LEÓN,BENITO JUAREZ,6,116,1,123,1776
NUEVO LEÓN,BENITO JUAREZ,1,68,0,69,1083
NUEVO LEÓN,BENITO JUAREZ,2,53,0,55,1082
NUEVO LEÓN,BENITO JUAREZ,3,87,0,90,1399
NUEVO LEÓN,BENITO JUAREZ,2,66,0,68,1399
NUEVO LEÓN,BENITO JUAREZ,5,114,0,119,1890
NUEVO LEÓN,BENITO JUAREZ,2,118,0,120,1890
NUEVO LEÓN,BENITO JUAREZ,3,114,1,118,1925
NUEVO LEÓN,BENITO JUAREZ,8,100,0,108,1924
NUEVO LEÓN,BENITO JUAREZ,13,120,0,133,1508
NUEVO LEÓN,BENITO JUAREZ,11,150,0,161,1507
NUEVO LEÓN,BENITO JUAREZ,13,170,2,185,1260
NUEVO LEÓN,BENITO JUAREZ,10,150,0,160,1259
NUEVO LEÓN,BENITO JUAREZ,4,120,3,127,1403
NUEVO LEÓN,BENITO JUAREZ,3,129,1,133,1403
NUEVO LEÓN,BENITO JUAREZ,2,138,1,141,1403
OAXACA,SAN JUAN BAUTISTA TUXTEPEC,2,297,6,305,1768
OAXACA,SAN JUAN BAUTISTA TUXTEPEC,9,257,5,271,1767
OAXACA,SAN JUAN BAUTISTA TUXTEPEC,12,503,13,528,1424
OAXACA,SAN JUAN BAUTISTA TUXTEPEC,9,476,11,496,1424
OAXACA,SAN JUAN BAUTISTA TUXTEPEC,14,457,7,478,1775
OAXACA,SAN JUAN BAUTISTA TUXTEPEC,7,436,11,454,1774
OAXACA,SAN JUAN BAUTISTA TUXTEPEC,13,385,11,409,1883
OAXACA,SAN JUAN BAUTISTA TUXTEPEC,8,430,10,448,1883
OAXACA,SAN JUAN BAUTISTA TUXTEPEC,11,453,4,468,1883
OAXACA,SAN JUAN BAUTISTA TUXTEPEC,11,416,7,434,1615
OAXACA,SAN JUAN BAUTISTA TUXTEPEC,6,414,6,426,1615
OAXACA,SAN JUAN BAUTISTA TUXTEPEC,7,417,10,434,1969
OAXACA,SAN JUAN BAUTISTA TUXTEPEC,9,426,6,441,1717
OAXACA,SAN JUAN BAUTISTA TUXTEPEC,10,391,18,419,1717
OAXACA,SAN JUAN BAUTISTA TUXTEPEC,14,240,13,267,1797
OAXACA,SAN JUAN BAUTISTA TUXTEPEC,6,294,22,322,1797
OAXACA,SAN JUAN BAUTISTA TUXTEPEC,21,425,4,450,1819
OAXACA,SAN JUAN BAUTISTA TUXTEPEC,22,497,14,533,1819
OAXACA,SAN JUAN BAUTISTA TUXTEPEC,11,346,6,363,1408
OAXACA,SAN JUAN BAUTISTA TUXTEPEC,20,400,5,425,1407
OAXACA,SAN JUAN BAUTISTA TUXTEPEC,4,404,10,418,1528
OAXACA,SAN JUAN BAUTISTA TUXTEPEC,10,401,14,425,1527
OAXACA,SAN JUAN BAUTISTA TUXTEPEC,3,340,8,351,1808
OAXACA,SAN JUAN BAUTISTA TUXTEPEC,9,380,16,405,1808
OAXACA,SAN JUAN BAUTISTA TUXTEPEC,13,583,12,608,1866
OAXACA,SAN JUAN BAUTISTA TUXTEPEC,20,475,10,505,1865
OAXACA,SAN JUAN BAUTISTA TUXTEPEC,6,312,10,328,1166
OAXACA,SAN JUAN BAUTISTA TUXTEPEC,7,276,3,286,1166
OAXACA,SAN JUAN BAUTISTA TUXTEPEC,9,380,9,398,1841
OAXACA,SAN JUAN BAUTISTA TUXTEPEC,7,398,9,414,1840
OAXACA,SAN JUAN BAUTISTA TUXTEPEC,11,374,4,389,1631
OAXACA,SAN JUAN BAUTISTA TUXTEPEC,10,401,7,418,1631
OAXACA,SAN JUAN BAUTISTA TUXTEPEC,11,428,9,448,1816
OAXACA,SAN JUAN BAUTISTA TUXTEPEC,10,400,9,419,1816
OAXACA,SAN JUAN BAUTISTA TUXTEPEC,10,386,8,404,1858
OAXACA,SAN JUAN BAUTISTA TUXTEPEC,12,406,2,420,1858
OAXACA,SAN JUAN BAUTISTA TUXTEPEC,9,421,7,437,1849
OAXACA,SAN JUAN BAUTISTA TUXTEPEC,1,408,8,417,1849
OAXACA,SAN JUAN BAUTISTA TUXTEPEC,7,397,3,407,1901
OAXACA,SAN JUAN BAUTISTA TUXTEPEC,7,410,8,425,1901
OAXACA,SAN JUAN BAUTISTA TUXTEPEC,5,373,1,379,1502
OAXACA,SAN JUAN BAUTISTA TUXTEPEC,4,361,3,368,1502
OAXACA,SAN JUAN BAUTISTA TUXTEPEC,8,359,6,373,1502
OAXACA,SAN JUAN BAUTISTA TUXTEPEC,8,207,7,222,1441
OAXACA,SAN JUAN BAUTISTA TUXTEPEC,7,237,10,254,1441
OAXACA,SAN JUAN BAUTISTA TUXTEPEC,9,239,6,254,1441
OAXACA,SAN JUAN BAUTISTA TUXTEPEC,8,506,8,522,1737
OAXACA,SAN JUAN BAUTISTA TUXTEPEC,11,535,9,555,1737
OAXACA,SAN JUAN BAUTISTA TUXTEPEC,12,575,14,601,1558
OAXACA,SAN JUAN BAUTISTA TUXTEPEC,10,558,9,577,1557
OAXACA,SAN JUAN BAUTISTA TUXTEPEC,8,494,5,507,1916
OAXACA,SAN JUAN BAUTISTA TUXTEPEC,12,440,0,452,1916
OAXACA,SAN JUAN BAUTISTA TUXTEPEC,5,491,0,496,1915
OAXACA,SAN JUAN BAUTISTA TUXTEPEC,4,363,0,367,1188
OAXACA,SAN JUAN BAUTISTA TUXTEPEC,8,335,0,343,1188
OAXACA,SAN JUAN BAUTISTA TUXTEPEC,9,494,4,507,1745
OAXACA,SAN JUAN BAUTISTA TUXTEPEC,3,451,6,460,1745
OAXACA,SAN JUAN BAUTISTA TUXTEPEC,9,417,3,429,1365
OAXACA,SAN JUAN BAUTISTA TUXTEPEC,14,435,7,456,1364
OAXACA,SAN JUAN BAUTISTA TUXTEPEC,11,400,10,421,1364
OAXACA,SAN JUAN BAUTISTA TUXTEPEC,9,489,3,501,1599
OAXACA,SAN JUAN BAUTISTA TUXTEPEC,9,471,4,484,1598
OAXACA,SAN JUAN BAUTISTA TUXTEPEC,0,445,1,446,1534
OAXACA,SAN JUAN BAUTISTA TUXTEPEC,12,383,3,398,1533
OAXACA,SAN JUAN BAUTISTA TUXTEPEC,50,1134,4,1188,0
OAXACA,SAN JUAN BAUTISTA TUXTEPEC,12,423,3,438,1741
OAXACA,SAN JUAN BAUTISTA TUXTEPEC,22,487,3,512,1741
OAXACA,SAN JUAN BAUTISTA TUXTEPEC,11,486,2,499,1905
OAXACA,SAN JUAN BAUTISTA TUXTEPEC,12,510,1,523,1904
OAXACA,SAN JUAN BAUTISTA TUXTEPEC,16,335,2,353,1431
OAXACA,SAN JUAN BAUTISTA TUXTEPEC,9,343,2,354,1431
OAXACA,SAN JUAN BAUTISTA TUXTEPEC,9,347,2,358,1430
OAXACA,SAN JUAN BAUTISTA TUXTEPEC,7,465,7,479,1970
OAXACA,SAN JUAN BAUTISTA TUXTEPEC,9,521,10,540,1970
OAXACA,SAN JUAN BAUTISTA TUXTEPEC,8,288,1,297,1228
OAXACA,SAN JUAN BAUTISTA TUXTEPEC,12,315,0,327,1228
OAXACA,SAN JUAN BAUTISTA TUXTEPEC,12,419,0,431,1418
OAXACA,SAN JUAN BAUTISTA TUXTEPEC,7,416,3,426,1418
OAXACA,SAN JUAN BAUTISTA TUXTEPEC,4,380,3,387,1418
OAXACA,SAN JUAN BAUTISTA TUXTEPEC,6,442,5,453,1389
OAXACA,SAN JUAN BAUTISTA TUXTEPEC,5,432,4,441,1389
OAXACA,SAN JUAN BAUTISTA TUXTEPEC,4,545,7,556,1596
OAXACA,SAN JUAN BAUTISTA TUXTEPEC,13,485,3,501,1595
OAXACA,SAN JUAN BAUTISTA TUXTEPEC,5,528,5,538,1802
OAXACA,SAN JUAN BAUTISTA TUXTEPEC,11,534,8,553,1802
OAXACA,SAN JUAN BAUTISTA TUXTEPEC,9,441,14,464,1647
OAXACA,SAN JUAN BAUTISTA TUXTEPEC,12,432,7,451,1647
OAXACA,SAN JUAN BAUTISTA TUXTEPEC,19,403,7,429,1647
OAXACA,SAN JUAN BAUTISTA TUXTEPEC,10,445,12,467,1647
OAXACA,SAN JUAN BAUTISTA TUXTEPEC,7,419,2,428,1358
OAXACA,SAN JUAN BAUTISTA TUXTEPEC,14,436,2,452,1357
OAXACA,SAN JUAN BAUTISTA TUXTEPEC,11,514,8,533,1783
OAXACA,SAN JUAN BAUTISTA TUXTEPEC,15,427,4,446,1783
OAXACA,SAN JUAN BAUTISTA TUXTEPEC,8,312,3,323,1406
OAXACA,SAN JUAN BAUTISTA TUXTEPEC,7,316,8,331,1406
OAXACA,SAN JUAN BAUTISTA TUXTEPEC,6,492,3,501,1581
OAXACA,SAN JUAN BAUTISTA TUXTEPEC,19,454,7,480,1581
OAXACA,SAN JUAN BAUTISTA TUXTEPEC,14,471,2,487,1581
OAXACA,SAN JUAN BAUTISTA TUXTEPEC,4,464,8,476,1400
OAXACA,SAN JUAN BAUTISTA TUXTEPEC,2,436,6,444,1400
OAXACA,SAN JUAN BAUTISTA TUXTEPEC,12,427,8,447,1400
OAXACA,SAN JUAN BAUTISTA TUXTEPEC,6,510,6,522,1950
OAXACA,SAN JUAN BAUTISTA TUXTEPEC,9,500,8,517,1949
OAXACA,SAN JUAN BAUTISTA TUXTEPEC,12,349,9,370,1024
OAXACA,SAN JUAN BAUTISTA TUXTEPEC,3,355,7,365,1023
OAXACA,SAN JUAN BAUTISTA TUXTEPEC,8,411,7,426,1553
OAXACA,SAN JUAN BAUTISTA TUXTEPEC,6,413,6,425,1552
OAXACA,SAN JUAN BAUTISTA TUXTEPEC,14,291,3,308,1024
OAXACA,SAN JUAN BAUTISTA TUXTEPEC,10,331,5,346,1024
OAXACA,SAN JUAN BAUTISTA TUXTEPEC,22,274,9,305,1071
OAXACA,SAN JUAN BAUTISTA TUXTEPEC,24,282,9,315,1070
OAXACA,SAN JUAN BAUTISTA TUXTEPEC,8,556,2,566,1910
OAXACA,SAN JUAN BAUTISTA TUXTEPEC,5,493,2,500,1909
OAXACA,SAN JUAN BAUTISTA TUXTEPEC,14,489,22,525,1887
OAXACA,SAN JUAN BAUTISTA TUXTEPEC,19,450,10,479,1887
OAXACA,SAN JUAN BAUTISTA TUXTEPEC,21,411,6,438,1570
OAXACA,SAN JUAN BAUTISTA TUXTEPEC,14,423,9,446,1569
OAXACA,SAN JUAN BAUTISTA TUXTEPEC,11,299,4,314,1007
OAXACA,SAN JUAN BAUTISTA TUXTEPEC,13,302,12,327,1006
OAXACA,SAN JUAN BAUTISTA TUXTEPEC,13,497,10,520,1465
OAXACA,SAN JUAN BAUTISTA TUXTEPEC,17,515,9,541,1465
OAXACA,SAN JUAN BAUTISTA TUXTEPEC,9,459,11,479,1465
OAXACA,SAN JUAN BAUTISTA TUXTEPEC,14,386,11,411,1940
OAXACA,SAN JUAN BAUTISTA TUXTEPEC,5,428,16,449,1939
OAXACA,SAN JUAN BAUTISTA TUXTEPEC,8,345,8,361,1437
OAXACA,SAN JUAN BAUTISTA TUXTEPEC,9,319,7,335,1437
OAXACA,SAN JUAN BAUTISTA TUXTEPEC,10,300,8,318,1437
OAXACA,SAN JUAN BAUTISTA TUXTEPEC,8,316,3,327,1361
OAXACA,SAN JUAN BAUTISTA TUXTEPEC,11,317,1,329,1360
OAXACA,SAN JUAN BAUTISTA TUXTEPEC,9,365,3,377,1360
OAXACA,SAN JUAN BAUTISTA TUXTEPEC,1,290,1,292,1400
OAXACA,SAN JUAN BAUTISTA TUXTEPEC,4,315,0,319,1400
OAXACA,SAN JUAN BAUTISTA TUXTEPEC,16,374,6,396,1365
OAXACA,SAN JUAN BAUTISTA TUXTEPEC,6,425,8,439,1365
OAXACA,SAN JUAN BAUTISTA TUXTEPEC,5,384,1,390,1365
OAXACA,SAN JUAN BAUTISTA TUXTEPEC,7,515,8,530,1707
OAXACA,SAN JUAN BAUTISTA TUXTEPEC,5,524,11,540,1707
OAXACA,SAN JUAN BAUTISTA TUXTEPEC,8,200,2,210,1617
OAXACA,SAN JUAN BAUTISTA TUXTEPEC,2,138,1,141,1616
OAXACA,SAN JUAN BAUTISTA TUXTEPEC,49,379,15,443,1756
OAXACA,SAN JUAN BAUTISTA TUXTEPEC,49,392,12,453,1756
OAXACA,SAN JUAN BAUTISTA TUXTEPEC,82,475,22,579,1612
OAXACA,SAN JUAN BAUTISTA TUXTEPEC,75,457,22,554,1612
OAXACA,SAN JUAN BAUTISTA TUXTEPEC,50,389,27,466,1333
OAXACA,SAN JUAN BAUTISTA TUXTEPEC,59,410,9,478,1333
OAXACA,SAN JUAN BAUTISTA TUXTEPEC,50,444,13,507,1333
OAXACA,SAN JUAN BAUTISTA TUXTEPEC,50,400,17,467,1241
OAXACA,SAN JUAN BAUTISTA TUXTEPEC,34,407,13,454,1241
OAXACA,SAN JUAN BAUTISTA TUXTEPEC,39,389,15,443,1854
OAXACA,SAN JUAN BAUTISTA TUXTEPEC,27,385,7,419,1853
OAXACA,SAN JUAN BAUTISTA TUXTEPEC,16,544,11,571,1563
OAXACA,SAN JUAN BAUTISTA TUXTEPEC,13,504,5,522,1563
OAXACA,SAN JUAN BAUTISTA TUXTEPEC,12,552,15,579,1563
OAXACA,SAN JUAN BAUTISTA TUXTEPEC,13,469,2,484,1501
OAXACA,SAN JUAN BAUTISTA TUXTEPEC,4,426,7,437,1500
OAXACA,SAN JUAN BAUTISTA TUXTEPEC,11,452,3,466,1500
OAXACA,SAN JUAN BAUTISTA TUXTEPEC,6,390,7,403,1468
OAXACA,SAN JUAN BAUTISTA TUXTEPEC,9,352,1,362,1468
OAXACA,SAN JUAN BAUTISTA TUXTEPEC,10,380,3,393,1468
OAXACA,SAN JUAN BAUTISTA TUXTEPEC,23,339,5,367,1859
OAXACA,SAN JUAN BAUTISTA TUXTEPEC,13,340,13,366,1859
OAXACA,SAN JUAN BAUTISTA TUXTEPEC,8,237,8,253,1727
OAXACA,SAN JUAN BAUTISTA TUXTEPEC,10,245,5,260,1726
OAXACA,SAN JUAN BAUTISTA TUXTEPEC,5,234,3,242,1726
OAXACA,SAN JUAN BAUTISTA TUXTEPEC,26,190,7,223,1308
OAXACA,SAN JUAN BAUTISTA TUXTEPEC,54,215,14,283,1307
OAXACA,SAN JUAN BAUTISTA TUXTEPEC,7,314,8,329,1389
OAXACA,SAN JUAN BAUTISTA TUXTEPEC,5,254,3,262,1388
OAXACA,SAN JUAN BAUTISTA TUXTEPEC,8,393,4,405,1465
OAXACA,SAN JUAN BAUTISTA TUXTEPEC,0,286,4,290,1465
OAXACA,SAN JUAN BAUTISTA TUXTEPEC,4,395,29,428,1981
OAXACA,SAN JUAN BAUTISTA TUXTEPEC,17,417,25,459,1981
OAXACA,SAN JUAN BAUTISTA TUXTEPEC,1,200,6,207,1517
OAXACA,SAN JUAN BAUTISTA TUXTEPEC,10,217,4,231,1517
OAXACA,SAN JUAN BAUTISTA TUXTEPEC,6,508,6,520,1815
OAXACA,SAN JUAN BAUTISTA TUXTEPEC,14,528,3,545,1815
OAXACA,TEOTITLAN DE FLORES MAGON,12,327,1,340,1695
OAXACA,TEOTITLAN DE FLORES MAGON,12,313,4,329,1694
OAXACA,TEOTITLAN DE FLORES MAGON,14,412,9,435,1792
OAXACA,TEOTITLAN DE FLORES MAGON,12,343,8,363,1792
OAXACA,TEOTITLAN DE FLORES MAGON,9,250,2,261,1166
OAXACA,TEOTITLAN DE FLORES MAGON,12,216,1,229,1166
OAXACA,TEOTITLAN DE FLORES MAGON,13,403,2,418,1837
OAXACA,TEOTITLAN DE FLORES MAGON,12,345,2,359,1837
OAXACA,TEOTITLAN DE FLORES MAGON,14,360,27,401,1892
OAXACA,TEOTITLAN DE FLORES MAGON,16,374,18,408,1891
OAXACA,TEOTITLAN DE FLORES MAGON,17,328,16,361,1891
OAXACA,TEOTITLAN DE FLORES MAGON,23,229,15,267,1369
OAXACA,TEOTITLAN DE FLORES MAGON,16,158,11,185,1368
OAXACA,TEOTITLAN DE FLORES MAGON,14,213,17,244,1368
OAXACA,TEOTITLAN DE FLORES MAGON,7,235,30,272,1867
OAXACA,TEOTITLAN DE FLORES MAGON,18,254,18,290,1866
OAXACA,TEOTITLAN DE FLORES MAGON,7,157,17,181,1023
OAXACA,TEOTITLAN DE FLORES MAGON,12,146,21,179,1023
OAXACA,TEOTITLAN DE FLORES MAGON,15,216,1,232,1424
OAXACA,TEOTITLAN DE FLORES MAGON,3,235,0,238,1424
OAXACA,TEOTITLAN DE FLORES MAGON,9,206,0,215,1423
OAXACA,TEOTITLAN DE FLORES MAGON,40,747,17,804,1863
OAXACA,TEOTITLAN DE FLORES MAGON,34,566,69,669,1862
OAXACA,TEOTITLAN DE FLORES MAGON,18,344,32,394,1952
OAXACA,TEOTITLAN DE FLORES MAGON,10,321,30,361,1951
OAXACA,TEOTITLAN DE FLORES MAGON,13,406,12,431,1502
OAXACA,TEOTITLAN DE FLORES MAGON,9,371,13,393,1501
OAXACA,TEOTITLAN DE FLORES MAGON,5,357,8,370,1501
OAXACA,TEOTITLAN DE FLORES MAGON,11,540,8,559,1984
OAXACA,TEOTITLAN DE FLORES MAGON,13,615,13,641,1984
OAXACA,TEOTITLAN DE FLORES MAGON,36,450,50,536,1822
OAXACA,TEOTITLAN DE FLORES MAGON,31,482,55,568,1821
OAXACA,TEOTITLAN DE FLORES MAGON,27,216,15,258,1800
OAXACA,TEOTITLAN DE FLORES MAGON,23,190,28,241,1799
OAXACA,TEOTITLAN DE FLORES MAGON,19,397,31,447,1842
OAXACA,TEOTITLAN DE FLORES MAGON,24,461,19,504,1842
OAXACA,TEOTITLAN DE FLORES MAGON,8,230,2,240,1395
OAXACA,TEOTITLAN DE FLORES MAGON,3,171,1,175,1395
OAXACA,TEOTITLAN DE FLORES MAGON,7,289,1,297,1600
OAXACA,TEOTITLAN DE FLORES MAGON,5,247,0,252,1600
OAXACA,TEOTITLAN DE FLORES MAGON,11,287,4,302,1600
OAXACA,TEOTITLAN DE FLORES MAGON,12,198,6,216,1327
OAXACA,TEOTITLAN DE FLORES MAGON,23,202,25,250,1326
OAXACA,TEOTITLAN DE FLORES MAGON,27,234,22,283,1326
OAXACA,TEOTITLAN DE FLORES MAGON,26,440,31,497,1975
OAXACA,TEOTITLAN DE FLORES MAGON,30,402,26,458,1974
OAXACA,TEOTITLAN DE FLORES MAGON,8,307,0,315,1633
OAXACA,TEOTITLAN DE FLORES MAGON,15,261,0,276,1633
OAXACA,TEOTITLAN DE FLORES MAGON,12,301,4,317,1633
OAXACA,TEOTITLAN DE FLORES MAGON,19,351,4,374,1664
OAXACA,TEOTITLAN DE FLORES MAGON,18,392,3,413,1664
OAXACA,TEOTITLAN DE FLORES MAGON,46,270,24,340,1379
OAXACA,TEOTITLAN DE FLORES MAGON,27,352,17,396,1379
OAXACA,TEOTITLAN DE FLORES MAGON,15,438,2,455,1861
OAXACA,TEOTITLAN DE FLORES MAGON,14,398,4,416,1860
OAXACA,TEOTITLAN DE FLORES MAGON,67,498,41,606,1739
OAXACA,TEOTITLAN DE FLORES MAGON,44,495,44,583,1739
OAXACA,TEOTITLAN DE FLORES MAGON,24,352,17,393,1470
OAXACA,TEOTITLAN DE FLORES MAGON,16,357,17,390,1470
OAXACA,TEOTITLAN DE FLORES MAGON,18,328,9,355,1716
OAXACA,TEOTITLAN DE FLORES MAGON,24,319,13,356,1715
OAXACA,TEOTITLAN DE FLORES MAGON,21,360,10,391,1666
OAXACA,TEOTITLAN DE FLORES MAGON,15,290,9,314,1665
OAXACA,TEOTITLAN DE FLORES MAGON,45,320,25,390,1659
OAXACA,TEOTITLAN DE FLORES MAGON,51,346,18,415,1659
OAXACA,TEOTITLAN DE FLORES MAGON,52,272,13,337,1554
OAXACA,TEOTITLAN DE FLORES MAGON,47,283,6,336,1554
OAXACA,TEOTITLAN DE FLORES MAGON,24,229,12,265,1225
OAXACA,TEOTITLAN DE FLORES MAGON,26,330,12,368,1224
OAXACA,TEOTITLAN DE FLORES MAGON,29,630,6,665,1737
OAXACA,TEOTITLAN DE FLORES MAGON,40,648,4,692,1737
OAXACA,TEOTITLAN DE FLORES MAGON,18,503,10,531,1367
OAXACA,TEOTITLAN DE FLORES MAGON,16,485,3,504,1367
OAXACA,TEOTITLAN DE FLORES MAGON,18,346,3,367,1070
OAXACA,TEOTITLAN DE FLORES MAGON,18,288,3,309,1069
OAXACA,TEOTITLAN DE FLORES MAGON,5,368,1,374,1498
OAXACA,TEOTITLAN DE FLORES MAGON,3,384,4,391,1498
OAXACA,TEOTITLAN DE FLORES MAGON,5,368,10,383,1498
OAXACA,TEOTITLAN DE FLORES MAGON,13,500,2,515,1544
OAXACA,TEOTITLAN DE FLORES MAGON,11,484,3,498,1543
OAXACA,TEOTITLAN DE FLORES MAGON,7,486,4,497,1543
OAXACA,TEOTITLAN DE FLORES MAGON,5,166,0,171,1494
OAXACA,TEOTITLAN DE FLORES MAGON,8,133,8,149,1493
OAXACA,TEOTITLAN DE FLORES MAGON,3,180,3,186,1493
OAXACA,TEOTITLAN DE FLORES MAGON,23,401,6,430,1591
OAXACA,TEOTITLAN DE FLORES MAGON,27,367,10,404,1591
OAXACA,TEOTITLAN DE FLORES MAGON,21,560,22,603,1758
OAXACA,TEOTITLAN DE FLORES MAGON,26,576,34,636,1758
OAXACA,TEOTITLAN DE FLORES MAGON,12,254,12,278,1391
OAXACA,TEOTITLAN DE FLORES MAGON,10,208,9,227,1390
OAXACA,TEOTITLAN DE FLORES MAGON,13,260,19,292,1695
OAXACA,TEOTITLAN DE FLORES MAGON,8,264,18,290,1695
OAXACA,TEOTITLAN DE FLORES MAGON,8,250,25,283,1695
OAXACA,TEOTITLAN DE FLORES MAGON,12,566,11,589,1984
OAXACA,TEOTITLAN DE FLORES MAGON,16,584,7,607,1983
OAXACA,TEOTITLAN DE FLORES MAGON,13,231,3,247,1441
OAXACA,TEOTITLAN DE FLORES MAGON,10,282,1,293,1441
OAXACA,TEOTITLAN DE FLORES MAGON,7,278,11,296,1779
OAXACA,TEOTITLAN DE FLORES MAGON,9,205,10,224,1778
OAXACA,TEOTITLAN DE FLORES MAGON,10,488,3,501,1913
OAXACA,TEOTITLAN DE FLORES MAGON,6,499,3,508,1913
OAXACA,TEOTITLAN DE FLORES MAGON,7,270,4,281,1458
OAXACA,TEOTITLAN DE FLORES MAGON,10,290,8,308,1458
OAXACA,TEOTITLAN DE FLORES MAGON,10,266,10,286,1458
OAXACA,TEOTITLAN DE FLORES MAGON,7,251,2,260,1606
OAXACA,TEOTITLAN DE FLORES MAGON,11,265,5,281,1605
OAXACA,TEOTITLAN DE FLORES MAGON,13,279,0,292,1637
OAXACA,TEOTITLAN DE FLORES MAGON,8,280,4,292,1636
OAXACA,TEOTITLAN DE FLORES MAGON,21,352,2,375,1986
OAXACA,TEOTITLAN DE FLORES MAGON,15,356,3,374,1985
OAXACA,TEOTITLAN DE FLORES MAGON,14,327,0,341,1687
OAXACA,TEOTITLAN DE FLORES MAGON,18,302,1,321,1686
OAXACA,TEOTITLAN DE FLORES MAGON,8,146,30,184,1453
OAXACA,TEOTITLAN DE FLORES MAGON,14,149,23,186,1453
OAXACA,TEOTITLAN DE FLORES MAGON,18,157,13,188,1453
OAXACA,TEOTITLAN DE FLORES MAGON,10,205,6,221,1895
OAXACA,TEOTITLAN DE FLORES MAGON,7,232,6,245,1895
OAXACA,TEOTITLAN DE FLORES MAGON,21,366,26,413,1779
OAXACA,TEOTITLAN DE FLORES MAGON,33,444,18,495,1779
OAXACA,TEOTITLAN DE FLORES MAGON,15,415,43,473,1570
OAXACA,TEOTITLAN DE FLORES MAGON,23,425,12,460,1570
OAXACA,TEOTITLAN DE FLORES MAGON,10,332,8,350,1773
OAXACA,TEOTITLAN DE FLORES MAGON,16,369,5,390,1773
OAXACA,TEOTITLAN DE FLORES MAGON,11,360,8,379,1772
OAXACA,TEOTITLAN DE FLORES MAGON,16,532,3,551,1889
OAXACA,TEOTITLAN DE FLORES MAGON,12,526,5,543,1888
OAXACA,TEOTITLAN DE FLORES MAGON,26,294,8,328,1107
OAXACA,TEOTITLAN DE FLORES MAGON,17,334,19,370,1107
OAXACA,TEOTITLAN DE FLORES MAGON,25,484,22,531,1916
OAXACA,TEOTITLAN DE FLORES MAGON,26,472,24,522,1916
OAXACA,TEOTITLAN DE FLORES MAGON,26,523,21,570,1947
OAXACA,TEOTITLAN DE FLORES MAGON,29,516,15,560,1947
OAXACA,TEOTITLAN DE FLORES MAGON,16,412,21,449,1690
OAXACA,TEOTITLAN DE FLORES MAGON,12,355,12,379,1689
OAXACA,TEOTITLAN DE FLORES MAGON,49,223,49,321,1043
OAXACA,TEOTITLAN DE FLORES MAGON,33,237,71,341,1042
OAXACA,TEOTITLAN DE FLORES MAGON,35,534,28,597,1730
OAXACA,TEOTITLAN DE FLORES MAGON,34,536,29,599,1729
OAXACA,TEOTITLAN DE FLORES MAGON,28,357,13,398,1720
OAXACA,TEOTITLAN DE FLORES MAGON,32,367,13,412,1720
OAXACA,TEOTITLAN DE FLORES MAGON,61,446,34,541,1942
OAXACA,TEOTITLAN DE FLORES MAGON,51,466,33,550,1942
OAXACA,TEOTITLAN DE FLORES MAGON,16,261,19,296,1332
OAXACA,TEOTITLAN DE FLORES MAGON,27,292,24,343,1331
OAXACA,TEOTITLAN DE FLORES MAGON,29,224,28,281,1460
OAXACA,TEOTITLAN DE FLORES MAGON,19,243,21,283,1460
OAXACA,TEOTITLAN DE FLORES MAGON,16,241,17,274,1459
OAXACA,TEOTITLAN DE FLORES MAGON,9,277,19,305,1964
OAXACA,TEOTITLAN DE FLORES MAGON,8,303,23,334,1964
OAXACA,TEOTITLAN DE FLORES MAGON,9,288,8,305,1963
OAXACA,TEOTITLAN DE FLORES MAGON,9,232,4,245,1560
OAXACA,TEOTITLAN DE FLORES MAGON,12,253,10,275,1560
OAXACA,TEOTITLAN DE FLORES MAGON,5,223,6,234,1559
OAXACA,TEOTITLAN DE FLORES MAGON,17,359,6,382,1987
OAXACA,TEOTITLAN DE FLORES MAGON,20,315,8,343,1987
OAXACA,TEOTITLAN DE FLORES MAGON,19,302,4,325,1909
OAXACA,TEOTITLAN DE FLORES MAGON,23,313,6,342,1908
OAXACA,TEOTITLAN DE FLORES MAGON,88,244,35,367,1619
OAXACA,TEOTITLAN DE FLORES MAGON,49,258,20,327,1619
OAXACA,TEOTITLAN DE FLORES MAGON,67,291,10,368,1619
OAXACA,TEOTITLAN DE FLORES MAGON,20,359,4,383,1948
OAXACA,TEOTITLAN DE FLORES MAGON,21,375,3,399,1948
OAXACA,TEOTITLAN DE FLORES MAGON,8,253,6,267,1093
OAXACA,TEOTITLAN DE FLORES MAGON,11,251,4,266,1093
OAXACA,TEOTITLAN DE FLORES MAGON,6,390,15,411,1593
OAXACA,TEOTITLAN DE FLORES MAGON,24,394,6,424,1593
OAXACA,TEOTITLAN DE FLORES MAGON,8,279,11,298,1037
OAXACA,TEOTITLAN DE FLORES MAGON,8,311,6,325,1037
OAXACA,TEOTITLAN DE FLORES MAGON,6,280,3,289,1509
OAXACA,TEOTITLAN DE FLORES MAGON,8,277,3,288,1509
OAXACA,TEOTITLAN DE FLORES MAGON,13,289,2,304,1508
OAXACA,TEOTITLAN DE FLORES MAGON,32,993,9,1034,0
OAXACA,TEOTITLAN DE FLORES MAGON,6,371,3,380,1971
OAXACA,TEOTITLAN DE FLORES MAGON,15,357,0,372,1970
OAXACA,HEROICA CIUDAD DE HUAJUAPAN DE LEON,35,412,9,456,1660
OAXACA,HEROICA CIUDAD DE HUAJUAPAN DE LEON,31,404,6,441,1659
OAXACA,HEROICA CIUDAD DE HUAJUAPAN DE LEON,12,159,3,174,1322
OAXACA,HEROICA CIUDAD DE HUAJUAPAN DE LEON,11,161,2,174,1322
OAXACA,HEROICA CIUDAD DE HUAJUAPAN DE LEON,11,338,4,353,2013
OAXACA,HEROICA CIUDAD DE HUAJUAPAN DE LEON,11,352,3,366,2013
OAXACA,HEROICA CIUDAD DE HUAJUAPAN DE LEON,17,365,4,386,2013
OAXACA,HEROICA CIUDAD DE HUAJUAPAN DE LEON,8,271,4,283,1257
OAXACA,HEROICA CIUDAD DE HUAJUAPAN DE LEON,3,278,0,281,1256
OAXACA,HEROICA CIUDAD DE HUAJUAPAN DE LEON,9,419,3,431,2083
OAXACA,HEROICA CIUDAD DE HUAJUAPAN DE LEON,9,390,4,403,1848
OAXACA,HEROICA CIUDAD DE HUAJUAPAN DE LEON,8,411,3,422,1847
OAXACA,HEROICA CIUDAD DE HUAJUAPAN DE LEON,7,469,2,478,1847
OAXACA,HEROICA CIUDAD DE HUAJUAPAN DE LEON,11,465,0,476,1906
OAXACA,HEROICA CIUDAD DE HUAJUAPAN DE LEON,8,440,2,450,1906
OAXACA,HEROICA CIUDAD DE HUAJUAPAN DE LEON,14,415,1,430,1905
OAXACA,HEROICA CIUDAD DE HUAJUAPAN DE LEON,7,288,4,299,1488
OAXACA,HEROICA CIUDAD DE HUAJUAPAN DE LEON,3,319,1,323,1488
OAXACA,HEROICA CIUDAD DE HUAJUAPAN DE LEON,8,275,4,287,1487
OAXACA,HEROICA CIUDAD DE HUAJUAPAN DE LEON,9,240,3,252,1153
OAXACA,HEROICA CIUDAD DE HUAJUAPAN DE LEON,5,232,2,239,1152
OAXACA,HEROICA CIUDAD DE HUAJUAPAN DE LEON,14,389,2,405,2007
OAXACA,HEROICA CIUDAD DE HUAJUAPAN DE LEON,15,399,1,415,2006
OAXACA,HEROICA CIUDAD DE HUAJUAPAN DE LEON,13,412,1,426,2006
OAXACA,HEROICA CIUDAD DE HUAJUAPAN DE LEON,7,322,2,331,1623
OAXACA,HEROICA CIUDAD DE HUAJUAPAN DE LEON,11,359,5,375,1623
OAXACA,HEROICA CIUDAD DE HUAJUAPAN DE LEON,8,354,1,363,1623
OAXACA,HEROICA CIUDAD DE HUAJUAPAN DE LEON,15,257,2,274,1442
OAXACA,HEROICA CIUDAD DE HUAJUAPAN DE LEON,12,288,2,302,1441
OAXACA,HEROICA CIUDAD DE HUAJUAPAN DE LEON,17,330,4,351,1880
OAXACA,HEROICA CIUDAD DE HUAJUAPAN DE LEON,9,342,2,353,1879
OAXACA,HEROICA CIUDAD DE HUAJUAPAN DE LEON,9,349,1,359,2043
OAXACA,HEROICA CIUDAD DE HUAJUAPAN DE LEON,12,393,5,410,2043
OAXACA,HEROICA CIUDAD DE HUAJUAPAN DE LEON,16,360,0,376,1851
OAXACA,HEROICA CIUDAD DE HUAJUAPAN DE LEON,17,352,1,370,1850
OAXACA,HEROICA CIUDAD DE HUAJUAPAN DE LEON,14,322,2,338,1848
OAXACA,HEROICA CIUDAD DE HUAJUAPAN DE LEON,15,343,3,361,1848
OAXACA,HEROICA CIUDAD DE HUAJUAPAN DE LEON,9,257,2,268,1872
OAXACA,HEROICA CIUDAD DE HUAJUAPAN DE LEON,4,297,3,304,1871
OAXACA,HEROICA CIUDAD DE HUAJUAPAN DE LEON,11,415,1,427,1911
OAXACA,HEROICA CIUDAD DE HUAJUAPAN DE LEON,10,394,2,406,1910
OAXACA,HEROICA CIUDAD DE HUAJUAPAN DE LEON,42,1033,5,1080,0
OAXACA,HEROICA CIUDAD DE HUAJUAPAN DE LEON,9,324,2,335,1929
OAXACA,HEROICA CIUDAD DE HUAJUAPAN DE LEON,5,361,6,372,1929
OAXACA,HEROICA CIUDAD DE HUAJUAPAN DE LEON,10,387,7,404,1929
OAXACA,HEROICA CIUDAD DE HUAJUAPAN DE LEON,9,333,3,345,1928
OAXACA,HEROICA CIUDAD DE HUAJUAPAN DE LEON,11,190,5,206,1195
OAXACA,HEROICA CIUDAD DE HUAJUAPAN DE LEON,9,252,9,270,1194
OAXACA,HEROICA CIUDAD DE HUAJUAPAN DE LEON,23,751,11,785,1712
OAXACA,HEROICA CIUDAD DE HUAJUAPAN DE LEON,7,294,1,302,1851
OAXACA,HEROICA CIUDAD DE HUAJUAPAN DE LEON,15,298,6,319,1851
OAXACA,HEROICA CIUDAD DE HUAJUAPAN DE LEON,20,332,3,355,1851
OAXACA,HEROICA CIUDAD DE HUAJUAPAN DE LEON,9,305,3,317,1851
OAXACA,HEROICA CIUDAD DE HUAJUAPAN DE LEON,8,166,3,177,1870
OAXACA,HEROICA CIUDAD DE HUAJUAPAN DE LEON,8,188,1,197,1870
OAXACA,HEROICA CIUDAD DE HUAJUAPAN DE LEON,5,186,3,194,1870
OAXACA,HEROICA CIUDAD DE HUAJUAPAN DE LEON,5,140,3,148,1869
OAXACA,HEROICA CIUDAD DE HUAJUAPAN DE LEON,22,595,16,633,1809
OAXACA,HEROICA CIUDAD DE HUAJUAPAN DE LEON,8,470,14,492,1809
OAXACA,HEROICA CIUDAD DE HUAJUAPAN DE LEON,5,137,4,146,1162
OAXACA,HEROICA CIUDAD DE HUAJUAPAN DE LEON,2,144,2,148,1162
OAXACA,HEROICA CIUDAD DE HUAJUAPAN DE LEON,10,304,7,321,1175
OAXACA,HEROICA CIUDAD DE HUAJUAPAN DE LEON,11,315,9,335,1175
OAXACA,HEROICA CIUDAD DE HUAJUAPAN DE LEON,12,189,1,202,1483
OAXACA,HEROICA CIUDAD DE HUAJUAPAN DE LEON,5,191,9,205,1483
OAXACA,HEROICA CIUDAD DE HUAJUAPAN DE LEON,14,188,3,205,1482
OAXACA,HEROICA CIUDAD DE HUAJUAPAN DE LEON,9,294,2,305,2009
OAXACA,HEROICA CIUDAD DE HUAJUAPAN DE LEON,12,222,5,239,2008
OAXACA,HEROICA CIUDAD DE HUAJUAPAN DE LEON,10,283,5,298,2008
OAXACA,HEROICA CIUDAD DE HUAJUAPAN DE LEON,8,289,6,303,2008
OAXACA,HEROICA CIUDAD DE HUAJUAPAN DE LEON,13,287,7,307,2008
OAXACA,HEROICA CIUDAD DE HUAJUAPAN DE LEON,15,486,6,507,1943
OAXACA,HEROICA CIUDAD DE HUAJUAPAN DE LEON,18,490,5,513,1943
OAXACA,HEROICA CIUDAD DE HUAJUAPAN DE LEON,6,455,1,462,1943
OAXACA,HEROICA CIUDAD DE HUAJUAPAN DE LEON,17,330,2,349,2051
OAXACA,HEROICA CIUDAD DE HUAJUAPAN DE LEON,11,332,5,348,2070
OAXACA,HEROICA CIUDAD DE HUAJUAPAN DE LEON,7,328,2,337,2070
OAXACA,HEROICA CIUDAD DE HUAJUAPAN DE LEON,20,390,3,413,1567
OAXACA,HEROICA CIUDAD DE HUAJUAPAN DE LEON,16,433,4,453,1566
OAXACA,HEROICA CIUDAD DE HUAJUAPAN DE LEON,19,373,1,393,1566
OAXACA,HEROICA CIUDAD DE HUAJUAPAN DE LEON,19,257,0,276,1145
OAXACA,HEROICA CIUDAD DE HUAJUAPAN DE LEON,15,318,2,335,1145
OAXACA,HEROICA CIUDAD DE HUAJUAPAN DE LEON,15,316,2,333,1077
OAXACA,HEROICA CIUDAD DE HUAJUAPAN DE LEON,15,302,7,324,1076
OAXACA,HEROICA CIUDAD DE HUAJUAPAN DE LEON,16,391,4,411,1312
OAXACA,HEROICA CIUDAD DE HUAJUAPAN DE LEON,21,389,3,413,1312
OAXACA,HEROICA CIUDAD DE HUAJUAPAN DE LEON,25,443,5,473,1695
OAXACA,HEROICA CIUDAD DE HUAJUAPAN DE LEON,30,390,5,425,1695
OAXACA,HEROICA CIUDAD DE HUAJUAPAN DE LEON,25,433,4,462,1695
OAXACA,HEROICA CIUDAD DE HUAJUAPAN DE LEON,22,347,0,369,1376
OAXACA,HEROICA CIUDAD DE HUAJUAPAN DE LEON,21,327,5,353,1375
OAXACA,HEROICA CIUDAD DE HUAJUAPAN DE LEON,22,361,4,387,1993
OAXACA,HEROICA CIUDAD DE HUAJUAPAN DE LEON,22,370,2,394,1993
OAXACA,HEROICA CIUDAD DE HUAJUAPAN DE LEON,24,378,0,402,1992
OAXACA,HEROICA CIUDAD DE HUAJUAPAN DE LEON,13,349,2,364,1992
OAXACA,HEROICA CIUDAD DE HUAJUAPAN DE LEON,17,472,2,491,1691
OAXACA,HEROICA CIUDAD DE HUAJUAPAN DE LEON,24,458,4,486,1690
OAXACA,HEROICA CIUDAD DE HUAJUAPAN DE LEON,16,467,2,485,2005
OAXACA,HEROICA CIUDAD DE HUAJUAPAN DE LEON,17,437,5,459,2004
OAXACA,HEROICA CIUDAD DE HUAJUAPAN DE LEON,15,482,5,502,2004
OAXACA,HEROICA CIUDAD DE HUAJUAPAN DE LEON,8,445,4,457,2004
OAXACA,HEROICA CIUDAD DE HUAJUAPAN DE LEON,20,493,10,523,2004
OAXACA,HEROICA CIUDAD DE HUAJUAPAN DE LEON,23,523,3,549,1978
OAXACA,HEROICA CIUDAD DE HUAJUAPAN DE LEON,27,441,6,474,1978
OAXACA,HEROICA CIUDAD DE HUAJUAPAN DE LEON,10,337,1,348,1186
OAXACA,HEROICA CIUDAD DE HUAJUAPAN DE LEON,20,340,2,362,1186
OAXACA,HEROICA CIUDAD DE HUAJUAPAN DE LEON,20,501,5,526,1793
OAXACA,HEROICA CIUDAD DE HUAJUAPAN DE LEON,24,436,2,462,1792
OAXACA,HEROICA CIUDAD DE HUAJUAPAN DE LEON,23,412,5,440,1702
OAXACA,HEROICA CIUDAD DE HUAJUAPAN DE LEON,24,401,2,427,1702
OAXACA,HEROICA CIUDAD DE HUAJUAPAN DE LEON,19,374,10,403,1702
OAXACA,HEROICA CIUDAD DE HUAJUAPAN DE LEON,25,344,5,374,1444
OAXACA,HEROICA CIUDAD DE HUAJUAPAN DE LEON,17,339,1,357,1444
OAXACA,HEROICA CIUDAD DE HUAJUAPAN DE LEON,18,335,5,358,1444
OAXACA,HEROICA CIUDAD DE HUAJUAPAN DE LEON,20,335,2,357,1609
OAXACA,HEROICA CIUDAD DE HUAJUAPAN DE LEON,16,315,1,332,1609
OAXACA,HEROICA CIUDAD DE HUAJUAPAN DE LEON,12,380,5,397,1608
OAXACA,HEROICA CIUDAD DE HUAJUAPAN DE LEON,20,347,3,370,1608
OAXACA,HEROICA CIUDAD DE HUAJUAPAN DE LEON,23,284,4,311,1196
OAXACA,HEROICA CIUDAD DE HUAJUAPAN DE LEON,11,277,1,289,1195
OAXACA,HEROICA CIUDAD DE HUAJUAPAN DE LEON,9,114,9,132,1746
OAXACA,HEROICA CIUDAD DE HUAJUAPAN DE LEON,4,79,1,84,1745
OAXACA,HEROICA CIUDAD DE HUAJUAPAN DE LEON,6,54,0,60,1745
OAXACA,HEROICA CIUDAD DE HUAJUAPAN DE LEON,9,122,1,132,1745
OAXACA,HEROICA CIUDAD DE HUAJUAPAN DE LEON,28,216,14,258,1729
OAXACA,HEROICA CIUDAD DE HUAJUAPAN DE LEON,43,189,18,250,1728
OAXACA,HEROICA CIUDAD DE HUAJUAPAN DE LEON,56,242,20,318,1728
OAXACA,HEROICA CIUDAD DE HUAJUAPAN DE LEON,11,164,3,178,1673
OAXACA,HEROICA CIUDAD DE HUAJUAPAN DE LEON,9,126,5,140,1673
OAXACA,HEROICA CIUDAD DE HUAJUAPAN DE LEON,14,150,4,168,1673
OAXACA,HEROICA CIUDAD DE HUAJUAPAN DE LEON,8,322,6,336,1741
OAXACA,HEROICA CIUDAD DE HUAJUAPAN DE LEON,2,234,6,242,1741
OAXACA,HEROICA CIUDAD DE HUAJUAPAN DE LEON,3,154,0,157,1740
OAXACA,HEROICA CIUDAD DE HUAJUAPAN DE LEON,6,514,4,524,2018
OAXACA,HEROICA CIUDAD DE HUAJUAPAN DE LEON,11,529,6,546,2018
OAXACA,HEROICA CIUDAD DE HUAJUAPAN DE LEON,8,486,11,505,2017
OAXACA,HEROICA CIUDAD DE HUAJUAPAN DE LEON,9,220,5,234,1594
OAXACA,HEROICA CIUDAD DE HUAJUAPAN DE LEON,6,208,2,216,1594
OAXACA,HEROICA CIUDAD DE HUAJUAPAN DE LEON,4,186,0,190,1593
OAXACA,HEROICA CIUDAD DE HUAJUAPAN DE LEON,6,207,0,213,1593
OAXACA,HEROICA CIUDAD DE HUAJUAPAN DE LEON,19,173,6,198,1473
OAXACA,HEROICA CIUDAD DE HUAJUAPAN DE LEON,7,180,12,199,1472
OAXACA,HEROICA CIUDAD DE HUAJUAPAN DE LEON,18,209,9,236,1472
OAXACA,HEROICA CIUDAD DE HUAJUAPAN DE LEON,22,232,17,271,1653
OAXACA,HEROICA CIUDAD DE HUAJUAPAN DE LEON,13,230,16,259,1653
OAXACA,HEROICA CIUDAD DE HUAJUAPAN DE LEON,16,538,6,560,1860
OAXACA,HEROICA CIUDAD DE HUAJUAPAN DE LEON,6,565,12,583,2050
OAXACA,HEROICA CIUDAD DE HUAJUAPAN DE LEON,11,525,5,541,2049
OAXACA,HEROICA CIUDAD DE HUAJUAPAN DE LEON,7,537,6,550,2049
OAXACA,HEROICA CIUDAD DE HUAJUAPAN DE LEON,14,501,3,518,2049
OAXACA,HEROICA CIUDAD DE HUAJUAPAN DE LEON,21,556,16,593,1584
OAXACA,HEROICA CIUDAD DE HUAJUAPAN DE LEON,28,561,13,602,1584
OAXACA,HEROICA CIUDAD DE HUAJUAPAN DE LEON,4,453,16,473,1190
OAXACA,HEROICA CIUDAD DE HUAJUAPAN DE LEON,9,500,9,518,1189
OAXACA,HEROICA CIUDAD DE HUAJUAPAN DE LEON,18,388,10,416,1407
OAXACA,HEROICA CIUDAD DE HUAJUAPAN DE LEON,12,454,7,473,1406
OAXACA,HEROICA CIUDAD DE HUAJUAPAN DE LEON,23,453,18,494,1471
OAXACA,HEROICA CIUDAD DE HUAJUAPAN DE LEON,24,432,21,477,1470
OAXACA,HEROICA CIUDAD DE HUAJUAPAN DE LEON,8,339,3,350,1470
OAXACA,HEROICA CIUDAD DE HUAJUAPAN DE LEON,5,376,5,386,2035
OAXACA,HEROICA CIUDAD DE HUAJUAPAN DE LEON,12,221,1,234,2035
OAXACA,HEROICA CIUDAD DE HUAJUAPAN DE LEON,8,337,2,347,2035
OAXACA,HEROICA CIUDAD DE HUAJUAPAN DE LEON,8,333,4,345,2035
OAXACA,HEROICA CIUDAD DE HUAJUAPAN DE LEON,10,372,3,385,1512
OAXACA,HEROICA CIUDAD DE HUAJUAPAN DE LEON,16,324,0,340,1512
OAXACA,HEROICA CIUDAD DE HUAJUAPAN DE LEON,8,436,2,446,1749
OAXACA,HEROICA CIUDAD DE HUAJUAPAN DE LEON,9,454,1,464,1749
OAXACA,HEROICA CIUDAD DE HUAJUAPAN DE LEON,17,463,1,481,1984
OAXACA,HEROICA CIUDAD DE HUAJUAPAN DE LEON,8,438,4,450,1984
OAXACA,HEROICA CIUDAD DE HUAJUAPAN DE LEON,11,286,1,298,2090
OAXACA,HEROICA CIUDAD DE HUAJUAPAN DE LEON,10,257,3,270,2090
OAXACA,HEROICA CIUDAD DE HUAJUAPAN DE LEON,9,283,6,298,2090
OAXACA,HEROICA CIUDAD DE HUAJUAPAN DE LEON,12,297,7,316,2090
OAXACA,HEROICA CIUDAD DE HUAJUAPAN DE LEON,9,268,5,282,2090
OAXACA,HEROICA CIUDAD DE HUAJUAPAN DE LEON,12,227,3,242,2089
OAXACA,HEROICA CIUDAD DE HUAJUAPAN DE LEON,12,265,6,283,2089
OAXACA,HEROICA CIUDAD DE HUAJUAPAN DE LEON,12,247,5,264,2089
OAXACA,HEROICA CIUDAD DE HUAJUAPAN DE LEON,2,116,4,122,1092
OAXACA,HEROICA CIUDAD DE HUAJUAPAN DE LEON,6,136,10,152,1091
OAXACA,HEROICA CIUDAD DE HUAJUAPAN DE LEON,14,182,3,199,1329
OAXACA,HEROICA CIUDAD DE HUAJUAPAN DE LEON,7,142,4,153,1328
OAXACA,HEROICA CIUDAD DE HUAJUAPAN DE LEON,16,270,2,288,1572
OAXACA,HEROICA CIUDAD DE HUAJUAPAN DE LEON,12,284,1,297,1572
OAXACA,HEROICA CIUDAD DE HUAJUAPAN DE LEON,12,279,0,291,1571
OAXACA,TLACOLULA DE MATAMOROS,10,362,1,373,1674
OAXACA,TLACOLULA DE MATAMOROS,13,306,0,319,1673
OAXACA,TLACOLULA DE MATAMOROS,8,438,11,457,1479
OAXACA,TLACOLULA DE MATAMOROS,16,408,11,435,1479
OAXACA,TLACOLULA DE MATAMOROS,24,179,1,204,1304
OAXACA,TLACOLULA DE MATAMOROS,26,141,1,168,1304
OAXACA,TLACOLULA DE MATAMOROS,8,357,4,369,1484
OAXACA,TLACOLULA DE MATAMOROS,4,364,3,371,1483
OAXACA,TLACOLULA DE MATAMOROS,14,239,13,266,1193
OAXACA,TLACOLULA DE MATAMOROS,20,285,3,308,1192
OAXACA,TLACOLULA DE MATAMOROS,1,172,1,174,1533
OAXACA,TLACOLULA DE MATAMOROS,2,147,2,151,1532
OAXACA,TLACOLULA DE MATAMOROS,5,227,2,234,1610
OAXACA,TLACOLULA DE MATAMOROS,4,234,3,241,1609
OAXACA,TLACOLULA DE MATAMOROS,6,265,0,271,1508
OAXACA,TLACOLULA DE MATAMOROS,10,292,4,306,1508
OAXACA,TLACOLULA DE MATAMOROS,8,245,2,255,1507
OAXACA,TLACOLULA DE MATAMOROS,10,326,0,336,1879
OAXACA,TLACOLULA DE MATAMOROS,9,333,5,347,1879
OAXACA,TLACOLULA DE MATAMOROS,12,271,3,286,1878
OAXACA,TLACOLULA DE MATAMOROS,4,246,3,253,1120
OAXACA,TLACOLULA DE MATAMOROS,13,219,2,234,1119
OAXACA,TLACOLULA DE MATAMOROS,12,320,8,340,1917
OAXACA,TLACOLULA DE MATAMOROS,16,336,1,353,1916
OAXACA,TLACOLULA DE MATAMOROS,19,311,4,334,1904
OAXACA,TLACOLULA DE MATAMOROS,16,330,2,348,1904
OAXACA,TLACOLULA DE MATAMOROS,0,223,3,226,1183
OAXACA,TLACOLULA DE MATAMOROS,0,193,1,194,1182
OAXACA,TLACOLULA DE MATAMOROS,8,248,1,257,1602
OAXACA,TLACOLULA DE MATAMOROS,4,230,2,236,1602
OAXACA,TLACOLULA DE MATAMOROS,8,211,1,220,1602
OAXACA,TLACOLULA DE MATAMOROS,14,217,4,235,1923
OAXACA,TLACOLULA DE MATAMOROS,9,233,4,246,1922
OAXACA,TLACOLULA DE MATAMOROS,8,245,4,257,1945
OAXACA,TLACOLULA DE MATAMOROS,7,297,5,309,1944
OAXACA,TLACOLULA DE MATAMOROS,9,240,2,251,1458
OAXACA,TLACOLULA DE MATAMOROS,13,236,3,252,1458
OAXACA,TLACOLULA DE MATAMOROS,10,221,15,246,1236
OAXACA,TLACOLULA DE MATAMOROS,8,230,5,243,1235
OAXACA,TLACOLULA DE MATAMOROS,14,256,4,274,1458
OAXACA,TLACOLULA DE MATAMOROS,6,261,0,267,1457
OAXACA,TLACOLULA DE MATAMOROS,14,257,1,272,1457
OAXACA,TLACOLULA DE MATAMOROS,10,388,3,401,1426
OAXACA,TLACOLULA DE MATAMOROS,6,230,8,244,1425
OAXACA,TLACOLULA DE MATAMOROS,12,493,11,516,1425
OAXACA,TLACOLULA DE MATAMOROS,6,163,1,170,1807
OAXACA,TLACOLULA DE MATAMOROS,13,168,21,202,1806
OAXACA,TLACOLULA DE MATAMOROS,17,271,12,300,1961
OAXACA,TLACOLULA DE MATAMOROS,13,224,5,242,1485
OAXACA,TLACOLULA DE MATAMOROS,16,221,9,246,1484
OAXACA,TLACOLULA DE MATAMOROS,10,115,7,132,1568
OAXACA,TLACOLULA DE MATAMOROS,18,139,6,163,1567
OAXACA,TLACOLULA DE MATAMOROS,7,80,2,89,1044
OAXACA,TLACOLULA DE MATAMOROS,6,99,1,106,1044
OAXACA,TLACOLULA DE MATAMOROS,19,230,4,253,1935
OAXACA,TLACOLULA DE MATAMOROS,10,255,2,267,1934
OAXACA,TLACOLULA DE MATAMOROS,10,565,30,605,1492
OAXACA,TLACOLULA DE MATAMOROS,7,554,17,578,1492
OAXACA,TLACOLULA DE MATAMOROS,13,85,5,103,1168
OAXACA,TLACOLULA DE MATAMOROS,2,44,3,49,1168
OAXACA,TLACOLULA DE MATAMOROS,9,257,1,267,1369
OAXACA,TLACOLULA DE MATAMOROS,12,267,4,283,1369
OAXACA,TLACOLULA DE MATAMOROS,6,210,3,219,1170
OAXACA,TLACOLULA DE MATAMOROS,8,184,3,195,1170
OAXACA,TLACOLULA DE MATAMOROS,22,141,5,168,1560
OAXACA,TLACOLULA DE MATAMOROS,15,143,2,160,1559
OAXACA,TLACOLULA DE MATAMOROS,11,123,2,136,1559
OAXACA,TLACOLULA DE MATAMOROS,16,165,6,187,1559
OAXACA,TLACOLULA DE MATAMOROS,8,520,7,535,1325
OAXACA,TLACOLULA DE MATAMOROS,11,485,7,503,1324
OAXACA,TLACOLULA DE MATAMOROS,6,192,13,211,1203
OAXACA,TLACOLULA DE MATAMOROS,3,145,3,151,1202
OAXACA,TLACOLULA DE MATAMOROS,9,235,10,254,1776
OAXACA,TLACOLULA DE MATAMOROS,7,210,6,223,1775
OAXACA,TLACOLULA DE MATAMOROS,10,400,8,418,1135
OAXACA,TLACOLULA DE MATAMOROS,10,389,10,409,1135
OAXACA,TLACOLULA DE MATAMOROS,9,249,20,278,1777
OAXACA,TLACOLULA DE MATAMOROS,4,211,14,229,1776
OAXACA,TLACOLULA DE MATAMOROS,3,152,0,155,1433
OAXACA,TLACOLULA DE MATAMOROS,3,132,2,137,1433
OAXACA,TLACOLULA DE MATAMOROS,4,116,0,120,1433
OAXACA,TLACOLULA DE MATAMOROS,6,98,5,109,1497
OAXACA,TLACOLULA DE MATAMOROS,11,135,6,152,1497
OAXACA,TLACOLULA DE MATAMOROS,5,161,7,173,1497
OAXACA,TLACOLULA DE MATAMOROS,9,152,2,163,1497
OAXACA,TLACOLULA DE MATAMOROS,6,478,11,495,1405
OAXACA,TLACOLULA DE MATAMOROS,8,450,9,467,1404
OAXACA,TLACOLULA DE MATAMOROS,8,230,23,261,1880
OAXACA,TLACOLULA DE MATAMOROS,11,295,20,326,1879
OAXACA,TLACOLULA DE MATAMOROS,4,353,3,360,1447
OAXACA,TLACOLULA DE MATAMOROS,14,317,5,336,1446
OAXACA,TLACOLULA DE MATAMOROS,11,310,2,323,1250
OAXACA,TLACOLULA DE MATAMOROS,8,266,5,279,1250
OAXACA,TLACOLULA DE MATAMOROS,3,180,2,185,1134
OAXACA,TLACOLULA DE MATAMOROS,3,187,2,192,1134
OAXACA,TLACOLULA DE MATAMOROS,5,187,3,195,1224
OAXACA,TLACOLULA DE MATAMOROS,4,217,2,223,1224
OAXACA,TLACOLULA DE MATAMOROS,6,305,5,316,1291
OAXACA,TLACOLULA DE MATAMOROS,5,299,7,311,1291
OAXACA,TLACOLULA DE MATAMOROS,13,423,1,437,1801
OAXACA,TLACOLULA DE MATAMOROS,14,448,5,467,1800
OAXACA,TLACOLULA DE MATAMOROS,5,506,9,520,1560
OAXACA,TLACOLULA DE MATAMOROS,4,461,15,480,1559
OAXACA,TLACOLULA DE MATAMOROS,14,424,13,451,1931
OAXACA,TLACOLULA DE MATAMOROS,10,376,17,403,1931
OAXACA,TLACOLULA DE MATAMOROS,3,331,12,346,1557
OAXACA,TLACOLULA DE MATAMOROS,6,289,11,306,1557
OAXACA,TLACOLULA DE MATAMOROS,1,327,10,338,1528
OAXACA,TLACOLULA DE MATAMOROS,10,318,15,343,1528
OAXACA,TLACOLULA DE MATAMOROS,4,311,4,319,1878
OAXACA,TLACOLULA DE MATAMOROS,7,297,3,307,1878
OAXACA,TLACOLULA DE MATAMOROS,5,279,4,288,1807
OAXACA,TLACOLULA DE MATAMOROS,8,290,4,302,1806
OAXACA,TLACOLULA DE MATAMOROS,20,246,4,270,1387
OAXACA,TLACOLULA DE MATAMOROS,19,297,0,316,1387
OAXACA,TLACOLULA DE MATAMOROS,19,304,3,326,1386
OAXACA,TLACOLULA DE MATAMOROS,22,386,0,408,1717
OAXACA,TLACOLULA DE MATAMOROS,11,390,0,401,1716
OAXACA,TLACOLULA DE MATAMOROS,12,201,0,213,1099
OAXACA,TLACOLULA DE MATAMOROS,13,221,3,237,1098
OAXACA,TLACOLULA DE MATAMOROS,10,254,4,268,1695
OAXACA,TLACOLULA DE MATAMOROS,15,268,0,283,1694
OAXACA,TLACOLULA DE MATAMOROS,13,256,2,271,1694
OAXACA,TLACOLULA DE MATAMOROS,16,185,19,220,1493
OAXACA,TLACOLULA DE MATAMOROS,17,232,18,267,1492
OAXACA,TLACOLULA DE MATAMOROS,2,224,2,228,1620
OAXACA,TLACOLULA DE MATAMOROS,4,168,4,176,1620
OAXACA,TLACOLULA DE MATAMOROS,7,240,3,250,1620
OAXACA,TLACOLULA DE MATAMOROS,14,279,1,294,1255
OAXACA,TLACOLULA DE MATAMOROS,17,297,2,316,1255
OAXACA,TLACOLULA DE MATAMOROS,9,344,3,356,1705
OAXACA,TLACOLULA DE MATAMOROS,16,369,3,388,1705
OAXACA,TLACOLULA DE MATAMOROS,22,351,1,374,1705
OAXACA,TLACOLULA DE MATAMOROS,6,263,2,271,1464
OAXACA,TLACOLULA DE MATAMOROS,6,270,2,278,1463
OAXACA,TLACOLULA DE MATAMOROS,19,134,5,158,1677
OAXACA,TLACOLULA DE MATAMOROS,11,91,8,110,1677
OAXACA,TLACOLULA DE MATAMOROS,15,84,7,106,1676
OAXACA,TLACOLULA DE MATAMOROS,10,120,5,135,1676
OAXACA,TLACOLULA DE MATAMOROS,10,186,2,198,1230
OAXACA,TLACOLULA DE MATAMOROS,6,166,0,172,1230
OAXACA,TLACOLULA DE MATAMOROS,9,249,2,260,1614
OAXACA,TLACOLULA DE MATAMOROS,20,257,1,278,1613
OAXACA,TLACOLULA DE MATAMOROS,17,381,2,400,1904
OAXACA,TLACOLULA DE MATAMOROS,13,362,1,376,1904
OAXACA,TLACOLULA DE MATAMOROS,2,369,4,375,1786
OAXACA,TLACOLULA DE MATAMOROS,4,450,11,465,1785
OAXACA,TLACOLULA DE MATAMOROS,3,278,8,289,1785
OAXACA,TLACOLULA DE MATAMOROS,31,249,45,325,1899
OAXACA,TLACOLULA DE MATAMOROS,14,257,25,296,1899
OAXACA,TLACOLULA DE MATAMOROS,10,399,5,414,1744
OAXACA,TLACOLULA DE MATAMOROS,8,435,7,450,1744
OAXACA,TLACOLULA DE MATAMOROS,4,256,1,261,1436
OAXACA,TLACOLULA DE MATAMOROS,1,208,3,212,1436
OAXACA,TLACOLULA DE MATAMOROS,1,73,7,81,1388
OAXACA,TLACOLULA DE MATAMOROS,2,109,4,115,1388
OAXACA,TLACOLULA DE MATAMOROS,7,84,2,93,1388
OAXACA,TLACOLULA DE MATAMOROS,9,196,7,212,1439
OAXACA,TLACOLULA DE MATAMOROS,0,181,6,187,1439
OAXACA,TLACOLULA DE MATAMOROS,5,172,4,181,1438
OAXACA,TLACOLULA DE MATAMOROS,5,222,2,229,1366
OAXACA,TLACOLULA DE MATAMOROS,9,207,3,219,1366
OAXACA,TLACOLULA DE MATAMOROS,5,228,2,235,1626
OAXACA,TLACOLULA DE MATAMOROS,7,249,5,261,1625
OAXACA,TLACOLULA DE MATAMOROS,6,228,2,236,1625
OAXACA,TLACOLULA DE MATAMOROS,10,145,4,159,1844
OAXACA,TLACOLULA DE MATAMOROS,11,111,10,132,1844
OAXACA,TLACOLULA DE MATAMOROS,9,144,12,165,1844
OAXACA,TLACOLULA DE MATAMOROS,19,189,8,216,1892
OAXACA,TLACOLULA DE MATAMOROS,25,199,4,228,1891
OAXACA,TLACOLULA DE MATAMOROS,5,257,1,263,1164
OAXACA,TLACOLULA DE MATAMOROS,7,231,1,239,1164
OAXACA,TLACOLULA DE MATAMOROS,5,373,5,383,1421
OAXACA,TLACOLULA DE MATAMOROS,3,595,3,601,1420
OAXACA,TLACOLULA DE MATAMOROS,0,431,10,441,1499
OAXACA,TLACOLULA DE MATAMOROS,4,446,6,456,1498
OAXACA,TLACOLULA DE MATAMOROS,6,401,7,414,1803
OAXACA,TLACOLULA DE MATAMOROS,8,317,3,328,1802
OAXACA,TLACOLULA DE MATAMOROS,3,366,3,372,1802
OAXACA,TLACOLULA DE MATAMOROS,5,336,1,342,1785
OAXACA,TLACOLULA DE MATAMOROS,9,363,3,375,1785
OAXACA,TLACOLULA DE MATAMOROS,11,321,5,337,1785
OAXACA,TLACOLULA DE MATAMOROS,30,712,9,751,0
OAXACA,TLACOLULA DE MATAMOROS,8,230,2,240,1772
OAXACA,TLACOLULA DE MATAMOROS,6,293,2,301,1771
OAXACA,TLACOLULA DE MATAMOROS,7,234,2,243,1771
OAXACA,TLACOLULA DE MATAMOROS,6,265,3,274,1542
OAXACA,TLACOLULA DE MATAMOROS,14,241,4,259,1541
OAXACA,TLACOLULA DE MATAMOROS,12,368,13,393,1975
OAXACA,TLACOLULA DE MATAMOROS,9,322,5,336,1375
OAXACA,TLACOLULA DE MATAMOROS,6,327,5,338,1375
OAXACA,TLACOLULA DE MATAMOROS,13,298,4,315,1223
OAXACA,TLACOLULA DE MATAMOROS,2,317,6,325,1223
OAXACA,TLACOLULA DE MATAMOROS,9,242,3,254,1701
OAXACA,TLACOLULA DE MATAMOROS,19,196,5,220,1700
OAXACA,TLACOLULA DE MATAMOROS,1,110,1,112,1382
OAXACA,TLACOLULA DE MATAMOROS,3,120,0,123,1382
OAXACA,TLACOLULA DE MATAMOROS,14,234,3,251,1868
OAXACA,TLACOLULA DE MATAMOROS,2,118,0,120,1706
OAXACA,TLACOLULA DE MATAMOROS,3,123,5,131,1705
OAXACA,TLACOLULA DE MATAMOROS,4,88,6,98,1705
OAXACA,TLACOLULA DE MATAMOROS,6,144,4,154,1705
OAXACA,TLACOLULA DE MATAMOROS,5,424,2,431,1909
OAXACA,TLACOLULA DE MATAMOROS,4,418,4,426,1909
OAXACA,TLACOLULA DE MATAMOROS,7,306,6,319,1966
OAXACA,TLACOLULA DE MATAMOROS,6,304,6,316,1965
OAXACA,TLACOLULA DE MATAMOROS,5,282,6,293,2010
OAXACA,TLACOLULA DE MATAMOROS,6,337,3,346,2010
OAXACA,TLACOLULA DE MATAMOROS,6,241,6,253,1087
OAXACA,TLACOLULA DE MATAMOROS,10,248,8,266,1086
OAXACA,SALINA CRUZ,0,332,5,337,1867
OAXACA,SALINA CRUZ,3,349,4,356,1866
OAXACA,SALINA CRUZ,2,301,2,305,1866
OAXACA,SALINA CRUZ,2,568,1,571,1656
OAXACA,SALINA CRUZ,5,584,4,593,1656
OAXACA,SALINA CRUZ,1,585,0,586,1655
OAXACA,SALINA CRUZ,6,76,5,87,1605
OAXACA,SALINA CRUZ,1,29,1,31,1604
OAXACA,SALINA CRUZ,2,60,3,65,1604
OAXACA,SALINA CRUZ,3,85,1,89,1604
OAXACA,SALINA CRUZ,10,341,9,360,2041
OAXACA,SALINA CRUZ,6,324,9,339,2041
OAXACA,SALINA CRUZ,2,341,0,343,2040
OAXACA,SALINA CRUZ,9,556,2,567,1707
OAXACA,SALINA CRUZ,7,526,3,536,1706
OAXACA,SALINA CRUZ,11,471,1,483,1332
OAXACA,SALINA CRUZ,11,456,1,468,1332
OAXACA,SALINA CRUZ,6,597,2,605,1978
OAXACA,SALINA CRUZ,15,567,2,584,1978
OAXACA,SALINA CRUZ,5,445,0,450,1505
OAXACA,SALINA CRUZ,13,509,1,523,1504
OAXACA,SALINA CRUZ,10,445,0,455,1657
OAXACA,SALINA CRUZ,11,434,2,447,1657
OAXACA,SALINA CRUZ,3,458,2,463,1449
OAXACA,SALINA CRUZ,6,452,5,463,1449
OAXACA,SALINA CRUZ,2,466,1,469,1448
OAXACA,SALINA CRUZ,1,536,0,537,1980
OAXACA,SALINA CRUZ,4,512,4,520,1980
OAXACA,SALINA CRUZ,6,371,0,377,1461
OAXACA,SALINA CRUZ,9,363,5,377,1461
OAXACA,SALINA CRUZ,5,360,1,366,1036
OAXACA,SALINA CRUZ,9,340,0,349,1036
OAXACA,SALINA CRUZ,6,497,0,503,1636
OAXACA,SALINA CRUZ,7,460,8,475,1635
OAXACA,SALINA CRUZ,7,465,0,472,1457
OAXACA,SALINA CRUZ,5,484,0,489,1457
OAXACA,SALINA CRUZ,8,593,8,609,1936
OAXACA,SALINA CRUZ,4,570,3,577,1935
OAXACA,SALINA CRUZ,10,544,4,558,1844
OAXACA,SALINA CRUZ,11,542,2,555,1844
OAXACA,SALINA CRUZ,6,540,12,558,1733
OAXACA,SALINA CRUZ,5,573,9,587,1733
OAXACA,SALINA CRUZ,12,580,5,597,1945
OAXACA,SALINA CRUZ,7,602,1,610,1945
OAXACA,SALINA CRUZ,2,415,6,423,1238
OAXACA,SALINA CRUZ,1,434,1,436,1238
OAXACA,SALINA CRUZ,10,583,11,604,1721
OAXACA,SALINA CRUZ,17,616,11,644,1721
OAXACA,SALINA CRUZ,0,576,1,577,1444
OAXACA,SALINA CRUZ,2,546,2,550,1444
OAXACA,SALINA CRUZ,3,229,3,235,1951
OAXACA,SALINA CRUZ,3,262,5,270,1950
OAXACA,SALINA CRUZ,0,206,6,212,1570
OAXACA,SALINA CRUZ,6,175,6,187,1569
OAXACA,SALINA CRUZ,0,120,2,122,1569
OAXACA,SALINA CRUZ,21,253,23,297,1491
OAXACA,SALINA CRUZ,33,293,20,346,1490
OAXACA,SALINA CRUZ,34,280,21,335,1490
OAXACA,SALINA CRUZ,7,165,2,174,1016
OAXACA,SALINA CRUZ,16,169,7,192,1016
OAXACA,SALINA CRUZ,4,288,3,295,1305
OAXACA,SALINA CRUZ,7,271,6,284,1305
OAXACA,SALINA CRUZ,16,514,12,542,1977
OAXACA,SALINA CRUZ,8,521,9,538,1977
OAXACA,SALINA CRUZ,11,492,8,511,1532
OAXACA,SALINA CRUZ,1,473,1,475,1531
OAXACA,SALINA CRUZ,82,274,16,372,1301
OAXACA,SALINA CRUZ,62,136,13,211,1300
OAXACA,SALINA CRUZ,36,126,10,172,1300
OAXACA,SALINA CRUZ,60,413,36,509,1822
OAXACA,SALINA CRUZ,58,393,45,496,1821
OAXACA,SALINA CRUZ,60,382,25,467,1451
OAXACA,SALINA CRUZ,32,356,8,396,1451
OAXACA,SALINA CRUZ,54,379,13,446,1450
OAXACA,SALINA CRUZ,160,500,83,743,1251
OAXACA,SALINA CRUZ,170,479,71,720,1250
OAXACA,SALINA CRUZ,10,418,10,438,1568
OAXACA,SALINA CRUZ,6,373,11,390,1568
OAXACA,SALINA CRUZ,25,542,8,575,1848
OAXACA,SALINA CRUZ,9,510,10,529,1848
OAXACA,SALINA CRUZ,3,168,0,171,1577
OAXACA,SALINA CRUZ,0,188,2,190,1577
OAXACA,SALINA CRUZ,1,186,0,187,1576
OAXACA,SALINA CRUZ,5,140,21,166,1397
OAXACA,SALINA CRUZ,4,44,1,49,1397
OAXACA,SALINA CRUZ,4,46,3,53,1396
OAXACA,SALINA CRUZ,5,246,9,260,1199
OAXACA,SALINA CRUZ,9,275,0,284,1199
OAXACA,SALINA CRUZ,5,182,7,194,1404
OAXACA,SALINA CRUZ,20,243,16,279,1404
OAXACA,SALINA CRUZ,4,685,2,691,1828
OAXACA,SALINA CRUZ,7,744,6,757,1827
OAXACA,SALINA CRUZ,7,510,4,521,1880
OAXACA,SALINA CRUZ,6,559,7,572,1879
OAXACA,SALINA CRUZ,2,419,5,426,1721
OAXACA,SALINA CRUZ,4,407,3,414,1720
OAXACA,SALINA CRUZ,5,386,2,393,1199
OAXACA,SALINA CRUZ,5,388,3,396,1198
OAXACA,SALINA CRUZ,4,312,12,328,1880
OAXACA,SALINA CRUZ,4,403,13,420,1880
OAXACA,SALINA CRUZ,6,273,7,286,1880
OAXACA,SALINA CRUZ,0,76,2,78,1365
OAXACA,SALINA CRUZ,6,114,1,121,1365
OAXACA,SALINA CRUZ,4,103,1,108,1365
OAXACA,SALINA CRUZ,5,143,3,151,1361
OAXACA,SALINA CRUZ,7,157,2,166,1361
OAXACA,SALINA CRUZ,7,254,8,269,1360
OAXACA,SALINA CRUZ,10,444,11,465,1782
OAXACA,SALINA CRUZ,3,374,4,381,1781
OAXACA,SALINA CRUZ,2,191,6,199,1348
OAXACA,SALINA CRUZ,2,211,3,216,1348
OAXACA,SALINA CRUZ,3,685,1,689,1909
OAXACA,SALINA CRUZ,2,646,2,650,1909
OAXACA,SALINA CRUZ,6,490,4,500,1287
OAXACA,SALINA CRUZ,3,462,2,467,1287
OAXACA,SALINA CRUZ,3,690,3,696,1659
OAXACA,SALINA CRUZ,6,696,2,704,1658
OAXACA,SALINA CRUZ,10,679,0,689,1961
OAXACA,SALINA CRUZ,8,695,3,706,1960
OAXACA,SALINA CRUZ,9,247,6,262,1640
OAXACA,SALINA CRUZ,6,207,3,216,1640
OAXACA,SALINA CRUZ,5,279,6,290,1639
OAXACA,SALINA CRUZ,7,438,1,446,1868
OAXACA,SALINA CRUZ,11,404,7,422,1868
OAXACA,SALINA CRUZ,13,389,3,405,1867
OAXACA,SALINA CRUZ,3,669,1,673,1833
OAXACA,SALINA CRUZ,7,624,5,636,1833
OAXACA,SALINA CRUZ,5,334,5,344,1384
OAXACA,SALINA CRUZ,7,358,5,370,1384
OAXACA,SALINA CRUZ,12,342,4,358,1384
OAXACA,SALINA CRUZ,8,425,6,439,1438
OAXACA,SALINA CRUZ,8,456,3,467,1438
OAXACA,SALINA CRUZ,19,498,1,518,1302
OAXACA,SALINA CRUZ,2,538,4,544,1301
OAXACA,SALINA CRUZ,6,555,9,570,1930
OAXACA,SALINA CRUZ,6,577,6,589,1930
OAXACA,SALINA CRUZ,9,543,3,555,1397
OAXACA,SALINA CRUZ,9,482,1,492,1397
OAXACA,SALINA CRUZ,8,654,5,667,1943
OAXACA,SALINA CRUZ,21,630,7,658,1943
OAXACA,SALINA CRUZ,8,388,3,399,1038
OAXACA,SALINA CRUZ,8,386,5,399,1037
OAXACA,SALINA CRUZ,12,682,7,701,1933
OAXACA,SALINA CRUZ,14,708,4,726,1933
OAXACA,SALINA CRUZ,3,677,10,690,1958
OAXACA,SALINA CRUZ,2,639,4,645,1958
OAXACA,SALINA CRUZ,16,609,5,630,1991
OAXACA,SALINA CRUZ,7,602,9,618,1990
OAXACA,SALINA CRUZ,6,436,2,444,1408
OAXACA,SALINA CRUZ,8,452,6,466,1408
OAXACA,SALINA CRUZ,9,437,9,455,1407
OAXACA,SALINA CRUZ,7,443,3,453,1599
OAXACA,SALINA CRUZ,1,404,18,423,1599
OAXACA,SALINA CRUZ,6,425,7,438,1599
OAXACA,SALINA CRUZ,7,460,6,473,1837
OAXACA,SALINA CRUZ,8,501,7,516,1836
OAXACA,SALINA CRUZ,9,571,10,590,1571
OAXACA,SALINA CRUZ,5,539,1,545,1570
OAXACA,SALINA CRUZ,8,244,1,253,1326
OAXACA,SALINA CRUZ,5,263,2,270,1325
OAXACA,SALINA CRUZ,5,282,2,289,1149
OAXACA,SALINA CRUZ,5,324,2,331,1149
OAXACA,SALINA CRUZ,3,392,6,401,1455
OAXACA,SALINA CRUZ,3,441,2,446,1455
OAXACA,SALINA CRUZ,10,422,6,438,1491
OAXACA,SALINA CRUZ,0,491,4,495,1491
OAXACA,SALINA CRUZ,5,458,3,466,1490
OAXACA,SALINA CRUZ,1,394,0,395,1544
OAXACA,SALINA CRUZ,5,377,3,385,1543
OAXACA,SALINA CRUZ,8,502,9,519,1760
OAXACA,SALINA CRUZ,12,507,7,526,1760
OAXACA,SALINA CRUZ,4,509,3,516,1720
OAXACA,SALINA CRUZ,6,467,1,474,1720
OAXACA,SALINA CRUZ,2,501,2,505,1720
OAXACA,SALINA CRUZ,3,503,2,508,1720
OAXACA,SALINA CRUZ,6,430,6,442,1285
OAXACA,SALINA CRUZ,6,420,4,430,1285
OAXACA,SALINA CRUZ,24,1113,7,1144,0
OAXACA,HEROICA CIUDAD DE TLAXIACO,8,551,14,573,1745
OAXACA,HEROICA CIUDAD DE TLAXIACO,7,547,16,570,1744
OAXACA,HEROICA CIUDAD DE TLAXIACO,11,550,3,564,1744
OAXACA,HEROICA CIUDAD DE TLAXIACO,2,386,10,398,1914
OAXACA,HEROICA CIUDAD DE TLAXIACO,10,391,11,412,1914
OAXACA,HEROICA CIUDAD DE TLAXIACO,9,453,20,482,2004
OAXACA,HEROICA CIUDAD DE TLAXIACO,15,511,20,546,2003
OAXACA,HEROICA CIUDAD DE TLAXIACO,10,88,0,98,1863
OAXACA,HEROICA CIUDAD DE TLAXIACO,5,60,10,75,1863
OAXACA,HEROICA CIUDAD DE TLAXIACO,9,50,4,63,1863
OAXACA,HEROICA CIUDAD DE TLAXIACO,39,658,36,733,1934
OAXACA,HEROICA CIUDAD DE TLAXIACO,30,650,46,726,1934
OAXACA,HEROICA CIUDAD DE TLAXIACO,14,458,15,487,1713
OAXACA,HEROICA CIUDAD DE TLAXIACO,15,453,22,490,1712
OAXACA,HEROICA CIUDAD DE TLAXIACO,19,441,9,469,1787
OAXACA,HEROICA CIUDAD DE TLAXIACO,22,476,26,524,1786
OAXACA,HEROICA CIUDAD DE TLAXIACO,9,415,10,434,1826
OAXACA,HEROICA CIUDAD DE TLAXIACO,6,522,2,530,1826
OAXACA,HEROICA CIUDAD DE TLAXIACO,3,376,4,383,1380
OAXACA,HEROICA CIUDAD DE TLAXIACO,6,331,5,342,1380
OAXACA,HEROICA CIUDAD DE TLAXIACO,2,359,7,368,1380
OAXACA,HEROICA CIUDAD DE TLAXIACO,11,333,4,348,1525
OAXACA,HEROICA CIUDAD DE TLAXIACO,3,342,10,355,1525
OAXACA,HEROICA CIUDAD DE TLAXIACO,5,392,12,409,1525
OAXACA,HEROICA CIUDAD DE TLAXIACO,4,344,10,358,1525
OAXACA,HEROICA CIUDAD DE TLAXIACO,12,492,5,509,1843
OAXACA,HEROICA CIUDAD DE TLAXIACO,10,444,3,457,1843
OAXACA,HEROICA CIUDAD DE TLAXIACO,14,448,6,468,1618
OAXACA,HEROICA CIUDAD DE TLAXIACO,10,422,13,445,1617
OAXACA,HEROICA CIUDAD DE TLAXIACO,17,409,14,440,1155
OAXACA,HEROICA CIUDAD DE TLAXIACO,27,383,27,437,1155
OAXACA,HEROICA CIUDAD DE TLAXIACO,0,498,11,509,1782
OAXACA,HEROICA CIUDAD DE TLAXIACO,7,453,7,467,1782
OAXACA,HEROICA CIUDAD DE TLAXIACO,9,477,11,497,1782
OAXACA,HEROICA CIUDAD DE TLAXIACO,21,257,19,297,1205
OAXACA,HEROICA CIUDAD DE TLAXIACO,17,276,12,305,1204
OAXACA,HEROICA CIUDAD DE TLAXIACO,27,285,28,340,1901
OAXACA,HEROICA CIUDAD DE TLAXIACO,30,334,12,376,1900
OAXACA,HEROICA CIUDAD DE TLAXIACO,18,48,1,67,1474
OAXACA,HEROICA CIUDAD DE TLAXIACO,21,64,1,86,1474
OAXACA,HEROICA CIUDAD DE TLAXIACO,20,305,17,342,1997
OAXACA,HEROICA CIUDAD DE TLAXIACO,15,315,32,362,1270
OAXACA,HEROICA CIUDAD DE TLAXIACO,10,331,4,345,1269
OAXACA,HEROICA CIUDAD DE TLAXIACO,5,300,3,308,1564
OAXACA,HEROICA CIUDAD DE TLAXIACO,3,317,4,324,1563
OAXACA,HEROICA CIUDAD DE TLAXIACO,26,599,25,650,1468
OAXACA,HEROICA CIUDAD DE TLAXIACO,17,631,13,661,1467
OAXACA,HEROICA CIUDAD DE TLAXIACO,16,600,21,637,1467
OAXACA,HEROICA CIUDAD DE TLAXIACO,11,309,20,340,1466
OAXACA,HEROICA CIUDAD DE TLAXIACO,7,372,12,391,1465
OAXACA,HEROICA CIUDAD DE TLAXIACO,11,383,2,396,1465
OAXACA,HEROICA CIUDAD DE TLAXIACO,5,94,0,99,1758
OAXACA,HEROICA CIUDAD DE TLAXIACO,20,124,2,146,1758
OAXACA,HEROICA CIUDAD DE TLAXIACO,6,78,2,86,1757
OAXACA,HEROICA CIUDAD DE TLAXIACO,4,311,5,320,1197
OAXACA,HEROICA CIUDAD DE TLAXIACO,5,247,0,252,1197
OAXACA,HEROICA CIUDAD DE TLAXIACO,6,587,18,611,1762
OAXACA,HEROICA CIUDAD DE TLAXIACO,5,593,52,650,1761
OAXACA,HEROICA CIUDAD DE TLAXIACO,8,289,7,304,1937
OAXACA,HEROICA CIUDAD DE TLAXIACO,28,321,14,363,1936
OAXACA,HEROICA CIUDAD DE TLAXIACO,29,277,9,315,1936
OAXACA,HEROICA CIUDAD DE TLAXIACO,24,294,10,328,1936
OAXACA,HEROICA CIUDAD DE TLAXIACO,33,123,17,173,1814
OAXACA,HEROICA CIUDAD DE TLAXIACO,16,263,9,288,1485
OAXACA,HEROICA CIUDAD DE TLAXIACO,13,250,16,279,1485
OAXACA,HEROICA CIUDAD DE TLAXIACO,10,238,12,260,1485
OAXACA,HEROICA CIUDAD DE TLAXIACO,10,418,15,443,1863
OAXACA,HEROICA CIUDAD DE TLAXIACO,14,351,13,378,1862
OAXACA,HEROICA CIUDAD DE TLAXIACO,22,411,17,450,1780
OAXACA,HEROICA CIUDAD DE TLAXIACO,11,420,18,449,1780
OAXACA,HEROICA CIUDAD DE TLAXIACO,6,305,8,319,1780
OAXACA,HEROICA CIUDAD DE TLAXIACO,17,382,1,400,1343
OAXACA,HEROICA CIUDAD DE TLAXIACO,6,394,11,411,1343
OAXACA,HEROICA CIUDAD DE TLAXIACO,4,396,6,406,1342
OAXACA,HEROICA CIUDAD DE TLAXIACO,3,349,2,354,1730
OAXACA,HEROICA CIUDAD DE TLAXIACO,6,314,5,325,1729
OAXACA,HEROICA CIUDAD DE TLAXIACO,5,317,3,325,1729
OAXACA,HEROICA CIUDAD DE TLAXIACO,23,542,20,585,2009
OAXACA,HEROICA CIUDAD DE TLAXIACO,16,497,16,529,2008
OAXACA,HEROICA CIUDAD DE TLAXIACO,15,549,17,581,2008
OAXACA,HEROICA CIUDAD DE TLAXIACO,9,199,11,219,1655
OAXACA,HEROICA CIUDAD DE TLAXIACO,11,208,26,245,1655
OAXACA,HEROICA CIUDAD DE TLAXIACO,4,176,12,192,1655
OAXACA,HEROICA CIUDAD DE TLAXIACO,16,507,25,548,1978
OAXACA,HEROICA CIUDAD DE TLAXIACO,14,492,21,527,1978
OAXACA,HEROICA CIUDAD DE TLAXIACO,4,364,3,371,1985
OAXACA,HEROICA CIUDAD DE TLAXIACO,10,348,5,363,1984
OAXACA,HEROICA CIUDAD DE TLAXIACO,6,185,5,196,1256
OAXACA,HEROICA CIUDAD DE TLAXIACO,22,209,10,241,1255
OAXACA,HEROICA CIUDAD DE TLAXIACO,10,312,7,329,2022
OAXACA,HEROICA CIUDAD DE TLAXIACO,12,295,7,314,2022
OAXACA,HEROICA CIUDAD DE TLAXIACO,7,66,5,78,1173
OAXACA,HEROICA CIUDAD DE TLAXIACO,8,140,6,154,1173
OAXACA,HEROICA CIUDAD DE TLAXIACO,13,504,16,533,1695
OAXACA,HEROICA CIUDAD DE TLAXIACO,7,535,10,552,1695
OAXACA,HEROICA CIUDAD DE TLAXIACO,11,578,16,605,1694
OAXACA,HEROICA CIUDAD DE TLAXIACO,7,199,6,212,1245
OAXACA,HEROICA CIUDAD DE TLAXIACO,6,317,3,326,1245
OAXACA,HEROICA CIUDAD DE TLAXIACO,12,497,7,516,1698
OAXACA,HEROICA CIUDAD DE TLAXIACO,5,483,9,497,1697
OAXACA,HEROICA CIUDAD DE TLAXIACO,3,423,12,438,1615
OAXACA,HEROICA CIUDAD DE TLAXIACO,7,461,10,478,1614
OAXACA,HEROICA CIUDAD DE TLAXIACO,14,551,10,575,1548
OAXACA,HEROICA CIUDAD DE TLAXIACO,8,504,12,524,1547
OAXACA,HEROICA CIUDAD DE TLAXIACO,15,172,3,190,1634
OAXACA,HEROICA CIUDAD DE TLAXIACO,5,210,2,217,1634
OAXACA,HEROICA CIUDAD DE TLAXIACO,12,145,21,178,1634
OAXACA,HEROICA CIUDAD DE TLAXIACO,14,126,13,153,1306
OAXACA,HEROICA CIUDAD DE TLAXIACO,8,67,8,83,1306
OAXACA,HEROICA CIUDAD DE TLAXIACO,18,295,4,317,1491
OAXACA,HEROICA CIUDAD DE TLAXIACO,11,291,5,307,1491
OAXACA,HEROICA CIUDAD DE TLAXIACO,8,303,9,320,1490
OAXACA,HEROICA CIUDAD DE TLAXIACO,13,302,4,319,1142
OAXACA,HEROICA CIUDAD DE TLAXIACO,10,292,1,303,1141
OAXACA,HEROICA CIUDAD DE TLAXIACO,8,275,6,289,1171
OAXACA,HEROICA CIUDAD DE TLAXIACO,5,239,5,249,1170
OAXACA,HEROICA CIUDAD DE TLAXIACO,6,287,14,307,1177
OAXACA,HEROICA CIUDAD DE TLAXIACO,12,291,9,312,1176
OAXACA,HEROICA CIUDAD DE TLAXIACO,3,389,13,405,1949
OAXACA,HEROICA CIUDAD DE TLAXIACO,12,352,5,369,1948
OAXACA,HEROICA CIUDAD DE TLAXIACO,52,450,22,524,1059
OAXACA,HEROICA CIUDAD DE TLAXIACO,37,434,23,494,1059
OAXACA,HEROICA CIUDAD DE TLAXIACO,13,317,6,336,1365
OAXACA,HEROICA CIUDAD DE TLAXIACO,17,298,19,334,1364
OAXACA,HEROICA CIUDAD DE TLAXIACO,20,557,7,584,1103
OAXACA,HEROICA CIUDAD DE TLAXIACO,7,548,4,559,1102
OAXACA,HEROICA CIUDAD DE TLAXIACO,7,275,9,291,1410
OAXACA,HEROICA CIUDAD DE TLAXIACO,13,298,13,324,1410
OAXACA,HEROICA CIUDAD DE TLAXIACO,7,273,5,285,1410
OAXACA,HEROICA CIUDAD DE TLAXIACO,19,394,14,427,1503
OAXACA,HEROICA CIUDAD DE TLAXIACO,28,431,6,465,1503
OAXACA,HEROICA CIUDAD DE TLAXIACO,14,322,17,353,1502
OAXACA,HEROICA CIUDAD DE TLAXIACO,23,354,17,394,1502
OAXACA,HEROICA CIUDAD DE TLAXIACO,5,378,9,392,1815
OAXACA,HEROICA CIUDAD DE TLAXIACO,9,340,11,360,1814
OAXACA,HEROICA CIUDAD DE TLAXIACO,11,360,5,376,1424
OAXACA,HEROICA CIUDAD DE TLAXIACO,6,367,3,376,1423
OAXACA,HEROICA CIUDAD DE TLAXIACO,9,388,0,397,1423
OAXACA,HEROICA CIUDAD DE TLAXIACO,4,516,3,523,1541
OAXACA,HEROICA CIUDAD DE TLAXIACO,5,434,2,441,1540
OAXACA,HEROICA CIUDAD DE TLAXIACO,9,458,14,481,1540
OAXACA,HEROICA CIUDAD DE TLAXIACO,11,319,11,341,1393
OAXACA,HEROICA CIUDAD DE TLAXIACO,12,284,10,306,1392
OAXACA,HEROICA CIUDAD DE TLAXIACO,13,565,10,588,2020
OAXACA,HEROICA CIUDAD DE TLAXIACO,7,287,3,297,1179
OAXACA,HEROICA CIUDAD DE TLAXIACO,3,304,10,317,1178
OAXACA,HEROICA CIUDAD DE TLAXIACO,13,312,10,335,1882
OAXACA,HEROICA CIUDAD DE TLAXIACO,8,253,6,267,1881
OAXACA,HEROICA CIUDAD DE TLAXIACO,5,323,7,335,1881
OAXACA,HEROICA CIUDAD DE TLAXIACO,4,250,6,260,1439
OAXACA,HEROICA CIUDAD DE TLAXIACO,1,302,9,312,1438
OAXACA,HEROICA CIUDAD DE TLAXIACO,6,304,13,323,1438
OAXACA,HEROICA CIUDAD DE TLAXIACO,8,579,6,593,2015
OAXACA,HEROICA CIUDAD DE TLAXIACO,7,549,4,560,2015
OAXACA,HEROICA CIUDAD DE TLAXIACO,13,403,4,420,1389
OAXACA,HEROICA CIUDAD DE TLAXIACO,6,365,7,378,1389
OAXACA,HEROICA CIUDAD DE TLAXIACO,21,879,9,909,0
OAXACA,HEROICA CIUDAD DE TLAXIACO,7,444,1,452,1519
OAXACA,HEROICA CIUDAD DE TLAXIACO,12,398,2,412,1519
OAXACA,HEROICA CIUDAD DE TLAXIACO,6,394,2,402,1519
OAXACA,HEROICA CIUDAD DE TLAXIACO,7,391,5,403,1922
OAXACA,HEROICA CIUDAD DE TLAXIACO,10,311,2,323,1921
OAXACA,HEROICA CIUDAD DE TLAXIACO,13,474,4,491,1581
OAXACA,HEROICA CIUDAD DE TLAXIACO,14,489,2,505,1580
OAXACA,HEROICA CIUDAD DE TLAXIACO,9,443,2,454,1580
OAXACA,HEROICA CIUDAD DE TLAXIACO,11,478,2,491,1627
OAXACA,HEROICA CIUDAD DE TLAXIACO,6,448,0,454,1626
OAXACA,HEROICA CIUDAD DE TLAXIACO,6,496,6,508,1892
OAXACA,HEROICA CIUDAD DE TLAXIACO,10,409,6,425,1891
OAXACA,HEROICA CIUDAD DE TLAXIACO,6,355,7,368,1392
OAXACA,HEROICA CIUDAD DE TLAXIACO,7,324,12,343,1392
OAXACA,HEROICA CIUDAD DE TLAXIACO,8,400,6,414,1748
OAXACA,HEROICA CIUDAD DE TLAXIACO,9,397,4,410,1748
OAXACA,HEROICA CIUDAD DE TLAXIACO,14,391,10,415,1396
OAXACA,HEROICA CIUDAD DE TLAXIACO,14,418,7,439,1396
OAXACA,HEROICA CIUDAD DE TLAXIACO,11,205,8,224,1900
OAXACA,HEROICA CIUDAD DE TLAXIACO,4,175,5,184,1899
OAXACA,HEROICA CIUDAD DE TLAXIACO,7,224,6,237,1899
OAXACA,HEROICA CIUDAD DE TLAXIACO,10,151,7,168,1899
OAXACA,HEROICA CIUDAD DE TLAXIACO,8,265,12,285,1564
OAXACA,HEROICA CIUDAD DE TLAXIACO,9,211,13,233,1564
OAXACA,CIUDAD IXTEPEC,5,556,7,568,1593
OAXACA,CIUDAD IXTEPEC,3,569,2,574,1592
OAXACA,CIUDAD IXTEPEC,2,614,6,622,1592
OAXACA,CIUDAD IXTEPEC,4,498,10,512,1366
OAXACA,CIUDAD IXTEPEC,8,495,1,504,1366
OAXACA,CIUDAD IXTEPEC,7,556,0,563,1366
OAXACA,CIUDAD IXTEPEC,12,435,8,455,1294
OAXACA,CIUDAD IXTEPEC,11,394,9,414,1294
OAXACA,CIUDAD IXTEPEC,7,500,3,510,1488
OAXACA,CIUDAD IXTEPEC,2,500,0,502,1488
OAXACA,CIUDAD IXTEPEC,7,316,0,323,1347
OAXACA,CIUDAD IXTEPEC,6,270,2,278,1347
OAXACA,CIUDAD IXTEPEC,3,355,2,360,1346
OAXACA,CIUDAD IXTEPEC,5,456,6,467,1613
OAXACA,CIUDAD IXTEPEC,7,440,8,455,1612
OAXACA,CIUDAD IXTEPEC,14,559,9,582,1621
OAXACA,CIUDAD IXTEPEC,8,567,5,580,1620
OAXACA,CIUDAD IXTEPEC,4,476,1,481,1877
OAXACA,CIUDAD IXTEPEC,5,374,3,382,1877
OAXACA,CIUDAD IXTEPEC,2,439,1,442,1877
OAXACA,CIUDAD IXTEPEC,4,413,0,417,1877
OAXACA,CIUDAD IXTEPEC,5,403,1,409,1877
OAXACA,CIUDAD IXTEPEC,7,446,3,456,1876
OAXACA,CIUDAD IXTEPEC,6,659,3,668,1598
OAXACA,CIUDAD IXTEPEC,9,608,4,621,1598
OAXACA,CIUDAD IXTEPEC,10,620,2,632,1597
OAXACA,CIUDAD IXTEPEC,4,565,11,580,1492
OAXACA,CIUDAD IXTEPEC,13,536,7,556,1492
OAXACA,CIUDAD IXTEPEC,8,624,7,639,1844
OAXACA,CIUDAD IXTEPEC,2,606,7,615,1843
OAXACA,CIUDAD IXTEPEC,10,584,3,597,1598
OAXACA,CIUDAD IXTEPEC,10,579,1,590,1598
OAXACA,CIUDAD IXTEPEC,5,430,4,439,1355
OAXACA,CIUDAD IXTEPEC,3,415,3,421,1354
OAXACA,CIUDAD IXTEPEC,6,434,0,440,1354
OAXACA,CIUDAD IXTEPEC,12,554,5,571,1976
OAXACA,CIUDAD IXTEPEC,11,557,5,573,1976
OAXACA,CIUDAD IXTEPEC,13,411,6,430,1203
OAXACA,CIUDAD IXTEPEC,13,394,3,410,1203
OAXACA,CIUDAD IXTEPEC,7,363,2,372,1175
OAXACA,CIUDAD IXTEPEC,10,365,4,379,1174
OAXACA,CIUDAD IXTEPEC,10,334,1,345,1039
OAXACA,CIUDAD IXTEPEC,13,352,4,369,1039
OAXACA,CIUDAD IXTEPEC,11,747,10,768,1888
OAXACA,CIUDAD IXTEPEC,10,730,8,748,1888
OAXACA,CIUDAD IXTEPEC,3,778,6,787,1887
OAXACA,CIUDAD IXTEPEC,9,525,8,542,1380
OAXACA,CIUDAD IXTEPEC,6,506,2,514,1379
OAXACA,CIUDAD IXTEPEC,9,728,7,744,1940
OAXACA,CIUDAD IXTEPEC,7,706,3,716,1940
OAXACA,CIUDAD IXTEPEC,37,1734,9,1780,0
OAXACA,CIUDAD IXTEPEC,9,608,0,617,1452
OAXACA,CIUDAD IXTEPEC,4,654,1,659,1452
OAXACA,CIUDAD IXTEPEC,6,603,4,613,1451
OAXACA,CIUDAD IXTEPEC,2,424,1,427,1780
OAXACA,CIUDAD IXTEPEC,1,364,2,367,1780
OAXACA,CIUDAD IXTEPEC,5,415,0,420,1780
OAXACA,CIUDAD IXTEPEC,5,468,1,474,1780
OAXACA,CIUDAD IXTEPEC,4,479,1,484,1780
OAXACA,CIUDAD IXTEPEC,2,398,2,402,1779
OAXACA,CIUDAD IXTEPEC,10,551,5,566,1461
OAXACA,CIUDAD IXTEPEC,2,555,4,561,1460
OAXACA,CIUDAD IXTEPEC,6,570,2,578,1460
OAXACA,CIUDAD IXTEPEC,2,809,1,812,1898
OAXACA,CIUDAD IXTEPEC,4,842,4,850,1898
OAXACA,CIUDAD IXTEPEC,4,594,1,599,1432
OAXACA,CIUDAD IXTEPEC,6,627,1,634,1431
OAXACA,CIUDAD IXTEPEC,4,638,1,643,1431
OAXACA,CIUDAD IXTEPEC,6,700,0,706,1539
OAXACA,CIUDAD IXTEPEC,3,698,2,703,1538
OAXACA,CIUDAD IXTEPEC,5,552,6,563,1433
OAXACA,CIUDAD IXTEPEC,1,589,5,595,1432
OAXACA,CIUDAD IXTEPEC,2,586,2,590,1432
OAXACA,CIUDAD IXTEPEC,2,814,3,819,1891
OAXACA,CIUDAD IXTEPEC,8,845,2,855,1891
OAXACA,CIUDAD IXTEPEC,3,639,0,642,1559
OAXACA,CIUDAD IXTEPEC,3,672,3,678,1559
OAXACA,CIUDAD IXTEPEC,8,709,2,719,1558
OAXACA,CIUDAD IXTEPEC,3,741,1,745,1836
OAXACA,CIUDAD IXTEPEC,4,698,3,705,1836
OAXACA,CIUDAD IXTEPEC,3,767,0,770,1835
OAXACA,CIUDAD IXTEPEC,5,636,4,645,1479
OAXACA,CIUDAD IXTEPEC,1,609,2,612,1478
OAXACA,CIUDAD IXTEPEC,6,778,1,785,1764
OAXACA,CIUDAD IXTEPEC,0,447,0,447,1408
OAXACA,CIUDAD IXTEPEC,3,460,0,463,1408
OAXACA,CIUDAD IXTEPEC,1,443,3,447,1408
OAXACA,CIUDAD IXTEPEC,4,489,4,497,1868
OAXACA,CIUDAD IXTEPEC,1,500,2,503,1868
OAXACA,CIUDAD IXTEPEC,5,553,1,559,1868
OAXACA,CIUDAD IXTEPEC,2,414,0,416,1868
OAXACA,CIUDAD IXTEPEC,2,335,0,337,1327
OAXACA,CIUDAD IXTEPEC,1,333,3,337,1327
OAXACA,CIUDAD IXTEPEC,0,376,3,379,1326
OAXACA,CIUDAD IXTEPEC,18,388,5,411,1418
OAXACA,CIUDAD IXTEPEC,11,388,4,403,1417
OAXACA,CIUDAD IXTEPEC,11,430,10,451,1417
OAXACA,CIUDAD IXTEPEC,9,418,12,439,1778
OAXACA,CIUDAD IXTEPEC,11,435,14,460,1777
OAXACA,CIUDAD IXTEPEC,4,394,4,402,1607
OAXACA,CIUDAD IXTEPEC,11,420,3,434,1606
OAXACA,CIUDAD IXTEPEC,4,423,4,431,1613
OAXACA,CIUDAD IXTEPEC,11,400,6,417,1612
OAXACA,CIUDAD IXTEPEC,16,592,10,618,1778
OAXACA,CIUDAD IXTEPEC,17,587,15,619,1777
OAXACA,CIUDAD IXTEPEC,15,477,15,507,1759
OAXACA,CIUDAD IXTEPEC,11,453,10,474,1759
OAXACA,CIUDAD IXTEPEC,8,435,4,447,1264
OAXACA,CIUDAD IXTEPEC,8,434,9,451,1263
OAXACA,CIUDAD IXTEPEC,5,701,20,726,1947
OAXACA,CIUDAD IXTEPEC,13,627,12,652,1946
OAXACA,CIUDAD IXTEPEC,20,412,10,442,1815
OAXACA,CIUDAD IXTEPEC,11,470,20,501,1814
OAXACA,CIUDAD IXTEPEC,1,456,0,457,1329
OAXACA,CIUDAD IXTEPEC,0,440,0,440,1329
OAXACA,CIUDAD IXTEPEC,1,399,0,400,1391
OAXACA,CIUDAD IXTEPEC,0,439,1,440,1390
OAXACA,CIUDAD IXTEPEC,1,460,0,461,1130
OAXACA,CIUDAD IXTEPEC,0,451,3,454,1129
OAXACA,CIUDAD IXTEPEC,3,606,6,615,1657
OAXACA,CIUDAD IXTEPEC,1,547,3,551,1657
OAXACA,CIUDAD IXTEPEC,7,471,3,481,1498
OAXACA,CIUDAD IXTEPEC,2,472,0,474,1498
OAXACA,CIUDAD IXTEPEC,15,799,4,818,1576
OAXACA,CIUDAD IXTEPEC,4,875,2,881,1575
OAXACA,CIUDAD IXTEPEC,4,882,0,886,1575
OAXACA,CIUDAD IXTEPEC,16,279,4,299,1654
OAXACA,CIUDAD IXTEPEC,14,360,7,381,1654
OAXACA,CIUDAD IXTEPEC,26,697,8,731,1462
OAXACA,CIUDAD IXTEPEC,30,742,20,792,1462
OAXACA,CIUDAD IXTEPEC,10,704,7,721,1462
OAXACA,CIUDAD IXTEPEC,28,707,5,740,1796
OAXACA,CIUDAD IXTEPEC,30,706,15,751,1796
OAXACA,CIUDAD IXTEPEC,25,831,8,864,1937
OAXACA,CIUDAD IXTEPEC,17,790,7,814,1936
OAXACA,CIUDAD IXTEPEC,11,523,4,538,1171
OAXACA,CIUDAD IXTEPEC,7,495,3,505,1171
OAXACA,CIUDAD IXTEPEC,11,528,6,545,1627
OAXACA,CIUDAD IXTEPEC,13,516,11,540,1627
OAXACA,CIUDAD IXTEPEC,11,151,4,166,1978
OAXACA,CIUDAD IXTEPEC,14,163,0,177,1978
OAXACA,CIUDAD IXTEPEC,13,147,1,161,1977
OAXACA,CIUDAD IXTEPEC,25,128,4,157,1438
OAXACA,CIUDAD IXTEPEC,19,122,5,146,1438
OAXACA,CIUDAD IXTEPEC,17,100,5,122,1438
OAXACA,CIUDAD IXTEPEC,15,404,9,428,1513
OAXACA,CIUDAD IXTEPEC,17,404,6,427,1512
OAXACA,CIUDAD IXTEPEC,22,325,2,349,1592
OAXACA,CIUDAD IXTEPEC,12,432,9,453,1899
OAXACA,CIUDAD IXTEPEC,4,543,3,550,1899
OAXACA,CIUDAD IXTEPEC,6,454,11,471,1941
OAXACA,CIUDAD IXTEPEC,6,454,3,463,1941
OAXACA,CIUDAD IXTEPEC,8,171,8,187,1361
OAXACA,CIUDAD IXTEPEC,25,256,10,291,1361
OAXACA,CIUDAD IXTEPEC,19,162,5,186,1360
OAXACA,CIUDAD IXTEPEC,4,624,5,633,1373
OAXACA,CIUDAD IXTEPEC,8,701,1,710,1372
OAXACA,CIUDAD IXTEPEC,17,453,13,483,1469
OAXACA,CIUDAD IXTEPEC,19,498,12,529,1469
OAXACA,CIUDAD IXTEPEC,15,482,14,511,1469
OAXACA,CIUDAD IXTEPEC,9,512,29,550,1451
OAXACA,CIUDAD IXTEPEC,17,518,15,550,1451
OAXACA,CIUDAD IXTEPEC,8,508,3,519,1451
OAXACA,CIUDAD IXTEPEC,9,506,14,529,1169
OAXACA,CIUDAD IXTEPEC,8,479,5,492,1169
OAXACA,CIUDAD IXTEPEC,7,487,6,500,1023
OAXACA,CIUDAD IXTEPEC,9,476,5,490,1022
OAXACA,CIUDAD IXTEPEC,3,701,6,710,1915
OAXACA,CIUDAD IXTEPEC,4,657,10,671,1915
OAXACA,CIUDAD IXTEPEC,1,460,7,468,1452
OAXACA,CIUDAD IXTEPEC,6,484,5,495,1451
OAXACA,CIUDAD IXTEPEC,3,524,0,527,1587
OAXACA,CIUDAD IXTEPEC,1,615,1,617,1586
OAXACA,CIUDAD IXTEPEC,0,592,0,592,1586
OAXACA,CIUDAD IXTEPEC,14,801,3,818,1880
OAXACA,CIUDAD IXTEPEC,6,399,0,405,1710
OAXACA,CIUDAD IXTEPEC,6,482,5,493,1710
OAXACA,CIUDAD IXTEPEC,0,499,1,500,1710
OAXACA,CIUDAD IXTEPEC,5,431,4,440,1709
OAXACA,CIUDAD IXTEPEC,2,523,3,528,1889
OAXACA,CIUDAD IXTEPEC,5,555,2,562,1888
OAXACA,CIUDAD IXTEPEC,3,567,1,571,1748
OAXACA,CIUDAD IXTEPEC,1,709,4,714,1704
OAXACA,CIUDAD IXTEPEC,6,717,1,724,1704
OAXACA,CIUDAD IXTEPEC,2,494,4,500,1341
OAXACA,CIUDAD IXTEPEC,5,574,1,580,1341
OAXACA,CIUDAD IXTEPEC,0,541,4,545,1340
OAXACA,CIUDAD IXTEPEC,5,760,6,771,1958
OAXACA,CIUDAD IXTEPEC,2,792,3,797,1957
OAXACA,CIUDAD IXTEPEC,5,832,4,841,1868
OAXACA,CIUDAD IXTEPEC,8,853,6,867,1867
OAXACA,OAXACA DE JUAREZ,10,334,6,350,1692
OAXACA,OAXACA DE JUAREZ,15,347,3,365,1692
OAXACA,OAXACA DE JUAREZ,11,319,1,331,1692
OAXACA,OAXACA DE JUAREZ,9,337,5,351,1691
OAXACA,OAXACA DE JUAREZ,19,312,0,331,1519
OAXACA,OAXACA DE JUAREZ,15,317,4,336,1518
OAXACA,OAXACA DE JUAREZ,10,308,3,321,1714
OAXACA,OAXACA DE JUAREZ,20,319,2,341,1714
OAXACA,OAXACA DE JUAREZ,26,270,7,303,1890
OAXACA,OAXACA DE JUAREZ,28,302,4,334,1890
OAXACA,OAXACA DE JUAREZ,6,181,0,187,1170
OAXACA,OAXACA DE JUAREZ,7,213,1,221,1169
OAXACA,OAXACA DE JUAREZ,12,334,5,351,1821
OAXACA,OAXACA DE JUAREZ,13,310,4,327,1821
OAXACA,OAXACA DE JUAREZ,22,293,1,316,1497
OAXACA,OAXACA DE JUAREZ,14,309,2,325,1497
OAXACA,OAXACA DE JUAREZ,10,320,1,331,1497
OAXACA,OAXACA DE JUAREZ,6,259,2,267,1496
OAXACA,OAXACA DE JUAREZ,25,335,11,371,1914
OAXACA,OAXACA DE JUAREZ,31,385,4,420,1914
OAXACA,OAXACA DE JUAREZ,9,374,3,386,1761
OAXACA,OAXACA DE JUAREZ,11,382,4,397,1761
OAXACA,OAXACA DE JUAREZ,11,345,7,363,1761
OAXACA,OAXACA DE JUAREZ,17,321,3,341,1364
OAXACA,OAXACA DE JUAREZ,23,292,2,317,1364
OAXACA,OAXACA DE JUAREZ,13,254,4,271,1675
OAXACA,OAXACA DE JUAREZ,6,270,5,281,1675
OAXACA,OAXACA DE JUAREZ,12,246,2,260,1416
OAXACA,OAXACA DE JUAREZ,16,236,0,252,1416
OAXACA,OAXACA DE JUAREZ,16,262,1,279,1416
OAXACA,OAXACA DE JUAREZ,17,226,1,244,1443
OAXACA,OAXACA DE JUAREZ,16,216,0,232,1443
OAXACA,OAXACA DE JUAREZ,11,279,1,291,1335
OAXACA,OAXACA DE JUAREZ,6,267,1,274,1334
OAXACA,OAXACA DE JUAREZ,14,265,3,282,1334
OAXACA,OAXACA DE JUAREZ,8,297,3,308,1449
OAXACA,OAXACA DE JUAREZ,19,311,3,333,1448
OAXACA,OAXACA DE JUAREZ,27,376,4,407,1829
OAXACA,OAXACA DE JUAREZ,22,395,0,417,1828
OAXACA,OAXACA DE JUAREZ,8,277,0,285,1373
OAXACA,OAXACA DE JUAREZ,8,228,2,238,1373
OAXACA,OAXACA DE JUAREZ,16,254,3,273,1373
OAXACA,OAXACA DE JUAREZ,16,366,2,384,1866
OAXACA,OAXACA DE JUAREZ,14,358,3,375,1865
OAXACA,OAXACA DE JUAREZ,23,434,6,463,1957
OAXACA,OAXACA DE JUAREZ,15,370,0,385,1957
OAXACA,OAXACA DE JUAREZ,24,287,3,314,1767
OAXACA,OAXACA DE JUAREZ,15,290,1,306,1766
OAXACA,OAXACA DE JUAREZ,33,282,0,315,1406
OAXACA,OAXACA DE JUAREZ,28,306,1,335,1406
OAXACA,OAXACA DE JUAREZ,14,248,2,264,1272
OAXACA,OAXACA DE JUAREZ,12,280,0,292,1271
OAXACA,OAXACA DE JUAREZ,17,344,2,363,1630
OAXACA,OAXACA DE JUAREZ,17,350,2,369,1630
OAXACA,OAXACA DE JUAREZ,17,342,1,360,1629
OAXACA,OAXACA DE JUAREZ,11,195,1,207,1068
OAXACA,OAXACA DE JUAREZ,12,210,0,222,1067
OAXACA,OAXACA DE JUAREZ,17,370,3,390,1905
OAXACA,OAXACA DE JUAREZ,15,352,5,372,1905
OAXACA,OAXACA DE JUAREZ,14,266,3,283,1081
OAXACA,OAXACA DE JUAREZ,13,244,1,258,1080
OAXACA,OAXACA DE JUAREZ,18,381,0,399,1725
OAXACA,OAXACA DE JUAREZ,15,342,1,358,1725
OAXACA,OAXACA DE JUAREZ,12,250,3,265,1649
OAXACA,OAXACA DE JUAREZ,23,235,1,259,1649
OAXACA,OAXACA DE JUAREZ,17,241,2,260,1649
OAXACA,OAXACA DE JUAREZ,25,414,4,443,1976
OAXACA,OAXACA DE JUAREZ,16,415,4,435,1975
OAXACA,OAXACA DE JUAREZ,7,284,3,294,1877
OAXACA,OAXACA DE JUAREZ,9,265,0,274,1877
OAXACA,OAXACA DE JUAREZ,12,379,5,396,1839
OAXACA,OAXACA DE JUAREZ,11,366,3,380,1839
OAXACA,OAXACA DE JUAREZ,5,201,0,206,1017
OAXACA,OAXACA DE JUAREZ,11,209,0,220,1016
OAXACA,OAXACA DE JUAREZ,14,329,2,345,1892
OAXACA,OAXACA DE JUAREZ,11,333,2,346,1892
OAXACA,OAXACA DE JUAREZ,25,320,1,346,1642
OAXACA,OAXACA DE JUAREZ,11,295,2,308,1642
OAXACA,OAXACA DE JUAREZ,14,327,3,344,1862
OAXACA,OAXACA DE JUAREZ,20,307,1,328,1862
OAXACA,OAXACA DE JUAREZ,35,1959,8,2002,0
OAXACA,OAXACA DE JUAREZ,9,362,1,372,1758
OAXACA,OAXACA DE JUAREZ,13,370,3,386,1758
OAXACA,OAXACA DE JUAREZ,13,305,0,318,1536
OAXACA,OAXACA DE JUAREZ,13,315,2,330,1535
OAXACA,OAXACA DE JUAREZ,12,326,0,338,1722
OAXACA,OAXACA DE JUAREZ,19,278,1,298,1722
OAXACA,OAXACA DE JUAREZ,11,257,4,272,1669
OAXACA,OAXACA DE JUAREZ,29,200,0,229,1669
OAXACA,OAXACA DE JUAREZ,22,254,3,279,1668
OAXACA,OAXACA DE JUAREZ,13,285,1,299,1437
OAXACA,OAXACA DE JUAREZ,15,261,1,277,1437
OAXACA,OAXACA DE JUAREZ,13,281,0,294,1436
OAXACA,OAXACA DE JUAREZ,6,313,3,322,1919
OAXACA,OAXACA DE JUAREZ,15,273,0,288,1918
OAXACA,OAXACA DE JUAREZ,15,298,1,314,1356
OAXACA,OAXACA DE JUAREZ,14,295,3,312,1355
OAXACA,OAXACA DE JUAREZ,7,294,3,304,1574
OAXACA,OAXACA DE JUAREZ,12,317,2,331,1573
OAXACA,OAXACA DE JUAREZ,7,298,4,309,1680
OAXACA,OAXACA DE JUAREZ,7,280,6,293,1679
OAXACA,OAXACA DE JUAREZ,26,283,4,313,1897
OAXACA,OAXACA DE JUAREZ,17,318,4,339,1897
OAXACA,OAXACA DE JUAREZ,28,334,2,364,1664
OAXACA,OAXACA DE JUAREZ,19,339,3,361,1663
OAXACA,OAXACA DE JUAREZ,23,322,3,348,1715
OAXACA,OAXACA DE JUAREZ,27,311,2,340,1715
OAXACA,OAXACA DE JUAREZ,8,313,0,321,1857
OAXACA,OAXACA DE JUAREZ,9,313,9,331,1857
OAXACA,OAXACA DE JUAREZ,17,365,1,383,1896
OAXACA,OAXACA DE JUAREZ,20,343,3,366,1895
OAXACA,OAXACA DE JUAREZ,10,279,0,289,1712
OAXACA,OAXACA DE JUAREZ,9,328,4,341,1711
OAXACA,OAXACA DE JUAREZ,10,327,1,338,1508
OAXACA,OAXACA DE JUAREZ,9,287,2,298,1507
OAXACA,OAXACA DE JUAREZ,8,268,2,278,1608
OAXACA,OAXACA DE JUAREZ,11,289,0,300,1608
OAXACA,OAXACA DE JUAREZ,12,283,3,298,1608
OAXACA,OAXACA DE JUAREZ,22,424,0,446,1940
OAXACA,OAXACA DE JUAREZ,36,484,1,521,1939
OAXACA,OAXACA DE JUAREZ,17,299,3,319,1745
OAXACA,OAXACA DE JUAREZ,8,317,3,328,1745
OAXACA,OAXACA DE JUAREZ,15,302,2,319,1760
OAXACA,OAXACA DE JUAREZ,25,347,2,374,1759
OAXACA,OAXACA DE JUAREZ,14,286,1,301,1559
OAXACA,OAXACA DE JUAREZ,17,278,1,296,1558
OAXACA,OAXACA DE JUAREZ,29,417,2,448,1660
OAXACA,OAXACA DE JUAREZ,13,415,6,434,1660
OAXACA,OAXACA DE JUAREZ,11,262,4,277,1486
OAXACA,OAXACA DE JUAREZ,15,260,2,277,1486
OAXACA,OAXACA DE JUAREZ,7,284,2,293,1486
OAXACA,OAXACA DE JUAREZ,6,225,3,234,1773
OAXACA,OAXACA DE JUAREZ,11,202,2,215,1772
OAXACA,OAXACA DE JUAREZ,15,250,3,268,1764
OAXACA,OAXACA DE JUAREZ,19,208,1,228,1764
OAXACA,OAXACA DE JUAREZ,17,202,2,221,1764
OAXACA,OAXACA DE JUAREZ,9,271,0,280,1456
OAXACA,OAXACA DE JUAREZ,21,230,2,253,1456
OAXACA,OAXACA DE JUAREZ,14,263,4,281,1456
OAXACA,OAXACA DE JUAREZ,19,329,3,351,1626
OAXACA,OAXACA DE JUAREZ,17,317,1,335,1626
OAXACA,OAXACA DE JUAREZ,15,241,1,257,1184
OAXACA,OAXACA DE JUAREZ,9,245,1,255,1183
OAXACA,OAXACA DE JUAREZ,13,228,0,241,1531
OAXACA,OAXACA DE JUAREZ,14,215,0,229,1531
OAXACA,OAXACA DE JUAREZ,10,204,3,217,1530
OAXACA,OAXACA DE JUAREZ,7,205,4,216,1530
OAXACA,OAXACA DE JUAREZ,10,229,2,241,1317
OAXACA,OAXACA DE JUAREZ,11,235,1,247,1316
OAXACA,OAXACA DE JUAREZ,16,276,1,293,1304
OAXACA,OAXACA DE JUAREZ,10,241,1,252,1303
OAXACA,OAXACA DE JUAREZ,24,330,2,356,1773
OAXACA,OAXACA DE JUAREZ,30,362,2,394,1772
OAXACA,OAXACA DE JUAREZ,10,239,1,250,1602
OAXACA,OAXACA DE JUAREZ,18,217,1,236,1601
OAXACA,OAXACA DE JUAREZ,18,350,4,372,1935
OAXACA,OAXACA DE JUAREZ,15,343,3,361,1935
OAXACA,OAXACA DE JUAREZ,19,335,2,356,1726
OAXACA,OAXACA DE JUAREZ,12,364,0,376,1726
OAXACA,OAXACA DE JUAREZ,11,249,1,261,1249
OAXACA,OAXACA DE JUAREZ,10,228,0,238,1249
OAXACA,OAXACA DE JUAREZ,18,274,0,292,1345
OAXACA,OAXACA DE JUAREZ,13,280,3,296,1345
OAXACA,OAXACA DE JUAREZ,8,369,7,384,1668
OAXACA,OAXACA DE JUAREZ,15,326,3,344,1668
OAXACA,OAXACA DE JUAREZ,16,328,3,347,1668
OAXACA,OAXACA DE JUAREZ,17,274,1,292,1521
OAXACA,OAXACA DE JUAREZ,11,277,2,290,1521
OAXACA,OAXACA DE JUAREZ,10,272,2,284,1553
OAXACA,OAXACA DE JUAREZ,9,326,1,336,1553
OAXACA,OAXACA DE JUAREZ,16,288,0,304,1553
OAXACA,OAXACA DE JUAREZ,9,267,0,276,1552
OAXACA,OAXACA DE JUAREZ,11,266,2,279,1419
OAXACA,OAXACA DE JUAREZ,11,301,0,312,1418
OAXACA,OAXACA DE JUAREZ,11,294,1,306,1762
OAXACA,OAXACA DE JUAREZ,16,298,1,315,1762
OAXACA,OAXACA DE JUAREZ,4,272,1,277,1761
OAXACA,OAXACA DE JUAREZ,10,258,1,269,1761
OAXACA,OAXACA DE JUAREZ,10,256,1,267,1761
OAXACA,OAXACA DE JUAREZ,13,286,5,304,1761
OAXACA,OAXACA DE JUAREZ,10,79,1,90,1060
OAXACA,OAXACA DE JUAREZ,8,104,4,116,1059
OAXACA,OAXACA DE JUAREZ,16,402,8,426,1821
OAXACA,OAXACA DE JUAREZ,27,380,8,415,1821
OAXACA,OAXACA DE JUAREZ,16,339,5,360,1924
OAXACA,OAXACA DE JUAREZ,15,365,2,382,1924
OAXACA,OAXACA DE JUAREZ,11,244,1,256,1140
OAXACA,OAXACA DE JUAREZ,11,206,2,219,1139
OAXACA,OAXACA DE JUAREZ,9,282,1,292,1148
OAXACA,OAXACA DE JUAREZ,12,235,2,249,1148
OAXACA,OAXACA DE JUAREZ,18,206,5,229,1096
OAXACA,OAXACA DE JUAREZ,19,194,5,218,1096
OAXACA,OAXACA DE JUAREZ,4,206,2,212,1270
OAXACA,OAXACA DE JUAREZ,5,145,1,151,1269
OAXACA,OAXACA DE JUAREZ,14,336,4,354,1906
OAXACA,OAXACA DE JUAREZ,8,292,3,303,1905
OAXACA,OAXACA DE JUAREZ,12,315,2,329,1741
OAXACA,OAXACA DE JUAREZ,19,307,1,327,1741
OAXACA,OAXACA DE JUAREZ,15,301,5,321,1411
OAXACA,OAXACA DE JUAREZ,14,256,3,273,1411
OAXACA,OAXACA DE JUAREZ,16,271,2,289,1410
OAXACA,OAXACA DE JUAREZ,16,311,3,330,1935
OAXACA,OAXACA DE JUAREZ,6,253,1,260,1935
OAXACA,PUERTO ESCONDIDO,11,567,15,593,1583
OAXACA,PUERTO ESCONDIDO,15,447,10,472,1583
OAXACA,PUERTO ESCONDIDO,16,376,13,405,1517
OAXACA,PUERTO ESCONDIDO,9,362,6,377,1587
OAXACA,PUERTO ESCONDIDO,8,375,5,388,1586
OAXACA,PUERTO ESCONDIDO,9,313,13,335,1228
OAXACA,PUERTO ESCONDIDO,16,355,24,395,1227
OAXACA,PUERTO ESCONDIDO,19,370,20,409,1412
OAXACA,PUERTO ESCONDIDO,15,477,17,509,1411
OAXACA,PUERTO ESCONDIDO,9,471,6,486,1411
OAXACA,PUERTO ESCONDIDO,9,468,8,485,1517
OAXACA,PUERTO ESCONDIDO,9,495,6,510,1516
OAXACA,PUERTO ESCONDIDO,9,412,8,429,1516
OAXACA,PUERTO ESCONDIDO,4,89,3,96,1501
OAXACA,PUERTO ESCONDIDO,2,57,4,63,1500
OAXACA,PUERTO ESCONDIDO,18,412,13,443,1694
OAXACA,PUERTO ESCONDIDO,14,374,3,391,1694
OAXACA,PUERTO ESCONDIDO,7,198,6,211,1175
OAXACA,PUERTO ESCONDIDO,12,166,8,186,1175
OAXACA,PUERTO ESCONDIDO,11,476,3,490,1853
OAXACA,PUERTO ESCONDIDO,13,427,7,447,1852
OAXACA,PUERTO ESCONDIDO,3,520,10,533,1938
OAXACA,PUERTO ESCONDIDO,10,536,6,552,1937
OAXACA,PUERTO ESCONDIDO,4,338,2,344,1359
OAXACA,PUERTO ESCONDIDO,3,381,4,388,1359
OAXACA,PUERTO ESCONDIDO,10,411,17,438,1435
OAXACA,PUERTO ESCONDIDO,18,392,4,414,1434
OAXACA,PUERTO ESCONDIDO,6,362,13,381,1434
OAXACA,PUERTO ESCONDIDO,17,277,15,309,1656
OAXACA,PUERTO ESCONDIDO,6,260,5,271,1655
OAXACA,PUERTO ESCONDIDO,57,286,33,376,1542
OAXACA,PUERTO ESCONDIDO,20,273,13,306,1542
OAXACA,PUERTO ESCONDIDO,27,278,16,321,1541
OAXACA,PUERTO ESCONDIDO,23,377,33,433,1410
OAXACA,PUERTO ESCONDIDO,55,360,25,440,1410
OAXACA,PUERTO ESCONDIDO,24,547,23,594,1929
OAXACA,PUERTO ESCONDIDO,6,456,22,484,1496
OAXACA,PUERTO ESCONDIDO,10,348,30,388,1495
OAXACA,PUERTO ESCONDIDO,12,404,14,430,1495
OAXACA,PUERTO ESCONDIDO,10,340,9,359,1369
OAXACA,PUERTO ESCONDIDO,7,356,4,367,1368
OAXACA,PUERTO ESCONDIDO,9,381,3,393,1141
OAXACA,PUERTO ESCONDIDO,9,374,8,391,1140
OAXACA,PUERTO ESCONDIDO,18,445,10,473,1278
OAXACA,PUERTO ESCONDIDO,7,419,11,437,1278
OAXACA,PUERTO ESCONDIDO,12,259,18,289,1587
OAXACA,PUERTO ESCONDIDO,8,320,14,342,1586
OAXACA,PUERTO ESCONDIDO,13,421,18,452,1757
OAXACA,PUERTO ESCONDIDO,14,389,24,427,1756
OAXACA,PUERTO ESCONDIDO,14,137,11,162,1029
OAXACA,PUERTO ESCONDIDO,13,197,8,218,1029
OAXACA,PUERTO ESCONDIDO,15,478,6,499,1201
OAXACA,PUERTO ESCONDIDO,9,479,5,493,1200
OAXACA,PUERTO ESCONDIDO,24,207,13,244,1226
OAXACA,PUERTO ESCONDIDO,16,247,19,282,1225
OAXACA,PUERTO ESCONDIDO,11,475,10,496,1867
OAXACA,PUERTO ESCONDIDO,11,440,12,463,1867
OAXACA,PUERTO ESCONDIDO,12,329,4,345,1506
OAXACA,PUERTO ESCONDIDO,9,350,3,362,1505
OAXACA,PUERTO ESCONDIDO,4,254,3,261,1095
OAXACA,PUERTO ESCONDIDO,5,294,1,300,1094
OAXACA,PUERTO ESCONDIDO,6,489,9,504,1838
OAXACA,PUERTO ESCONDIDO,9,506,12,527,1837
OAXACA,PUERTO ESCONDIDO,8,355,3,366,1822
OAXACA,PUERTO ESCONDIDO,6,340,4,350,1822
OAXACA,PUERTO ESCONDIDO,9,350,1,360,1821
OAXACA,PUERTO ESCONDIDO,2,351,3,356,1821
OAXACA,PUERTO ESCONDIDO,5,347,6,358,1821
OAXACA,PUERTO ESCONDIDO,5,337,2,344,1821
OAXACA,PUERTO ESCONDIDO,15,425,5,445,1896
OAXACA,PUERTO ESCONDIDO,13,396,5,414,1896
OAXACA,PUERTO ESCONDIDO,7,301,3,311,1565
OAXACA,PUERTO ESCONDIDO,8,276,4,288,1565
OAXACA,PUERTO ESCONDIDO,7,313,3,323,1565
OAXACA,PUERTO ESCONDIDO,53,1279,5,1337,0
OAXACA,PUERTO ESCONDIDO,9,255,2,266,1250
OAXACA,PUERTO ESCONDIDO,4,229,1,234,1249
OAXACA,PUERTO ESCONDIDO,8,399,0,407,1515
OAXACA,PUERTO ESCONDIDO,14,375,2,391,1515
OAXACA,PUERTO ESCONDIDO,17,373,20,410,1978
OAXACA,PUERTO ESCONDIDO,9,264,2,275,1158
OAXACA,PUERTO ESCONDIDO,7,262,3,272,1157
OAXACA,PUERTO ESCONDIDO,7,251,3,261,1011
OAXACA,PUERTO ESCONDIDO,6,280,2,288,1011
OAXACA,PUERTO ESCONDIDO,3,253,1,257,1611
OAXACA,PUERTO ESCONDIDO,5,231,3,239,1611
OAXACA,PUERTO ESCONDIDO,3,247,5,255,1610
OAXACA,PUERTO ESCONDIDO,6,247,9,262,1178
OAXACA,PUERTO ESCONDIDO,3,213,4,220,1178
OAXACA,PUERTO ESCONDIDO,3,389,3,395,1583
OAXACA,PUERTO ESCONDIDO,3,428,5,436,1583
OAXACA,PUERTO ESCONDIDO,6,384,0,390,1583
OAXACA,PUERTO ESCONDIDO,7,362,5,374,1373
OAXACA,PUERTO ESCONDIDO,5,335,4,344,1372
OAXACA,PUERTO ESCONDIDO,2,335,2,339,1372
OAXACA,PUERTO ESCONDIDO,6,205,1,212,1541
OAXACA,PUERTO ESCONDIDO,6,180,1,187,1541
OAXACA,PUERTO ESCONDIDO,2,284,7,293,1608
OAXACA,PUERTO ESCONDIDO,2,260,3,265,1608
OAXACA,PUERTO ESCONDIDO,3,428,3,434,1785
OAXACA,PUERTO ESCONDIDO,6,393,1,400,1784
OAXACA,PUERTO ESCONDIDO,6,249,6,261,1396
OAXACA,PUERTO ESCONDIDO,9,200,1,210,1396
OAXACA,PUERTO ESCONDIDO,7,425,10,442,1578
OAXACA,PUERTO ESCONDIDO,12,449,6,467,1577
OAXACA,PUERTO ESCONDIDO,22,325,12,359,1670
OAXACA,PUERTO ESCONDIDO,14,276,8,298,1669
OAXACA,PUERTO ESCONDIDO,23,295,8,326,1669
OAXACA,PUERTO ESCONDIDO,7,278,8,293,1410
OAXACA,PUERTO ESCONDIDO,2,266,6,274,1410
OAXACA,PUERTO ESCONDIDO,8,274,12,294,1410
OAXACA,PUERTO ESCONDIDO,18,271,9,298,1535
OAXACA,PUERTO ESCONDIDO,19,234,15,268,1535
OAXACA,PUERTO ESCONDIDO,37,178,22,237,1418
OAXACA,PUERTO ESCONDIDO,22,188,14,224,1418
OAXACA,PUERTO ESCONDIDO,29,202,21,252,1418
OAXACA,PUERTO ESCONDIDO,25,260,21,306,1706
OAXACA,PUERTO ESCONDIDO,15,317,28,360,1705
OAXACA,PUERTO ESCONDIDO,27,149,31,207,1011
OAXACA,PUERTO ESCONDIDO,54,178,23,255,1011
OAXACA,PUERTO ESCONDIDO,3,328,6,337,1041
OAXACA,PUERTO ESCONDIDO,4,279,8,291,1040
OAXACA,PUERTO ESCONDIDO,18,367,11,396,1050
OAXACA,PUERTO ESCONDIDO,12,351,12,375,1050
OAXACA,PUERTO ESCONDIDO,12,247,11,270,1425
OAXACA,PUERTO ESCONDIDO,14,235,5,254,1425
OAXACA,PUERTO ESCONDIDO,18,239,7,264,1424
OAXACA,PUERTO ESCONDIDO,6,358,6,370,1844
OAXACA,PUERTO ESCONDIDO,0,439,3,442,1843
OAXACA,PUERTO ESCONDIDO,6,256,7,269,1979
OAXACA,PUERTO ESCONDIDO,12,207,19,238,1979
OAXACA,PUERTO ESCONDIDO,75,440,70,585,1536
OAXACA,PUERTO ESCONDIDO,80,426,59,565,1536
OAXACA,PUERTO ESCONDIDO,97,447,54,598,1536
OAXACA,PUERTO ESCONDIDO,74,418,50,542,1535
OAXACA,PUERTO ESCONDIDO,9,480,8,497,1446
OAXACA,PUERTO ESCONDIDO,8,472,12,492,1445
OAXACA,PUERTO ESCONDIDO,4,459,2,465,1901
OAXACA,PUERTO ESCONDIDO,6,534,0,540,1901
OAXACA,PUERTO ESCONDIDO,9,504,13,526,1901
OAXACA,PUERTO ESCONDIDO,11,253,22,286,1364
OAXACA,PUERTO ESCONDIDO,10,254,12,276,1363
OAXACA,PUERTO ESCONDIDO,10,265,15,290,1363
OAXACA,PUERTO ESCONDIDO,9,373,2,384,1475
OAXACA,PUERTO ESCONDIDO,7,354,2,363,1475
OAXACA,PUERTO ESCONDIDO,6,375,1,382,1830
OAXACA,PUERTO ESCONDIDO,8,391,7,406,1830
OAXACA,PUERTO ESCONDIDO,9,246,6,261,1427
OAXACA,PUERTO ESCONDIDO,7,290,7,304,1426
OAXACA,PUERTO ESCONDIDO,6,281,9,296,1426
OAXACA,PUERTO ESCONDIDO,10,392,1,403,1542
OAXACA,PUERTO ESCONDIDO,10,419,4,433,1542
OAXACA,PUERTO ESCONDIDO,11,325,3,339,1533
OAXACA,PUERTO ESCONDIDO,6,362,8,376,1533
OAXACA,PUERTO ESCONDIDO,4,309,2,315,1533
OAXACA,PUERTO ESCONDIDO,8,196,5,209,1057
OAXACA,PUERTO ESCONDIDO,8,249,4,261,1057
OAXACA,PUERTO ESCONDIDO,4,191,3,198,1382
OAXACA,PUERTO ESCONDIDO,4,242,2,248,1382
OAXACA,PUERTO ESCONDIDO,6,196,4,206,1382
OAXACA,PUERTO ESCONDIDO,5,256,2,263,1246
OAXACA,PUERTO ESCONDIDO,2,271,5,278,1245
OAXACA,PUERTO ESCONDIDO,9,224,2,235,1370
OAXACA,PUERTO ESCONDIDO,4,196,0,200,1370
OAXACA,PUERTO ESCONDIDO,9,197,4,210,1370
OAXACA,PUERTO ESCONDIDO,7,144,5,156,1265
OAXACA,PUERTO ESCONDIDO,13,160,6,179,1264
OAXACA,PUERTO ESCONDIDO,8,233,2,243,1510
OAXACA,PUERTO ESCONDIDO,11,199,6,216,1509
OAXACA,PUERTO ESCONDIDO,12,316,10,338,1768
OAXACA,PUERTO ESCONDIDO,12,379,13,404,1768
OAXACA,PUERTO ESCONDIDO,5,296,7,308,1415
OAXACA,PUERTO ESCONDIDO,14,265,5,284,1415
OAXACA,PUERTO ESCONDIDO,16,205,2,223,1109
OAXACA,PUERTO ESCONDIDO,17,213,3,233,1108
OAXACA,PUERTO ESCONDIDO,17,375,9,401,1616
OAXACA,PUERTO ESCONDIDO,10,417,13,440,1616
OAXACA,PUERTO ESCONDIDO,18,353,8,379,1616
OAXACA,PUERTO ESCONDIDO,30,267,44,341,1455
OAXACA,PUERTO ESCONDIDO,51,302,70,423,1455
OAXACA,PUERTO ESCONDIDO,7,252,7,266,1161
OAXACA,PUERTO ESCONDIDO,8,246,3,257,1161
OAXACA,PUERTO ESCONDIDO,9,508,4,521,1931
OAXACA,PUERTO ESCONDIDO,11,489,9,509,1930
OAXACA,PUERTO ESCONDIDO,2,420,3,425,1492
OAXACA,PUERTO ESCONDIDO,6,437,8,451,1492
OAXACA,PUERTO ESCONDIDO,7,450,1,458,1492
OAXACA,PUERTO ESCONDIDO,11,285,13,309,1430
OAXACA,PUERTO ESCONDIDO,23,301,13,337,1430
OAXACA,PUERTO ESCONDIDO,26,300,10,336,1429
OAXACA,PUERTO ESCONDIDO,11,221,11,243,1623
OAXACA,PUERTO ESCONDIDO,9,228,11,248,1623
OAXACA,PUERTO ESCONDIDO,6,120,6,132,1397
OAXACA,PUERTO ESCONDIDO,8,177,12,197,1396
OAXACA,MIAHUATLAN DE PORFIRIO DIAZ,5,362,11,378,1832
OAXACA,MIAHUATLAN DE PORFIRIO DIAZ,6,364,9,379,1832
OAXACA,MIAHUATLAN DE PORFIRIO DIAZ,26,400,33,459,1919
OAXACA,MIAHUATLAN DE PORFIRIO DIAZ,16,366,25,407,1919
OAXACA,MIAHUATLAN DE PORFIRIO DIAZ,32,236,28,296,1548
OAXACA,MIAHUATLAN DE PORFIRIO DIAZ,17,249,19,285,1548
OAXACA,MIAHUATLAN DE PORFIRIO DIAZ,17,272,14,303,1548
OAXACA,MIAHUATLAN DE PORFIRIO DIAZ,30,289,11,330,1512
OAXACA,MIAHUATLAN DE PORFIRIO DIAZ,15,266,9,290,1512
OAXACA,MIAHUATLAN DE PORFIRIO DIAZ,19,284,11,314,1512
OAXACA,MIAHUATLAN DE PORFIRIO DIAZ,14,337,6,357,1512
OAXACA,MIAHUATLAN DE PORFIRIO DIAZ,16,373,10,399,1741
OAXACA,MIAHUATLAN DE PORFIRIO DIAZ,14,395,13,422,1741
OAXACA,MIAHUATLAN DE PORFIRIO DIAZ,12,339,7,358,1741
OAXACA,MIAHUATLAN DE PORFIRIO DIAZ,23,486,16,525,2121
OAXACA,MIAHUATLAN DE PORFIRIO DIAZ,16,289,6,311,1477
OAXACA,MIAHUATLAN DE PORFIRIO DIAZ,28,335,6,369,1476
OAXACA,MIAHUATLAN DE PORFIRIO DIAZ,17,280,35,332,2094
OAXACA,MIAHUATLAN DE PORFIRIO DIAZ,21,316,15,352,2093
OAXACA,MIAHUATLAN DE PORFIRIO DIAZ,7,310,0,317,1352
OAXACA,MIAHUATLAN DE PORFIRIO DIAZ,16,309,8,333,1352
OAXACA,MIAHUATLAN DE PORFIRIO DIAZ,7,304,4,315,1352
OAXACA,MIAHUATLAN DE PORFIRIO DIAZ,8,380,2,390,2068
OAXACA,MIAHUATLAN DE PORFIRIO DIAZ,8,421,3,432,2067
OAXACA,MIAHUATLAN DE PORFIRIO DIAZ,7,321,4,332,1581
OAXACA,MIAHUATLAN DE PORFIRIO DIAZ,7,335,2,344,1581
OAXACA,MIAHUATLAN DE PORFIRIO DIAZ,9,417,8,434,1654
OAXACA,MIAHUATLAN DE PORFIRIO DIAZ,13,372,1,386,1653
OAXACA,MIAHUATLAN DE PORFIRIO DIAZ,10,285,2,297,1612
OAXACA,MIAHUATLAN DE PORFIRIO DIAZ,13,290,2,305,1612
OAXACA,MIAHUATLAN DE PORFIRIO DIAZ,9,349,3,361,2046
OAXACA,MIAHUATLAN DE PORFIRIO DIAZ,11,370,6,387,2046
OAXACA,MIAHUATLAN DE PORFIRIO DIAZ,7,334,7,348,2046
OAXACA,MIAHUATLAN DE PORFIRIO DIAZ,22,225,4,251,1496
OAXACA,MIAHUATLAN DE PORFIRIO DIAZ,56,371,10,437,1496
OAXACA,MIAHUATLAN DE PORFIRIO DIAZ,29,270,7,306,1496
OAXACA,MIAHUATLAN DE PORFIRIO DIAZ,19,175,6,200,1797
OAXACA,MIAHUATLAN DE PORFIRIO DIAZ,24,202,7,233,1796
OAXACA,MIAHUATLAN DE PORFIRIO DIAZ,21,235,17,273,1675
OAXACA,MIAHUATLAN DE PORFIRIO DIAZ,31,321,17,369,1675
OAXACA,MIAHUATLAN DE PORFIRIO DIAZ,25,280,26,331,1675
OAXACA,MIAHUATLAN DE PORFIRIO DIAZ,34,629,16,679,2073
OAXACA,MIAHUATLAN DE PORFIRIO DIAZ,24,612,9,645,2073
OAXACA,MIAHUATLAN DE PORFIRIO DIAZ,18,188,3,209,1543
OAXACA,MIAHUATLAN DE PORFIRIO DIAZ,16,171,4,191,1542
OAXACA,MIAHUATLAN DE PORFIRIO DIAZ,25,141,4,170,1542
OAXACA,MIAHUATLAN DE PORFIRIO DIAZ,13,113,7,133,1542
OAXACA,MIAHUATLAN DE PORFIRIO DIAZ,17,120,7,144,1515
OAXACA,MIAHUATLAN DE PORFIRIO DIAZ,8,85,3,96,1514
OAXACA,MIAHUATLAN DE PORFIRIO DIAZ,9,75,2,86,1514
OAXACA,MIAHUATLAN DE PORFIRIO DIAZ,17,98,8,123,1514
OAXACA,MIAHUATLAN DE PORFIRIO DIAZ,11,105,3,119,1201
OAXACA,MIAHUATLAN DE PORFIRIO DIAZ,12,89,3,104,1201
OAXACA,MIAHUATLAN DE PORFIRIO DIAZ,76,295,23,394,1835
OAXACA,MIAHUATLAN DE PORFIRIO DIAZ,54,244,11,309,1835
OAXACA,MIAHUATLAN DE PORFIRIO DIAZ,9,47,4,60,1603
OAXACA,MIAHUATLAN DE PORFIRIO DIAZ,16,57,12,85,1602
OAXACA,MIAHUATLAN DE PORFIRIO DIAZ,14,334,15,363,2076
OAXACA,MIAHUATLAN DE PORFIRIO DIAZ,4,207,8,219,2076
OAXACA,MIAHUATLAN DE PORFIRIO DIAZ,3,205,6,214,2076
OAXACA,MIAHUATLAN DE PORFIRIO DIAZ,17,164,2,183,1058
OAXACA,MIAHUATLAN DE PORFIRIO DIAZ,12,157,6,175,1058
OAXACA,MIAHUATLAN DE PORFIRIO DIAZ,19,246,6,271,2069
OAXACA,MIAHUATLAN DE PORFIRIO DIAZ,18,359,24,401,2068
OAXACA,MIAHUATLAN DE PORFIRIO DIAZ,22,351,18,391,1744
OAXACA,MIAHUATLAN DE PORFIRIO DIAZ,14,246,6,266,1743
OAXACA,MIAHUATLAN DE PORFIRIO DIAZ,20,215,3,238,1795
OAXACA,MIAHUATLAN DE PORFIRIO DIAZ,14,193,9,216,1794
OAXACA,MIAHUATLAN DE PORFIRIO DIAZ,21,181,7,209,1204
OAXACA,MIAHUATLAN DE PORFIRIO DIAZ,11,216,3,230,1203
OAXACA,MIAHUATLAN DE PORFIRIO DIAZ,9,39,0,48,1789
OAXACA,MIAHUATLAN DE PORFIRIO DIAZ,14,86,6,106,1788
OAXACA,MIAHUATLAN DE PORFIRIO DIAZ,16,73,6,95,1788
OAXACA,MIAHUATLAN DE PORFIRIO DIAZ,24,319,9,352,1862
OAXACA,MIAHUATLAN DE PORFIRIO DIAZ,24,281,8,313,1862
OAXACA,MIAHUATLAN DE PORFIRIO DIAZ,3,63,2,68,1390
OAXACA,MIAHUATLAN DE PORFIRIO DIAZ,3,100,1,104,1390
OAXACA,MIAHUATLAN DE PORFIRIO DIAZ,1,120,3,124,1390
OAXACA,MIAHUATLAN DE PORFIRIO DIAZ,29,132,6,167,1830
OAXACA,MIAHUATLAN DE PORFIRIO DIAZ,29,142,17,188,1830
OAXACA,MIAHUATLAN DE PORFIRIO DIAZ,31,122,4,157,1829
OAXACA,MIAHUATLAN DE PORFIRIO DIAZ,11,236,15,262,1371
OAXACA,MIAHUATLAN DE PORFIRIO DIAZ,18,242,11,271,1370
OAXACA,MIAHUATLAN DE PORFIRIO DIAZ,52,230,14,296,1433
OAXACA,MIAHUATLAN DE PORFIRIO DIAZ,26,128,5,159,1432
OAXACA,MIAHUATLAN DE PORFIRIO DIAZ,42,148,4,194,1267
OAXACA,MIAHUATLAN DE PORFIRIO DIAZ,33,156,7,196,1267
OAXACA,MIAHUATLAN DE PORFIRIO DIAZ,7,162,6,175,1873
OAXACA,MIAHUATLAN DE PORFIRIO DIAZ,5,154,9,168,1872
OAXACA,MIAHUATLAN DE PORFIRIO DIAZ,26,172,31,229,1854
OAXACA,MIAHUATLAN DE PORFIRIO DIAZ,24,269,31,324,1854
OAXACA,MIAHUATLAN DE PORFIRIO DIAZ,21,170,23,214,1854
OAXACA,MIAHUATLAN DE PORFIRIO DIAZ,8,359,5,372,1866
OAXACA,MIAHUATLAN DE PORFIRIO DIAZ,9,356,2,367,1865
OAXACA,MIAHUATLAN DE PORFIRIO DIAZ,8,276,6,290,1554
OAXACA,MIAHUATLAN DE PORFIRIO DIAZ,12,321,10,343,1553
OAXACA,MIAHUATLAN DE PORFIRIO DIAZ,7,420,16,443,2186
OAXACA,MIAHUATLAN DE PORFIRIO DIAZ,6,476,5,487,2185
OAXACA,MIAHUATLAN DE PORFIRIO DIAZ,2,326,9,337,1305
OAXACA,MIAHUATLAN DE PORFIRIO DIAZ,16,326,4,346,1305
OAXACA,MIAHUATLAN DE PORFIRIO DIAZ,10,281,5,296,1413
OAXACA,MIAHUATLAN DE PORFIRIO DIAZ,6,280,3,289,1413
OAXACA,MIAHUATLAN DE PORFIRIO DIAZ,16,510,7,533,1209
OAXACA,MIAHUATLAN DE PORFIRIO DIAZ,24,482,8,514,1209
OAXACA,MIAHUATLAN DE PORFIRIO DIAZ,12,301,5,318,1487
OAXACA,MIAHUATLAN DE PORFIRIO DIAZ,23,289,6,318,1487
OAXACA,MIAHUATLAN DE PORFIRIO DIAZ,18,283,1,302,1486
OAXACA,MIAHUATLAN DE PORFIRIO DIAZ,12,687,2,701,1575
OAXACA,MIAHUATLAN DE PORFIRIO DIAZ,12,697,5,714,1575
OAXACA,MIAHUATLAN DE PORFIRIO DIAZ,10,708,5,723,1575
OAXACA,MIAHUATLAN DE PORFIRIO DIAZ,15,398,5,418,2174
OAXACA,MIAHUATLAN DE PORFIRIO DIAZ,6,455,7,468,2173
OAXACA,MIAHUATLAN DE PORFIRIO DIAZ,27,298,20,345,1832
OAXACA,MIAHUATLAN DE PORFIRIO DIAZ,14,340,21,375,1832
OAXACA,MIAHUATLAN DE PORFIRIO DIAZ,13,156,9,178,1431
OAXACA,MIAHUATLAN DE PORFIRIO DIAZ,1,162,6,169,1430
OAXACA,MIAHUATLAN DE PORFIRIO DIAZ,21,223,0,244,1857
OAXACA,MIAHUATLAN DE PORFIRIO DIAZ,25,163,7,195,1856
OAXACA,MIAHUATLAN DE PORFIRIO DIAZ,14,284,17,315,1882
OAXACA,MIAHUATLAN DE PORFIRIO DIAZ,19,373,12,404,1881
OAXACA,MIAHUATLAN DE PORFIRIO DIAZ,8,226,7,241,1622
OAXACA,MIAHUATLAN DE PORFIRIO DIAZ,19,221,6,246,1622
OAXACA,MIAHUATLAN DE PORFIRIO DIAZ,3,72,4,79,1502
OAXACA,MIAHUATLAN DE PORFIRIO DIAZ,7,62,3,72,1501
OAXACA,MIAHUATLAN DE PORFIRIO DIAZ,43,72,6,121,1764
OAXACA,MIAHUATLAN DE PORFIRIO DIAZ,43,78,7,128,1764
OAXACA,MIAHUATLAN DE PORFIRIO DIAZ,6,403,1,410,1913
OAXACA,MIAHUATLAN DE PORFIRIO DIAZ,15,427,3,445,1912
OAXACA,MIAHUATLAN DE PORFIRIO DIAZ,8,414,2,424,1770
OAXACA,MIAHUATLAN DE PORFIRIO DIAZ,12,384,4,400,1770
OAXACA,MIAHUATLAN DE PORFIRIO DIAZ,10,354,13,377,1769
OAXACA,MIAHUATLAN DE PORFIRIO DIAZ,11,334,1,346,1488
OAXACA,MIAHUATLAN DE PORFIRIO DIAZ,9,301,3,313,1487
OAXACA,MIAHUATLAN DE PORFIRIO DIAZ,7,290,0,297,1386
OAXACA,MIAHUATLAN DE PORFIRIO DIAZ,6,267,4,277,1386
OAXACA,MIAHUATLAN DE PORFIRIO DIAZ,5,278,3,286,1385
OAXACA,MIAHUATLAN DE PORFIRIO DIAZ,23,235,16,274,1655
OAXACA,MIAHUATLAN DE PORFIRIO DIAZ,23,286,7,316,1654
OAXACA,MIAHUATLAN DE PORFIRIO DIAZ,10,471,6,487,1687
OAXACA,MIAHUATLAN DE PORFIRIO DIAZ,5,414,8,427,1687
OAXACA,MIAHUATLAN DE PORFIRIO DIAZ,7,467,7,481,1686
OAXACA,MIAHUATLAN DE PORFIRIO DIAZ,11,532,12,555,1956
OAXACA,MIAHUATLAN DE PORFIRIO DIAZ,4,516,4,524,1956
OAXACA,MIAHUATLAN DE PORFIRIO DIAZ,12,548,13,573,1955
OAXACA,MIAHUATLAN DE PORFIRIO DIAZ,23,527,6,556,1828
OAXACA,MIAHUATLAN DE PORFIRIO DIAZ,18,477,13,508,1828
OAXACA,MIAHUATLAN DE PORFIRIO DIAZ,12,485,5,502,1830
OAXACA,MIAHUATLAN DE PORFIRIO DIAZ,18,461,3,482,1830
OAXACA,MIAHUATLAN DE PORFIRIO DIAZ,7,438,6,451,1830
OAXACA,MIAHUATLAN DE PORFIRIO DIAZ,67,1649,8,1724,0
OAXACA,MIAHUATLAN DE PORFIRIO DIAZ,13,413,2,428,1918
OAXACA,MIAHUATLAN DE PORFIRIO DIAZ,13,446,5,464,1918
OAXACA,MIAHUATLAN DE PORFIRIO DIAZ,11,476,7,494,1918
OAXACA,MIAHUATLAN DE PORFIRIO DIAZ,12,455,5,472,1918
OAXACA,MIAHUATLAN DE PORFIRIO DIAZ,17,425,3,445,1918
OAXACA,MIAHUATLAN DE PORFIRIO DIAZ,20,434,4,458,1917
OAXACA,MIAHUATLAN DE PORFIRIO DIAZ,16,309,4,329,1215
OAXACA,MIAHUATLAN DE PORFIRIO DIAZ,11,289,3,303,1214
OAXACA,MIAHUATLAN DE PORFIRIO DIAZ,31,165,7,203,1858
OAXACA,MIAHUATLAN DE PORFIRIO DIAZ,21,140,2,163,1858
OAXACA,MIAHUATLAN DE PORFIRIO DIAZ,18,225,9,252,1420
OAXACA,MIAHUATLAN DE PORFIRIO DIAZ,6,261,10,277,1420
OAXACA,MIAHUATLAN DE PORFIRIO DIAZ,16,136,13,165,1215
OAXACA,MIAHUATLAN DE PORFIRIO DIAZ,17,148,11,176,1214
OAXACA,MIAHUATLAN DE PORFIRIO DIAZ,4,262,5,271,1283
OAXACA,MIAHUATLAN DE PORFIRIO DIAZ,6,291,4,301,1283
OAXACA,MIAHUATLAN DE PORFIRIO DIAZ,24,352,14,390,1911
OAXACA,MIAHUATLAN DE PORFIRIO DIAZ,9,340,6,355,1910
OAXACA,MIAHUATLAN DE PORFIRIO DIAZ,13,170,6,189,1948
OAXACA,MIAHUATLAN DE PORFIRIO DIAZ,12,195,1,208,1948
OAXACA,MIAHUATLAN DE PORFIRIO DIAZ,17,403,2,422,1647
OAXACA,MIAHUATLAN DE PORFIRIO DIAZ,22,302,6,330,1646
OAXACA,MIAHUATLAN DE PORFIRIO DIAZ,6,200,1,207,1166
OAXACA,MIAHUATLAN DE PORFIRIO DIAZ,7,238,1,246,1165
OAXACA,MIAHUATLAN DE PORFIRIO DIAZ,27,283,5,315,1786
OAXACA,MIAHUATLAN DE PORFIRIO DIAZ,14,254,7,275,1786
OAXACA,MIAHUATLAN DE PORFIRIO DIAZ,2,115,3,120,1474
OAXACA,MIAHUATLAN DE PORFIRIO DIAZ,4,147,4,155,1474
OAXACA,MIAHUATLAN DE PORFIRIO DIAZ,2,152,5,159,1474
OAXACA,MIAHUATLAN DE PORFIRIO DIAZ,14,143,4,161,1660
OAXACA,MIAHUATLAN DE PORFIRIO DIAZ,5,133,7,145,1659
OAXACA,MIAHUATLAN DE PORFIRIO DIAZ,6,112,5,123,1659
OAXACA,MIAHUATLAN DE PORFIRIO DIAZ,14,199,3,216,1262
OAXACA,MIAHUATLAN DE PORFIRIO DIAZ,22,211,5,238,1261
OAXACA,MIAHUATLAN DE PORFIRIO DIAZ,9,339,7,355,1758
OAXACA,MIAHUATLAN DE PORFIRIO DIAZ,10,306,2,318,1757
OAXACA,MIAHUATLAN DE PORFIRIO DIAZ,5,340,3,348,1222
OAXACA,MIAHUATLAN DE PORFIRIO DIAZ,7,276,0,283,1221
OAXACA,MIAHUATLAN DE PORFIRIO DIAZ,4,226,4,234,1585
OAXACA,MIAHUATLAN DE PORFIRIO DIAZ,7,237,2,246,1585
OAXACA,MIAHUATLAN DE PORFIRIO DIAZ,9,201,8,218,1584
OAXACA,MIAHUATLAN DE PORFIRIO DIAZ,19,326,5,350,1106
OAXACA,MIAHUATLAN DE PORFIRIO DIAZ,5,293,5,303,1105
OAXACA,MIAHUATLAN DE PORFIRIO DIAZ,9,167,6,182,1393
OAXACA,MIAHUATLAN DE PORFIRIO DIAZ,13,231,5,249,1393
OAXACA,MIAHUATLAN DE PORFIRIO DIAZ,10,494,6,510,1960
OAXACA,MIAHUATLAN DE PORFIRIO DIAZ,13,545,9,567,1960
OAXACA,MIAHUATLAN DE PORFIRIO DIAZ,11,372,10,393,1894
OAXACA,MIAHUATLAN DE PORFIRIO DIAZ,15,364,12,391,1894
PUEBLA,HUAUCHINANGO DE DEGOLLADO,28,296,33,357,1284
PUEBLA,HUAUCHINANGO DE DEGOLLADO,18,315,42,375,1283
PUEBLA,HUAUCHINANGO DE DEGOLLADO,16,203,16,235,1839
PUEBLA,HUAUCHINANGO DE DEGOLLADO,12,197,9,218,1838
PUEBLA,HUAUCHINANGO DE DEGOLLADO,8,127,0,135,1074
PUEBLA,HUAUCHINANGO DE DEGOLLADO,12,136,1,149,1074
PUEBLA,HUAUCHINANGO DE DEGOLLADO,11,391,2,404,1438
PUEBLA,HUAUCHINANGO DE DEGOLLADO,12,283,8,303,1437
PUEBLA,HUAUCHINANGO DE DEGOLLADO,15,321,7,343,1437
PUEBLA,HUAUCHINANGO DE DEGOLLADO,29,470,14,513,1957
PUEBLA,HUAUCHINANGO DE DEGOLLADO,14,433,16,463,1956
PUEBLA,HUAUCHINANGO DE DEGOLLADO,23,468,16,507,1874
PUEBLA,HUAUCHINANGO DE DEGOLLADO,31,469,24,524,1873
PUEBLA,HUAUCHINANGO DE DEGOLLADO,33,382,54,469,1781
PUEBLA,HUAUCHINANGO DE DEGOLLADO,27,457,23,507,1781
PUEBLA,HUAUCHINANGO DE DEGOLLADO,44,848,3,895,0
PUEBLA,HUAUCHINANGO DE DEGOLLADO,15,324,6,345,1646
PUEBLA,HUAUCHINANGO DE DEGOLLADO,14,324,6,344,1646
PUEBLA,HUAUCHINANGO DE DEGOLLADO,14,290,3,307,1864
PUEBLA,HUAUCHINANGO DE DEGOLLADO,13,315,3,331,1864
PUEBLA,HUAUCHINANGO DE DEGOLLADO,15,328,3,346,1620
PUEBLA,HUAUCHINANGO DE DEGOLLADO,24,290,0,314,1620
PUEBLA,HUAUCHINANGO DE DEGOLLADO,16,288,5,309,1620
PUEBLA,HUAUCHINANGO DE DEGOLLADO,12,301,5,318,1591
PUEBLA,HUAUCHINANGO DE DEGOLLADO,9,289,4,302,1591
PUEBLA,HUAUCHINANGO DE DEGOLLADO,15,287,4,306,1703
PUEBLA,HUAUCHINANGO DE DEGOLLADO,12,293,5,310,1702
PUEBLA,HUAUCHINANGO DE DEGOLLADO,12,245,6,263,1443
PUEBLA,HUAUCHINANGO DE DEGOLLADO,16,236,5,257,1442
PUEBLA,HUAUCHINANGO DE DEGOLLADO,13,238,8,259,1394
PUEBLA,HUAUCHINANGO DE DEGOLLADO,14,255,5,274,1393
PUEBLA,HUAUCHINANGO DE DEGOLLADO,14,244,10,268,1872
PUEBLA,HUAUCHINANGO DE DEGOLLADO,9,282,10,301,1871
PUEBLA,HUAUCHINANGO DE DEGOLLADO,15,249,10,274,1871
PUEBLA,HUAUCHINANGO DE DEGOLLADO,18,229,6,253,1428
PUEBLA,HUAUCHINANGO DE DEGOLLADO,14,273,2,289,1428
PUEBLA,HUAUCHINANGO DE DEGOLLADO,10,225,4,239,1427
PUEBLA,HUAUCHINANGO DE DEGOLLADO,13,249,7,269,1874
PUEBLA,HUAUCHINANGO DE DEGOLLADO,15,243,2,260,1874
PUEBLA,HUAUCHINANGO DE DEGOLLADO,10,257,7,274,1874
PUEBLA,HUAUCHINANGO DE DEGOLLADO,19,191,15,225,1527
PUEBLA,HUAUCHINANGO DE DEGOLLADO,25,186,16,227,1526
PUEBLA,HUAUCHINANGO DE DEGOLLADO,6,371,11,388,1823
PUEBLA,HUAUCHINANGO DE DEGOLLADO,9,394,7,410,1823
PUEBLA,HUAUCHINANGO DE DEGOLLADO,17,198,11,226,1908
PUEBLA,HUAUCHINANGO DE DEGOLLADO,2,237,8,247,1908
PUEBLA,HUAUCHINANGO DE DEGOLLADO,18,424,19,461,1989
PUEBLA,HUAUCHINANGO DE DEGOLLADO,21,496,12,529,1989
PUEBLA,HUAUCHINANGO DE DEGOLLADO,9,115,1,125,1083
PUEBLA,HUAUCHINANGO DE DEGOLLADO,13,183,6,202,1083
PUEBLA,HUAUCHINANGO DE DEGOLLADO,24,326,7,357,1522
PUEBLA,HUAUCHINANGO DE DEGOLLADO,21,322,2,345,1521
PUEBLA,HUAUCHINANGO DE DEGOLLADO,14,376,12,402,1758
PUEBLA,HUAUCHINANGO DE DEGOLLADO,10,365,17,392,1758
PUEBLA,HUAUCHINANGO DE DEGOLLADO,31,334,17,382,1780
PUEBLA,HUAUCHINANGO DE DEGOLLADO,24,339,20,383,1779
PUEBLA,HUAUCHINANGO DE DEGOLLADO,21,200,14,235,1452
PUEBLA,HUAUCHINANGO DE DEGOLLADO,20,140,26,186,1451
PUEBLA,HUAUCHINANGO DE DEGOLLADO,19,192,25,236,1451
PUEBLA,HUAUCHINANGO DE DEGOLLADO,13,262,5,280,1595
PUEBLA,HUAUCHINANGO DE DEGOLLADO,6,229,7,242,1594
PUEBLA,HUAUCHINANGO DE DEGOLLADO,11,340,9,360,1118
PUEBLA,HUAUCHINANGO DE DEGOLLADO,7,326,9,342,1118
PUEBLA,HUAUCHINANGO DE DEGOLLADO,20,489,25,534,1608
PUEBLA,HUAUCHINANGO DE DEGOLLADO,25,388,32,445,1607
PUEBLA,HUAUCHINANGO DE DEGOLLADO,14,557,12,583,1891
PUEBLA,HUAUCHINANGO DE DEGOLLADO,9,544,13,566,1890
PUEBLA,HUAUCHINANGO DE DEGOLLADO,12,331,7,350,1441
PUEBLA,HUAUCHINANGO DE DEGOLLADO,14,345,21,380,1440
PUEBLA,HUAUCHINANGO DE DEGOLLADO,14,320,1,335,1423
PUEBLA,HUAUCHINANGO DE DEGOLLADO,12,332,5,349,1423
PUEBLA,HUAUCHINANGO DE DEGOLLADO,8,418,7,433,1423
PUEBLA,HUAUCHINANGO DE DEGOLLADO,43,226,21,290,1918
PUEBLA,HUAUCHINANGO DE DEGOLLADO,36,240,25,301,1918
PUEBLA,HUAUCHINANGO DE DEGOLLADO,18,165,23,206,1239
PUEBLA,HUAUCHINANGO DE DEGOLLADO,21,189,12,222,1239
PUEBLA,HUAUCHINANGO DE DEGOLLADO,9,161,19,189,1727
PUEBLA,HUAUCHINANGO DE DEGOLLADO,14,139,20,173,1726
PUEBLA,HUAUCHINANGO DE DEGOLLADO,12,369,7,388,1895
PUEBLA,HUAUCHINANGO DE DEGOLLADO,13,387,10,410,1894
PUEBLA,HUAUCHINANGO DE DEGOLLADO,2,335,5,342,1578
PUEBLA,HUAUCHINANGO DE DEGOLLADO,9,307,8,324,1577
PUEBLA,HUAUCHINANGO DE DEGOLLADO,9,186,2,197,1391
PUEBLA,HUAUCHINANGO DE DEGOLLADO,11,207,11,229,1391
PUEBLA,HUAUCHINANGO DE DEGOLLADO,11,226,11,248,1391
PUEBLA,HUAUCHINANGO DE DEGOLLADO,64,584,43,691,1308
PUEBLA,HUAUCHINANGO DE DEGOLLADO,48,480,41,569,1307
PUEBLA,HUAUCHINANGO DE DEGOLLADO,81,751,28,860,1856
PUEBLA,HUAUCHINANGO DE DEGOLLADO,47,611,19,677,1855
PUEBLA,HUAUCHINANGO DE DEGOLLADO,55,520,18,593,1189
PUEBLA,HUAUCHINANGO DE DEGOLLADO,39,512,24,575,1189
PUEBLA,HUAUCHINANGO DE DEGOLLADO,53,449,15,517,1395
PUEBLA,HUAUCHINANGO DE DEGOLLADO,72,524,32,628,1395
PUEBLA,HUAUCHINANGO DE DEGOLLADO,60,538,20,618,1394
PUEBLA,HUAUCHINANGO DE DEGOLLADO,32,415,17,464,1557
PUEBLA,HUAUCHINANGO DE DEGOLLADO,17,443,19,479,1557
PUEBLA,HUAUCHINANGO DE DEGOLLADO,26,465,16,507,1557
PUEBLA,HUAUCHINANGO DE DEGOLLADO,28,473,17,518,2032
PUEBLA,HUAUCHINANGO DE DEGOLLADO,21,480,35,536,2031
PUEBLA,HUAUCHINANGO DE DEGOLLADO,31,182,3,216,1739
PUEBLA,HUAUCHINANGO DE DEGOLLADO,19,229,12,260,1739
PUEBLA,HUAUCHINANGO DE DEGOLLADO,21,284,23,328,1752
PUEBLA,HUAUCHINANGO DE DEGOLLADO,14,240,12,266,1752
PUEBLA,HUAUCHINANGO DE DEGOLLADO,19,280,12,311,1762
PUEBLA,HUAUCHINANGO DE DEGOLLADO,23,280,32,335,1762
PUEBLA,HUAUCHINANGO DE DEGOLLADO,11,138,18,167,1651
PUEBLA,HUAUCHINANGO DE DEGOLLADO,19,152,17,188,1650
PUEBLA,HUAUCHINANGO DE DEGOLLADO,17,288,11,316,1740
PUEBLA,HUAUCHINANGO DE DEGOLLADO,27,264,18,309,1740
PUEBLA,HUAUCHINANGO DE DEGOLLADO,22,261,27,310,1739
PUEBLA,HUAUCHINANGO DE DEGOLLADO,30,75,7,112,1819
PUEBLA,HUAUCHINANGO DE DEGOLLADO,34,56,5,95,1819
PUEBLA,HUAUCHINANGO DE DEGOLLADO,37,530,49,616,2023
PUEBLA,HUAUCHINANGO DE DEGOLLADO,31,574,35,640,2022
PUEBLA,HUAUCHINANGO DE DEGOLLADO,34,411,22,467,1906
PUEBLA,HUAUCHINANGO DE DEGOLLADO,26,398,32,456,1905
PUEBLA,HUAUCHINANGO DE DEGOLLADO,16,385,18,419,1812
PUEBLA,HUAUCHINANGO DE DEGOLLADO,15,377,20,412,1811
PUEBLA,HUAUCHINANGO DE DEGOLLADO,19,343,22,384,1811
PUEBLA,HUAUCHINANGO DE DEGOLLADO,17,526,23,566,1777
PUEBLA,HUAUCHINANGO DE DEGOLLADO,12,523,27,562,1777
PUEBLA,HUAUCHINANGO DE DEGOLLADO,8,485,22,515,1630
PUEBLA,HUAUCHINANGO DE DEGOLLADO,6,431,9,446,1630
PUEBLA,HUAUCHINANGO DE DEGOLLADO,16,448,12,476,1630
PUEBLA,HUAUCHINANGO DE DEGOLLADO,9,539,21,569,1996
PUEBLA,HUAUCHINANGO DE DEGOLLADO,14,547,11,572,1995
PUEBLA,HUAUCHINANGO DE DEGOLLADO,9,359,7,375,1251
PUEBLA,HUAUCHINANGO DE DEGOLLADO,14,326,10,350,1251
PUEBLA,HUAUCHINANGO DE DEGOLLADO,12,473,16,501,1844
PUEBLA,HUAUCHINANGO DE DEGOLLADO,13,418,16,447,1844
PUEBLA,HUAUCHINANGO DE DEGOLLADO,5,333,9,347,1674
PUEBLA,HUAUCHINANGO DE DEGOLLADO,12,354,6,372,1674
PUEBLA,HUAUCHINANGO DE DEGOLLADO,10,347,5,362,1673
PUEBLA,HUAUCHINANGO DE DEGOLLADO,12,363,12,387,1389
PUEBLA,HUAUCHINANGO DE DEGOLLADO,7,320,10,337,1389
PUEBLA,HUAUCHINANGO DE DEGOLLADO,10,359,8,377,1389
PUEBLA,HUAUCHINANGO DE DEGOLLADO,10,235,2,247,1641
PUEBLA,HUAUCHINANGO DE DEGOLLADO,13,215,9,237,1640
PUEBLA,HUAUCHINANGO DE DEGOLLADO,8,218,9,235,1640
PUEBLA,HUAUCHINANGO DE DEGOLLADO,20,292,11,323,1937
PUEBLA,HUAUCHINANGO DE DEGOLLADO,18,275,13,306,1936
PUEBLA,HUAUCHINANGO DE DEGOLLADO,12,192,6,210,1186
PUEBLA,HUAUCHINANGO DE DEGOLLADO,16,188,5,209,1185
PUEBLA,HUAUCHINANGO DE DEGOLLADO,17,215,2,234,1578
PUEBLA,HUAUCHINANGO DE DEGOLLADO,21,269,3,293,1578
PUEBLA,HUAUCHINANGO DE DEGOLLADO,19,237,5,261,1481
PUEBLA,HUAUCHINANGO DE DEGOLLADO,31,217,7,255,1480
PUEBLA,HUAUCHINANGO DE DEGOLLADO,30,299,3,332,1804
PUEBLA,HUAUCHINANGO DE DEGOLLADO,15,281,4,300,1804
PUEBLA,HUAUCHINANGO DE DEGOLLADO,17,178,6,201,1465
PUEBLA,HUAUCHINANGO DE DEGOLLADO,20,216,2,238,1464
PUEBLA,HUAUCHINANGO DE DEGOLLADO,17,200,6,223,1464
PUEBLA,HUAUCHINANGO DE DEGOLLADO,15,260,5,280,1622
PUEBLA,HUAUCHINANGO DE DEGOLLADO,9,241,5,255,1622
PUEBLA,HUAUCHINANGO DE DEGOLLADO,19,251,3,273,1662
PUEBLA,HUAUCHINANGO DE DEGOLLADO,17,242,2,261,1661
PUEBLA,HUAUCHINANGO DE DEGOLLADO,30,309,8,347,1836
PUEBLA,HUAUCHINANGO DE DEGOLLADO,17,285,7,309,1835
PUEBLA,HUAUCHINANGO DE DEGOLLADO,14,264,11,289,1501
PUEBLA,HUAUCHINANGO DE DEGOLLADO,12,276,10,298,1501
PUEBLA,HUAUCHINANGO DE DEGOLLADO,16,284,18,318,1500
PUEBLA,HUAUCHINANGO DE DEGOLLADO,9,361,11,381,1653
PUEBLA,HUAUCHINANGO DE DEGOLLADO,20,356,10,386,1652
PUEBLA,HUAUCHINANGO DE DEGOLLADO,7,307,7,321,1406
PUEBLA,HUAUCHINANGO DE DEGOLLADO,13,282,10,305,1405
PUEBLA,HUAUCHINANGO DE DEGOLLADO,17,301,17,335,1405
PUEBLA,HUAUCHINANGO DE DEGOLLADO,36,572,12,620,1829
PUEBLA,HUAUCHINANGO DE DEGOLLADO,33,519,17,569,1828
PUEBLA,HUAUCHINANGO DE DEGOLLADO,8,144,6,158,1023
PUEBLA,HUAUCHINANGO DE DEGOLLADO,7,143,5,155,1023
PUEBLA,HUAUCHINANGO DE DEGOLLADO,34,394,21,449,1782
PUEBLA,HUAUCHINANGO DE DEGOLLADO,28,372,24,424,1781
PUEBLA,HUAUCHINANGO DE DEGOLLADO,10,201,12,223,1194
PUEBLA,HUAUCHINANGO DE DEGOLLADO,18,194,6,218,1194
PUEBLA,HUAUCHINANGO DE DEGOLLADO,10,180,9,199,1351
PUEBLA,HUAUCHINANGO DE DEGOLLADO,14,193,6,213,1351
PUEBLA,HUAUCHINANGO DE DEGOLLADO,19,177,20,216,1350
PUEBLA,HUAUCHINANGO DE DEGOLLADO,19,464,40,523,1878
PUEBLA,HUAUCHINANGO DE DEGOLLADO,24,381,34,439,1877
PUEBLA,HUAUCHINANGO DE DEGOLLADO,14,248,6,268,1560
PUEBLA,HUAUCHINANGO DE DEGOLLADO,33,251,14,298,1559
PUEBLA,CUAUTILULCO BARRIO,30,394,32,456,1579
PUEBLA,CUAUTILULCO BARRIO,42,535,34,611,1578
PUEBLA,CUAUTILULCO BARRIO,111,1236,80,1427,1902
PUEBLA,CUAUTILULCO BARRIO,136,392,61,589,1627
PUEBLA,CUAUTILULCO BARRIO,104,365,63,532,1627
PUEBLA,CUAUTILULCO BARRIO,39,275,39,353,1200
PUEBLA,CUAUTILULCO BARRIO,48,283,44,375,1200
PUEBLA,CUAUTILULCO BARRIO,13,299,13,325,2099
PUEBLA,CUAUTILULCO BARRIO,4,288,2,294,2099
PUEBLA,CUAUTILULCO BARRIO,17,406,7,430,1841
PUEBLA,CUAUTILULCO BARRIO,7,731,15,753,1841
PUEBLA,CUAUTILULCO BARRIO,53,714,20,787,2045
PUEBLA,CUAUTILULCO BARRIO,46,521,23,590,2045
PUEBLA,CUAUTILULCO BARRIO,40,204,5,249,1088
PUEBLA,CUAUTILULCO BARRIO,38,389,12,439,1088
PUEBLA,CUAUTILULCO BARRIO,71,553,57,681,1359
PUEBLA,CUAUTILULCO BARRIO,58,537,58,653,1358
PUEBLA,CUAUTILULCO BARRIO,53,717,40,810,1480
PUEBLA,CUAUTILULCO BARRIO,56,709,50,815,1479
PUEBLA,CUAUTILULCO BARRIO,96,505,42,643,1418
PUEBLA,CUAUTILULCO BARRIO,78,554,39,671,1418
PUEBLA,CUAUTILULCO BARRIO,72,717,36,825,1978
PUEBLA,CUAUTILULCO BARRIO,36,527,25,588,1269
PUEBLA,CUAUTILULCO BARRIO,52,555,27,634,1269
PUEBLA,CUAUTILULCO BARRIO,14,148,22,184,2021
PUEBLA,CUAUTILULCO BARRIO,15,168,23,206,2021
PUEBLA,CUAUTILULCO BARRIO,11,94,19,124,2020
PUEBLA,CUAUTILULCO BARRIO,41,163,11,215,1499
PUEBLA,CUAUTILULCO BARRIO,36,151,15,202,1499
PUEBLA,CUAUTILULCO BARRIO,37,89,22,148,1187
PUEBLA,CUAUTILULCO BARRIO,30,92,22,144,1187
PUEBLA,CUAUTILULCO BARRIO,14,628,100,742,2052
PUEBLA,CUAUTILULCO BARRIO,24,219,9,252,2052
PUEBLA,CUAUTILULCO BARRIO,9,190,5,204,1426
PUEBLA,CUAUTILULCO BARRIO,15,1237,9,1261,1426
PUEBLA,CUAUTILULCO BARRIO,16,992,3,1011,1464
PUEBLA,CUAUTILULCO BARRIO,4,788,12,804,1464
PUEBLA,CUAUTILULCO BARRIO,21,225,8,254,1807
PUEBLA,CUAUTILULCO BARRIO,19,221,3,243,1806
PUEBLA,CUAUTILULCO BARRIO,15,231,8,254,1806
PUEBLA,CUAUTILULCO BARRIO,16,1132,7,1155,1754
PUEBLA,CUAUTILULCO BARRIO,12,819,4,835,1754
PUEBLA,CUAUTILULCO BARRIO,34,286,15,335,2126
PUEBLA,CUAUTILULCO BARRIO,35,855,12,902,1269
PUEBLA,CUAUTILULCO BARRIO,18,906,9,933,1268
PUEBLA,CUAUTILULCO BARRIO,25,1510,10,1545,1894
PUEBLA,CUAUTILULCO BARRIO,44,1616,22,1682,1894
PUEBLA,CUAUTILULCO BARRIO,33,1332,7,1372,1900
PUEBLA,CUAUTILULCO BARRIO,18,1234,14,1266,1899
PUEBLA,CUAUTILULCO BARRIO,18,243,13,274,2040
PUEBLA,CUAUTILULCO BARRIO,21,276,8,305,2040
PUEBLA,CUAUTILULCO BARRIO,8,1118,1,1127,1663
PUEBLA,CUAUTILULCO BARRIO,7,1135,14,1156,1662
PUEBLA,CUAUTILULCO BARRIO,22,1440,12,1474,1553
PUEBLA,CUAUTILULCO BARRIO,34,1347,15,1396,1553
PUEBLA,CUAUTILULCO BARRIO,51,643,62,756,1583
PUEBLA,CUAUTILULCO BARRIO,33,675,57,765,1583
PUEBLA,CUAUTILULCO BARRIO,27,706,43,776,1582
PUEBLA,CUAUTILULCO BARRIO,23,374,35,432,1321
PUEBLA,CUAUTILULCO BARRIO,20,392,34,446,1320
PUEBLA,CUAUTILULCO BARRIO,57,395,44,496,1137
PUEBLA,CUAUTILULCO BARRIO,39,413,41,493,1136
PUEBLA,CUAUTILULCO BARRIO,57,486,59,602,1148
PUEBLA,CUAUTILULCO BARRIO,45,584,25,654,1148
PUEBLA,CUAUTILULCO BARRIO,48,748,44,840,1989
PUEBLA,CUAUTILULCO BARRIO,10,362,35,407,1149
PUEBLA,CUAUTILULCO BARRIO,11,350,26,387,1149
PUEBLA,CUAUTILULCO BARRIO,25,330,39,394,1621
PUEBLA,CUAUTILULCO BARRIO,19,328,16,363,1621
PUEBLA,CUAUTILULCO BARRIO,10,188,28,226,1990
PUEBLA,CUAUTILULCO BARRIO,19,210,28,257,1990
PUEBLA,CUAUTILULCO BARRIO,20,252,11,283,1587
PUEBLA,CUAUTILULCO BARRIO,15,286,14,315,1586
PUEBLA,CUAUTILULCO BARRIO,65,704,37,806,1493
PUEBLA,CUAUTILULCO BARRIO,50,741,44,835,1493
PUEBLA,CUAUTILULCO BARRIO,26,601,22,649,2046
PUEBLA,CUAUTILULCO BARRIO,44,624,36,704,2049
PUEBLA,CUAUTILULCO BARRIO,26,273,13,312,1795
PUEBLA,CUAUTILULCO BARRIO,23,236,24,283,1794
PUEBLA,CUAUTILULCO BARRIO,13,133,3,149,1217
PUEBLA,CUAUTILULCO BARRIO,4,105,1,110,1217
PUEBLA,CUAUTILULCO BARRIO,22,383,17,422,1177
PUEBLA,CUAUTILULCO BARRIO,27,336,17,380,1176
PUEBLA,CUAUTILULCO BARRIO,29,334,14,377,1824
PUEBLA,CUAUTILULCO BARRIO,24,366,10,400,1823
PUEBLA,CUAUTILULCO BARRIO,7,219,10,236,2030
PUEBLA,CUAUTILULCO BARRIO,20,479,34,533,1245
PUEBLA,CUAUTILULCO BARRIO,36,508,24,568,1245
PUEBLA,CUAUTILULCO BARRIO,26,524,33,583,1399
PUEBLA,CUAUTILULCO BARRIO,29,517,16,562,1399
PUEBLA,CUAUTILULCO BARRIO,26,623,27,676,1802
PUEBLA,CUAUTILULCO BARRIO,20,587,30,637,1801
PUEBLA,CUAUTILULCO BARRIO,16,369,17,402,1318
PUEBLA,CUAUTILULCO BARRIO,16,346,33,395,1317
PUEBLA,CUAUTILULCO BARRIO,38,441,90,569,1746
PUEBLA,CUAUTILULCO BARRIO,51,489,74,614,1745
PUEBLA,CUAUTILULCO BARRIO,24,352,34,410,1680
PUEBLA,CUAUTILULCO BARRIO,18,361,51,430,1680
PUEBLA,CUAUTILULCO BARRIO,44,868,51,963,1526
PUEBLA,CUAUTILULCO BARRIO,34,553,68,655,1526
PUEBLA,CUAUTILULCO BARRIO,45,365,88,498,1661
PUEBLA,CUAUTILULCO BARRIO,49,418,74,541,1661
PUEBLA,CUAUTILULCO BARRIO,67,513,70,650,1938
PUEBLA,CUAUTILULCO BARRIO,39,305,30,374,1086
PUEBLA,CUAUTILULCO BARRIO,60,283,48,391,1085
PUEBLA,CUAUTILULCO BARRIO,24,430,16,470,1680
PUEBLA,CUAUTILULCO BARRIO,26,414,14,454,1679
PUEBLA,CUAUTILULCO BARRIO,40,460,23,523,2081
PUEBLA,CUAUTILULCO BARRIO,34,439,25,498,2080
PUEBLA,CUAUTILULCO BARRIO,58,322,31,411,1983
PUEBLA,CUAUTILULCO BARRIO,18,451,32,501,2098
PUEBLA,CUAUTILULCO BARRIO,51,488,24,563,1981
PUEBLA,CUAUTILULCO BARRIO,29,293,14,336,1510
PUEBLA,CUAUTILULCO BARRIO,15,262,9,286,1509
PUEBLA,CUAUTILULCO BARRIO,16,271,22,309,1190
PUEBLA,CUAUTILULCO BARRIO,14,275,35,324,1190
PUEBLA,CUAUTILULCO BARRIO,28,669,23,720,1576
PUEBLA,CUAUTILULCO BARRIO,23,670,12,705,1575
PUEBLA,CUAUTILULCO BARRIO,18,655,24,697,1575
PUEBLA,CUAUTILULCO BARRIO,38,534,27,599,1867
PUEBLA,CUAUTILULCO BARRIO,38,515,33,586,1866
PUEBLA,CUAUTILULCO BARRIO,56,646,67,769,2067
PUEBLA,CUAUTILULCO BARRIO,35,641,33,709,2125
PUEBLA,CUAUTILULCO BARRIO,18,211,24,253,1506
PUEBLA,CUAUTILULCO BARRIO,22,204,28,254,1505
PUEBLA,CUAUTILULCO BARRIO,48,522,36,606,2146
PUEBLA,CUAUTILULCO BARRIO,17,255,7,279,1709
PUEBLA,CUAUTILULCO BARRIO,35,276,7,318,1709
PUEBLA,CUAUTILULCO BARRIO,29,344,4,377,1581
PUEBLA,CUAUTILULCO BARRIO,36,311,7,354,1581
PUEBLA,CUAUTILULCO BARRIO,30,335,6,371,1990
PUEBLA,CUAUTILULCO BARRIO,29,340,4,373,1990
PUEBLA,CUAUTILULCO BARRIO,22,249,0,271,1826
PUEBLA,CUAUTILULCO BARRIO,16,234,9,259,1826
PUEBLA,CUAUTILULCO BARRIO,11,266,7,284,1825
PUEBLA,CUAUTILULCO BARRIO,125,1128,16,1269,0
PUEBLA,CUAUTILULCO BARRIO,47,624,32,703,2112
PUEBLA,CUAUTILULCO BARRIO,15,505,26,546,1305
PUEBLA,CUAUTILULCO BARRIO,34,472,16,522,1304
PUEBLA,CUAUTILULCO BARRIO,40,248,14,302,1974
PUEBLA,CUAUTILULCO BARRIO,21,130,2,153,1720
PUEBLA,CUAUTILULCO BARRIO,16,125,11,152,1720
PUEBLA,CUAUTILULCO BARRIO,19,132,5,156,1720
PUEBLA,CUAUTILULCO BARRIO,12,183,7,202,1454
PUEBLA,CUAUTILULCO BARRIO,17,157,12,186,1453
PUEBLA,CUAUTILULCO BARRIO,21,261,20,302,1789
PUEBLA,CUAUTILULCO BARRIO,19,285,10,314,1789
PUEBLA,CUAUTILULCO BARRIO,24,253,1,278,1789
PUEBLA,CUAUTILULCO BARRIO,21,481,11,513,1463
PUEBLA,CUAUTILULCO BARRIO,27,241,4,272,1462
PUEBLA,CUAUTILULCO BARRIO,21,305,11,337,2043
PUEBLA,CUAUTILULCO BARRIO,21,294,9,324,2042
PUEBLA,CUAUTILULCO BARRIO,29,351,11,391,2119
PUEBLA,CUAUTILULCO BARRIO,29,311,7,347,2119
PUEBLA,CUAUTILULCO BARRIO,22,398,9,429,2118
PUEBLA,CUAUTILULCO BARRIO,16,283,3,302,1874
PUEBLA,CUAUTILULCO BARRIO,22,246,4,272,1873
PUEBLA,CUAUTILULCO BARRIO,26,759,7,792,1641
PUEBLA,CUAUTILULCO BARRIO,16,274,8,298,1641
PUEBLA,CUAUTILULCO BARRIO,45,427,52,524,1635
PUEBLA,CUAUTILULCO BARRIO,46,477,27,550,1634
PUEBLA,CUAUTILULCO BARRIO,32,728,12,772,1752
PUEBLA,CUAUTILULCO BARRIO,31,709,22,762,1465
PUEBLA,CUAUTILULCO BARRIO,33,677,21,731,1465
PUEBLA,CUAUTILULCO BARRIO,41,566,11,618,1288
PUEBLA,CUAUTILULCO BARRIO,23,560,16,599,1287
PUEBLA,CUAUTILULCO BARRIO,34,403,24,461,1720
PUEBLA,CUAUTILULCO BARRIO,37,394,27,458,1719
PUEBLA,CUAUTILULCO BARRIO,28,334,14,376,1138
PUEBLA,CUAUTILULCO BARRIO,25,327,16,368,1137
PUEBLA,CUAUTILULCO BARRIO,35,400,15,450,1387
PUEBLA,CUAUTILULCO BARRIO,37,368,13,418,1386
PUEBLA,CUAUTILULCO BARRIO,40,452,18,510,1309
PUEBLA,CUAUTILULCO BARRIO,49,423,38,510,1309
PUEBLA,CUAUTILULCO BARRIO,30,1024,14,1068,1817
PUEBLA,CUAUTILULCO BARRIO,27,876,22,925,1816
PUEBLA,CUAUTILULCO BARRIO,32,640,57,729,1988
PUEBLA,CUAUTILULCO BARRIO,25,254,6,285,1639
PUEBLA,CUAUTILULCO BARRIO,29,229,6,264,1639
PUEBLA,CUAUTILULCO BARRIO,18,185,3,206,1121
PUEBLA,CUAUTILULCO BARRIO,15,218,1,234,1120
PUEBLA,TEZIUTLAN,22,492,13,527,1732
PUEBLA,TEZIUTLAN,26,529,21,576,1732
PUEBLA,TEZIUTLAN,9,446,19,474,1450
PUEBLA,TEZIUTLAN,11,385,15,411,1450
PUEBLA,TEZIUTLAN,19,394,18,431,1449
PUEBLA,TEZIUTLAN,20,346,3,369,1661
PUEBLA,TEZIUTLAN,18,347,5,370,1661
PUEBLA,TEZIUTLAN,26,329,8,363,1687
PUEBLA,TEZIUTLAN,30,326,12,368,1687
PUEBLA,TEZIUTLAN,23,244,6,273,1439
PUEBLA,TEZIUTLAN,31,220,20,271,1439
PUEBLA,TEZIUTLAN,12,211,9,232,1546
PUEBLA,TEZIUTLAN,31,167,7,205,1545
PUEBLA,TEZIUTLAN,9,188,10,207,1545
PUEBLA,TEZIUTLAN,18,152,9,179,1437
PUEBLA,TEZIUTLAN,15,206,4,225,1437
PUEBLA,TEZIUTLAN,17,465,17,499,1580
PUEBLA,TEZIUTLAN,17,423,21,461,1579
PUEBLA,TEZIUTLAN,17,439,8,464,1579
PUEBLA,TEZIUTLAN,19,422,19,460,1532
PUEBLA,TEZIUTLAN,19,423,24,466,1532
PUEBLA,TEZIUTLAN,18,401,24,443,1532
PUEBLA,TEZIUTLAN,26,499,14,539,1655
PUEBLA,TEZIUTLAN,32,504,20,556,1654
PUEBLA,TEZIUTLAN,27,503,22,552,1654
PUEBLA,TEZIUTLAN,22,485,19,526,1296
PUEBLA,TEZIUTLAN,15,416,20,451,1295
PUEBLA,TEZIUTLAN,9,417,14,440,1305
PUEBLA,TEZIUTLAN,22,395,16,433,1304
PUEBLA,TEZIUTLAN,19,615,22,656,2060
PUEBLA,TEZIUTLAN,22,591,34,647,2059
PUEBLA,TEZIUTLAN,31,442,26,499,1390
PUEBLA,TEZIUTLAN,43,421,24,488,1390
PUEBLA,TEZIUTLAN,121,459,43,623,1839
PUEBLA,TEZIUTLAN,104,490,50,644,1839
PUEBLA,TEZIUTLAN,25,521,24,570,1869
PUEBLA,TEZIUTLAN,38,515,21,574,1869
PUEBLA,TEZIUTLAN,13,412,12,437,1405
PUEBLA,TEZIUTLAN,21,402,21,444,1404
PUEBLA,TEZIUTLAN,15,405,13,433,1404
PUEBLA,TEZIUTLAN,18,243,9,270,1671
PUEBLA,TEZIUTLAN,16,257,7,280,1670
PUEBLA,TEZIUTLAN,18,154,6,178,1221
PUEBLA,TEZIUTLAN,6,163,3,172,1221
PUEBLA,TEZIUTLAN,12,278,10,300,1937
PUEBLA,TEZIUTLAN,7,273,7,287,1936
PUEBLA,TEZIUTLAN,27,203,6,236,1601
PUEBLA,TEZIUTLAN,24,234,7,265,1600
PUEBLA,TEZIUTLAN,14,127,10,151,1239
PUEBLA,TEZIUTLAN,10,97,13,120,1238
PUEBLA,TEZIUTLAN,40,352,17,409,1574
PUEBLA,TEZIUTLAN,43,357,7,407,1574
PUEBLA,TEZIUTLAN,37,373,19,429,1574
PUEBLA,TEZIUTLAN,60,456,57,573,2091
PUEBLA,TEZIUTLAN,49,436,45,530,2090
PUEBLA,TEZIUTLAN,29,423,23,475,1955
PUEBLA,TEZIUTLAN,16,427,14,457,1955
PUEBLA,TEZIUTLAN,40,538,30,608,1987
PUEBLA,TEZIUTLAN,39,515,15,569,1987
PUEBLA,TEZIUTLAN,21,341,25,387,1393
PUEBLA,TEZIUTLAN,19,408,14,441,1393
PUEBLA,TEZIUTLAN,20,372,29,421,1393
PUEBLA,TEZIUTLAN,28,314,15,357,1569
PUEBLA,TEZIUTLAN,30,265,16,311,1569
PUEBLA,TEZIUTLAN,17,337,11,365,1569
PUEBLA,TEZIUTLAN,23,279,14,316,1408
PUEBLA,TEZIUTLAN,13,330,18,361,1407
PUEBLA,TEZIUTLAN,21,327,11,359,1407
PUEBLA,TEZIUTLAN,30,613,27,670,1661
PUEBLA,TEZIUTLAN,43,597,24,664,1661
PUEBLA,TEZIUTLAN,49,685,21,755,1661
PUEBLA,TEZIUTLAN,20,478,7,505,1544
PUEBLA,TEZIUTLAN,28,502,12,542,1544
PUEBLA,TEZIUTLAN,35,468,13,516,1543
PUEBLA,TEZIUTLAN,16,310,3,329,1485
PUEBLA,TEZIUTLAN,34,276,3,313,1485
PUEBLA,TEZIUTLAN,31,334,8,373,1981
PUEBLA,TEZIUTLAN,19,335,1,355,1981
PUEBLA,TEZIUTLAN,16,343,2,361,2044
PUEBLA,TEZIUTLAN,24,306,10,340,2044
PUEBLA,TEZIUTLAN,25,283,2,310,1537
PUEBLA,TEZIUTLAN,23,286,3,312,1537
PUEBLA,TEZIUTLAN,21,268,4,293,1909
PUEBLA,TEZIUTLAN,15,282,3,300,1909
PUEBLA,TEZIUTLAN,83,1357,18,1458,0
PUEBLA,TEZIUTLAN,18,228,3,249,1444
PUEBLA,TEZIUTLAN,10,242,7,259,1444
PUEBLA,TEZIUTLAN,13,231,0,244,1573
PUEBLA,TEZIUTLAN,16,201,3,220,1573
PUEBLA,TEZIUTLAN,15,209,4,228,1573
PUEBLA,TEZIUTLAN,13,349,2,364,1928
PUEBLA,TEZIUTLAN,24,335,7,366,1927
PUEBLA,TEZIUTLAN,18,290,6,314,1522
PUEBLA,TEZIUTLAN,20,319,8,347,1521
PUEBLA,TEZIUTLAN,18,335,6,359,1521
PUEBLA,TEZIUTLAN,7,236,3,246,1702
PUEBLA,TEZIUTLAN,17,237,8,262,1701
PUEBLA,TEZIUTLAN,14,257,4,275,1701
PUEBLA,TEZIUTLAN,32,259,5,296,1848
PUEBLA,TEZIUTLAN,17,296,4,317,1847
PUEBLA,TEZIUTLAN,17,255,4,276,1547
PUEBLA,TEZIUTLAN,24,272,3,299,1546
PUEBLA,TEZIUTLAN,16,207,3,226,1546
PUEBLA,TEZIUTLAN,28,334,18,380,1999
PUEBLA,TEZIUTLAN,26,399,7,432,1998
PUEBLA,TEZIUTLAN,15,582,10,607,1906
PUEBLA,TEZIUTLAN,19,325,10,354,2042
PUEBLA,TEZIUTLAN,25,278,11,314,2042
PUEBLA,TEZIUTLAN,16,249,1,266,1225
PUEBLA,TEZIUTLAN,14,239,6,259,1225
PUEBLA,TEZIUTLAN,14,292,9,315,2005
PUEBLA,TEZIUTLAN,16,292,8,316,2004
PUEBLA,TEZIUTLAN,25,258,7,290,1950
PUEBLA,TEZIUTLAN,19,177,5,201,1124
PUEBLA,TEZIUTLAN,11,172,5,188,1123
PUEBLA,TEZIUTLAN,15,225,6,246,2045
PUEBLA,TEZIUTLAN,20,244,14,278,2045
PUEBLA,TEZIUTLAN,8,195,10,213,1126
PUEBLA,TEZIUTLAN,5,162,4,171,1125
PUEBLA,TEZIUTLAN,33,424,13,470,1829
PUEBLA,TEZIUTLAN,32,421,10,463,1829
PUEBLA,TEZIUTLAN,29,353,9,391,1669
PUEBLA,TEZIUTLAN,36,354,8,398,1669
PUEBLA,TEZIUTLAN,36,352,2,390,1668
PUEBLA,TEZIUTLAN,80,553,32,665,1717
PUEBLA,TEZIUTLAN,97,431,40,568,1833
PUEBLA,TEZIUTLAN,81,449,33,563,1833
PUEBLA,TEZIUTLAN,37,491,14,542,2051
PUEBLA,TEZIUTLAN,40,537,15,592,2051
PUEBLA,TEZIUTLAN,46,509,20,575,2074
PUEBLA,TEZIUTLAN,47,515,16,578,2074
PUEBLA,TEZIUTLAN,27,464,10,501,2034
PUEBLA,TEZIUTLAN,40,475,14,529,2033
PUEBLA,TEZIUTLAN,46,451,31,528,1681
PUEBLA,TEZIUTLAN,48,431,31,510,1681
PUEBLA,TEZIUTLAN,32,267,34,333,1730
PUEBLA,TEZIUTLAN,55,301,35,391,1730
PUEBLA,TEZIUTLAN,2,345,41,388,1459
PUEBLA,TEZIUTLAN,30,329,16,375,1459
PUEBLA,TEZIUTLAN,39,186,2,227,1460
PUEBLA,TEZIUTLAN,35,164,5,204,1459
PUEBLA,TEZIUTLAN,28,674,28,730,1869
PUEBLA,TEZIUTLAN,20,740,22,782,1868
PUEBLA,TEZIUTLAN,42,770,25,837,1966
PUEBLA,TEZIUTLAN,15,371,7,393,1865
PUEBLA,TEZIUTLAN,22,385,11,418,1865
PUEBLA,TEZIUTLAN,10,286,9,305,1758
PUEBLA,TEZIUTLAN,14,248,9,271,1757
PUEBLA,TEZIUTLAN,11,234,10,255,1757
PUEBLA,TEZIUTLAN,18,279,5,302,1231
PUEBLA,TEZIUTLAN,7,280,1,288,1230
PUEBLA,TEZIUTLAN,18,260,14,292,1469
PUEBLA,TEZIUTLAN,12,216,12,240,1468
PUEBLA,TEZIUTLAN,14,277,9,300,1468
PUEBLA,TEZIUTLAN,19,303,22,344,1286
PUEBLA,TEZIUTLAN,31,268,28,327,1286
PUEBLA,TEZIUTLAN,14,347,7,368,1659
PUEBLA,TEZIUTLAN,25,304,21,350,1658
PUEBLA,TEZIUTLAN,9,354,1,364,1741
PUEBLA,TEZIUTLAN,11,376,5,392,1741
PUEBLA,TEZIUTLAN,17,327,17,361,1652
PUEBLA,TEZIUTLAN,16,268,12,296,1651
PUEBLA,TEZIUTLAN,27,333,17,377,1480
PUEBLA,TEZIUTLAN,23,333,18,374,1479
PUEBLA,TEZIUTLAN,40,414,18,472,1614
PUEBLA,TEZIUTLAN,34,437,21,492,1886
PUEBLA,TEZIUTLAN,16,431,13,460,1885
PUEBLA,TEZIUTLAN,27,506,8,541,1949
PUEBLA,TEZIUTLAN,22,440,12,474,1948
PUEBLA,TEZIUTLAN,27,431,14,472,1586
PUEBLA,TEZIUTLAN,28,433,9,470,1586
PUEBLA,TEZIUTLAN,18,347,4,369,1233
PUEBLA,TEZIUTLAN,18,322,4,344,1233
PUEBLA,TEZIUTLAN,30,422,23,475,1868
PUEBLA,TEZIUTLAN,27,174,16,217,1629
PUEBLA,TEZIUTLAN,34,217,7,258,1628
PUEBLA,TEZIUTLAN,30,307,21,358,1983
PUEBLA,TEZIUTLAN,20,325,19,364,1983
PUEBLA,TEZIUTLAN,41,238,11,290,1653
PUEBLA,TEZIUTLAN,11,213,9,233,1652
PUEBLA,TEZIUTLAN,18,411,12,441,1906
PUEBLA,TEZIUTLAN,15,434,13,462,1905
PUEBLA,AJALPAN,16,323,5,344,1675
PUEBLA,AJALPAN,17,361,11,389,1674
PUEBLA,AJALPAN,16,339,10,365,1674
PUEBLA,AJALPAN,12,289,5,306,1193
PUEBLA,AJALPAN,13,254,7,274,1192
PUEBLA,AJALPAN,9,371,7,387,1438
PUEBLA,AJALPAN,12,335,10,357,1437
PUEBLA,AJALPAN,14,342,9,365,1479
PUEBLA,AJALPAN,10,383,5,398,1479
PUEBLA,AJALPAN,7,360,8,375,1665
PUEBLA,AJALPAN,16,353,9,378,1665
PUEBLA,AJALPAN,21,440,5,466,1935
PUEBLA,AJALPAN,17,449,5,471,1934
PUEBLA,AJALPAN,6,356,9,371,1117
PUEBLA,AJALPAN,2,305,9,316,1116
PUEBLA,AJALPAN,38,104,76,218,1483
PUEBLA,AJALPAN,46,93,73,212,1482
PUEBLA,AJALPAN,60,175,49,284,1405
PUEBLA,AJALPAN,35,129,73,237,1404
PUEBLA,AJALPAN,80,299,91,470,1998
PUEBLA,AJALPAN,83,359,93,535,1997
PUEBLA,AJALPAN,104,341,128,573,1798
PUEBLA,AJALPAN,89,389,84,562,1797
PUEBLA,AJALPAN,58,439,51,548,1904
PUEBLA,AJALPAN,62,307,141,510,1904
PUEBLA,AJALPAN,11,464,15,490,1618
PUEBLA,AJALPAN,6,516,6,528,1618
PUEBLA,AJALPAN,6,338,5,349,1072
PUEBLA,AJALPAN,6,354,8,368,1071
PUEBLA,AJALPAN,16,625,9,650,0
PUEBLA,AJALPAN,1,413,3,417,1117
PUEBLA,AJALPAN,6,412,8,426,1116
PUEBLA,AJALPAN,0,415,3,418,1485
PUEBLA,AJALPAN,6,368,8,382,1485
PUEBLA,AJALPAN,4,416,8,428,1485
PUEBLA,AJALPAN,7,642,8,657,1985
PUEBLA,AJALPAN,7,631,6,644,1985
PUEBLA,AJALPAN,27,407,17,451,1393
PUEBLA,AJALPAN,21,409,12,442,1392
PUEBLA,AJALPAN,17,347,8,372,1920
PUEBLA,AJALPAN,17,322,9,348,1919
PUEBLA,AJALPAN,4,168,4,176,1734
PUEBLA,AJALPAN,8,171,2,181,1733
PUEBLA,AJALPAN,18,72,7,97,1261
PUEBLA,AJALPAN,34,90,3,127,1261
PUEBLA,AJALPAN,18,241,12,271,1544
PUEBLA,AJALPAN,16,197,16,229,1543
PUEBLA,AJALPAN,19,390,4,413,1520
PUEBLA,AJALPAN,7,466,9,482,1520
PUEBLA,AJALPAN,12,437,10,459,1520
PUEBLA,AJALPAN,86,556,46,688,1758
PUEBLA,AJALPAN,76,451,35,562,1758
PUEBLA,AJALPAN,85,508,52,645,1758
PUEBLA,AJALPAN,10,374,15,399,1739
PUEBLA,AJALPAN,15,372,13,400,1739
PUEBLA,AJALPAN,23,445,18,486,1784
PUEBLA,AJALPAN,17,507,11,535,1783
PUEBLA,AJALPAN,21,508,26,555,1783
PUEBLA,AJALPAN,1,6,1,8,1836
PUEBLA,AJALPAN,1,4,0,5,1835
PUEBLA,AJALPAN,4,7,0,11,1565
PUEBLA,AJALPAN,0,7,0,7,1564
PUEBLA,AJALPAN,15,251,1,267,1610
PUEBLA,AJALPAN,13,233,1,247,1610
PUEBLA,AJALPAN,14,181,15,210,1768
PUEBLA,AJALPAN,15,242,6,263,1768
PUEBLA,AJALPAN,71,680,20,771,1698
PUEBLA,AJALPAN,97,588,32,717,1697
PUEBLA,AJALPAN,114,564,68,746,1457
PUEBLA,AJALPAN,77,603,39,719,1456
PUEBLA,AJALPAN,94,654,56,804,1518
PUEBLA,AJALPAN,105,668,49,822,1517
PUEBLA,AJALPAN,23,198,5,226,1574
PUEBLA,AJALPAN,10,253,2,265,1574
PUEBLA,AJALPAN,13,150,6,169,1574
PUEBLA,AJALPAN,24,333,11,368,1690
PUEBLA,AJALPAN,27,262,2,291,1689
PUEBLA,AJALPAN,14,206,8,228,1222
PUEBLA,AJALPAN,9,174,2,185,1221
PUEBLA,AJALPAN,20,283,5,308,1864
PUEBLA,AJALPAN,19,302,7,328,1863
PUEBLA,AJALPAN,13,190,5,208,1414
PUEBLA,AJALPAN,17,227,7,251,1414
PUEBLA,AJALPAN,18,228,5,251,1414
PUEBLA,AJALPAN,24,395,7,426,1756
PUEBLA,AJALPAN,16,354,4,374,1755
PUEBLA,AJALPAN,16,198,4,218,1669
PUEBLA,AJALPAN,7,188,0,195,1668
PUEBLA,AJALPAN,57,180,9,246,1387
PUEBLA,AJALPAN,58,159,12,229,1386
PUEBLA,AJALPAN,16,208,2,226,1615
PUEBLA,AJALPAN,32,260,7,299,1614
PUEBLA,AJALPAN,19,122,3,144,1378
PUEBLA,AJALPAN,7,118,1,126,1378
PUEBLA,AJALPAN,20,95,8,123,1378
PUEBLA,AJALPAN,14,261,11,286,1845
PUEBLA,AJALPAN,7,213,7,227,1845
PUEBLA,AJALPAN,6,201,4,211,1524
PUEBLA,AJALPAN,26,228,8,262,1524
PUEBLA,AJALPAN,15,193,5,213,1524
PUEBLA,AJALPAN,25,245,12,282,1961
PUEBLA,AJALPAN,22,324,23,369,1961
PUEBLA,AJALPAN,16,203,15,234,1218
PUEBLA,AJALPAN,23,227,7,257,1217
PUEBLA,AJALPAN,12,232,7,251,1037
PUEBLA,AJALPAN,9,235,3,247,1036
PUEBLA,AJALPAN,18,313,9,340,1802
PUEBLA,AJALPAN,22,343,5,370,1801
PUEBLA,AJALPAN,6,216,2,224,1379
PUEBLA,AJALPAN,15,254,7,276,1379
PUEBLA,AJALPAN,7,221,4,232,1919
PUEBLA,AJALPAN,4,181,4,189,1919
PUEBLA,AJALPAN,11,250,1,262,1359
PUEBLA,AJALPAN,12,209,3,224,1358
PUEBLA,AJALPAN,11,223,4,238,1773
PUEBLA,AJALPAN,8,201,5,214,1772
PUEBLA,AJALPAN,12,344,2,358,1600
PUEBLA,AJALPAN,5,317,7,329,1599
PUEBLA,AJALPAN,7,117,3,127,1473
PUEBLA,AJALPAN,9,139,6,154,1472
PUEBLA,AJALPAN,5,108,0,113,1472
PUEBLA,AJALPAN,5,283,6,294,1657
PUEBLA,AJALPAN,10,274,2,286,1657
PUEBLA,AJALPAN,9,199,2,210,1943
PUEBLA,AJALPAN,11,168,1,180,1942
PUEBLA,AJALPAN,11,254,1,266,2019
PUEBLA,AJALPAN,9,267,0,276,2019
PUEBLA,AJALPAN,44,216,29,289,1598
PUEBLA,AJALPAN,14,231,26,271,1597
PUEBLA,AJALPAN,10,285,3,298,1264
PUEBLA,AJALPAN,13,268,4,285,1263
PUEBLA,AJALPAN,20,549,5,574,1711
PUEBLA,AJALPAN,8,529,6,543,1710
PUEBLA,AJALPAN,23,660,3,686,1896
PUEBLA,AJALPAN,25,661,3,689,1895
PUEBLA,AJALPAN,6,461,5,472,1571
PUEBLA,AJALPAN,16,478,12,506,1571
PUEBLA,AJALPAN,17,542,24,583,1686
PUEBLA,AJALPAN,14,517,23,554,1686
PUEBLA,AJALPAN,5,520,12,537,1649
PUEBLA,AJALPAN,6,553,15,574,1649
PUEBLA,AJALPAN,8,507,13,528,1381
PUEBLA,AJALPAN,5,391,11,407,1381
PUEBLA,AJALPAN,74,479,80,633,1391
PUEBLA,AJALPAN,19,598,76,693,1391
PUEBLA,AJALPAN,61,753,47,861,1645
PUEBLA,AJALPAN,51,723,22,796,1644
PUEBLA,AJALPAN,59,540,48,647,1346
PUEBLA,AJALPAN,41,566,34,641,1346
PUEBLA,AJALPAN,48,415,47,510,1452
PUEBLA,AJALPAN,48,408,27,483,1452
PUEBLA,AJALPAN,61,587,62,710,1787
PUEBLA,AJALPAN,64,621,41,726,1787
PUEBLA,AJALPAN,90,459,105,654,1404
PUEBLA,AJALPAN,104,522,80,706,1403
PUEBLA,AJALPAN,134,575,143,852,1741
PUEBLA,AJALPAN,138,554,119,811,1740
PUEBLA,AJALPAN,107,334,184,625,1322
PUEBLA,AJALPAN,51,364,152,567,1321
PUEBLA,AJALPAN,20,577,13,610,1509
PUEBLA,AJALPAN,11,601,4,616,1509
PUEBLA,AJALPAN,24,307,16,347,1701
PUEBLA,AJALPAN,16,299,12,327,1700
PUEBLA,AJALPAN,8,489,9,506,1286
PUEBLA,AJALPAN,4,526,10,540,1286
PUEBLA,AJALPAN,24,655,14,693,1794
PUEBLA,AJALPAN,22,646,18,686,1793
PUEBLA,AJALPAN,9,395,9,413,1032
PUEBLA,AJALPAN,12,396,5,413,1032
PUEBLA,AJALPAN,21,712,18,751,1907
PUEBLA,AJALPAN,22,672,11,705,1906
PUEBLA,AJALPAN,40,137,23,200,1232
PUEBLA,AJALPAN,40,125,37,202,1231
PUEBLA,AJALPAN,44,111,32,187,1911
PUEBLA,AJALPAN,40,120,27,187,1911
PUEBLA,AJALPAN,72,461,68,601,1951
PUEBLA,AJALPAN,92,446,98,636,1951
PUEBLA,AJALPAN,101,409,114,624,1940
PUEBLA,AJALPAN,98,389,122,609,1939
PUEBLA,AJALPAN,42,116,6,164,1860
PUEBLA,AJALPAN,49,153,27,229,1860
PUEBLA,AJALPAN,85,286,88,459,1607
PUEBLA,AJALPAN,77,255,122,454,1607
PUEBLA,SAN MARTIN TEXMELUCAN DE LABASTIDA,38,286,8,332,1871
PUEBLA,SAN MARTIN TEXMELUCAN DE LABASTIDA,25,271,2,298,1870
PUEBLA,SAN MARTIN TEXMELUCAN DE LABASTIDA,23,159,3,185,1392
PUEBLA,SAN MARTIN TEXMELUCAN DE LABASTIDA,21,148,6,175,1392
PUEBLA,SAN MARTIN TEXMELUCAN DE LABASTIDA,9,181,5,195,1003
PUEBLA,SAN MARTIN TEXMELUCAN DE LABASTIDA,16,161,6,183,1002
PUEBLA,SAN MARTIN TEXMELUCAN DE LABASTIDA,31,301,27,359,1998
PUEBLA,SAN MARTIN TEXMELUCAN DE LABASTIDA,18,171,0,189,1422
PUEBLA,SAN MARTIN TEXMELUCAN DE LABASTIDA,13,147,3,163,1422
PUEBLA,SAN MARTIN TEXMELUCAN DE LABASTIDA,15,190,3,208,1422
PUEBLA,SAN MARTIN TEXMELUCAN DE LABASTIDA,9,166,3,178,1467
PUEBLA,SAN MARTIN TEXMELUCAN DE LABASTIDA,16,152,2,170,1466
PUEBLA,SAN MARTIN TEXMELUCAN DE LABASTIDA,9,170,1,180,1466
PUEBLA,SAN MARTIN TEXMELUCAN DE LABASTIDA,8,170,1,179,1246
PUEBLA,SAN MARTIN TEXMELUCAN DE LABASTIDA,1,134,1,136,1246
PUEBLA,SAN MARTIN TEXMELUCAN DE LABASTIDA,11,193,5,209,1755
PUEBLA,SAN MARTIN TEXMELUCAN DE LABASTIDA,13,158,3,174,1755
PUEBLA,SAN MARTIN TEXMELUCAN DE LABASTIDA,17,167,5,189,1375
PUEBLA,SAN MARTIN TEXMELUCAN DE LABASTIDA,12,192,11,215,1375
PUEBLA,SAN MARTIN TEXMELUCAN DE LABASTIDA,11,222,4,237,1335
PUEBLA,SAN MARTIN TEXMELUCAN DE LABASTIDA,6,204,6,216,1334
PUEBLA,SAN MARTIN TEXMELUCAN DE LABASTIDA,18,242,4,264,1363
PUEBLA,SAN MARTIN TEXMELUCAN DE LABASTIDA,17,193,5,215,1363
PUEBLA,SAN MARTIN TEXMELUCAN DE LABASTIDA,18,239,2,259,1485
PUEBLA,SAN MARTIN TEXMELUCAN DE LABASTIDA,18,251,7,276,1484
PUEBLA,SAN MARTIN TEXMELUCAN DE LABASTIDA,18,200,1,219,1484
PUEBLA,SAN MARTIN TEXMELUCAN DE LABASTIDA,20,223,1,244,2025
PUEBLA,SAN MARTIN TEXMELUCAN DE LABASTIDA,24,240,3,267,2024
PUEBLA,SAN MARTIN TEXMELUCAN DE LABASTIDA,18,239,3,260,2024
PUEBLA,SAN MARTIN TEXMELUCAN DE LABASTIDA,22,209,3,234,2024
PUEBLA,SAN MARTIN TEXMELUCAN DE LABASTIDA,15,209,1,225,2024
PUEBLA,SAN MARTIN TEXMELUCAN DE LABASTIDA,14,313,10,337,1725
PUEBLA,SAN MARTIN TEXMELUCAN DE LABASTIDA,22,306,7,335,1725
PUEBLA,SAN MARTIN TEXMELUCAN DE LABASTIDA,18,203,0,221,1573
PUEBLA,SAN MARTIN TEXMELUCAN DE LABASTIDA,18,194,5,217,1573
PUEBLA,SAN MARTIN TEXMELUCAN DE LABASTIDA,18,207,3,228,1572
PUEBLA,SAN MARTIN TEXMELUCAN DE LABASTIDA,21,200,2,223,1572
PUEBLA,SAN MARTIN TEXMELUCAN DE LABASTIDA,20,320,6,346,1935
PUEBLA,SAN MARTIN TEXMELUCAN DE LABASTIDA,22,301,12,335,1934
PUEBLA,SAN MARTIN TEXMELUCAN DE LABASTIDA,26,238,5,269,1252
PUEBLA,SAN MARTIN TEXMELUCAN DE LABASTIDA,15,224,2,241,1251
PUEBLA,SAN MARTIN TEXMELUCAN DE LABASTIDA,17,280,4,301,1459
PUEBLA,SAN MARTIN TEXMELUCAN DE LABASTIDA,24,275,2,301,1458
PUEBLA,SAN MARTIN TEXMELUCAN DE LABASTIDA,17,218,1,236,1123
PUEBLA,SAN MARTIN TEXMELUCAN DE LABASTIDA,18,230,3,251,1122
PUEBLA,SAN MARTIN TEXMELUCAN DE LABASTIDA,30,259,1,290,1453
PUEBLA,SAN MARTIN TEXMELUCAN DE LABASTIDA,14,265,6,285,1453
PUEBLA,SAN MARTIN TEXMELUCAN DE LABASTIDA,13,248,4,265,1326
PUEBLA,SAN MARTIN TEXMELUCAN DE LABASTIDA,6,238,1,245,1326
PUEBLA,SAN MARTIN TEXMELUCAN DE LABASTIDA,14,256,6,276,1327
PUEBLA,SAN MARTIN TEXMELUCAN DE LABASTIDA,8,267,4,279,1326
PUEBLA,SAN MARTIN TEXMELUCAN DE LABASTIDA,21,345,4,370,1417
PUEBLA,SAN MARTIN TEXMELUCAN DE LABASTIDA,15,336,5,356,1417
PUEBLA,SAN MARTIN TEXMELUCAN DE LABASTIDA,15,319,3,337,1417
PUEBLA,SAN MARTIN TEXMELUCAN DE LABASTIDA,6,140,4,150,1413
PUEBLA,SAN MARTIN TEXMELUCAN DE LABASTIDA,14,185,9,208,1412
PUEBLA,SAN MARTIN TEXMELUCAN DE LABASTIDA,14,160,3,177,1412
PUEBLA,SAN MARTIN TEXMELUCAN DE LABASTIDA,22,228,17,267,1301
PUEBLA,SAN MARTIN TEXMELUCAN DE LABASTIDA,21,213,13,247,1301
PUEBLA,SAN MARTIN TEXMELUCAN DE LABASTIDA,24,145,7,176,1463
PUEBLA,SAN MARTIN TEXMELUCAN DE LABASTIDA,34,155,13,202,1463
PUEBLA,SAN MARTIN TEXMELUCAN DE LABASTIDA,10,174,2,186,1164
PUEBLA,SAN MARTIN TEXMELUCAN DE LABASTIDA,8,173,3,184,1163
PUEBLA,SAN MARTIN TEXMELUCAN DE LABASTIDA,26,238,2,266,1384
PUEBLA,SAN MARTIN TEXMELUCAN DE LABASTIDA,15,234,3,252,1383
PUEBLA,SAN MARTIN TEXMELUCAN DE LABASTIDA,14,249,6,269,1383
PUEBLA,SAN MARTIN TEXMELUCAN DE LABASTIDA,27,241,10,278,1854
PUEBLA,SAN MARTIN TEXMELUCAN DE LABASTIDA,15,235,3,253,1853
PUEBLA,SAN MARTIN TEXMELUCAN DE LABASTIDA,15,138,5,158,1840
PUEBLA,SAN MARTIN TEXMELUCAN DE LABASTIDA,8,180,0,188,1840
PUEBLA,SAN MARTIN TEXMELUCAN DE LABASTIDA,4,248,4,256,2019
PUEBLA,SAN MARTIN TEXMELUCAN DE LABASTIDA,10,125,4,139,1052
PUEBLA,SAN MARTIN TEXMELUCAN DE LABASTIDA,4,112,1,117,1052
PUEBLA,SAN MARTIN TEXMELUCAN DE LABASTIDA,17,247,3,267,1567
PUEBLA,SAN MARTIN TEXMELUCAN DE LABASTIDA,7,256,6,269,1567
PUEBLA,SAN MARTIN TEXMELUCAN DE LABASTIDA,19,265,3,287,1566
PUEBLA,SAN MARTIN TEXMELUCAN DE LABASTIDA,19,220,7,246,1627
PUEBLA,SAN MARTIN TEXMELUCAN DE LABASTIDA,16,203,2,221,1627
PUEBLA,SAN MARTIN TEXMELUCAN DE LABASTIDA,15,196,2,213,1540
PUEBLA,SAN MARTIN TEXMELUCAN DE LABASTIDA,16,209,2,227,1540
PUEBLA,SAN MARTIN TEXMELUCAN DE LABASTIDA,19,298,7,324,1701
PUEBLA,SAN MARTIN TEXMELUCAN DE LABASTIDA,10,272,3,285,1700
PUEBLA,SAN MARTIN TEXMELUCAN DE LABASTIDA,18,310,5,333,1858
PUEBLA,SAN MARTIN TEXMELUCAN DE LABASTIDA,27,322,4,353,1857
PUEBLA,SAN MARTIN TEXMELUCAN DE LABASTIDA,20,362,6,388,1927
PUEBLA,SAN MARTIN TEXMELUCAN DE LABASTIDA,18,314,12,344,1926
PUEBLA,SAN MARTIN TEXMELUCAN DE LABASTIDA,13,236,2,251,1365
PUEBLA,SAN MARTIN TEXMELUCAN DE LABASTIDA,5,211,1,217,1365
PUEBLA,SAN MARTIN TEXMELUCAN DE LABASTIDA,17,237,2,256,1364
PUEBLA,SAN MARTIN TEXMELUCAN DE LABASTIDA,54,703,9,766,0
PUEBLA,SAN MARTIN TEXMELUCAN DE LABASTIDA,13,204,3,220,1444
PUEBLA,SAN MARTIN TEXMELUCAN DE LABASTIDA,18,263,2,283,1444
PUEBLA,SAN MARTIN TEXMELUCAN DE LABASTIDA,18,254,5,277,1796
PUEBLA,SAN MARTIN TEXMELUCAN DE LABASTIDA,14,298,3,315,1795
PUEBLA,SAN MARTIN TEXMELUCAN DE LABASTIDA,19,255,3,277,1561
PUEBLA,SAN MARTIN TEXMELUCAN DE LABASTIDA,18,252,0,270,1560
PUEBLA,SAN MARTIN TEXMELUCAN DE LABASTIDA,11,239,6,256,1323
PUEBLA,SAN MARTIN TEXMELUCAN DE LABASTIDA,2,237,3,242,1322
PUEBLA,SAN MARTIN TEXMELUCAN DE LABASTIDA,9,195,3,207,1167
PUEBLA,SAN MARTIN TEXMELUCAN DE LABASTIDA,5,193,5,203,1166
PUEBLA,SAN MARTIN TEXMELUCAN DE LABASTIDA,12,329,7,348,1714
PUEBLA,SAN MARTIN TEXMELUCAN DE LABASTIDA,12,275,5,292,1714
PUEBLA,SAN MARTIN TEXMELUCAN DE LABASTIDA,18,292,4,314,1595
PUEBLA,SAN MARTIN TEXMELUCAN DE LABASTIDA,13,247,8,268,1595
PUEBLA,SAN MARTIN TEXMELUCAN DE LABASTIDA,13,212,5,230,1863
PUEBLA,SAN MARTIN TEXMELUCAN DE LABASTIDA,17,217,0,234,1863
PUEBLA,SAN MARTIN TEXMELUCAN DE LABASTIDA,13,246,4,263,1863
PUEBLA,SAN MARTIN TEXMELUCAN DE LABASTIDA,10,242,3,255,2097
PUEBLA,SAN MARTIN TEXMELUCAN DE LABASTIDA,22,263,4,289,2097
PUEBLA,SAN MARTIN TEXMELUCAN DE LABASTIDA,9,194,3,206,1086
PUEBLA,SAN MARTIN TEXMELUCAN DE LABASTIDA,11,158,1,170,1086
PUEBLA,SAN MARTIN TEXMELUCAN DE LABASTIDA,15,268,7,290,1563
PUEBLA,SAN MARTIN TEXMELUCAN DE LABASTIDA,11,257,2,270,1562
PUEBLA,SAN MARTIN TEXMELUCAN DE LABASTIDA,23,223,2,248,1602
PUEBLA,SAN MARTIN TEXMELUCAN DE LABASTIDA,16,264,8,288,1601
PUEBLA,SAN MARTIN TEXMELUCAN DE LABASTIDA,13,228,1,242,1445
PUEBLA,SAN MARTIN TEXMELUCAN DE LABASTIDA,10,204,5,219,1445
PUEBLA,SAN MARTIN TEXMELUCAN DE LABASTIDA,21,275,8,304,1752
PUEBLA,SAN MARTIN TEXMELUCAN DE LABASTIDA,16,309,4,329,1751
PUEBLA,SAN MARTIN TEXMELUCAN DE LABASTIDA,15,274,3,292,1751
PUEBLA,SAN MARTIN TEXMELUCAN DE LABASTIDA,15,317,2,334,1656
PUEBLA,SAN MARTIN TEXMELUCAN DE LABASTIDA,10,277,3,290,1656
PUEBLA,SAN MARTIN TEXMELUCAN DE LABASTIDA,11,230,3,244,1776
PUEBLA,SAN MARTIN TEXMELUCAN DE LABASTIDA,11,227,1,239,1776
PUEBLA,SAN MARTIN TEXMELUCAN DE LABASTIDA,6,190,2,198,1108
PUEBLA,SAN MARTIN TEXMELUCAN DE LABASTIDA,9,169,5,183,1107
PUEBLA,SAN MARTIN TEXMELUCAN DE LABASTIDA,28,358,6,392,2069
PUEBLA,SAN MARTIN TEXMELUCAN DE LABASTIDA,14,304,8,326,2068
PUEBLA,SAN MARTIN TEXMELUCAN DE LABASTIDA,11,163,2,176,1384
PUEBLA,SAN MARTIN TEXMELUCAN DE LABASTIDA,6,178,0,184,1383
PUEBLA,SAN MARTIN TEXMELUCAN DE LABASTIDA,15,167,4,186,1339
PUEBLA,SAN MARTIN TEXMELUCAN DE LABASTIDA,14,189,3,206,1339
PUEBLA,SAN MARTIN TEXMELUCAN DE LABASTIDA,10,196,4,210,1614
PUEBLA,SAN MARTIN TEXMELUCAN DE LABASTIDA,14,222,1,237,1614
PUEBLA,SAN MARTIN TEXMELUCAN DE LABASTIDA,9,259,1,269,1694
PUEBLA,SAN MARTIN TEXMELUCAN DE LABASTIDA,11,268,3,282,1694
PUEBLA,SAN MARTIN TEXMELUCAN DE LABASTIDA,16,246,5,267,1690
PUEBLA,SAN MARTIN TEXMELUCAN DE LABASTIDA,16,219,5,240,1690
PUEBLA,SAN MARTIN TEXMELUCAN DE LABASTIDA,14,213,2,229,1680
PUEBLA,SAN MARTIN TEXMELUCAN DE LABASTIDA,11,192,2,205,1680
PUEBLA,SAN MARTIN TEXMELUCAN DE LABASTIDA,2,178,8,188,1680
PUEBLA,SAN MARTIN TEXMELUCAN DE LABASTIDA,5,155,2,162,1361
PUEBLA,SAN MARTIN TEXMELUCAN DE LABASTIDA,10,128,2,140,1361
PUEBLA,SAN MARTIN TEXMELUCAN DE LABASTIDA,6,144,2,152,1360
PUEBLA,SAN MARTIN TEXMELUCAN DE LABASTIDA,7,251,4,262,1368
PUEBLA,SAN MARTIN TEXMELUCAN DE LABASTIDA,15,241,4,260,1368
PUEBLA,SAN MARTIN TEXMELUCAN DE LABASTIDA,3,234,3,240,1367
PUEBLA,SAN MARTIN TEXMELUCAN DE LABASTIDA,12,261,1,274,2040
PUEBLA,SAN MARTIN TEXMELUCAN DE LABASTIDA,15,190,6,211,2040
PUEBLA,SAN MARTIN TEXMELUCAN DE LABASTIDA,7,144,1,152,1456
PUEBLA,SAN MARTIN TEXMELUCAN DE LABASTIDA,7,170,3,180,1456
PUEBLA,SAN MARTIN TEXMELUCAN DE LABASTIDA,18,222,5,245,1733
PUEBLA,SAN MARTIN TEXMELUCAN DE LABASTIDA,12,241,6,259,1733
PUEBLA,SAN MARTIN TEXMELUCAN DE LABASTIDA,15,274,3,292,1420
PUEBLA,SAN MARTIN TEXMELUCAN DE LABASTIDA,11,208,10,229,1420
PUEBLA,SAN MARTIN TEXMELUCAN DE LABASTIDA,7,238,5,250,1419
PUEBLA,SAN MARTIN TEXMELUCAN DE LABASTIDA,14,373,2,389,1952
PUEBLA,SAN MARTIN TEXMELUCAN DE LABASTIDA,16,415,4,435,1952
PUEBLA,SAN MARTIN TEXMELUCAN DE LABASTIDA,15,205,3,223,1183
PUEBLA,SAN MARTIN TEXMELUCAN DE LABASTIDA,17,213,2,232,1182
PUEBLA,SAN MARTIN TEXMELUCAN DE LABASTIDA,12,270,3,285,1462
PUEBLA,SAN MARTIN TEXMELUCAN DE LABASTIDA,15,285,8,308,1462
PUEBLA,SAN MARTIN TEXMELUCAN DE LABASTIDA,16,397,6,419,1796
PUEBLA,SAN MARTIN TEXMELUCAN DE LABASTIDA,14,427,5,446,1795
PUEBLA,SAN MARTIN TEXMELUCAN DE LABASTIDA,23,339,21,383,1780
PUEBLA,SAN MARTIN TEXMELUCAN DE LABASTIDA,11,310,9,330,1779
PUEBLA,SAN MARTIN TEXMELUCAN DE LABASTIDA,14,236,7,257,1450
PUEBLA,SAN MARTIN TEXMELUCAN DE LABASTIDA,15,237,3,255,1450
PUEBLA,SAN MARTIN TEXMELUCAN DE LABASTIDA,17,243,1,261,1837
PUEBLA,SAN MARTIN TEXMELUCAN DE LABASTIDA,19,238,11,268,1837
PUEBLA,SAN MARTIN TEXMELUCAN DE LABASTIDA,12,302,8,322,1840
PUEBLA,SAN MARTIN TEXMELUCAN DE LABASTIDA,16,283,2,301,1839
PUEBLA,SAN MARTIN TEXMELUCAN DE LABASTIDA,6,203,6,215,1590
PUEBLA,SAN MARTIN TEXMELUCAN DE LABASTIDA,9,170,1,180,1590
PUEBLA,SAN MARTIN TEXMELUCAN DE LABASTIDA,9,244,2,255,2028
PUEBLA,SAN MARTIN TEXMELUCAN DE LABASTIDA,8,199,2,209,2028
PUEBLA,SAN MARTIN TEXMELUCAN DE LABASTIDA,11,206,1,218,1327
PUEBLA,SAN MARTIN TEXMELUCAN DE LABASTIDA,11,181,1,193,1326
PUEBLA,SAN MARTIN TEXMELUCAN DE LABASTIDA,22,268,7,297,1927
PUEBLA,SAN MARTIN TEXMELUCAN DE LABASTIDA,19,305,6,330,1926
PUEBLA,SAN MARTIN TEXMELUCAN DE LABASTIDA,5,162,4,171,1425
PUEBLA,SAN MARTIN TEXMELUCAN DE LABASTIDA,7,192,4,203,1424
PUEBLA,SAN MARTIN TEXMELUCAN DE LABASTIDA,7,179,7,193,1424
PUEBLA,SAN MARTIN TEXMELUCAN DE LABASTIDA,12,233,9,254,1814
PUEBLA,SAN MARTIN TEXMELUCAN DE LABASTIDA,14,230,5,249,1814
PUEBLA,SAN MARTIN TEXMELUCAN DE LABASTIDA,6,247,4,257,1299
PUEBLA,SAN MARTIN TEXMELUCAN DE LABASTIDA,9,259,4,272,1299
PUEBLA,SAN MARTIN TEXMELUCAN DE LABASTIDA,52,420,11,483,1999
PUEBLA,SAN MARTIN TEXMELUCAN DE LABASTIDA,23,262,5,290,1543
PUEBLA,SAN MARTIN TEXMELUCAN DE LABASTIDA,19,254,6,279,1542
PUEBLA,SAN MARTIN TEXMELUCAN DE LABASTIDA,8,226,0,234,1309
PUEBLA,SAN MARTIN TEXMELUCAN DE LABASTIDA,9,201,6,216,1308
PUEBLA,SAN MARTIN TEXMELUCAN DE LABASTIDA,10,441,6,457,1799
PUEBLA,SAN MARTIN TEXMELUCAN DE LABASTIDA,10,389,4,403,1799
PUEBLA,SAN MARTIN TEXMELUCAN DE LABASTIDA,17,194,8,219,1418
PUEBLA,SAN MARTIN TEXMELUCAN DE LABASTIDA,19,244,4,267,1417
PUEBLA,SAN MARTIN TEXMELUCAN DE LABASTIDA,15,121,4,140,1404
PUEBLA,SAN MARTIN TEXMELUCAN DE LABASTIDA,16,152,3,171,1403
PUEBLA,SAN MARTIN TEXMELUCAN DE LABASTIDA,5,234,6,245,1753
PUEBLA,SAN MARTIN TEXMELUCAN DE LABASTIDA,10,221,3,234,1753
PUEBLA,SAN MARTIN TEXMELUCAN DE LABASTIDA,12,341,5,358,1765
PUEBLA,SAN MARTIN TEXMELUCAN DE LABASTIDA,14,169,1,184,1623
PUEBLA,SAN MARTIN TEXMELUCAN DE LABASTIDA,8,176,5,189,1622
PUEBLA,HEROICA PUEBLA DE ZARAGOZA,36,343,1,380,1621
PUEBLA,HEROICA PUEBLA DE ZARAGOZA,31,352,4,387,1620
PUEBLA,HEROICA PUEBLA DE ZARAGOZA,26,337,6,369,1620
PUEBLA,HEROICA PUEBLA DE ZARAGOZA,27,271,3,301,1877
PUEBLA,HEROICA PUEBLA DE ZARAGOZA,29,262,4,295,1876
PUEBLA,HEROICA PUEBLA DE ZARAGOZA,20,221,6,247,1581
PUEBLA,HEROICA PUEBLA DE ZARAGOZA,17,195,1,213,1581
PUEBLA,HEROICA PUEBLA DE ZARAGOZA,16,332,1,349,1853
PUEBLA,HEROICA PUEBLA DE ZARAGOZA,21,287,3,311,1852
PUEBLA,HEROICA PUEBLA DE ZARAGOZA,13,221,4,238,1177
PUEBLA,HEROICA PUEBLA DE ZARAGOZA,12,255,1,268,1176
PUEBLA,HEROICA PUEBLA DE ZARAGOZA,19,184,6,209,1045
PUEBLA,HEROICA PUEBLA DE ZARAGOZA,14,210,5,229,1045
PUEBLA,HEROICA PUEBLA DE ZARAGOZA,19,291,2,312,1728
PUEBLA,HEROICA PUEBLA DE ZARAGOZA,24,318,8,350,1728
PUEBLA,HEROICA PUEBLA DE ZARAGOZA,21,270,4,295,1797
PUEBLA,HEROICA PUEBLA DE ZARAGOZA,23,279,1,303,1797
PUEBLA,HEROICA PUEBLA DE ZARAGOZA,65,913,5,983,0
PUEBLA,HEROICA PUEBLA DE ZARAGOZA,25,234,3,262,1568
PUEBLA,HEROICA PUEBLA DE ZARAGOZA,10,238,3,251,1567
PUEBLA,HEROICA PUEBLA DE ZARAGOZA,22,312,0,334,1876
PUEBLA,HEROICA PUEBLA DE ZARAGOZA,19,286,2,307,1876
PUEBLA,HEROICA PUEBLA DE ZARAGOZA,17,293,1,311,1874
PUEBLA,HEROICA PUEBLA DE ZARAGOZA,14,333,1,348,1874
PUEBLA,HEROICA PUEBLA DE ZARAGOZA,13,234,6,253,1504
PUEBLA,HEROICA PUEBLA DE ZARAGOZA,13,222,3,238,1504
PUEBLA,HEROICA PUEBLA DE ZARAGOZA,23,224,3,250,1536
PUEBLA,HEROICA PUEBLA DE ZARAGOZA,25,280,1,306,1536
PUEBLA,HEROICA PUEBLA DE ZARAGOZA,19,227,2,248,1600
PUEBLA,HEROICA PUEBLA DE ZARAGOZA,21,222,3,246,1600
PUEBLA,HEROICA PUEBLA DE ZARAGOZA,17,208,0,225,1475
PUEBLA,HEROICA PUEBLA DE ZARAGOZA,19,233,0,252,1475
PUEBLA,HEROICA PUEBLA DE ZARAGOZA,10,260,2,272,1632
PUEBLA,HEROICA PUEBLA DE ZARAGOZA,13,238,4,255,1631
PUEBLA,HEROICA PUEBLA DE ZARAGOZA,12,241,2,255,1631
PUEBLA,HEROICA PUEBLA DE ZARAGOZA,21,259,2,282,1959
PUEBLA,HEROICA PUEBLA DE ZARAGOZA,17,273,1,291,1959
PUEBLA,HEROICA PUEBLA DE ZARAGOZA,29,252,3,284,1720
PUEBLA,HEROICA PUEBLA DE ZARAGOZA,32,270,2,304,1720
PUEBLA,HEROICA PUEBLA DE ZARAGOZA,36,259,4,299,1720
PUEBLA,HEROICA PUEBLA DE ZARAGOZA,18,234,4,256,1392
PUEBLA,HEROICA PUEBLA DE ZARAGOZA,16,257,5,278,1392
PUEBLA,HEROICA PUEBLA DE ZARAGOZA,13,246,3,262,1790
PUEBLA,HEROICA PUEBLA DE ZARAGOZA,31,232,0,263,1790
PUEBLA,HEROICA PUEBLA DE ZARAGOZA,16,219,2,237,1384
PUEBLA,HEROICA PUEBLA DE ZARAGOZA,11,265,0,276,1383
PUEBLA,HEROICA PUEBLA DE ZARAGOZA,20,265,0,285,1383
PUEBLA,HEROICA PUEBLA DE ZARAGOZA,24,249,3,276,1747
PUEBLA,HEROICA PUEBLA DE ZARAGOZA,26,275,7,308,1747
PUEBLA,HEROICA PUEBLA DE ZARAGOZA,10,235,4,249,1337
PUEBLA,HEROICA PUEBLA DE ZARAGOZA,20,225,1,246,1337
PUEBLA,HEROICA PUEBLA DE ZARAGOZA,15,183,0,198,1337
PUEBLA,HEROICA PUEBLA DE ZARAGOZA,12,247,1,260,1615
PUEBLA,HEROICA PUEBLA DE ZARAGOZA,15,274,0,289,1615
PUEBLA,HEROICA PUEBLA DE ZARAGOZA,14,239,2,255,1614
PUEBLA,HEROICA PUEBLA DE ZARAGOZA,8,231,7,246,1614
PUEBLA,HEROICA PUEBLA DE ZARAGOZA,21,225,3,249,1840
PUEBLA,HEROICA PUEBLA DE ZARAGOZA,19,239,6,264,1840
PUEBLA,HEROICA PUEBLA DE ZARAGOZA,14,221,3,238,1840
PUEBLA,HEROICA PUEBLA DE ZARAGOZA,14,237,3,254,1481
PUEBLA,HEROICA PUEBLA DE ZARAGOZA,23,244,0,267,1480
PUEBLA,HEROICA PUEBLA DE ZARAGOZA,26,245,0,271,1480
PUEBLA,HEROICA PUEBLA DE ZARAGOZA,19,226,1,246,1543
PUEBLA,HEROICA PUEBLA DE ZARAGOZA,19,279,0,298,1542
PUEBLA,HEROICA PUEBLA DE ZARAGOZA,32,321,2,355,1939
PUEBLA,HEROICA PUEBLA DE ZARAGOZA,24,315,6,345,1938
PUEBLA,HEROICA PUEBLA DE ZARAGOZA,26,326,4,356,1931
PUEBLA,HEROICA PUEBLA DE ZARAGOZA,30,292,1,323,1931
PUEBLA,HEROICA PUEBLA DE ZARAGOZA,26,289,0,315,1931
PUEBLA,HEROICA PUEBLA DE ZARAGOZA,25,270,1,296,1931
PUEBLA,HEROICA PUEBLA DE ZARAGOZA,30,316,6,352,1931
PUEBLA,HEROICA PUEBLA DE ZARAGOZA,17,188,6,211,1485
PUEBLA,HEROICA PUEBLA DE ZARAGOZA,8,192,0,200,1485
PUEBLA,HEROICA PUEBLA DE ZARAGOZA,18,200,0,218,1484
PUEBLA,HEROICA PUEBLA DE ZARAGOZA,15,138,1,154,1477
PUEBLA,HEROICA PUEBLA DE ZARAGOZA,22,168,0,190,1476
PUEBLA,HEROICA PUEBLA DE ZARAGOZA,15,160,1,176,1786
PUEBLA,HEROICA PUEBLA DE ZARAGOZA,8,101,3,112,1786
PUEBLA,HEROICA PUEBLA DE ZARAGOZA,31,160,2,193,1786
PUEBLA,HEROICA PUEBLA DE ZARAGOZA,10,173,7,190,1759
PUEBLA,HEROICA PUEBLA DE ZARAGOZA,10,161,0,171,1759
PUEBLA,HEROICA PUEBLA DE ZARAGOZA,8,147,2,157,1759
PUEBLA,HEROICA PUEBLA DE ZARAGOZA,10,142,5,157,1759
PUEBLA,HEROICA PUEBLA DE ZARAGOZA,9,171,7,187,1758
PUEBLA,HEROICA PUEBLA DE ZARAGOZA,10,191,5,206,1758
PUEBLA,HEROICA PUEBLA DE ZARAGOZA,7,151,6,164,1758
PUEBLA,HEROICA PUEBLA DE ZARAGOZA,13,191,6,210,1758
PUEBLA,HEROICA PUEBLA DE ZARAGOZA,6,148,5,159,1221
PUEBLA,HEROICA PUEBLA DE ZARAGOZA,12,155,2,169,1220
PUEBLA,HEROICA PUEBLA DE ZARAGOZA,9,218,12,239,1839
PUEBLA,HEROICA PUEBLA DE ZARAGOZA,6,221,5,232,1839
PUEBLA,HEROICA PUEBLA DE ZARAGOZA,21,236,6,263,1839
PUEBLA,HEROICA PUEBLA DE ZARAGOZA,9,227,5,241,1838
PUEBLA,HEROICA PUEBLA DE ZARAGOZA,14,210,0,224,1838
PUEBLA,HEROICA PUEBLA DE ZARAGOZA,14,228,0,242,1838
PUEBLA,HEROICA PUEBLA DE ZARAGOZA,11,186,8,205,1462
PUEBLA,HEROICA PUEBLA DE ZARAGOZA,6,147,4,157,1461
PUEBLA,HEROICA PUEBLA DE ZARAGOZA,17,225,2,244,1824
PUEBLA,HEROICA PUEBLA DE ZARAGOZA,14,210,0,224,1824
PUEBLA,HEROICA PUEBLA DE ZARAGOZA,12,206,2,220,1824
PUEBLA,HEROICA PUEBLA DE ZARAGOZA,13,218,1,232,1824
PUEBLA,HEROICA PUEBLA DE ZARAGOZA,21,230,2,253,1824
PUEBLA,HEROICA PUEBLA DE ZARAGOZA,11,185,2,198,1823
PUEBLA,HEROICA PUEBLA DE ZARAGOZA,16,213,0,229,1823
PUEBLA,HEROICA PUEBLA DE ZARAGOZA,9,189,4,202,1951
PUEBLA,HEROICA PUEBLA DE ZARAGOZA,5,195,1,201,1951
PUEBLA,HEROICA PUEBLA DE ZARAGOZA,4,180,2,186,1951
PUEBLA,HEROICA PUEBLA DE ZARAGOZA,9,170,4,183,1951
PUEBLA,HEROICA PUEBLA DE ZARAGOZA,22,211,5,238,1967
PUEBLA,HEROICA PUEBLA DE ZARAGOZA,24,246,1,271,1966
PUEBLA,HEROICA PUEBLA DE ZARAGOZA,11,222,0,233,1966
PUEBLA,HEROICA PUEBLA DE ZARAGOZA,17,221,5,243,1966
PUEBLA,HEROICA PUEBLA DE ZARAGOZA,2,166,6,174,1749
PUEBLA,HEROICA PUEBLA DE ZARAGOZA,9,184,6,199,1749
PUEBLA,HEROICA PUEBLA DE ZARAGOZA,8,206,19,233,1511
PUEBLA,HEROICA PUEBLA DE ZARAGOZA,10,170,23,203,1510
PUEBLA,HEROICA PUEBLA DE ZARAGOZA,11,181,8,200,1692
PUEBLA,HEROICA PUEBLA DE ZARAGOZA,9,180,11,200,1691
PUEBLA,HEROICA PUEBLA DE ZARAGOZA,13,365,4,382,1972
PUEBLA,HEROICA PUEBLA DE ZARAGOZA,12,296,3,311,1972
PUEBLA,HEROICA PUEBLA DE ZARAGOZA,23,240,2,265,1740
PUEBLA,HEROICA PUEBLA DE ZARAGOZA,33,228,4,265,1740
PUEBLA,HEROICA PUEBLA DE ZARAGOZA,31,336,5,372,1748
PUEBLA,HEROICA PUEBLA DE ZARAGOZA,26,338,2,366,1748
PUEBLA,HEROICA PUEBLA DE ZARAGOZA,24,266,7,297,1078
PUEBLA,HEROICA PUEBLA DE ZARAGOZA,19,217,3,239,1077
PUEBLA,HEROICA PUEBLA DE ZARAGOZA,18,253,2,273,1597
PUEBLA,HEROICA PUEBLA DE ZARAGOZA,13,254,4,271,1596
PUEBLA,HEROICA PUEBLA DE ZARAGOZA,26,267,0,293,1646
PUEBLA,HEROICA PUEBLA DE ZARAGOZA,26,276,2,304,1646
PUEBLA,HEROICA PUEBLA DE ZARAGOZA,23,299,2,324,1850
PUEBLA,HEROICA PUEBLA DE ZARAGOZA,31,294,6,331,1849
PUEBLA,HEROICA PUEBLA DE ZARAGOZA,26,247,6,279,1478
PUEBLA,HEROICA PUEBLA DE ZARAGOZA,39,261,3,303,1478
PUEBLA,HEROICA PUEBLA DE ZARAGOZA,12,250,2,264,1396
PUEBLA,HEROICA PUEBLA DE ZARAGOZA,12,296,3,311,1396
PUEBLA,HEROICA PUEBLA DE ZARAGOZA,26,260,6,292,1395
PUEBLA,HEROICA PUEBLA DE ZARAGOZA,29,379,5,413,1912
PUEBLA,HEROICA PUEBLA DE ZARAGOZA,23,350,3,376,1911
PUEBLA,HEROICA PUEBLA DE ZARAGOZA,25,248,1,274,1656
PUEBLA,HEROICA PUEBLA DE ZARAGOZA,22,236,2,260,1655
PUEBLA,HEROICA PUEBLA DE ZARAGOZA,19,232,1,252,1655
PUEBLA,HEROICA PUEBLA DE ZARAGOZA,15,201,4,220,1405
PUEBLA,HEROICA PUEBLA DE ZARAGOZA,11,213,2,226,1405
PUEBLA,HEROICA PUEBLA DE ZARAGOZA,16,214,0,230,1405
PUEBLA,HEROICA PUEBLA DE ZARAGOZA,10,248,5,263,1350
PUEBLA,HEROICA PUEBLA DE ZARAGOZA,12,296,7,315,1349
PUEBLA,HEROICA PUEBLA DE ZARAGOZA,20,193,4,217,1380
PUEBLA,HEROICA PUEBLA DE ZARAGOZA,20,174,1,195,1379
PUEBLA,HEROICA PUEBLA DE ZARAGOZA,26,284,1,311,1931
PUEBLA,HEROICA PUEBLA DE ZARAGOZA,28,274,3,305,1931
PUEBLA,HEROICA PUEBLA DE ZARAGOZA,20,271,3,294,1931
PUEBLA,HEROICA PUEBLA DE ZARAGOZA,30,259,0,289,1930
PUEBLA,HEROICA PUEBLA DE ZARAGOZA,15,274,0,289,1930
PUEBLA,HEROICA PUEBLA DE ZARAGOZA,17,265,3,285,1930
PUEBLA,HEROICA PUEBLA DE ZARAGOZA,18,300,3,321,1930
PUEBLA,HEROICA PUEBLA DE ZARAGOZA,29,298,2,329,1930
PUEBLA,HEROICA PUEBLA DE ZARAGOZA,15,232,0,247,1927
PUEBLA,HEROICA PUEBLA DE ZARAGOZA,19,233,1,253,1927
PUEBLA,HEROICA PUEBLA DE ZARAGOZA,11,211,4,226,1927
PUEBLA,HEROICA PUEBLA DE ZARAGOZA,15,231,4,250,1927
PUEBLA,HEROICA PUEBLA DE ZARAGOZA,19,246,2,267,1927
PUEBLA,HEROICA PUEBLA DE ZARAGOZA,18,224,0,242,1927
PUEBLA,HEROICA PUEBLA DE ZARAGOZA,18,222,5,245,1374
PUEBLA,HEROICA PUEBLA DE ZARAGOZA,23,197,4,224,1374
PUEBLA,HEROICA PUEBLA DE ZARAGOZA,15,209,1,225,1373
PUEBLA,HEROICA PUEBLA DE ZARAGOZA,22,219,3,244,1900
PUEBLA,HEROICA PUEBLA DE ZARAGOZA,20,248,7,275,1900
PUEBLA,HEROICA PUEBLA DE ZARAGOZA,15,225,4,244,1900
PUEBLA,HEROICA PUEBLA DE ZARAGOZA,16,231,9,256,1900
PUEBLA,HEROICA PUEBLA DE ZARAGOZA,15,262,1,278,1766
PUEBLA,HEROICA PUEBLA DE ZARAGOZA,7,241,1,249,1766
PUEBLA,HEROICA PUEBLA DE ZARAGOZA,15,206,2,223,1766
PUEBLA,HEROICA PUEBLA DE ZARAGOZA,19,221,4,244,1766
PUEBLA,HEROICA PUEBLA DE ZARAGOZA,15,214,2,231,1766
PUEBLA,HEROICA PUEBLA DE ZARAGOZA,15,212,0,227,1766
PUEBLA,HEROICA PUEBLA DE ZARAGOZA,196,13,0,209,1766
PUEBLA,HEROICA PUEBLA DE ZARAGOZA,15,197,3,215,1766
PUEBLA,HEROICA PUEBLA DE ZARAGOZA,12,211,3,226,1766
PUEBLA,HEROICA PUEBLA DE ZARAGOZA,23,190,0,213,1686
PUEBLA,HEROICA PUEBLA DE ZARAGOZA,17,202,0,219,1685
PUEBLA,HEROICA PUEBLA DE ZARAGOZA,11,179,2,192,1550
PUEBLA,HEROICA PUEBLA DE ZARAGOZA,14,187,1,202,1550
PUEBLA,HEROICA PUEBLA DE ZARAGOZA,19,157,1,177,1636
PUEBLA,HEROICA PUEBLA DE ZARAGOZA,23,226,0,249,1636
PUEBLA,HEROICA PUEBLA DE ZARAGOZA,7,201,0,208,1868
PUEBLA,HEROICA PUEBLA DE ZARAGOZA,5,280,4,289,1868
PUEBLA,HEROICA PUEBLA DE ZARAGOZA,3,90,0,93,1017
PUEBLA,HEROICA PUEBLA DE ZARAGOZA,2,103,1,106,1016
PUEBLA,TEPEACA,11,202,5,218,1409
PUEBLA,TEPEACA,18,200,2,220,1409
PUEBLA,TEPEACA,16,231,2,249,1408
PUEBLA,TEPEACA,14,215,6,235,1290
PUEBLA,TEPEACA,6,239,2,247,1290
PUEBLA,TEPEACA,16,301,2,319,1861
PUEBLA,TEPEACA,10,304,1,315,1861
PUEBLA,TEPEACA,16,243,6,265,1460
PUEBLA,TEPEACA,12,207,2,221,1459
PUEBLA,TEPEACA,7,190,1,198,1310
PUEBLA,TEPEACA,7,181,3,191,1309
PUEBLA,TEPEACA,16,185,6,207,1460
PUEBLA,TEPEACA,18,151,7,176,1460
PUEBLA,TEPEACA,28,194,6,228,1618
PUEBLA,TEPEACA,30,174,14,218,1618
PUEBLA,TEPEACA,24,148,14,186,1298
PUEBLA,TEPEACA,22,115,8,145,1298
PUEBLA,TEPEACA,10,218,4,232,1263
PUEBLA,TEPEACA,10,228,2,240,1262
PUEBLA,TEPEACA,21,266,1,288,1979
PUEBLA,TEPEACA,20,231,7,258,1978
PUEBLA,TEPEACA,14,301,1,316,1805
PUEBLA,TEPEACA,8,253,2,263,1805
PUEBLA,TEPEACA,7,268,2,277,1783
PUEBLA,TEPEACA,10,293,4,307,1783
PUEBLA,TEPEACA,4,211,2,217,1315
PUEBLA,TEPEACA,5,227,2,234,1315
PUEBLA,TEPEACA,9,183,2,194,1165
PUEBLA,TEPEACA,12,146,6,164,1165
PUEBLA,TEPEACA,10,233,5,248,1685
PUEBLA,TEPEACA,7,233,2,242,1685
PUEBLA,TEPEACA,9,188,6,203,1706
PUEBLA,TEPEACA,9,224,4,237,1706
PUEBLA,TEPEACA,6,201,3,210,1706
PUEBLA,TEPEACA,9,219,5,233,1445
PUEBLA,TEPEACA,11,222,1,234,1444
PUEBLA,TEPEACA,18,227,1,246,1444
PUEBLA,TEPEACA,11,150,3,164,1576
PUEBLA,TEPEACA,4,203,8,215,1576
PUEBLA,TEPEACA,5,108,4,117,1410
PUEBLA,TEPEACA,6,159,5,170,1410
PUEBLA,TEPEACA,6,132,1,139,1409
PUEBLA,TEPEACA,19,271,8,298,1915
PUEBLA,TEPEACA,13,326,3,342,1914
PUEBLA,TEPEACA,17,310,8,335,1737
PUEBLA,TEPEACA,8,246,3,257,1736
PUEBLA,TEPEACA,5,213,2,220,1019
PUEBLA,TEPEACA,4,166,3,173,1019
PUEBLA,TEPEACA,0,247,9,256,1475
PUEBLA,TEPEACA,12,275,6,293,1474
PUEBLA,TEPEACA,22,366,13,401,1920
PUEBLA,TEPEACA,32,375,6,413,1919
PUEBLA,TEPEACA,10,81,7,98,1270
PUEBLA,TEPEACA,11,105,2,118,1269
PUEBLA,TEPEACA,16,69,4,89,1382
PUEBLA,TEPEACA,9,83,3,95,1382
PUEBLA,TEPEACA,34,202,6,242,1754
PUEBLA,TEPEACA,32,160,7,199,1753
PUEBLA,TEPEACA,28,212,9,249,1753
PUEBLA,TEPEACA,38,202,20,260,1705
PUEBLA,TEPEACA,9,202,6,217,1705
PUEBLA,TEPEACA,26,162,11,199,1705
PUEBLA,TEPEACA,13,198,2,213,1338
PUEBLA,TEPEACA,18,204,2,224,1337
PUEBLA,TEPEACA,15,194,3,212,1337
PUEBLA,TEPEACA,28,204,5,237,1793
PUEBLA,TEPEACA,25,261,3,289,1793
PUEBLA,TEPEACA,20,225,2,247,1874
PUEBLA,TEPEACA,21,200,8,229,1874
PUEBLA,TEPEACA,17,232,7,256,1873
PUEBLA,TEPEACA,20,318,5,343,1646
PUEBLA,TEPEACA,16,192,0,208,1646
PUEBLA,TEPEACA,18,207,1,226,1646
PUEBLA,TEPEACA,46,306,12,364,1881
PUEBLA,TEPEACA,32,298,14,344,1880
PUEBLA,TEPEACA,42,326,7,375,1880
PUEBLA,TEPEACA,26,271,3,300,1676
PUEBLA,TEPEACA,18,270,5,293,1676
PUEBLA,TEPEACA,26,298,6,330,1675
PUEBLA,TEPEACA,27,278,2,307,1675
PUEBLA,TEPEACA,7,280,2,289,1832
PUEBLA,TEPEACA,26,256,1,283,1831
PUEBLA,TEPEACA,27,217,2,246,1682
PUEBLA,TEPEACA,18,230,3,251,1682
PUEBLA,TEPEACA,24,252,1,277,1682
PUEBLA,TEPEACA,20,234,0,254,1681
PUEBLA,TEPEACA,13,238,2,253,1681
PUEBLA,TEPEACA,22,222,3,247,1667
PUEBLA,TEPEACA,15,200,2,217,1667
PUEBLA,TEPEACA,15,205,1,221,1666
PUEBLA,TEPEACA,14,185,2,201,1666
PUEBLA,TEPEACA,17,219,3,239,1666
PUEBLA,TEPEACA,15,227,4,246,1666
PUEBLA,TEPEACA,15,156,2,173,1189
PUEBLA,TEPEACA,14,169,2,185,1188
PUEBLA,TEPEACA,15,255,7,277,1816
PUEBLA,TEPEACA,22,225,7,254,1815
PUEBLA,TEPEACA,15,200,3,218,1594
PUEBLA,TEPEACA,6,163,2,171,1594
PUEBLA,TEPEACA,15,186,4,205,1594
PUEBLA,TEPEACA,18,158,1,177,1594
PUEBLA,TEPEACA,24,171,4,199,1593
PUEBLA,TEPEACA,6,169,3,178,1409
PUEBLA,TEPEACA,9,168,3,180,1408
PUEBLA,TEPEACA,10,238,1,249,1620
PUEBLA,TEPEACA,15,274,8,297,1619
PUEBLA,TEPEACA,13,297,4,314,1183
PUEBLA,TEPEACA,20,240,8,268,1183
PUEBLA,TEPEACA,26,323,6,355,1580
PUEBLA,TEPEACA,24,343,7,374,1580
PUEBLA,TEPEACA,26,426,19,471,1559
PUEBLA,TEPEACA,38,409,12,459,1559
PUEBLA,TEPEACA,12,300,5,317,1508
PUEBLA,TEPEACA,22,322,8,352,1507
PUEBLA,TEPEACA,15,263,13,291,1412
PUEBLA,TEPEACA,19,256,8,283,1412
PUEBLA,TEPEACA,19,284,16,319,1411
PUEBLA,TEPEACA,17,156,11,184,1824
PUEBLA,TEPEACA,13,207,9,229,1823
PUEBLA,TEPEACA,8,187,8,203,1075
PUEBLA,TEPEACA,4,199,2,205,1075
PUEBLA,TEPEACA,9,224,5,238,1485
PUEBLA,TEPEACA,16,212,4,232,1485
PUEBLA,TEPEACA,12,228,4,244,1029
PUEBLA,TEPEACA,13,176,1,190,1029
PUEBLA,TEPEACA,4,170,3,177,1164
PUEBLA,TEPEACA,12,156,4,172,1163
PUEBLA,TEPEACA,12,215,7,234,1446
PUEBLA,TEPEACA,3,230,0,233,1446
PUEBLA,TEPEACA,8,247,6,261,1622
PUEBLA,TEPEACA,13,248,8,269,1621
PUEBLA,TEPEACA,15,530,15,560,1601
PUEBLA,TEPEACA,18,527,19,564,1600
PUEBLA,TEPEACA,10,436,16,462,1333
PUEBLA,TEPEACA,20,462,15,497,1333
PUEBLA,TEPEACA,7,311,2,320,1825
PUEBLA,TEPEACA,8,305,3,316,1825
PUEBLA,TEPEACA,10,304,5,319,1824
PUEBLA,TEPEACA,11,232,4,247,1836
PUEBLA,TEPEACA,14,310,8,332,1836
PUEBLA,TEPEACA,20,319,6,345,2007
PUEBLA,TEPEACA,8,277,5,290,1950
PUEBLA,TEPEACA,9,310,2,321,1949
PUEBLA,TEPEACA,18,388,5,411,1815
PUEBLA,TEPEACA,15,325,15,355,1815
PUEBLA,TEPEACA,12,335,5,352,1772
PUEBLA,TEPEACA,10,351,5,366,1772
PUEBLA,TEPEACA,18,394,2,414,1885
PUEBLA,TEPEACA,16,383,3,402,1884
PUEBLA,TEPEACA,22,337,2,361,1781
PUEBLA,TEPEACA,25,331,6,362,1780
PUEBLA,TEPEACA,29,358,4,391,1594
PUEBLA,TEPEACA,38,340,5,383,1594
PUEBLA,TEPEACA,111,1236,40,1387,0
PUEBLA,TEPEACA,25,245,4,274,1319
PUEBLA,TEPEACA,19,257,9,285,1319
PUEBLA,TEPEACA,29,248,7,284,1343
PUEBLA,TEPEACA,21,241,3,265,1342
PUEBLA,TEPEACA,28,269,4,301,1028
PUEBLA,TEPEACA,20,261,5,286,1028
PUEBLA,TEPEACA,31,367,15,413,1931
PUEBLA,TEPEACA,23,352,10,385,1930
PUEBLA,TEPEACA,30,320,8,358,1663
PUEBLA,TEPEACA,53,501,18,572,1663
PUEBLA,TEPEACA,31,187,22,240,1821
PUEBLA,TEPEACA,28,205,11,244,1820
PUEBLA,TEPEACA,34,272,26,332,1551
PUEBLA,TEPEACA,36,328,21,385,1550
PUEBLA,TEPEACA,31,417,188,636,1904
PUEBLA,TEPEACA,26,648,15,689,1904
PUEBLA,TEPEACA,17,1091,9,1117,1649
PUEBLA,TEPEACA,19,1280,7,1306,1648
PUEBLA,TEPEACA,35,1231,15,1281,1667
PUEBLA,TEPEACA,35,756,463,1254,1666
PUEBLA,TEPEACA,14,256,7,277,1666
PUEBLA,TEPEACA,23,191,12,226,1812
PUEBLA,TEPEACA,37,1427,7,1471,1811
PUEBLA,TEPEACA,27,710,5,742,1500
PUEBLA,TEPEACA,22,713,22,757,1500
PUEBLA,TEPEACA,12,525,6,543,1336
PUEBLA,TEPEACA,18,447,3,468,1335
PUEBLA,TEPEACA,29,443,6,478,1855
PUEBLA,TEPEACA,29,549,7,585,1855
PUEBLA,TEPEACA,20,640,4,664,1461
PUEBLA,TEPEACA,1,669,3,673,1460
PUEBLA,TEPEACA,9,237,1,247,1364
PUEBLA,TEPEACA,4,308,2,314,1363
PUEBLA,TEPEACA,13,107,1,121,1078
PUEBLA,TEPEACA,8,91,2,101,1078
PUEBLA,TEPEACA,7,231,4,242,1389
PUEBLA,TEPEACA,10,227,1,238,1389
PUEBLA,TEPEACA,22,237,4,263,1859
PUEBLA,TEPEACA,20,238,10,268,1859
PUEBLA,TEPEACA,26,267,8,301,1858
PUEBLA,TEPEACA,15,271,4,290,1490
PUEBLA,TEPEACA,6,237,7,250,1489
PUEBLA,CIUDAD SERDAN,6,330,5,341,1943
PUEBLA,CIUDAD SERDAN,11,271,10,292,1942
PUEBLA,CIUDAD SERDAN,19,257,5,281,1583
PUEBLA,CIUDAD SERDAN,8,203,5,216,1583
PUEBLA,CIUDAD SERDAN,5,504,7,516,1389
PUEBLA,CIUDAD SERDAN,2,518,0,520,1389
PUEBLA,CIUDAD SERDAN,19,209,4,232,1006
PUEBLA,CIUDAD SERDAN,19,188,3,210,1005
PUEBLA,CIUDAD SERDAN,30,357,11,398,1775
PUEBLA,CIUDAD SERDAN,45,372,17,434,1775
PUEBLA,CIUDAD SERDAN,27,368,11,406,1606
PUEBLA,CIUDAD SERDAN,21,349,8,378,1606
PUEBLA,CIUDAD SERDAN,15,279,7,301,1590
PUEBLA,CIUDAD SERDAN,12,246,12,270,1589
PUEBLA,CIUDAD SERDAN,17,277,7,301,1589
PUEBLA,CIUDAD SERDAN,16,175,7,198,1464
PUEBLA,CIUDAD SERDAN,22,184,7,213,1464
PUEBLA,CIUDAD SERDAN,16,183,5,204,1333
PUEBLA,CIUDAD SERDAN,17,160,3,180,1333
PUEBLA,CIUDAD SERDAN,10,155,2,167,1332
PUEBLA,CIUDAD SERDAN,12,173,6,191,1465
PUEBLA,CIUDAD SERDAN,11,168,4,183,1465
PUEBLA,CIUDAD SERDAN,20,248,4,272,1945
PUEBLA,CIUDAD SERDAN,31,260,6,297,1944
PUEBLA,CIUDAD SERDAN,20,158,7,185,1925
PUEBLA,CIUDAD SERDAN,11,139,1,151,1924
PUEBLA,CIUDAD SERDAN,33,407,1,441,0
PUEBLA,CIUDAD SERDAN,16,159,6,181,1375
PUEBLA,CIUDAD SERDAN,8,147,1,156,1374
PUEBLA,CIUDAD SERDAN,12,148,1,161,1374
PUEBLA,CIUDAD SERDAN,25,221,3,249,1889
PUEBLA,CIUDAD SERDAN,18,222,4,244,1888
PUEBLA,CIUDAD SERDAN,6,104,2,112,1695
PUEBLA,CIUDAD SERDAN,11,113,6,130,1694
PUEBLA,CIUDAD SERDAN,15,168,15,198,1815
PUEBLA,CIUDAD SERDAN,10,174,7,191,1815
PUEBLA,CIUDAD SERDAN,8,156,9,173,1815
PUEBLA,CIUDAD SERDAN,12,206,2,220,1439
PUEBLA,CIUDAD SERDAN,11,172,7,190,1438
PUEBLA,CIUDAD SERDAN,28,159,8,195,1482
PUEBLA,CIUDAD SERDAN,18,125,10,153,1481
PUEBLA,CIUDAD SERDAN,19,137,9,165,1434
PUEBLA,CIUDAD SERDAN,17,130,8,155,1434
PUEBLA,CIUDAD SERDAN,13,126,8,147,1437
PUEBLA,CIUDAD SERDAN,17,139,8,164,1437
PUEBLA,CIUDAD SERDAN,38,83,12,133,1279
PUEBLA,CIUDAD SERDAN,28,68,13,109,1278
PUEBLA,CIUDAD SERDAN,20,263,13,296,1883
PUEBLA,CIUDAD SERDAN,9,212,9,230,1883
PUEBLA,CIUDAD SERDAN,12,194,7,213,1577
PUEBLA,CIUDAD SERDAN,3,200,6,209,1577
PUEBLA,CIUDAD SERDAN,21,67,6,94,1009
PUEBLA,CIUDAD SERDAN,9,55,9,73,1008
PUEBLA,CIUDAD SERDAN,47,299,16,362,1813
PUEBLA,CIUDAD SERDAN,48,310,15,373,1812
PUEBLA,CIUDAD SERDAN,27,420,6,453,1600
PUEBLA,CIUDAD SERDAN,20,352,7,379,1599
PUEBLA,CIUDAD SERDAN,10,291,11,312,1244
PUEBLA,CIUDAD SERDAN,15,296,9,320,1243
PUEBLA,CIUDAD SERDAN,8,254,7,269,1117
PUEBLA,CIUDAD SERDAN,11,274,7,292,1116
PUEBLA,CIUDAD SERDAN,19,451,10,480,1058
PUEBLA,CIUDAD SERDAN,7,418,3,428,1057
PUEBLA,CIUDAD SERDAN,41,351,12,404,1863
PUEBLA,CIUDAD SERDAN,41,328,6,375,1863
PUEBLA,CIUDAD SERDAN,23,327,6,356,1862
PUEBLA,CIUDAD SERDAN,56,375,20,451,1937
PUEBLA,CIUDAD SERDAN,31,407,12,450,1937
PUEBLA,CIUDAD SERDAN,21,326,6,353,1841
PUEBLA,CIUDAD SERDAN,22,292,6,320,1841
PUEBLA,CIUDAD SERDAN,8,136,7,151,1554
PUEBLA,CIUDAD SERDAN,16,171,4,191,1554
PUEBLA,CIUDAD SERDAN,10,94,12,116,1554
PUEBLA,CIUDAD SERDAN,12,133,10,155,1553
PUEBLA,CIUDAD SERDAN,33,387,9,429,1789
PUEBLA,CIUDAD SERDAN,20,383,13,416,1789
PUEBLA,CIUDAD SERDAN,37,363,8,408,1715
PUEBLA,CIUDAD SERDAN,21,448,7,476,1714
PUEBLA,CIUDAD SERDAN,25,285,3,313,1451
PUEBLA,CIUDAD SERDAN,22,267,5,294,1450
PUEBLA,CIUDAD SERDAN,15,276,14,305,1450
PUEBLA,CIUDAD SERDAN,27,543,15,585,1836
PUEBLA,CIUDAD SERDAN,32,506,11,549,1836
PUEBLA,CIUDAD SERDAN,19,281,14,314,1254
PUEBLA,CIUDAD SERDAN,19,307,11,337,1253
PUEBLA,CIUDAD SERDAN,23,433,14,470,1824
PUEBLA,CIUDAD SERDAN,21,528,10,559,1824
PUEBLA,CIUDAD SERDAN,30,491,0,521,1904
PUEBLA,CIUDAD SERDAN,22,1511,16,1549,1903
PUEBLA,CIUDAD SERDAN,36,260,14,310,1121
PUEBLA,CIUDAD SERDAN,20,264,19,303,1120
PUEBLA,CIUDAD SERDAN,23,212,2,237,1552
PUEBLA,CIUDAD SERDAN,11,229,4,244,1552
PUEBLA,CIUDAD SERDAN,14,183,8,205,1930
PUEBLA,CIUDAD SERDAN,21,279,9,309,1930
PUEBLA,CIUDAD SERDAN,15,152,8,175,1744
PUEBLA,CIUDAD SERDAN,12,104,5,121,1744
PUEBLA,CIUDAD SERDAN,47,105,6,158,1109
PUEBLA,CIUDAD SERDAN,34,89,4,127,1108
PUEBLA,CIUDAD SERDAN,20,119,7,146,1327
PUEBLA,CIUDAD SERDAN,7,74,10,91,1327
PUEBLA,CIUDAD SERDAN,19,106,3,128,1326
PUEBLA,CIUDAD SERDAN,12,230,3,245,1123
PUEBLA,CIUDAD SERDAN,5,229,2,236,1123
PUEBLA,CIUDAD SERDAN,12,229,7,248,1925
PUEBLA,CIUDAD SERDAN,20,213,14,247,1924
PUEBLA,CIUDAD SERDAN,10,213,8,231,1924
PUEBLA,CIUDAD SERDAN,14,328,8,350,1713
PUEBLA,CIUDAD SERDAN,13,277,7,297,1713
PUEBLA,CIUDAD SERDAN,11,349,10,370,1713
PUEBLA,CIUDAD SERDAN,9,236,2,247,1147
PUEBLA,CIUDAD SERDAN,7,265,4,276,1147
PUEBLA,CIUDAD SERDAN,7,230,5,242,1572
PUEBLA,CIUDAD SERDAN,13,207,6,226,1571
PUEBLA,CIUDAD SERDAN,8,292,7,307,1467
PUEBLA,CIUDAD SERDAN,22,246,3,271,1467
PUEBLA,CIUDAD SERDAN,21,307,3,331,1467
PUEBLA,CIUDAD SERDAN,14,182,3,199,1635
PUEBLA,CIUDAD SERDAN,29,221,6,256,1635
PUEBLA,CIUDAD SERDAN,22,255,11,288,1529
PUEBLA,CIUDAD SERDAN,20,247,8,275,1529
PUEBLA,CIUDAD SERDAN,29,209,17,255,1528
PUEBLA,CIUDAD SERDAN,202,32,6,240,1858
PUEBLA,CIUDAD SERDAN,20,229,8,257,1857
PUEBLA,CIUDAD SERDAN,32,350,8,390,1960
PUEBLA,CIUDAD SERDAN,18,334,15,367,1960
PUEBLA,CIUDAD SERDAN,14,245,9,268,1339
PUEBLA,CIUDAD SERDAN,12,252,3,267,1339
PUEBLA,CIUDAD SERDAN,11,233,6,250,1338
PUEBLA,CIUDAD SERDAN,8,211,5,224,1646
PUEBLA,CIUDAD SERDAN,12,253,4,269,1645
PUEBLA,CIUDAD SERDAN,17,388,5,410,1795
PUEBLA,CIUDAD SERDAN,22,372,5,399,1795
PUEBLA,CIUDAD SERDAN,17,230,11,258,1100
PUEBLA,CIUDAD SERDAN,15,278,6,299,1099
PUEBLA,CIUDAD SERDAN,35,311,17,363,1569
PUEBLA,CIUDAD SERDAN,20,315,9,344,1569
PUEBLA,CIUDAD SERDAN,17,358,7,382,1568
PUEBLA,CIUDAD SERDAN,14,245,10,269,1525
PUEBLA,CIUDAD SERDAN,16,298,3,317,1525
PUEBLA,CIUDAD SERDAN,18,253,5,276,1524
PUEBLA,CIUDAD SERDAN,15,401,2,418,1810
PUEBLA,CIUDAD SERDAN,16,395,8,419,1809
PUEBLA,CIUDAD SERDAN,19,464,11,494,1610
PUEBLA,CIUDAD SERDAN,24,463,13,500,1610
PUEBLA,CIUDAD SERDAN,14,500,12,526,1900
PUEBLA,CIUDAD SERDAN,17,409,10,436,1899
PUEBLA,CIUDAD SERDAN,17,286,10,313,1684
PUEBLA,CIUDAD SERDAN,16,314,5,335,1683
PUEBLA,CIUDAD SERDAN,13,203,8,224,1971
PUEBLA,CIUDAD SERDAN,21,246,2,269,1970
PUEBLA,CIUDAD SERDAN,16,199,8,223,1005
PUEBLA,CIUDAD SERDAN,15,192,7,214,1004
PUEBLA,CIUDAD SERDAN,25,221,15,261,1686
PUEBLA,CIUDAD SERDAN,25,215,10,250,1685
PUEBLA,CIUDAD SERDAN,18,257,11,286,1685
PUEBLA,CIUDAD SERDAN,26,312,14,352,1571
PUEBLA,CIUDAD SERDAN,39,262,17,318,1571
PUEBLA,CIUDAD SERDAN,13,252,14,279,1479
PUEBLA,CIUDAD SERDAN,22,220,8,250,1479
PUEBLA,CIUDAD SERDAN,6,366,3,375,1318
PUEBLA,CIUDAD SERDAN,14,327,3,344,1318
PUEBLA,CIUDAD SERDAN,22,396,7,425,1317
PUEBLA,CIUDAD SERDAN,16,409,6,431,1675
PUEBLA,CIUDAD SERDAN,11,330,4,345,1674
PUEBLA,CIUDAD SERDAN,54,311,12,377,1578
PUEBLA,CIUDAD SERDAN,56,326,19,401,1578
PUEBLA,CIUDAD SERDAN,37,238,14,289,1498
PUEBLA,CIUDAD SERDAN,39,288,7,334,1498
PUEBLA,CIUDAD SERDAN,40,322,19,381,1374
PUEBLA,CIUDAD SERDAN,45,295,17,357,1373
PUEBLA,CIUDAD SERDAN,41,342,22,405,1373
PUEBLA,CIUDAD SERDAN,42,333,42,417,1839
PUEBLA,CIUDAD SERDAN,45,424,22,491,1838
PUEBLA,CIUDAD SERDAN,30,279,18,327,1368
PUEBLA,CIUDAD SERDAN,37,235,17,289,1367
PUEBLA,CIUDAD SERDAN,49,314,36,399,1059
PUEBLA,CIUDAD SERDAN,31,286,32,349,1059
PUEBLA,CIUDAD SERDAN,76,264,23,363,1333
PUEBLA,CIUDAD SERDAN,86,209,37,332,1332
PUEBLA,CIUDAD SERDAN,56,213,19,288,1057
PUEBLA,CIUDAD SERDAN,66,183,12,261,1057
PUEBLA,CIUDAD SERDAN,102,253,29,384,1089
PUEBLA,CIUDAD SERDAN,102,210,32,344,1089
PUEBLA,CIUDAD SERDAN,11,225,3,239,1392
PUEBLA,CIUDAD SERDAN,17,182,2,201,1392
PUEBLA,CIUDAD SERDAN,13,185,2,200,1392
PUEBLA,CIUDAD SERDAN,23,187,8,218,1240
PUEBLA,CIUDAD SERDAN,25,216,4,245,1240
PUEBLA,HEROICA PUEBLA DE ZARAGOZA,38,187,2,227,1609
PUEBLA,HEROICA PUEBLA DE ZARAGOZA,42,190,5,237,1609
PUEBLA,HEROICA PUEBLA DE ZARAGOZA,21,154,4,179,1082
PUEBLA,HEROICA PUEBLA DE ZARAGOZA,16,158,3,177,1082
PUEBLA,HEROICA PUEBLA DE ZARAGOZA,21,310,0,331,1907
PUEBLA,HEROICA PUEBLA DE ZARAGOZA,29,316,4,349,1906
PUEBLA,HEROICA PUEBLA DE ZARAGOZA,18,236,1,255,1444
PUEBLA,HEROICA PUEBLA DE ZARAGOZA,17,233,0,250,1443
PUEBLA,HEROICA PUEBLA DE ZARAGOZA,14,190,6,210,1423
PUEBLA,HEROICA PUEBLA DE ZARAGOZA,12,196,2,210,1423
PUEBLA,HEROICA PUEBLA DE ZARAGOZA,22,140,1,163,1207
PUEBLA,HEROICA PUEBLA DE ZARAGOZA,24,128,0,152,1206
PUEBLA,HEROICA PUEBLA DE ZARAGOZA,20,227,2,249,1904
PUEBLA,HEROICA PUEBLA DE ZARAGOZA,18,257,1,276,1903
PUEBLA,HEROICA PUEBLA DE ZARAGOZA,20,234,2,256,1724
PUEBLA,HEROICA PUEBLA DE ZARAGOZA,35,218,2,255,1724
PUEBLA,HEROICA PUEBLA DE ZARAGOZA,20,309,3,332,1871
PUEBLA,HEROICA PUEBLA DE ZARAGOZA,31,298,2,331,1870
PUEBLA,HEROICA PUEBLA DE ZARAGOZA,20,165,2,187,1192
PUEBLA,HEROICA PUEBLA DE ZARAGOZA,16,173,5,194,1191
PUEBLA,HEROICA PUEBLA DE ZARAGOZA,18,234,4,256,1500
PUEBLA,HEROICA PUEBLA DE ZARAGOZA,23,247,0,270,1499
PUEBLA,HEROICA PUEBLA DE ZARAGOZA,15,257,4,276,1785
PUEBLA,HEROICA PUEBLA DE ZARAGOZA,33,240,1,274,1785
PUEBLA,HEROICA PUEBLA DE ZARAGOZA,13,172,3,188,1116
PUEBLA,HEROICA PUEBLA DE ZARAGOZA,19,167,1,187,1115
PUEBLA,HEROICA PUEBLA DE ZARAGOZA,20,202,2,224,1389
PUEBLA,HEROICA PUEBLA DE ZARAGOZA,16,227,0,243,1389
PUEBLA,HEROICA PUEBLA DE ZARAGOZA,21,196,2,219,1388
PUEBLA,HEROICA PUEBLA DE ZARAGOZA,22,280,3,305,1637
PUEBLA,HEROICA PUEBLA DE ZARAGOZA,13,270,4,287,1637
PUEBLA,HEROICA PUEBLA DE ZARAGOZA,12,216,2,230,1297
PUEBLA,HEROICA PUEBLA DE ZARAGOZA,8,231,2,241,1296
PUEBLA,HEROICA PUEBLA DE ZARAGOZA,23,250,1,274,1464
PUEBLA,HEROICA PUEBLA DE ZARAGOZA,23,261,3,287,1464
PUEBLA,HEROICA PUEBLA DE ZARAGOZA,22,257,2,281,1464
PUEBLA,HEROICA PUEBLA DE ZARAGOZA,42,207,2,251,1673
PUEBLA,HEROICA PUEBLA DE ZARAGOZA,42,204,3,249,1673
PUEBLA,HEROICA PUEBLA DE ZARAGOZA,33,273,3,309,1712
PUEBLA,HEROICA PUEBLA DE ZARAGOZA,26,270,3,299,1711
PUEBLA,HEROICA PUEBLA DE ZARAGOZA,22,239,1,262,1478
PUEBLA,HEROICA PUEBLA DE ZARAGOZA,25,234,0,259,1477
PUEBLA,HEROICA PUEBLA DE ZARAGOZA,29,162,2,193,1107
PUEBLA,HEROICA PUEBLA DE ZARAGOZA,20,164,1,185,1107
PUEBLA,HEROICA PUEBLA DE ZARAGOZA,34,276,4,314,1819
PUEBLA,HEROICA PUEBLA DE ZARAGOZA,28,331,2,361,1818
PUEBLA,HEROICA PUEBLA DE ZARAGOZA,28,279,4,311,1779
PUEBLA,HEROICA PUEBLA DE ZARAGOZA,22,305,3,330,1779
PUEBLA,HEROICA PUEBLA DE ZARAGOZA,33,205,1,239,1864
PUEBLA,HEROICA PUEBLA DE ZARAGOZA,27,209,2,238,1863
PUEBLA,HEROICA PUEBLA DE ZARAGOZA,16,279,0,295,1936
PUEBLA,HEROICA PUEBLA DE ZARAGOZA,22,281,3,306,1936
PUEBLA,HEROICA PUEBLA DE ZARAGOZA,24,215,2,241,1796
PUEBLA,HEROICA PUEBLA DE ZARAGOZA,35,199,2,236,1795
PUEBLA,HEROICA PUEBLA DE ZARAGOZA,23,195,3,221,1154
PUEBLA,HEROICA PUEBLA DE ZARAGOZA,17,232,1,250,1153
PUEBLA,HEROICA PUEBLA DE ZARAGOZA,33,205,1,239,1625
PUEBLA,HEROICA PUEBLA DE ZARAGOZA,45,212,2,259,1625
PUEBLA,HEROICA PUEBLA DE ZARAGOZA,30,223,3,256,1527
PUEBLA,HEROICA PUEBLA DE ZARAGOZA,24,217,2,243,1526
PUEBLA,HEROICA PUEBLA DE ZARAGOZA,19,193,3,215,1194
PUEBLA,HEROICA PUEBLA DE ZARAGOZA,22,202,1,225,1194
PUEBLA,HEROICA PUEBLA DE ZARAGOZA,18,219,3,240,1554
PUEBLA,HEROICA PUEBLA DE ZARAGOZA,21,219,0,240,1554
PUEBLA,HEROICA PUEBLA DE ZARAGOZA,21,305,8,334,1623
PUEBLA,HEROICA PUEBLA DE ZARAGOZA,19,358,0,377,1623
PUEBLA,HEROICA PUEBLA DE ZARAGOZA,40,345,2,387,1623
PUEBLA,HEROICA PUEBLA DE ZARAGOZA,25,248,1,274,1444
PUEBLA,HEROICA PUEBLA DE ZARAGOZA,19,226,8,253,1444
PUEBLA,HEROICA PUEBLA DE ZARAGOZA,30,253,1,284,1631
PUEBLA,HEROICA PUEBLA DE ZARAGOZA,26,246,0,272,1631
PUEBLA,HEROICA PUEBLA DE ZARAGOZA,41,247,2,290,1579
PUEBLA,HEROICA PUEBLA DE ZARAGOZA,39,239,3,281,1579
PUEBLA,HEROICA PUEBLA DE ZARAGOZA,40,264,2,306,1579
PUEBLA,HEROICA PUEBLA DE ZARAGOZA,31,262,2,295,1493
PUEBLA,HEROICA PUEBLA DE ZARAGOZA,28,247,1,276,1492
PUEBLA,HEROICA PUEBLA DE ZARAGOZA,121,1720,15,1856,0
PUEBLA,HEROICA PUEBLA DE ZARAGOZA,30,261,5,296,1805
PUEBLA,HEROICA PUEBLA DE ZARAGOZA,33,280,2,315,1804
PUEBLA,HEROICA PUEBLA DE ZARAGOZA,22,202,3,227,1158
PUEBLA,HEROICA PUEBLA DE ZARAGOZA,12,158,1,171,1158
PUEBLA,HEROICA PUEBLA DE ZARAGOZA,28,245,3,276,1706
PUEBLA,HEROICA PUEBLA DE ZARAGOZA,22,241,0,263,1706
PUEBLA,HEROICA PUEBLA DE ZARAGOZA,26,238,5,269,1419
PUEBLA,HEROICA PUEBLA DE ZARAGOZA,33,290,1,324,1419
PUEBLA,HEROICA PUEBLA DE ZARAGOZA,6,187,1,194,1737
PUEBLA,HEROICA PUEBLA DE ZARAGOZA,11,189,4,204,1736
PUEBLA,HEROICA PUEBLA DE ZARAGOZA,14,179,5,198,1610
PUEBLA,HEROICA PUEBLA DE ZARAGOZA,12,202,1,215,1609
PUEBLA,HEROICA PUEBLA DE ZARAGOZA,23,258,2,283,1625
PUEBLA,HEROICA PUEBLA DE ZARAGOZA,18,279,1,298,1625
PUEBLA,HEROICA PUEBLA DE ZARAGOZA,28,368,6,402,1732
PUEBLA,HEROICA PUEBLA DE ZARAGOZA,27,316,4,347,1731
PUEBLA,HEROICA PUEBLA DE ZARAGOZA,17,262,1,280,1594
PUEBLA,HEROICA PUEBLA DE ZARAGOZA,12,259,3,274,1593
PUEBLA,HEROICA PUEBLA DE ZARAGOZA,18,211,1,230,1759
PUEBLA,HEROICA PUEBLA DE ZARAGOZA,10,259,2,271,1759
PUEBLA,HEROICA PUEBLA DE ZARAGOZA,18,239,4,261,1377
PUEBLA,HEROICA PUEBLA DE ZARAGOZA,18,191,6,215,1377
PUEBLA,HEROICA PUEBLA DE ZARAGOZA,24,225,0,249,1376
PUEBLA,HEROICA PUEBLA DE ZARAGOZA,21,145,3,169,1093
PUEBLA,HEROICA PUEBLA DE ZARAGOZA,9,237,7,253,1092
PUEBLA,HEROICA PUEBLA DE ZARAGOZA,17,269,1,287,1738
PUEBLA,HEROICA PUEBLA DE ZARAGOZA,22,266,2,290,1737
PUEBLA,HEROICA PUEBLA DE ZARAGOZA,12,177,5,194,1358
PUEBLA,HEROICA PUEBLA DE ZARAGOZA,17,54,2,73,1357
PUEBLA,HEROICA PUEBLA DE ZARAGOZA,9,188,4,201,1770
PUEBLA,HEROICA PUEBLA DE ZARAGOZA,22,191,3,216,1770
PUEBLA,HEROICA PUEBLA DE ZARAGOZA,16,183,2,201,1769
PUEBLA,HEROICA PUEBLA DE ZARAGOZA,34,236,3,273,1838
PUEBLA,HEROICA PUEBLA DE ZARAGOZA,41,294,7,342,1837
PUEBLA,HEROICA PUEBLA DE ZARAGOZA,14,263,4,281,1760
PUEBLA,HEROICA PUEBLA DE ZARAGOZA,19,275,2,296,1759
PUEBLA,HEROICA PUEBLA DE ZARAGOZA,17,221,6,244,1739
PUEBLA,HEROICA PUEBLA DE ZARAGOZA,17,196,6,219,1739
PUEBLA,HEROICA PUEBLA DE ZARAGOZA,24,194,2,220,1739
PUEBLA,HEROICA PUEBLA DE ZARAGOZA,13,194,3,210,1739
PUEBLA,HEROICA PUEBLA DE ZARAGOZA,22,209,2,233,1738
PUEBLA,HEROICA PUEBLA DE ZARAGOZA,14,191,1,206,1738
PUEBLA,HEROICA PUEBLA DE ZARAGOZA,13,182,3,198,1738
PUEBLA,HEROICA PUEBLA DE ZARAGOZA,13,296,3,312,1654
PUEBLA,HEROICA PUEBLA DE ZARAGOZA,18,259,1,278,1653
PUEBLA,HEROICA PUEBLA DE ZARAGOZA,7,221,6,234,1808
PUEBLA,HEROICA PUEBLA DE ZARAGOZA,11,250,4,265,1807
PUEBLA,HEROICA PUEBLA DE ZARAGOZA,12,150,5,167,1045
PUEBLA,HEROICA PUEBLA DE ZARAGOZA,10,205,2,217,1044
PUEBLA,HEROICA PUEBLA DE ZARAGOZA,16,216,2,234,1627
PUEBLA,HEROICA PUEBLA DE ZARAGOZA,11,226,1,238,1627
PUEBLA,HEROICA PUEBLA DE ZARAGOZA,20,188,1,209,1627
PUEBLA,HEROICA PUEBLA DE ZARAGOZA,18,167,2,187,1205
PUEBLA,HEROICA PUEBLA DE ZARAGOZA,6,160,0,166,1205
PUEBLA,HEROICA PUEBLA DE ZARAGOZA,11,176,1,188,1584
PUEBLA,HEROICA PUEBLA DE ZARAGOZA,11,194,4,209,1584
PUEBLA,HEROICA PUEBLA DE ZARAGOZA,9,188,3,200,1583
PUEBLA,HEROICA PUEBLA DE ZARAGOZA,7,221,0,228,1583
PUEBLA,HEROICA PUEBLA DE ZARAGOZA,15,205,0,220,1470
PUEBLA,HEROICA PUEBLA DE ZARAGOZA,19,192,3,214,1470
PUEBLA,HEROICA PUEBLA DE ZARAGOZA,5,150,3,158,1257
PUEBLA,HEROICA PUEBLA DE ZARAGOZA,8,151,2,161,1256
PUEBLA,HEROICA PUEBLA DE ZARAGOZA,4,156,1,161,1693
PUEBLA,HEROICA PUEBLA DE ZARAGOZA,8,141,2,151,1693
PUEBLA,HEROICA PUEBLA DE ZARAGOZA,10,125,3,138,1693
PUEBLA,HEROICA PUEBLA DE ZARAGOZA,9,141,4,154,1693
PUEBLA,HEROICA PUEBLA DE ZARAGOZA,6,159,2,167,1693
PUEBLA,HEROICA PUEBLA DE ZARAGOZA,24,238,3,265,1914
PUEBLA,HEROICA PUEBLA DE ZARAGOZA,9,215,2,226,1914
PUEBLA,HEROICA PUEBLA DE ZARAGOZA,9,240,4,253,1557
PUEBLA,HEROICA PUEBLA DE ZARAGOZA,11,222,3,236,1557
PUEBLA,HEROICA PUEBLA DE ZARAGOZA,12,195,1,208,1556
PUEBLA,HEROICA PUEBLA DE ZARAGOZA,41,105,2,148,1749
PUEBLA,HEROICA PUEBLA DE ZARAGOZA,34,119,2,155,1749
PUEBLA,HEROICA PUEBLA DE ZARAGOZA,29,181,1,211,1210
PUEBLA,HEROICA PUEBLA DE ZARAGOZA,17,210,0,227,1209
PUEBLA,HEROICA PUEBLA DE ZARAGOZA,29,181,1,211,1848
PUEBLA,HEROICA PUEBLA DE ZARAGOZA,31,161,0,192,1848
PUEBLA,HEROICA PUEBLA DE ZARAGOZA,27,92,3,122,1146
PUEBLA,HEROICA PUEBLA DE ZARAGOZA,23,119,2,144,1145
PUEBLA,HEROICA PUEBLA DE ZARAGOZA,35,194,3,232,1789
PUEBLA,HEROICA PUEBLA DE ZARAGOZA,28,250,1,279,1788
PUEBLA,HEROICA PUEBLA DE ZARAGOZA,24,253,3,280,1759
PUEBLA,HEROICA PUEBLA DE ZARAGOZA,30,252,1,283,1758
PUEBLA,HEROICA PUEBLA DE ZARAGOZA,22,139,1,162,1461
PUEBLA,HEROICA PUEBLA DE ZARAGOZA,34,181,3,218,1461
PUEBLA,HEROICA PUEBLA DE ZARAGOZA,42,143,1,186,1461
PUEBLA,HEROICA PUEBLA DE ZARAGOZA,31,178,0,209,1616
PUEBLA,HEROICA PUEBLA DE ZARAGOZA,31,218,1,250,1616
PUEBLA,HEROICA PUEBLA DE ZARAGOZA,32,205,1,238,1615
PUEBLA,HEROICA PUEBLA DE ZARAGOZA,25,189,1,215,1549
PUEBLA,HEROICA PUEBLA DE ZARAGOZA,32,173,6,211,1548
PUEBLA,HEROICA PUEBLA DE ZARAGOZA,17,202,2,221,1417
PUEBLA,HEROICA PUEBLA DE ZARAGOZA,18,196,2,216,1416
PUEBLA,HEROICA PUEBLA DE ZARAGOZA,42,251,3,296,1823
PUEBLA,HEROICA PUEBLA DE ZARAGOZA,38,235,2,275,1823
PUEBLA,HEROICA PUEBLA DE ZARAGOZA,25,146,4,175,1468
PUEBLA,HEROICA PUEBLA DE ZARAGOZA,22,123,1,146,1468
PUEBLA,HEROICA PUEBLA DE ZARAGOZA,18,151,4,173,1467
PUEBLA,HEROICA PUEBLA DE ZARAGOZA,16,169,1,186,1413
PUEBLA,HEROICA PUEBLA DE ZARAGOZA,23,157,0,180,1413
PUEBLA,HEROICA PUEBLA DE ZARAGOZA,20,168,1,189,1412
PUEBLA,HEROICA PUEBLA DE ZARAGOZA,25,185,4,214,1441
PUEBLA,HEROICA PUEBLA DE ZARAGOZA,20,184,1,205,1440
PUEBLA,HEROICA PUEBLA DE ZARAGOZA,15,164,2,181,1440
PUEBLA,HEROICA PUEBLA DE ZARAGOZA,46,142,1,189,1886
PUEBLA,HEROICA PUEBLA DE ZARAGOZA,48,178,2,228,1886
PUEBLA,HEROICA PUEBLA DE ZARAGOZA,44,206,2,252,1843
PUEBLA,HEROICA PUEBLA DE ZARAGOZA,30,205,6,241,1842
PUEBLA,HEROICA PUEBLA DE ZARAGOZA,50,74,0,124,1641
PUEBLA,HEROICA PUEBLA DE ZARAGOZA,39,69,4,112,1640
PUEBLA,HEROICA PUEBLA DE ZARAGOZA,39,76,3,118,1148
PUEBLA,HEROICA PUEBLA DE ZARAGOZA,43,82,1,126,1147
PUEBLA,HEROICA PUEBLA DE ZARAGOZA,29,265,3,297,1605
PUEBLA,HEROICA PUEBLA DE ZARAGOZA,23,248,1,272,1605
PUEBLA,HEROICA PUEBLA DE ZARAGOZA,18,242,3,263,1604
PUEBLA,HEROICA PUEBLA DE ZARAGOZA,16,153,3,172,1063
PUEBLA,HEROICA PUEBLA DE ZARAGOZA,15,163,0,178,1062
PUEBLA,HEROICA PUEBLA DE ZARAGOZA,27,278,4,309,1814
PUEBLA,HEROICA PUEBLA DE ZARAGOZA,20,290,1,311,1813
PUEBLA,HEROICA PUEBLA DE ZARAGOZA,26,255,5,286,1483
PUEBLA,HEROICA PUEBLA DE ZARAGOZA,15,211,5,231,1482
PUEBLA,HEROICA PUEBLA DE ZARAGOZA,15,262,2,279,1482
PUEBLA,HEROICA PUEBLA DE ZARAGOZA,17,207,2,226,1236
PUEBLA,HEROICA PUEBLA DE ZARAGOZA,11,182,3,196,1236
PUEBLA,HEROICA PUEBLA DE ZARAGOZA,19,242,2,263,1802
PUEBLA,HEROICA PUEBLA DE ZARAGOZA,12,211,3,226,1802
PUEBLA,HEROICA PUEBLA DE ZARAGOZA,9,272,3,284,1802
PUEBLA,HEROICA PUEBLA DE ZARAGOZA,26,241,2,269,1620
PUEBLA,HEROICA PUEBLA DE ZARAGOZA,26,228,3,257,1619
PUEBLA,HEROICA PUEBLA DE ZARAGOZA,29,231,0,260,1619
PUEBLA,HEROICA PUEBLA DE ZARAGOZA,26,228,3,257,1870
PUEBLA,HEROICA PUEBLA DE ZARAGOZA,18,270,3,291,1870
PUEBLA,HEROICA PUEBLA DE ZARAGOZA,12,199,0,211,1000
PUEBLA,HEROICA PUEBLA DE ZARAGOZA,26,158,0,184,1000
PUEBLA,HEROICA PUEBLA DE ZARAGOZA,30,91,1,122,1425
PUEBLA,HEROICA PUEBLA DE ZARAGOZA,24,81,1,106,1424
PUEBLA,CHOLULA DE RIVADAVIA,14,466,3,483,1833
PUEBLA,CHOLULA DE RIVADAVIA,13,483,4,500,1833
PUEBLA,CHOLULA DE RIVADAVIA,14,351,2,367,1554
PUEBLA,CHOLULA DE RIVADAVIA,11,273,1,285,1554
PUEBLA,CHOLULA DE RIVADAVIA,13,314,4,331,1554
PUEBLA,CHOLULA DE RIVADAVIA,7,400,6,413,1353
PUEBLA,CHOLULA DE RIVADAVIA,13,359,5,377,1352
PUEBLA,CHOLULA DE RIVADAVIA,4,264,1,269,1816
PUEBLA,CHOLULA DE RIVADAVIA,13,284,1,298,1816
PUEBLA,CHOLULA DE RIVADAVIA,11,130,1,142,1154
PUEBLA,CHOLULA DE RIVADAVIA,5,145,1,151,1153
PUEBLA,CHOLULA DE RIVADAVIA,12,117,2,131,1113
PUEBLA,CHOLULA DE RIVADAVIA,11,118,1,130,1112
PUEBLA,CHOLULA DE RIVADAVIA,14,227,0,241,2038
PUEBLA,CHOLULA DE RIVADAVIA,13,139,0,152,2038
PUEBLA,CHOLULA DE RIVADAVIA,11,151,0,162,2038
PUEBLA,CHOLULA DE RIVADAVIA,9,148,3,160,2037
PUEBLA,CHOLULA DE RIVADAVIA,16,161,2,179,2037
PUEBLA,CHOLULA DE RIVADAVIA,23,135,2,160,2037
PUEBLA,CHOLULA DE RIVADAVIA,23,121,3,147,2037
PUEBLA,CHOLULA DE RIVADAVIA,14,157,0,171,2037
PUEBLA,CHOLULA DE RIVADAVIA,11,114,1,126,1350
PUEBLA,CHOLULA DE RIVADAVIA,12,138,2,152,1349
PUEBLA,CHOLULA DE RIVADAVIA,9,266,0,275,1456
PUEBLA,CHOLULA DE RIVADAVIA,8,258,4,270,1456
PUEBLA,CHOLULA DE RIVADAVIA,12,326,0,338,1456
PUEBLA,CHOLULA DE RIVADAVIA,21,181,1,203,1958
PUEBLA,CHOLULA DE RIVADAVIA,18,179,2,199,1958
PUEBLA,CHOLULA DE RIVADAVIA,25,185,4,214,1958
PUEBLA,CHOLULA DE RIVADAVIA,21,170,1,192,1958
PUEBLA,CHOLULA DE RIVADAVIA,26,158,0,184,1958
PUEBLA,CHOLULA DE RIVADAVIA,24,232,1,257,1958
PUEBLA,CHOLULA DE RIVADAVIA,26,218,2,246,1957
PUEBLA,CHOLULA DE RIVADAVIA,24,206,4,234,1957
PUEBLA,CHOLULA DE RIVADAVIA,8,196,3,207,1462
PUEBLA,CHOLULA DE RIVADAVIA,13,203,1,217,1462
PUEBLA,CHOLULA DE RIVADAVIA,13,199,3,215,1461
PUEBLA,CHOLULA DE RIVADAVIA,13,148,1,162,1399
PUEBLA,CHOLULA DE RIVADAVIA,19,145,1,165,1399
PUEBLA,CHOLULA DE RIVADAVIA,21,175,0,196,1398
PUEBLA,CHOLULA DE RIVADAVIA,14,222,3,239,1440
PUEBLA,CHOLULA DE RIVADAVIA,14,252,0,266,1440
PUEBLA,CHOLULA DE RIVADAVIA,24,210,2,236,1730
PUEBLA,CHOLULA DE RIVADAVIA,20,282,0,302,1730
PUEBLA,CHOLULA DE RIVADAVIA,13,227,1,241,1852
PUEBLA,CHOLULA DE RIVADAVIA,12,218,3,233,1851
PUEBLA,CHOLULA DE RIVADAVIA,12,233,1,246,1851
PUEBLA,CHOLULA DE RIVADAVIA,8,219,0,227,1572
PUEBLA,CHOLULA DE RIVADAVIA,11,203,1,215,1572
PUEBLA,CHOLULA DE RIVADAVIA,13,207,3,223,1572
PUEBLA,CHOLULA DE RIVADAVIA,10,218,2,230,1571
PUEBLA,CHOLULA DE RIVADAVIA,4,164,0,168,1385
PUEBLA,CHOLULA DE RIVADAVIA,6,235,3,244,1385
PUEBLA,CHOLULA DE RIVADAVIA,6,130,2,138,1384
PUEBLA,CHOLULA DE RIVADAVIA,5,179,2,186,1476
PUEBLA,CHOLULA DE RIVADAVIA,4,168,2,174,1476
PUEBLA,CHOLULA DE RIVADAVIA,20,181,0,201,1438
PUEBLA,CHOLULA DE RIVADAVIA,24,184,0,208,1438
PUEBLA,CHOLULA DE RIVADAVIA,16,184,4,204,1437
PUEBLA,CHOLULA DE RIVADAVIA,7,248,1,256,1662
PUEBLA,CHOLULA DE RIVADAVIA,9,250,1,260,1662
PUEBLA,CHOLULA DE RIVADAVIA,15,219,1,235,1662
PUEBLA,CHOLULA DE RIVADAVIA,9,269,5,283,1487
PUEBLA,CHOLULA DE RIVADAVIA,16,263,1,280,1487
PUEBLA,CHOLULA DE RIVADAVIA,13,249,0,262,1487
PUEBLA,CHOLULA DE RIVADAVIA,12,284,1,297,1887
PUEBLA,CHOLULA DE RIVADAVIA,18,348,4,370,1886
PUEBLA,CHOLULA DE RIVADAVIA,32,203,2,237,1950
PUEBLA,CHOLULA DE RIVADAVIA,23,223,2,248,1949
PUEBLA,CHOLULA DE RIVADAVIA,23,249,0,272,1949
PUEBLA,CHOLULA DE RIVADAVIA,33,229,2,264,1949
PUEBLA,CHOLULA DE RIVADAVIA,30,250,5,285,1949
PUEBLA,CHOLULA DE RIVADAVIA,35,232,1,268,1949
PUEBLA,CHOLULA DE RIVADAVIA,11,196,3,210,1785
PUEBLA,CHOLULA DE RIVADAVIA,7,258,0,265,1785
PUEBLA,CHOLULA DE RIVADAVIA,19,174,0,193,1543
PUEBLA,CHOLULA DE RIVADAVIA,17,185,4,206,1542
PUEBLA,CHOLULA DE RIVADAVIA,14,174,4,192,1351
PUEBLA,CHOLULA DE RIVADAVIA,12,174,0,186,1351
PUEBLA,CHOLULA DE RIVADAVIA,14,207,2,223,1351
PUEBLA,CHOLULA DE RIVADAVIA,8,201,2,211,1403
PUEBLA,CHOLULA DE RIVADAVIA,7,201,5,213,1402
PUEBLA,CHOLULA DE RIVADAVIA,11,226,0,237,1402
PUEBLA,CHOLULA DE RIVADAVIA,9,263,3,275,1612
PUEBLA,CHOLULA DE RIVADAVIA,6,238,5,249,1612
PUEBLA,CHOLULA DE RIVADAVIA,18,198,4,220,1710
PUEBLA,CHOLULA DE RIVADAVIA,27,217,2,246,1709
PUEBLA,CHOLULA DE RIVADAVIA,10,148,0,158,1869
PUEBLA,CHOLULA DE RIVADAVIA,25,102,0,127,1868
PUEBLA,CHOLULA DE RIVADAVIA,14,120,2,136,1868
PUEBLA,CHOLULA DE RIVADAVIA,17,217,3,237,1451
PUEBLA,CHOLULA DE RIVADAVIA,15,198,8,221,1450
PUEBLA,CHOLULA DE RIVADAVIA,19,265,4,288,1936
PUEBLA,CHOLULA DE RIVADAVIA,44,241,7,292,1936
PUEBLA,CHOLULA DE RIVADAVIA,24,229,4,257,1290
PUEBLA,CHOLULA DE RIVADAVIA,16,200,4,220,1289
PUEBLA,CHOLULA DE RIVADAVIA,10,257,5,272,1983
PUEBLA,CHOLULA DE RIVADAVIA,3,263,3,269,1982
PUEBLA,CHOLULA DE RIVADAVIA,15,280,2,297,2035
PUEBLA,CHOLULA DE RIVADAVIA,41,313,2,356,2034
PUEBLA,CHOLULA DE RIVADAVIA,14,193,1,208,1129
PUEBLA,CHOLULA DE RIVADAVIA,9,119,4,132,1128
PUEBLA,CHOLULA DE RIVADAVIA,16,261,4,281,2007
PUEBLA,CHOLULA DE RIVADAVIA,19,287,2,308,2006
PUEBLA,CHOLULA DE RIVADAVIA,12,135,148,295,1087
PUEBLA,CHOLULA DE RIVADAVIA,15,182,4,201,1087
PUEBLA,CHOLULA DE RIVADAVIA,12,152,2,166,1083
PUEBLA,CHOLULA DE RIVADAVIA,11,168,0,179,1082
PUEBLA,CHOLULA DE RIVADAVIA,33,179,4,216,1933
PUEBLA,CHOLULA DE RIVADAVIA,35,198,0,233,1932
PUEBLA,CHOLULA DE RIVADAVIA,36,163,3,202,1932
PUEBLA,CHOLULA DE RIVADAVIA,26,174,3,203,1932
PUEBLA,CHOLULA DE RIVADAVIA,30,179,2,211,1932
PUEBLA,CHOLULA DE RIVADAVIA,31,185,3,219,1698
PUEBLA,CHOLULA DE RIVADAVIA,42,168,1,211,1697
PUEBLA,CHOLULA DE RIVADAVIA,30,218,3,251,1697
PUEBLA,CHOLULA DE RIVADAVIA,34,174,2,210,1697
PUEBLA,CHOLULA DE RIVADAVIA,36,163,4,203,1697
PUEBLA,CHOLULA DE RIVADAVIA,16,210,0,226,1629
PUEBLA,CHOLULA DE RIVADAVIA,24,204,6,234,1629
PUEBLA,CHOLULA DE RIVADAVIA,12,220,1,233,1506
PUEBLA,CHOLULA DE RIVADAVIA,9,179,8,196,1506
PUEBLA,CHOLULA DE RIVADAVIA,15,206,1,222,1345
PUEBLA,CHOLULA DE RIVADAVIA,22,149,0,171,1345
PUEBLA,CHOLULA DE RIVADAVIA,10,137,0,147,1345
PUEBLA,CHOLULA DE RIVADAVIA,18,98,2,118,1860
PUEBLA,CHOLULA DE RIVADAVIA,25,153,1,179,1860
PUEBLA,CHOLULA DE RIVADAVIA,25,109,0,134,1859
PUEBLA,CHOLULA DE RIVADAVIA,18,106,0,124,1859
PUEBLA,CHOLULA DE RIVADAVIA,140,16,1,157,1859
PUEBLA,CHOLULA DE RIVADAVIA,32,184,1,217,1277
PUEBLA,CHOLULA DE RIVADAVIA,13,118,1,132,1277
PUEBLA,CHOLULA DE RIVADAVIA,33,312,4,349,1996
PUEBLA,CHOLULA DE RIVADAVIA,27,255,6,288,1996
PUEBLA,CHOLULA DE RIVADAVIA,9,97,1,107,1248
PUEBLA,CHOLULA DE RIVADAVIA,5,84,2,91,1247
PUEBLA,CHOLULA DE RIVADAVIA,40,67,4,111,1768
PUEBLA,CHOLULA DE RIVADAVIA,52,90,1,143,1768
PUEBLA,CHOLULA DE RIVADAVIA,31,412,15,458,1708
PUEBLA,CHOLULA DE RIVADAVIA,41,344,18,403,1707
PUEBLA,CHOLULA DE RIVADAVIA,20,200,1,221,1453
PUEBLA,CHOLULA DE RIVADAVIA,23,173,1,197,1453
PUEBLA,CHOLULA DE RIVADAVIA,22,143,1,166,1300
PUEBLA,CHOLULA DE RIVADAVIA,20,130,1,151,1300
PUEBLA,CHOLULA DE RIVADAVIA,42,161,0,203,1703
PUEBLA,CHOLULA DE RIVADAVIA,28,149,1,178,1703
PUEBLA,CHOLULA DE RIVADAVIA,26,192,3,221,1320
PUEBLA,CHOLULA DE RIVADAVIA,24,190,0,214,1319
PUEBLA,CHOLULA DE RIVADAVIA,35,322,4,361,1872
PUEBLA,CHOLULA DE RIVADAVIA,39,328,2,369,1872
PUEBLA,CHOLULA DE RIVADAVIA,28,196,3,227,1592
PUEBLA,CHOLULA DE RIVADAVIA,26,233,1,260,1592
PUEBLA,CHOLULA DE RIVADAVIA,47,244,0,291,1825
PUEBLA,CHOLULA DE RIVADAVIA,41,219,4,264,1825
PUEBLA,CHOLULA DE RIVADAVIA,23,214,3,240,1785
PUEBLA,CHOLULA DE RIVADAVIA,18,234,1,253,1785
PUEBLA,CHOLULA DE RIVADAVIA,38,289,2,329,1933
PUEBLA,CHOLULA DE RIVADAVIA,33,247,5,285,1932
PUEBLA,CHOLULA DE RIVADAVIA,130,1094,6,1230,0
PUEBLA,CHOLULA DE RIVADAVIA,37,157,2,196,1427
PUEBLA,CHOLULA DE RIVADAVIA,34,158,2,194,1427
PUEBLA,CHOLULA DE RIVADAVIA,34,191,1,226,1427
PUEBLA,CHOLULA DE RIVADAVIA,23,161,2,186,1178
PUEBLA,CHOLULA DE RIVADAVIA,18,165,1,184,1177
PUEBLA,CHOLULA DE RIVADAVIA,19,213,1,233,1579
PUEBLA,CHOLULA DE RIVADAVIA,24,227,8,259,1578
PUEBLA,CHOLULA DE RIVADAVIA,16,225,7,248,1681
PUEBLA,CHOLULA DE RIVADAVIA,22,191,3,216,1681
PUEBLA,CHOLULA DE RIVADAVIA,9,166,1,176,1110
PUEBLA,CHOLULA DE RIVADAVIA,12,211,5,228,1109
PUEBLA,CHOLULA DE RIVADAVIA,8,182,3,193,1794
PUEBLA,CHOLULA DE RIVADAVIA,3,157,1,161,1793
PUEBLA,CHOLULA DE RIVADAVIA,16,214,2,232,1460
PUEBLA,CHOLULA DE RIVADAVIA,21,282,3,306,1460
PUEBLA,CHOLULA DE RIVADAVIA,27,280,2,309,1459
PUEBLA,CHOLULA DE RIVADAVIA,9,172,1,182,1301
PUEBLA,CHOLULA DE RIVADAVIA,14,161,1,176,1300
PUEBLA,CHOLULA DE RIVADAVIA,14,227,0,241,1564
PUEBLA,CHOLULA DE RIVADAVIA,13,203,4,220,1564
PUEBLA,CHOLULA DE RIVADAVIA,5,257,5,267,1174
PUEBLA,CHOLULA DE RIVADAVIA,3,258,0,261,1173
PUEBLA,CHOLULA DE RIVADAVIA,5,203,5,213,1075
PUEBLA,CHOLULA DE RIVADAVIA,6,194,6,206,1075
PUEBLA,CHOLULA DE RIVADAVIA,17,196,2,215,1784
PUEBLA,CHOLULA DE RIVADAVIA,9,217,2,228,1784
PUEBLA,CHOLULA DE RIVADAVIA,32,160,0,192,1591
PUEBLA,CHOLULA DE RIVADAVIA,25,174,5,204,1591
PUEBLA,CHOLULA DE RIVADAVIA,41,251,4,296,1787
PUEBLA,CHOLULA DE RIVADAVIA,39,229,0,268,1787
PUEBLA,CHOLULA DE RIVADAVIA,36,258,3,297,1872
PUEBLA,CHOLULA DE RIVADAVIA,22,263,2,287,1872
PUEBLA,CHOLULA DE RIVADAVIA,19,193,0,212,1545
PUEBLA,CHOLULA DE RIVADAVIA,21,133,1,155,1544
PUEBLA,CHOLULA DE RIVADAVIA,25,198,2,225,1544
PUEBLA,CHOLULA DE RIVADAVIA,17,220,2,239,1544
PUEBLA,CHOLULA DE RIVADAVIA,38,160,1,199,1889
PUEBLA,CHOLULA DE RIVADAVIA,23,188,0,211,1889
PUEBLA,CHOLULA DE RIVADAVIA,22,196,1,219,1889
PUEBLA,CHOLULA DE RIVADAVIA,27,241,3,271,1889
PUEBLA,CHOLULA DE RIVADAVIA,23,208,3,234,1889
PUEBLA,CHOLULA DE RIVADAVIA,23,193,1,217,1889
PUEBLA,CHOLULA DE RIVADAVIA,13,107,0,120,1459
PUEBLA,CHOLULA DE RIVADAVIA,2,89,3,94,1458
PUEBLA,CHOLULA DE RIVADAVIA,12,118,1,131,1180
PUEBLA,CHOLULA DE RIVADAVIA,9,110,3,122,1179
PUEBLA,CHOLULA DE RIVADAVIA,9,98,4,111,1439
PUEBLA,CHOLULA DE RIVADAVIA,6,94,1,101,1438
PUEBLA,CHOLULA DE RIVADAVIA,11,106,0,117,1537
PUEBLA,CHOLULA DE RIVADAVIA,6,91,1,98,1537
PUEBLA,CHOLULA DE RIVADAVIA,9,100,1,110,1537
PUEBLA,CHOLULA DE RIVADAVIA,24,141,2,167,1345
PUEBLA,CHOLULA DE RIVADAVIA,33,128,4,165,1345
PUEBLA,CHOLULA DE RIVADAVIA,34,157,0,191,1695
PUEBLA,CHOLULA DE RIVADAVIA,33,173,1,207,1695
PUEBLA,CHOLULA DE RIVADAVIA,24,141,3,168,1447
PUEBLA,CHOLULA DE RIVADAVIA,29,138,1,168,1447
PUEBLA,CHOLULA DE RIVADAVIA,28,157,2,187,1447
PUEBLA,CHOLULA DE RIVADAVIA,17,216,3,236,1535
PUEBLA,CHOLULA DE RIVADAVIA,28,183,1,212,1534
PUEBLA,CHOLULA DE RIVADAVIA,24,99,0,123,1555
PUEBLA,CHOLULA DE RIVADAVIA,35,96,3,134,1555
PUEBLA,CHOLULA DE RIVADAVIA,35,207,2,244,1623
PUEBLA,CHOLULA DE RIVADAVIA,37,196,1,234,1622
PUEBLA,CHOLULA DE RIVADAVIA,17,34,3,54,1270
PUEBLA,CHOLULA DE RIVADAVIA,22,45,1,68,1269
PUEBLA,HEROICA PUEBLA DE ZARAGOZA,31,237,2,270,1705
PUEBLA,HEROICA PUEBLA DE ZARAGOZA,27,262,2,291,1705
PUEBLA,HEROICA PUEBLA DE ZARAGOZA,25,295,0,320,2087
PUEBLA,HEROICA PUEBLA DE ZARAGOZA,32,272,6,310,2086
PUEBLA,HEROICA PUEBLA DE ZARAGOZA,15,272,3,290,1784
PUEBLA,HEROICA PUEBLA DE ZARAGOZA,13,243,2,258,1784
PUEBLA,HEROICA PUEBLA DE ZARAGOZA,25,262,2,289,1784
PUEBLA,HEROICA PUEBLA DE ZARAGOZA,19,230,0,249,1784
PUEBLA,HEROICA PUEBLA DE ZARAGOZA,10,238,4,252,1784
PUEBLA,HEROICA PUEBLA DE ZARAGOZA,30,333,7,370,1992
PUEBLA,HEROICA PUEBLA DE ZARAGOZA,20,248,5,273,1966
PUEBLA,HEROICA PUEBLA DE ZARAGOZA,13,234,4,251,1966
PUEBLA,HEROICA PUEBLA DE ZARAGOZA,30,311,2,343,2040
PUEBLA,HEROICA PUEBLA DE ZARAGOZA,16,145,4,165,1365
PUEBLA,HEROICA PUEBLA DE ZARAGOZA,14,148,3,165,1365
PUEBLA,HEROICA PUEBLA DE ZARAGOZA,33,234,1,268,1691
PUEBLA,HEROICA PUEBLA DE ZARAGOZA,16,259,2,277,1691
PUEBLA,HEROICA PUEBLA DE ZARAGOZA,14,182,1,197,1723
PUEBLA,HEROICA PUEBLA DE ZARAGOZA,14,185,2,201,1722
PUEBLA,HEROICA PUEBLA DE ZARAGOZA,14,159,2,175,1722
PUEBLA,HEROICA PUEBLA DE ZARAGOZA,14,270,5,289,1927
PUEBLA,HEROICA PUEBLA DE ZARAGOZA,19,256,2,277,1927
PUEBLA,HEROICA PUEBLA DE ZARAGOZA,16,265,4,285,1926
PUEBLA,HEROICA PUEBLA DE ZARAGOZA,13,214,4,231,1613
PUEBLA,HEROICA PUEBLA DE ZARAGOZA,21,224,0,245,1612
PUEBLA,HEROICA PUEBLA DE ZARAGOZA,18,220,5,243,1812
PUEBLA,HEROICA PUEBLA DE ZARAGOZA,29,242,4,275,1812
PUEBLA,HEROICA PUEBLA DE ZARAGOZA,28,234,1,263,1741
PUEBLA,HEROICA PUEBLA DE ZARAGOZA,28,246,2,276,1740
PUEBLA,HEROICA PUEBLA DE ZARAGOZA,30,234,2,266,2067
PUEBLA,HEROICA PUEBLA DE ZARAGOZA,21,197,2,220,2067
PUEBLA,HEROICA PUEBLA DE ZARAGOZA,24,203,6,233,2067
PUEBLA,HEROICA PUEBLA DE ZARAGOZA,17,225,0,242,2067
PUEBLA,HEROICA PUEBLA DE ZARAGOZA,26,206,2,234,2067
PUEBLA,HEROICA PUEBLA DE ZARAGOZA,26,224,0,250,2066
PUEBLA,HEROICA PUEBLA DE ZARAGOZA,23,209,1,233,2066
PUEBLA,HEROICA PUEBLA DE ZARAGOZA,20,230,2,252,1810
PUEBLA,HEROICA PUEBLA DE ZARAGOZA,33,221,4,258,1810
PUEBLA,HEROICA PUEBLA DE ZARAGOZA,24,220,3,247,1810
PUEBLA,HEROICA PUEBLA DE ZARAGOZA,18,207,5,230,2123
PUEBLA,HEROICA PUEBLA DE ZARAGOZA,12,208,4,224,2123
PUEBLA,HEROICA PUEBLA DE ZARAGOZA,17,238,5,260,2123
PUEBLA,HEROICA PUEBLA DE ZARAGOZA,14,199,1,214,2123
PUEBLA,HEROICA PUEBLA DE ZARAGOZA,16,192,9,217,2122
PUEBLA,HEROICA PUEBLA DE ZARAGOZA,18,208,2,228,2122
PUEBLA,HEROICA PUEBLA DE ZARAGOZA,21,281,3,305,1950
PUEBLA,HEROICA PUEBLA DE ZARAGOZA,26,297,2,325,1949
PUEBLA,HEROICA PUEBLA DE ZARAGOZA,25,243,0,268,2064
PUEBLA,HEROICA PUEBLA DE ZARAGOZA,25,230,3,258,2063
PUEBLA,HEROICA PUEBLA DE ZARAGOZA,16,234,2,252,2063
PUEBLA,HEROICA PUEBLA DE ZARAGOZA,18,228,2,248,2063
PUEBLA,HEROICA PUEBLA DE ZARAGOZA,17,148,5,170,1837
PUEBLA,HEROICA PUEBLA DE ZARAGOZA,13,141,2,156,1836
PUEBLA,HEROICA PUEBLA DE ZARAGOZA,10,136,6,152,1984
PUEBLA,HEROICA PUEBLA DE ZARAGOZA,13,140,6,159,1984
PUEBLA,HEROICA PUEBLA DE ZARAGOZA,15,137,13,165,1470
PUEBLA,HEROICA PUEBLA DE ZARAGOZA,8,99,7,114,1470
PUEBLA,HEROICA PUEBLA DE ZARAGOZA,15,119,6,140,1470
PUEBLA,HEROICA PUEBLA DE ZARAGOZA,13,112,15,140,1676
PUEBLA,HEROICA PUEBLA DE ZARAGOZA,14,132,12,158,1676
PUEBLA,HEROICA PUEBLA DE ZARAGOZA,8,108,13,129,1676
PUEBLA,HEROICA PUEBLA DE ZARAGOZA,15,116,16,147,1675
PUEBLA,HEROICA PUEBLA DE ZARAGOZA,29,191,3,223,1867
PUEBLA,HEROICA PUEBLA DE ZARAGOZA,30,197,2,229,1867
PUEBLA,HEROICA PUEBLA DE ZARAGOZA,38,157,0,195,1922
PUEBLA,HEROICA PUEBLA DE ZARAGOZA,22,158,2,182,1921
PUEBLA,HEROICA PUEBLA DE ZARAGOZA,41,133,2,176,1921
PUEBLA,HEROICA PUEBLA DE ZARAGOZA,27,194,2,223,1921
PUEBLA,HEROICA PUEBLA DE ZARAGOZA,34,143,1,178,1921
PUEBLA,HEROICA PUEBLA DE ZARAGOZA,40,231,0,271,1950
PUEBLA,HEROICA PUEBLA DE ZARAGOZA,29,241,0,270,1949
PUEBLA,HEROICA PUEBLA DE ZARAGOZA,26,224,1,251,1743
PUEBLA,HEROICA PUEBLA DE ZARAGOZA,0,233,3,236,1742
PUEBLA,HEROICA PUEBLA DE ZARAGOZA,13,192,2,207,1742
PUEBLA,HEROICA PUEBLA DE ZARAGOZA,14,210,3,227,1742
PUEBLA,HEROICA PUEBLA DE ZARAGOZA,24,215,4,243,1742
PUEBLA,HEROICA PUEBLA DE ZARAGOZA,15,200,7,222,1605
PUEBLA,HEROICA PUEBLA DE ZARAGOZA,19,203,4,226,1605
PUEBLA,HEROICA PUEBLA DE ZARAGOZA,6,208,2,216,1604
PUEBLA,HEROICA PUEBLA DE ZARAGOZA,21,261,2,284,1915
PUEBLA,HEROICA PUEBLA DE ZARAGOZA,26,314,10,350,1915
PUEBLA,HEROICA PUEBLA DE ZARAGOZA,31,147,1,179,1289
PUEBLA,HEROICA PUEBLA DE ZARAGOZA,35,150,0,185,1289
PUEBLA,HEROICA PUEBLA DE ZARAGOZA,23,221,8,252,2130
PUEBLA,HEROICA PUEBLA DE ZARAGOZA,41,211,5,257,2129
PUEBLA,HEROICA PUEBLA DE ZARAGOZA,27,308,11,346,2133
PUEBLA,HEROICA PUEBLA DE ZARAGOZA,1,291,0,292,2133
PUEBLA,HEROICA PUEBLA DE ZARAGOZA,10,157,1,168,1375
PUEBLA,HEROICA PUEBLA DE ZARAGOZA,12,163,1,176,1375
PUEBLA,HEROICA PUEBLA DE ZARAGOZA,77,1000,9,1086,0
PUEBLA,HEROICA PUEBLA DE ZARAGOZA,19,233,7,259,2084
PUEBLA,HEROICA PUEBLA DE ZARAGOZA,16,262,1,279,2084
PUEBLA,HEROICA PUEBLA DE ZARAGOZA,8,223,2,233,2122
PUEBLA,HEROICA PUEBLA DE ZARAGOZA,10,273,4,287,2122
PUEBLA,HEROICA PUEBLA DE ZARAGOZA,14,182,1,197,1816
PUEBLA,HEROICA PUEBLA DE ZARAGOZA,9,177,2,188,1816
PUEBLA,HEROICA PUEBLA DE ZARAGOZA,10,165,2,177,1815
PUEBLA,HEROICA PUEBLA DE ZARAGOZA,15,156,2,173,1815
PUEBLA,HEROICA PUEBLA DE ZARAGOZA,11,174,3,188,1815
PUEBLA,HEROICA PUEBLA DE ZARAGOZA,14,202,3,219,1815
PUEBLA,HEROICA PUEBLA DE ZARAGOZA,21,260,1,282,1502
PUEBLA,HEROICA PUEBLA DE ZARAGOZA,17,269,4,290,1502
PUEBLA,HEROICA PUEBLA DE ZARAGOZA,18,271,4,293,1502
PUEBLA,HEROICA PUEBLA DE ZARAGOZA,19,218,3,240,2068
PUEBLA,HEROICA PUEBLA DE ZARAGOZA,17,200,17,234,2068
PUEBLA,HEROICA PUEBLA DE ZARAGOZA,8,124,4,136,1871
PUEBLA,HEROICA PUEBLA DE ZARAGOZA,11,152,3,166,1870
PUEBLA,HEROICA PUEBLA DE ZARAGOZA,0,173,2,175,1935
PUEBLA,HEROICA PUEBLA DE ZARAGOZA,16,150,4,170,1934
PUEBLA,HEROICA PUEBLA DE ZARAGOZA,23,167,4,194,1782
PUEBLA,HEROICA PUEBLA DE ZARAGOZA,18,172,4,194,1781
PUEBLA,HEROICA PUEBLA DE ZARAGOZA,14,164,2,180,1781
PUEBLA,HEROICA PUEBLA DE ZARAGOZA,20,199,8,227,1781
PUEBLA,HEROICA PUEBLA DE ZARAGOZA,16,222,1,239,1972
PUEBLA,HEROICA PUEBLA DE ZARAGOZA,20,191,3,214,1971
PUEBLA,HEROICA PUEBLA DE ZARAGOZA,3,279,1,283,2035
PUEBLA,HEROICA PUEBLA DE ZARAGOZA,17,266,0,283,2035
PUEBLA,HEROICA PUEBLA DE ZARAGOZA,10,55,3,68,1226
PUEBLA,HEROICA PUEBLA DE ZARAGOZA,3,45,0,48,1225
PUEBLA,HEROICA PUEBLA DE ZARAGOZA,17,223,3,243,1460
PUEBLA,HEROICA PUEBLA DE ZARAGOZA,29,203,2,234,1459
PUEBLA,HEROICA PUEBLA DE ZARAGOZA,19,214,1,234,1459
PUEBLA,HEROICA PUEBLA DE ZARAGOZA,25,237,1,263,1519
PUEBLA,HEROICA PUEBLA DE ZARAGOZA,20,213,0,233,1519
PUEBLA,HEROICA PUEBLA DE ZARAGOZA,8,187,2,197,1519
PUEBLA,HEROICA PUEBLA DE ZARAGOZA,17,227,6,250,1895
PUEBLA,HEROICA PUEBLA DE ZARAGOZA,40,223,2,265,1895
PUEBLA,HEROICA PUEBLA DE ZARAGOZA,19,180,3,202,1537
PUEBLA,HEROICA PUEBLA DE ZARAGOZA,16,188,0,204,1536
PUEBLA,HEROICA PUEBLA DE ZARAGOZA,14,177,2,193,1536
PUEBLA,HEROICA PUEBLA DE ZARAGOZA,13,160,0,173,1219
PUEBLA,HEROICA PUEBLA DE ZARAGOZA,23,109,52,184,1218
PUEBLA,HEROICA PUEBLA DE ZARAGOZA,11,173,5,189,1476
PUEBLA,HEROICA PUEBLA DE ZARAGOZA,10,160,3,173,1476
PUEBLA,HEROICA PUEBLA DE ZARAGOZA,16,170,0,186,1494
PUEBLA,HEROICA PUEBLA DE ZARAGOZA,17,195,2,214,1493
PUEBLA,HEROICA PUEBLA DE ZARAGOZA,13,139,6,158,1105
PUEBLA,HEROICA PUEBLA DE ZARAGOZA,10,121,6,137,1105
PUEBLA,HEROICA PUEBLA DE ZARAGOZA,9,193,8,210,1733
PUEBLA,HEROICA PUEBLA DE ZARAGOZA,16,181,4,201,1733
PUEBLA,HEROICA PUEBLA DE ZARAGOZA,7,150,3,160,1531
PUEBLA,HEROICA PUEBLA DE ZARAGOZA,12,142,1,155,1531
PUEBLA,HEROICA PUEBLA DE ZARAGOZA,5,150,2,157,1584
PUEBLA,HEROICA PUEBLA DE ZARAGOZA,5,124,0,129,1584
PUEBLA,HEROICA PUEBLA DE ZARAGOZA,13,159,3,175,1889
PUEBLA,HEROICA PUEBLA DE ZARAGOZA,15,165,0,180,1889
PUEBLA,HEROICA PUEBLA DE ZARAGOZA,24,249,3,276,1957
PUEBLA,HEROICA PUEBLA DE ZARAGOZA,31,268,1,300,1957
PUEBLA,HEROICA PUEBLA DE ZARAGOZA,9,138,2,149,1122
PUEBLA,HEROICA PUEBLA DE ZARAGOZA,5,137,1,143,1121
PUEBLA,HEROICA PUEBLA DE ZARAGOZA,28,206,3,237,1779
PUEBLA,HEROICA PUEBLA DE ZARAGOZA,29,192,1,222,1778
PUEBLA,HEROICA PUEBLA DE ZARAGOZA,19,187,2,208,1778
PUEBLA,HEROICA PUEBLA DE ZARAGOZA,29,143,1,173,1598
PUEBLA,HEROICA PUEBLA DE ZARAGOZA,21,137,4,162,1598
PUEBLA,HEROICA PUEBLA DE ZARAGOZA,39,219,1,259,2002
PUEBLA,HEROICA PUEBLA DE ZARAGOZA,39,209,4,252,2001
PUEBLA,HEROICA PUEBLA DE ZARAGOZA,17,217,0,234,1720
PUEBLA,HEROICA PUEBLA DE ZARAGOZA,17,194,1,212,1719
PUEBLA,HEROICA PUEBLA DE ZARAGOZA,26,209,1,236,1799
PUEBLA,HEROICA PUEBLA DE ZARAGOZA,19,166,1,186,1799
PUEBLA,HEROICA PUEBLA DE ZARAGOZA,30,206,2,238,1798
PUEBLA,HEROICA PUEBLA DE ZARAGOZA,15,187,1,203,1769
PUEBLA,HEROICA PUEBLA DE ZARAGOZA,19,185,0,204,1768
PUEBLA,HEROICA PUEBLA DE ZARAGOZA,13,170,3,186,1297
PUEBLA,HEROICA PUEBLA DE ZARAGOZA,13,152,0,165,1296
PUEBLA,HEROICA PUEBLA DE ZARAGOZA,27,225,1,253,1986
PUEBLA,HEROICA PUEBLA DE ZARAGOZA,24,221,2,247,1985
PUEBLA,HEROICA PUEBLA DE ZARAGOZA,26,225,1,252,1777
PUEBLA,HEROICA PUEBLA DE ZARAGOZA,22,208,2,232,1776
PUEBLA,HEROICA PUEBLA DE ZARAGOZA,20,221,4,245,1919
PUEBLA,HEROICA PUEBLA DE ZARAGOZA,20,226,1,247,1919
PUEBLA,HEROICA PUEBLA DE ZARAGOZA,9,175,7,191,1329
PUEBLA,HEROICA PUEBLA DE ZARAGOZA,11,150,3,164,1328
PUEBLA,HEROICA PUEBLA DE ZARAGOZA,10,108,0,118,1729
PUEBLA,HEROICA PUEBLA DE ZARAGOZA,13,102,0,115,1728
PUEBLA,HEROICA PUEBLA DE ZARAGOZA,25,213,5,243,1968
PUEBLA,HEROICA PUEBLA DE ZARAGOZA,8,223,3,234,1968
PUEBLA,HEROICA PUEBLA DE ZARAGOZA,13,200,3,216,1386
PUEBLA,HEROICA PUEBLA DE ZARAGOZA,19,200,1,220,1386
PUEBLA,HEROICA PUEBLA DE ZARAGOZA,9,189,5,203,1232
PUEBLA,HEROICA PUEBLA DE ZARAGOZA,14,185,2,201,1232
PUEBLA,HEROICA PUEBLA DE ZARAGOZA,16,189,1,206,1608
PUEBLA,HEROICA PUEBLA DE ZARAGOZA,12,172,1,185,1607
PUEBLA,HEROICA PUEBLA DE ZARAGOZA,13,206,0,219,1602
PUEBLA,HEROICA PUEBLA DE ZARAGOZA,15,178,4,197,1601
PUEBLA,HEROICA PUEBLA DE ZARAGOZA,10,116,2,128,1486
PUEBLA,HEROICA PUEBLA DE ZARAGOZA,9,128,5,142,1486
PUEBLA,HEROICA PUEBLA DE ZARAGOZA,7,129,3,139,1520
PUEBLA,HEROICA PUEBLA DE ZARAGOZA,8,147,4,159,1520
PUEBLA,HEROICA PUEBLA DE ZARAGOZA,9,131,7,147,1520
PUEBLA,HEROICA PUEBLA DE ZARAGOZA,7,76,1,84,1386
PUEBLA,HEROICA PUEBLA DE ZARAGOZA,8,75,5,88,1385
PUEBLA,HEROICA PUEBLA DE ZARAGOZA,22,207,1,230,1912
PUEBLA,HEROICA PUEBLA DE ZARAGOZA,32,203,2,237,1912
PUEBLA,HEROICA PUEBLA DE ZARAGOZA,15,143,2,160,1137
PUEBLA,HEROICA PUEBLA DE ZARAGOZA,20,120,1,141,1137
PUEBLA,HEROICA PUEBLA DE ZARAGOZA,8,125,5,138,1351
PUEBLA,HEROICA PUEBLA DE ZARAGOZA,8,144,0,152,1350
PUEBLA,HEROICA PUEBLA DE ZARAGOZA,12,130,2,144,1350
PUEBLA,HEROICA PUEBLA DE ZARAGOZA,28,232,3,263,1685
PUEBLA,HEROICA PUEBLA DE ZARAGOZA,14,254,1,269,1685
PUEBLA,HEROICA PUEBLA DE ZARAGOZA,25,186,4,215,1590
PUEBLA,HEROICA PUEBLA DE ZARAGOZA,23,201,0,224,1589
PUEBLA,HEROICA PUEBLA DE ZARAGOZA,23,149,4,176,1174
PUEBLA,HEROICA PUEBLA DE ZARAGOZA,24,137,2,163,1173
PUEBLA,HEROICA PUEBLA DE ZARAGOZA,28,166,3,197,1660
PUEBLA,HEROICA PUEBLA DE ZARAGOZA,30,173,0,203,1660
PUEBLA,HEROICA PUEBLA DE ZARAGOZA,43,155,2,200,1735
PUEBLA,HEROICA PUEBLA DE ZARAGOZA,33,151,0,184,1734
PUEBLA,HEROICA PUEBLA DE ZARAGOZA,27,181,0,208,1536
PUEBLA,HEROICA PUEBLA DE ZARAGOZA,32,173,0,205,1535
PUEBLA,HEROICA PUEBLA DE ZARAGOZA,29,192,2,223,1535
PUEBLA,HEROICA PUEBLA DE ZARAGOZA,38,143,0,181,1471
PUEBLA,HEROICA PUEBLA DE ZARAGOZA,23,124,1,148,1471
PUEBLA,HEROICA PUEBLA DE ZARAGOZA,34,153,1,188,1470
PUEBLA,HEROICA PUEBLA DE ZARAGOZA,30,174,0,204,1530
PUEBLA,HEROICA PUEBLA DE ZARAGOZA,21,186,1,208,1530
PUEBLA,HEROICA PUEBLA DE ZARAGOZA,40,157,3,200,1429
PUEBLA,HEROICA PUEBLA DE ZARAGOZA,38,171,3,212,1428
PUEBLA,HEROICA PUEBLA DE ZARAGOZA,30,198,6,234,1591
PUEBLA,HEROICA PUEBLA DE ZARAGOZA,29,236,3,268,1591
PUEBLA,HEROICA PUEBLA DE ZARAGOZA,24,238,1,263,1675
PUEBLA,HEROICA PUEBLA DE ZARAGOZA,22,212,2,236,1674
PUEBLA,HEROICA PUEBLA DE ZARAGOZA,30,302,2,334,1923
PUEBLA,HEROICA PUEBLA DE ZARAGOZA,36,305,0,341,1922
PUEBLA,HEROICA PUEBLA DE ZARAGOZA,34,243,5,282,1525
PUEBLA,HEROICA PUEBLA DE ZARAGOZA,33,276,3,312,1524
PUEBLA,HEROICA PUEBLA DE ZARAGOZA,22,145,0,167,1051
PUEBLA,HEROICA PUEBLA DE ZARAGOZA,17,128,1,146,1051
PUEBLA,HEROICA PUEBLA DE ZARAGOZA,16,159,2,177,1027
PUEBLA,HEROICA PUEBLA DE ZARAGOZA,24,172,1,197,1026
PUEBLA,HEROICA PUEBLA DE ZARAGOZA,50,183,1,234,1387
PUEBLA,HEROICA PUEBLA DE ZARAGOZA,38,196,3,237,1386
PUEBLA,HEROICA PUEBLA DE ZARAGOZA,37,297,5,339,1972
PUEBLA,HEROICA PUEBLA DE ZARAGOZA,44,287,5,336,1972
PUEBLA,HEROICA PUEBLA DE ZARAGOZA,39,245,5,289,1745
PUEBLA,HEROICA PUEBLA DE ZARAGOZA,37,249,0,286,1745
PUEBLA,HEROICA PUEBLA DE ZARAGOZA,28,248,7,283,1621
PUEBLA,HEROICA PUEBLA DE ZARAGOZA,27,250,4,281,1621
PUEBLA,HEROICA PUEBLA DE ZARAGOZA,37,237,3,277,1650
PUEBLA,HEROICA PUEBLA DE ZARAGOZA,44,257,5,306,1650
PUEBLA,HEROICA PUEBLA DE ZARAGOZA,23,211,10,244,1313
PUEBLA,HEROICA PUEBLA DE ZARAGOZA,25,241,1,267,1312
PUEBLA,HEROICA PUEBLA DE ZARAGOZA,33,243,8,284,1809
PUEBLA,HEROICA PUEBLA DE ZARAGOZA,28,266,5,299,1809
PUEBLA,HEROICA PUEBLA DE ZARAGOZA,21,229,5,255,1503
PUEBLA,HEROICA PUEBLA DE ZARAGOZA,27,294,4,325,1503
PUEBLA,HEROICA PUEBLA DE ZARAGOZA,29,232,1,262,1400
PUEBLA,HEROICA PUEBLA DE ZARAGOZA,19,228,2,249,1400
PUEBLA,HEROICA PUEBLA DE ZARAGOZA,17,227,4,248,1084
PUEBLA,HEROICA PUEBLA DE ZARAGOZA,12,191,1,204,1083
PUEBLA,HEROICA PUEBLA DE ZARAGOZA,21,250,2,273,1447
PUEBLA,HEROICA PUEBLA DE ZARAGOZA,20,269,0,289,1447
PUEBLA,HEROICA PUEBLA DE ZARAGOZA,16,232,3,251,1461
PUEBLA,HEROICA PUEBLA DE ZARAGOZA,27,228,2,257,1460
PUEBLA,HEROICA PUEBLA DE ZARAGOZA,25,229,1,255,1614
PUEBLA,HEROICA PUEBLA DE ZARAGOZA,29,216,1,246,1613
PUEBLA,HEROICA PUEBLA DE ZARAGOZA,16,234,2,252,1393
PUEBLA,HEROICA PUEBLA DE ZARAGOZA,23,243,5,271,1392
PUEBLA,HEROICA PUEBLA DE ZARAGOZA,13,247,2,262,1392
PUEBLA,HEROICA PUEBLA DE ZARAGOZA,16,259,5,280,1605
PUEBLA,HEROICA PUEBLA DE ZARAGOZA,28,264,2,294,1605
PUEBLA,HEROICA PUEBLA DE ZARAGOZA,20,206,2,228,1854
PUEBLA,HEROICA PUEBLA DE ZARAGOZA,26,215,3,244,1854
PUEBLA,HEROICA PUEBLA DE ZARAGOZA,34,200,3,237,1853
PUEBLA,HEROICA PUEBLA DE ZARAGOZA,34,242,1,277,1853
PUEBLA,HEROICA PUEBLA DE ZARAGOZA,17,225,4,246,1853
PUEBLA,HEROICA PUEBLA DE ZARAGOZA,17,226,2,245,1853
PUEBLA,HEROICA PUEBLA DE ZARAGOZA,23,215,1,239,1638
PUEBLA,HEROICA PUEBLA DE ZARAGOZA,22,207,1,230,1638
PUEBLA,HEROICA PUEBLA DE ZARAGOZA,19,225,3,247,1638
PUEBLA,HEROICA PUEBLA DE ZARAGOZA,21,251,8,280,1454
PUEBLA,HEROICA PUEBLA DE ZARAGOZA,21,225,2,248,1454
PUEBLA,HEROICA PUEBLA DE ZARAGOZA,16,235,5,256,1487
PUEBLA,HEROICA PUEBLA DE ZARAGOZA,21,251,3,275,1486
PUEBLA,HEROICA PUEBLA DE ZARAGOZA,25,257,3,285,1584
PUEBLA,HEROICA PUEBLA DE ZARAGOZA,23,261,4,288,1584
PUEBLA,HEROICA PUEBLA DE ZARAGOZA,11,217,3,231,1583
PUEBLA,HEROICA PUEBLA DE ZARAGOZA,29,294,4,327,1675
PUEBLA,HEROICA PUEBLA DE ZARAGOZA,16,265,2,283,1674
PUEBLA,HEROICA PUEBLA DE ZARAGOZA,23,270,3,296,1853
PUEBLA,HEROICA PUEBLA DE ZARAGOZA,22,270,1,293,1853
PUEBLA,HEROICA PUEBLA DE ZARAGOZA,14,191,1,206,1226
PUEBLA,HEROICA PUEBLA DE ZARAGOZA,12,183,0,195,1225
PUEBLA,HEROICA PUEBLA DE ZARAGOZA,33,220,4,257,1766
PUEBLA,HEROICA PUEBLA DE ZARAGOZA,22,215,2,239,1766
PUEBLA,HEROICA PUEBLA DE ZARAGOZA,24,201,3,228,1629
PUEBLA,HEROICA PUEBLA DE ZARAGOZA,24,168,2,194,1628
PUEBLA,HEROICA PUEBLA DE ZARAGOZA,23,186,3,212,1671
PUEBLA,HEROICA PUEBLA DE ZARAGOZA,12,196,0,208,1670
PUEBLA,HEROICA PUEBLA DE ZARAGOZA,37,222,4,263,1740
PUEBLA,HEROICA PUEBLA DE ZARAGOZA,33,238,1,272,1740
PUEBLA,HEROICA PUEBLA DE ZARAGOZA,32,265,2,299,1886
PUEBLA,HEROICA PUEBLA DE ZARAGOZA,35,275,1,311,1885
PUEBLA,HEROICA PUEBLA DE ZARAGOZA,27,249,0,276,1719
PUEBLA,HEROICA PUEBLA DE ZARAGOZA,29,226,2,257,1719
PUEBLA,HEROICA PUEBLA DE ZARAGOZA,36,240,3,279,1718
PUEBLA,HEROICA PUEBLA DE ZARAGOZA,24,267,4,295,1681
PUEBLA,HEROICA PUEBLA DE ZARAGOZA,35,222,5,262,1680
PUEBLA,HEROICA PUEBLA DE ZARAGOZA,31,231,2,264,1841
PUEBLA,HEROICA PUEBLA DE ZARAGOZA,18,200,6,224,1841
PUEBLA,HEROICA PUEBLA DE ZARAGOZA,10,222,2,234,1658
PUEBLA,HEROICA PUEBLA DE ZARAGOZA,18,232,0,250,1657
PUEBLA,HEROICA PUEBLA DE ZARAGOZA,24,242,3,269,1547
PUEBLA,HEROICA PUEBLA DE ZARAGOZA,20,208,2,230,1547
PUEBLA,HEROICA PUEBLA DE ZARAGOZA,21,264,4,289,1546
PUEBLA,HEROICA PUEBLA DE ZARAGOZA,25,223,5,253,1511
PUEBLA,HEROICA PUEBLA DE ZARAGOZA,27,254,5,286,1511
PUEBLA,HEROICA PUEBLA DE ZARAGOZA,22,265,1,288,1858
PUEBLA,HEROICA PUEBLA DE ZARAGOZA,27,282,5,314,1858
PUEBLA,HEROICA PUEBLA DE ZARAGOZA,17,225,3,245,1180
PUEBLA,HEROICA PUEBLA DE ZARAGOZA,22,244,3,269,1180
PUEBLA,HEROICA PUEBLA DE ZARAGOZA,46,219,1,266,1954
PUEBLA,HEROICA PUEBLA DE ZARAGOZA,44,302,4,350,1954
PUEBLA,HEROICA PUEBLA DE ZARAGOZA,32,221,2,255,1706
PUEBLA,HEROICA PUEBLA DE ZARAGOZA,23,212,1,236,1705
PUEBLA,HEROICA PUEBLA DE ZARAGOZA,22,201,1,224,1705
PUEBLA,HEROICA PUEBLA DE ZARAGOZA,125,1285,13,1423,0
PUEBLA,HEROICA PUEBLA DE ZARAGOZA,20,129,1,150,1410
PUEBLA,HEROICA PUEBLA DE ZARAGOZA,32,116,0,148,1409
PUEBLA,HEROICA PUEBLA DE ZARAGOZA,29,105,2,136,1409
PUEBLA,HEROICA PUEBLA DE ZARAGOZA,25,134,1,160,1315
PUEBLA,HEROICA PUEBLA DE ZARAGOZA,25,126,0,151,1315
PUEBLA,HEROICA PUEBLA DE ZARAGOZA,21,115,1,137,1314
PUEBLA,HEROICA PUEBLA DE ZARAGOZA,31,264,2,297,1680
PUEBLA,HEROICA PUEBLA DE ZARAGOZA,32,231,10,273,1680
PUEBLA,HEROICA PUEBLA DE ZARAGOZA,37,220,0,257,1720
PUEBLA,HEROICA PUEBLA DE ZARAGOZA,41,194,2,237,1720
PUEBLA,HEROICA PUEBLA DE ZARAGOZA,22,226,2,250,1415
PUEBLA,HEROICA PUEBLA DE ZARAGOZA,29,196,2,227,1415
PUEBLA,HEROICA PUEBLA DE ZARAGOZA,31,253,0,284,1415
PUEBLA,HEROICA PUEBLA DE ZARAGOZA,39,206,3,248,1843
PUEBLA,HEROICA PUEBLA DE ZARAGOZA,41,203,1,245,1842
PUEBLA,HEROICA PUEBLA DE ZARAGOZA,36,218,2,256,1597
PUEBLA,HEROICA PUEBLA DE ZARAGOZA,41,195,1,237,1596
PUEBLA,HEROICA PUEBLA DE ZARAGOZA,37,122,0,159,1540
PUEBLA,HEROICA PUEBLA DE ZARAGOZA,21,113,1,135,1540
PUEBLA,HEROICA PUEBLA DE ZARAGOZA,30,209,1,240,1665
PUEBLA,HEROICA PUEBLA DE ZARAGOZA,21,244,3,268,1664
PUEBLA,HEROICA PUEBLA DE ZARAGOZA,29,281,6,316,1625
PUEBLA,HEROICA PUEBLA DE ZARAGOZA,21,293,2,316,1625
PUEBLA,HEROICA PUEBLA DE ZARAGOZA,22,200,1,223,1612
PUEBLA,HEROICA PUEBLA DE ZARAGOZA,21,226,5,252,1611
PUEBLA,HEROICA PUEBLA DE ZARAGOZA,20,310,2,332,1865
PUEBLA,HEROICA PUEBLA DE ZARAGOZA,31,306,2,339,1865
PUEBLA,HEROICA PUEBLA DE ZARAGOZA,22,204,1,227,1524
PUEBLA,HEROICA PUEBLA DE ZARAGOZA,26,246,2,274,1523
PUEBLA,HEROICA PUEBLA DE ZARAGOZA,25,265,0,290,1682
PUEBLA,HEROICA PUEBLA DE ZARAGOZA,27,224,2,253,1682
PUEBLA,HEROICA PUEBLA DE ZARAGOZA,43,162,1,206,1354
PUEBLA,HEROICA PUEBLA DE ZARAGOZA,38,170,5,213,1353
PUEBLA,HEROICA PUEBLA DE ZARAGOZA,37,152,8,197,1353
PUEBLA,HEROICA PUEBLA DE ZARAGOZA,29,255,15,299,1836
PUEBLA,HEROICA PUEBLA DE ZARAGOZA,43,303,10,356,1836
PUEBLA,HEROICA PUEBLA DE ZARAGOZA,21,203,3,227,1626
PUEBLA,HEROICA PUEBLA DE ZARAGOZA,33,240,3,276,1625
PUEBLA,HEROICA PUEBLA DE ZARAGOZA,9,130,0,139,1098
PUEBLA,HEROICA PUEBLA DE ZARAGOZA,13,160,0,173,1098
PUEBLA,HEROICA PUEBLA DE ZARAGOZA,35,299,5,339,1855
PUEBLA,HEROICA PUEBLA DE ZARAGOZA,19,302,3,324,1854
PUEBLA,HEROICA PUEBLA DE ZARAGOZA,33,240,1,274,1610
PUEBLA,HEROICA PUEBLA DE ZARAGOZA,23,248,1,272,1610
PUEBLA,HEROICA PUEBLA DE ZARAGOZA,30,313,4,347,1902
PUEBLA,HEROICA PUEBLA DE ZARAGOZA,23,278,3,304,1902
PUEBLA,HEROICA PUEBLA DE ZARAGOZA,28,219,0,247,1495
PUEBLA,HEROICA PUEBLA DE ZARAGOZA,27,173,0,200,1494
PUEBLA,HEROICA PUEBLA DE ZARAGOZA,27,244,4,275,1760
PUEBLA,HEROICA PUEBLA DE ZARAGOZA,28,273,2,303,1760
PUEBLA,HEROICA PUEBLA DE ZARAGOZA,29,262,1,292,1790
PUEBLA,HEROICA PUEBLA DE ZARAGOZA,47,255,4,306,1789
PUEBLA,HEROICA PUEBLA DE ZARAGOZA,18,296,4,318,1751
PUEBLA,HEROICA PUEBLA DE ZARAGOZA,22,316,3,341,1751
PUEBLA,HEROICA PUEBLA DE ZARAGOZA,20,331,1,352,1726
PUEBLA,HEROICA PUEBLA DE ZARAGOZA,22,370,3,395,1726
PUEBLA,HEROICA PUEBLA DE ZARAGOZA,28,280,6,314,1921
PUEBLA,HEROICA PUEBLA DE ZARAGOZA,21,291,8,320,1921
PUEBLA,HEROICA PUEBLA DE ZARAGOZA,28,254,1,283,1535
PUEBLA,HEROICA PUEBLA DE ZARAGOZA,33,230,2,265,1535
PUEBLA,HEROICA PUEBLA DE ZARAGOZA,39,283,5,327,1776
PUEBLA,HEROICA PUEBLA DE ZARAGOZA,35,332,2,369,1775
PUEBLA,HEROICA PUEBLA DE ZARAGOZA,30,182,1,213,1591
PUEBLA,HEROICA PUEBLA DE ZARAGOZA,34,204,4,242,1590
PUEBLA,HEROICA PUEBLA DE ZARAGOZA,14,223,3,240,1376
PUEBLA,HEROICA PUEBLA DE ZARAGOZA,15,203,1,219,1376
PUEBLA,HEROICA PUEBLA DE ZARAGOZA,12,182,2,196,1375
PUEBLA,HEROICA PUEBLA DE ZARAGOZA,24,254,2,280,1262
PUEBLA,HEROICA PUEBLA DE ZARAGOZA,16,248,2,266,1261
PUEBLA,HEROICA PUEBLA DE ZARAGOZA,27,331,6,364,1920
PUEBLA,HEROICA PUEBLA DE ZARAGOZA,20,308,6,334,1920
PUEBLA,HEROICA PUEBLA DE ZARAGOZA,20,202,4,226,1179
PUEBLA,HEROICA PUEBLA DE ZARAGOZA,14,226,5,245,1178
PUEBLA,HEROICA PUEBLA DE ZARAGOZA,34,272,2,308,1864
PUEBLA,HEROICA PUEBLA DE ZARAGOZA,30,344,6,380,1864
PUEBLA,HEROICA PUEBLA DE ZARAGOZA,33,347,1,381,1824
PUEBLA,HEROICA PUEBLA DE ZARAGOZA,26,346,0,372,1823
PUEBLA,HEROICA PUEBLA DE ZARAGOZA,22,297,6,325,1800
PUEBLA,HEROICA PUEBLA DE ZARAGOZA,32,313,1,346,1799
PUEBLA,HEROICA PUEBLA DE ZARAGOZA,18,183,5,206,997
PUEBLA,HEROICA PUEBLA DE ZARAGOZA,6,187,4,197,996
PUEBLA,ATLIXCO,41,378,17,436,1799
PUEBLA,ATLIXCO,25,347,17,389,1798
PUEBLA,ATLIXCO,13,319,4,336,1672
PUEBLA,ATLIXCO,19,339,2,360,1672
PUEBLA,ATLIXCO,19,284,0,303,1671
PUEBLA,ATLIXCO,23,341,5,369,2142
PUEBLA,ATLIXCO,23,249,2,274,1575
PUEBLA,ATLIXCO,21,248,3,272,1575
PUEBLA,ATLIXCO,15,246,0,261,1575
PUEBLA,ATLIXCO,18,244,2,264,1575
PUEBLA,ATLIXCO,20,289,3,312,1329
PUEBLA,ATLIXCO,9,253,2,264,1328
PUEBLA,ATLIXCO,22,278,7,307,1799
PUEBLA,ATLIXCO,17,250,0,267,1798
PUEBLA,ATLIXCO,16,272,8,296,1798
PUEBLA,ATLIXCO,10,237,4,251,1363
PUEBLA,ATLIXCO,8,217,3,228,1363
PUEBLA,ATLIXCO,23,156,3,182,1155
PUEBLA,ATLIXCO,17,186,5,208,1154
PUEBLA,ATLIXCO,23,341,15,379,1831
PUEBLA,ATLIXCO,14,338,7,359,1830
PUEBLA,ATLIXCO,15,395,4,414,2050
PUEBLA,ATLIXCO,15,424,1,440,2049
PUEBLA,ATLIXCO,9,235,3,247,1276
PUEBLA,ATLIXCO,8,240,3,251,1276
PUEBLA,ATLIXCO,9,187,7,203,1613
PUEBLA,ATLIXCO,9,249,5,263,1612
PUEBLA,ATLIXCO,9,263,6,278,1612
PUEBLA,ATLIXCO,21,322,0,343,1807
PUEBLA,ATLIXCO,14,359,2,375,1807
PUEBLA,ATLIXCO,13,359,1,373,1855
PUEBLA,ATLIXCO,30,295,5,330,1854
PUEBLA,ATLIXCO,91,1081,16,1188,0
PUEBLA,ATLIXCO,18,370,3,391,1976
PUEBLA,ATLIXCO,12,361,5,378,1975
PUEBLA,ATLIXCO,16,204,6,226,1181
PUEBLA,ATLIXCO,12,213,4,229,1181
PUEBLA,ATLIXCO,12,238,2,252,1750
PUEBLA,ATLIXCO,9,271,3,283,1749
PUEBLA,ATLIXCO,19,364,1,384,1731
PUEBLA,ATLIXCO,18,363,2,383,1730
PUEBLA,ATLIXCO,31,302,3,336,1697
PUEBLA,ATLIXCO,17,315,4,336,1697
PUEBLA,ATLIXCO,10,218,2,230,1265
PUEBLA,ATLIXCO,5,260,1,266,1264
PUEBLA,ATLIXCO,13,289,4,306,1767
PUEBLA,ATLIXCO,8,254,3,265,1766
PUEBLA,ATLIXCO,9,278,7,294,1682
PUEBLA,ATLIXCO,12,278,11,301,1681
PUEBLA,ATLIXCO,14,237,8,259,1547
PUEBLA,ATLIXCO,12,230,9,251,1546
PUEBLA,ATLIXCO,18,255,13,286,1577
PUEBLA,ATLIXCO,11,293,12,316,1577
PUEBLA,ATLIXCO,14,245,3,262,1577
PUEBLA,ATLIXCO,23,293,2,318,1894
PUEBLA,ATLIXCO,16,258,2,276,1894
PUEBLA,ATLIXCO,25,232,4,261,1894
PUEBLA,ATLIXCO,19,163,11,193,1397
PUEBLA,ATLIXCO,15,188,7,210,1397
PUEBLA,ATLIXCO,16,173,9,198,1396
PUEBLA,ATLIXCO,36,210,14,260,1760
PUEBLA,ATLIXCO,26,237,21,284,1760
PUEBLA,ATLIXCO,6,93,7,106,1387
PUEBLA,ATLIXCO,9,104,5,118,1387
PUEBLA,ATLIXCO,10,102,4,116,1387
PUEBLA,ATLIXCO,10,134,2,146,1415
PUEBLA,ATLIXCO,5,177,8,190,1415
PUEBLA,ATLIXCO,7,150,5,162,1415
PUEBLA,ATLIXCO,29,110,5,144,1677
PUEBLA,ATLIXCO,32,79,6,117,1677
PUEBLA,ATLIXCO,14,297,25,336,1810
PUEBLA,ATLIXCO,14,264,10,288,1810
PUEBLA,ATLIXCO,12,392,9,413,1617
PUEBLA,ATLIXCO,14,392,5,411,1617
PUEBLA,ATLIXCO,18,336,5,359,1617
PUEBLA,ATLIXCO,20,193,9,222,1457
PUEBLA,ATLIXCO,15,186,10,211,1457
PUEBLA,ATLIXCO,21,309,11,341,1374
PUEBLA,ATLIXCO,15,282,10,307,1373
PUEBLA,ATLIXCO,4,344,7,355,1463
PUEBLA,ATLIXCO,6,336,7,349,1463
PUEBLA,ATLIXCO,15,413,9,437,2090
PUEBLA,ATLIXCO,13,558,6,577,2034
PUEBLA,ATLIXCO,12,520,7,539,2033
PUEBLA,ATLIXCO,12,378,1,391,1487
PUEBLA,ATLIXCO,8,352,5,365,1486
PUEBLA,ATLIXCO,6,380,2,388,1145
PUEBLA,ATLIXCO,5,336,1,342,1145
PUEBLA,ATLIXCO,10,457,0,467,1484
PUEBLA,ATLIXCO,10,468,6,484,1484
PUEBLA,ATLIXCO,10,288,3,301,1074
PUEBLA,ATLIXCO,14,303,0,317,1074
PUEBLA,ATLIXCO,10,509,11,530,1781
PUEBLA,ATLIXCO,20,524,12,556,1780
PUEBLA,ATLIXCO,8,353,1,362,1345
PUEBLA,ATLIXCO,9,380,4,393,1345
PUEBLA,ATLIXCO,10,279,9,298,1400
PUEBLA,ATLIXCO,14,259,14,287,1400
PUEBLA,ATLIXCO,14,273,12,299,1526
PUEBLA,ATLIXCO,0,285,7,292,1525
PUEBLA,ATLIXCO,11,275,11,297,1525
PUEBLA,ATLIXCO,16,225,8,249,1657
PUEBLA,ATLIXCO,20,213,2,235,1656
PUEBLA,ATLIXCO,26,192,10,228,1411
PUEBLA,ATLIXCO,24,195,1,220,1410
PUEBLA,ATLIXCO,24,338,12,374,1960
PUEBLA,ATLIXCO,20,308,10,338,1959
PUEBLA,ATLIXCO,12,252,4,268,1914
PUEBLA,ATLIXCO,15,269,2,286,1913
PUEBLA,ATLIXCO,18,284,7,309,1863
PUEBLA,ATLIXCO,13,267,10,290,1862
PUEBLA,ATLIXCO,10,209,219,438,1302
PUEBLA,ATLIXCO,7,219,3,229,1302
PUEBLA,ATLIXCO,5,319,7,331,1792
PUEBLA,ATLIXCO,5,354,4,363,1791
PUEBLA,ATLIXCO,7,325,2,334,1855
PUEBLA,ATLIXCO,11,327,4,342,1854
PUEBLA,ATLIXCO,6,278,3,287,1598
PUEBLA,ATLIXCO,10,207,1,218,1598
PUEBLA,ATLIXCO,12,250,0,262,1198
PUEBLA,ATLIXCO,6,277,6,289,1198
PUEBLA,ATLIXCO,9,228,1,238,1219
PUEBLA,ATLIXCO,7,222,5,234,1218
PUEBLA,ATLIXCO,17,263,3,283,1440
PUEBLA,ATLIXCO,9,279,2,290,1440
PUEBLA,ATLIXCO,17,227,4,248,1265
PUEBLA,ATLIXCO,9,208,6,223,1265
PUEBLA,ATLIXCO,16,280,4,300,1411
PUEBLA,ATLIXCO,11,291,4,306,1410
PUEBLA,ATLIXCO,19,349,1,369,1672
PUEBLA,ATLIXCO,9,374,2,385,1672
PUEBLA,ATLIXCO,16,312,4,332,1923
PUEBLA,ATLIXCO,8,302,6,316,1922
PUEBLA,ATLIXCO,9,228,1,238,1099
PUEBLA,ATLIXCO,7,236,1,244,1098
PUEBLA,ATLIXCO,12,335,4,351,1788
PUEBLA,ATLIXCO,11,379,2,392,1788
PUEBLA,ATLIXCO,4,374,4,382,1787
PUEBLA,ATLIXCO,11,311,7,329,1394
PUEBLA,ATLIXCO,12,262,7,281,1393
PUEBLA,ATLIXCO,8,349,5,362,1261
PUEBLA,ATLIXCO,8,352,7,367,1261
PUEBLA,ATLIXCO,5,400,4,409,1210
PUEBLA,ATLIXCO,3,382,2,387,1210
PUEBLA,ATLIXCO,3,317,4,324,1111
PUEBLA,ATLIXCO,9,314,4,327,1111
PUEBLA,ATLIXCO,13,361,11,385,1637
PUEBLA,ATLIXCO,8,313,8,329,1636
PUEBLA,ATLIXCO,15,226,13,254,1940
PUEBLA,ATLIXCO,9,207,7,223,1939
PUEBLA,ATLIXCO,13,124,2,139,1968
PUEBLA,ATLIXCO,19,89,1,109,1968
PUEBLA,ATLIXCO,13,127,2,142,1968
PUEBLA,ATLIXCO,11,154,1,166,1967
PUEBLA,ATLIXCO,13,175,4,192,1967
PUEBLA,ATLIXCO,32,239,5,276,1754
PUEBLA,ATLIXCO,25,222,5,252,1754
PUEBLA,ATLIXCO,9,178,3,190,1428
PUEBLA,ATLIXCO,12,204,6,222,1427
PUEBLA,ATLIXCO,4,214,1,219,1427
PUEBLA,ATLIXCO,15,170,1,186,1561
PUEBLA,ATLIXCO,20,192,4,216,1560
PUEBLA,ATLIXCO,4,117,3,124,1285
PUEBLA,ATLIXCO,7,123,2,132,1285
PUEBLA,ATLIXCO,14,211,8,233,1899
PUEBLA,ATLIXCO,8,220,5,233,1898
PUEBLA,ATLIXCO,11,273,5,289,2035
PUEBLA,ATLIXCO,17,264,9,290,2034
PUEBLA,ATLIXCO,6,207,13,226,1398
PUEBLA,ATLIXCO,9,242,7,258,1398
PUEBLA,ATLIXCO,4,217,9,230,1398
PUEBLA,ATLIXCO,9,239,5,253,1538
PUEBLA,ATLIXCO,11,265,3,279,1538
PUEBLA,ATLIXCO,6,244,3,253,1538
PUEBLA,ATLIXCO,22,450,10,482,2017
PUEBLA,ATLIXCO,10,325,13,348,1963
PUEBLA,ATLIXCO,3,306,13,322,1963
PUEBLA,ATLIXCO,7,320,7,334,1480
PUEBLA,ATLIXCO,16,314,4,334,1480
PUEBLA,ATLIXCO,8,323,5,336,1480
PUEBLA,ATLIXCO,17,229,12,258,2009
PUEBLA,ATLIXCO,13,256,4,273,2009
PUEBLA,ATLIXCO,7,388,5,400,1783
PUEBLA,ATLIXCO,14,356,4,374,1783
PUEBLA,ATLIXCO,9,283,3,295,1420
PUEBLA,ATLIXCO,4,292,4,300,1420
PUEBLA,ATLIXCO,5,275,7,287,1420
PUEBLA,ATLIXCO,7,315,6,328,1778
PUEBLA,ATLIXCO,7,327,5,339,1777
PUEBLA,ATLIXCO,11,161,2,174,1503
PUEBLA,ATLIXCO,11,110,7,128,1503
PUEBLA,ATLIXCO,13,108,4,125,1659
PUEBLA,ATLIXCO,14,113,7,134,1659
PUEBLA,ATLIXCO,23,151,17,191,1789
PUEBLA,ATLIXCO,26,127,9,162,1789
PUEBLA,ATLIXCO,34,281,12,327,2074
PUEBLA,ATLIXCO,20,251,6,277,2074
PUEBLA,ATLIXCO,25,187,8,220,1239
PUEBLA,ATLIXCO,16,202,7,225,1238
PUEBLA,ATLIXCO,6,254,6,266,1510
PUEBLA,ATLIXCO,9,247,5,261,1510
PUEBLA,ACATLAN DE OSORIO,13,533,8,554,1912
PUEBLA,ACATLAN DE OSORIO,4,544,2,550,1912
PUEBLA,ACATLAN DE OSORIO,9,543,7,559,1912
PUEBLA,ACATLAN DE OSORIO,12,533,4,549,1852
PUEBLA,ACATLAN DE OSORIO,12,472,9,493,1851
PUEBLA,ACATLAN DE OSORIO,9,329,1,339,1432
PUEBLA,ACATLAN DE OSORIO,7,391,3,401,1432
PUEBLA,ACATLAN DE OSORIO,1,342,3,346,1431
PUEBLA,ACATLAN DE OSORIO,26,808,12,846,0
PUEBLA,ACATLAN DE OSORIO,12,407,14,433,1546
PUEBLA,ACATLAN DE OSORIO,13,359,10,382,1546
PUEBLA,ACATLAN DE OSORIO,16,436,6,458,2086
PUEBLA,ACATLAN DE OSORIO,3,188,4,195,1456
PUEBLA,ACATLAN DE OSORIO,7,173,2,182,1455
PUEBLA,ACATLAN DE OSORIO,12,264,1,277,1455
PUEBLA,ACATLAN DE OSORIO,8,81,7,96,1784
PUEBLA,ACATLAN DE OSORIO,6,67,1,74,1207
PUEBLA,ACATLAN DE OSORIO,12,120,7,139,1206
PUEBLA,ACATLAN DE OSORIO,10,482,16,508,1762
PUEBLA,ACATLAN DE OSORIO,12,338,7,357,1314
PUEBLA,ACATLAN DE OSORIO,12,347,5,364,1707
PUEBLA,ACATLAN DE OSORIO,20,332,6,358,1707
PUEBLA,ACATLAN DE OSORIO,11,287,5,303,1706
PUEBLA,ACATLAN DE OSORIO,20,272,8,300,1001
PUEBLA,ACATLAN DE OSORIO,13,227,6,246,1134
PUEBLA,ACATLAN DE OSORIO,5,213,9,227,1133
PUEBLA,ACATLAN DE OSORIO,8,240,3,251,1166
PUEBLA,ACATLAN DE OSORIO,15,290,3,308,1434
PUEBLA,ACATLAN DE OSORIO,10,335,5,350,1433
PUEBLA,ACATLAN DE OSORIO,10,373,7,390,1532
PUEBLA,ACATLAN DE OSORIO,9,386,8,403,1531
PUEBLA,ACATLAN DE OSORIO,11,392,5,408,1531
PUEBLA,ACATLAN DE OSORIO,12,417,10,439,1672
PUEBLA,ACATLAN DE OSORIO,12,406,7,425,1671
PUEBLA,ACATLAN DE OSORIO,11,448,8,467,1671
PUEBLA,ACATLAN DE OSORIO,13,341,2,356,1414
PUEBLA,ACATLAN DE OSORIO,1,366,9,376,1413
PUEBLA,ACATLAN DE OSORIO,9,315,1,325,1393
PUEBLA,ACATLAN DE OSORIO,10,265,2,277,1393
PUEBLA,ACATLAN DE OSORIO,7,288,1,296,1392
PUEBLA,ACATLAN DE OSORIO,7,425,8,440,1176
PUEBLA,ACATLAN DE OSORIO,14,450,15,479,2048
PUEBLA,ACATLAN DE OSORIO,20,438,17,475,2047
PUEBLA,ACATLAN DE OSORIO,21,401,5,427,1182
PUEBLA,ACATLAN DE OSORIO,12,199,3,214,1155
PUEBLA,ACATLAN DE OSORIO,6,187,5,198,1154
PUEBLA,ACATLAN DE OSORIO,7,428,10,445,1766
PUEBLA,ACATLAN DE OSORIO,7,458,9,474,1766
PUEBLA,ACATLAN DE OSORIO,3,450,13,466,1765
PUEBLA,ACATLAN DE OSORIO,12,458,16,486,1704
PUEBLA,ACATLAN DE OSORIO,12,482,12,506,1704
PUEBLA,ACATLAN DE OSORIO,11,439,14,464,1704
PUEBLA,ACATLAN DE OSORIO,13,475,11,499,1569
PUEBLA,ACATLAN DE OSORIO,14,471,11,496,1569
PUEBLA,ACATLAN DE OSORIO,7,441,7,455,1569
PUEBLA,ACATLAN DE OSORIO,9,428,8,445,1335
PUEBLA,ACATLAN DE OSORIO,2,470,2,474,1335
PUEBLA,ACATLAN DE OSORIO,13,237,6,256,1629
PUEBLA,ACATLAN DE OSORIO,15,210,6,231,1628
PUEBLA,ACATLAN DE OSORIO,6,175,4,185,1628
PUEBLA,ACATLAN DE OSORIO,7,194,1,202,1407
PUEBLA,ACATLAN DE OSORIO,9,210,2,221,1407
PUEBLA,ACATLAN DE OSORIO,5,185,3,193,1406
PUEBLA,ACATLAN DE OSORIO,10,263,8,281,1493
PUEBLA,ACATLAN DE OSORIO,8,258,8,274,1492
PUEBLA,ACATLAN DE OSORIO,11,347,7,365,1449
PUEBLA,ACATLAN DE OSORIO,18,319,5,342,1449
PUEBLA,ACATLAN DE OSORIO,5,370,9,384,1499
PUEBLA,ACATLAN DE OSORIO,8,354,3,365,1499
PUEBLA,ACATLAN DE OSORIO,11,333,9,353,1498
PUEBLA,ACATLAN DE OSORIO,8,361,15,384,1498
PUEBLA,ACATLAN DE OSORIO,19,104,2,125,498
PUEBLA,ACATLAN DE OSORIO,18,402,4,424,1358
PUEBLA,ACATLAN DE OSORIO,3,356,6,365,1357
PUEBLA,ACATLAN DE OSORIO,4,272,4,280,1070
PUEBLA,ACATLAN DE OSORIO,9,301,5,315,1069
PUEBLA,ACATLAN DE OSORIO,3,287,4,294,1929
PUEBLA,ACATLAN DE OSORIO,4,321,3,328,1929
PUEBLA,ACATLAN DE OSORIO,7,396,14,417,1617
PUEBLA,ACATLAN DE OSORIO,8,384,7,399,1616
PUEBLA,ACATLAN DE OSORIO,4,324,3,331,1958
PUEBLA,ACATLAN DE OSORIO,8,344,11,363,1957
PUEBLA,ACATLAN DE OSORIO,11,393,8,412,1582
PUEBLA,ACATLAN DE OSORIO,11,405,10,426,1582
PUEBLA,ACATLAN DE OSORIO,5,87,4,96,776
PUEBLA,ACATLAN DE OSORIO,11,98,7,116,470
PUEBLA,ACATLAN DE OSORIO,8,433,6,447,1457
PUEBLA,ACATLAN DE OSORIO,7,386,11,404,1457
PUEBLA,ACATLAN DE OSORIO,5,444,3,452,1394
PUEBLA,ACATLAN DE OSORIO,21,455,0,476,1394
PUEBLA,ACATLAN DE OSORIO,5,438,4,447,1593
PUEBLA,ACATLAN DE OSORIO,13,358,3,374,1593
PUEBLA,ACATLAN DE OSORIO,17,373,2,392,1592
PUEBLA,ACATLAN DE OSORIO,11,363,6,380,1646
PUEBLA,ACATLAN DE OSORIO,3,364,1,368,1645
PUEBLA,ACATLAN DE OSORIO,15,391,2,408,1645
PUEBLA,ACATLAN DE OSORIO,10,274,7,291,696
PUEBLA,ACATLAN DE OSORIO,17,345,7,369,1549
PUEBLA,ACATLAN DE OSORIO,10,282,3,295,1548
PUEBLA,ACATLAN DE OSORIO,13,329,4,346,1548
PUEBLA,ACATLAN DE OSORIO,20,374,3,397,1344
PUEBLA,ACATLAN DE OSORIO,14,330,4,348,1344
PUEBLA,ACATLAN DE OSORIO,12,360,3,375,1344
PUEBLA,ACATLAN DE OSORIO,9,248,1,258,1083
PUEBLA,ACATLAN DE OSORIO,9,268,3,280,1082
PUEBLA,ACATLAN DE OSORIO,13,320,3,336,1830
PUEBLA,ACATLAN DE OSORIO,12,323,5,340,1830
PUEBLA,ACATLAN DE OSORIO,10,314,2,326,1402
PUEBLA,ACATLAN DE OSORIO,10,317,4,331,1402
PUEBLA,ACATLAN DE OSORIO,15,328,3,346,1401
PUEBLA,ACATLAN DE OSORIO,15,388,10,413,1821
PUEBLA,ACATLAN DE OSORIO,26,358,7,391,1820
PUEBLA,ACATLAN DE OSORIO,28,413,3,444,1934
PUEBLA,ACATLAN DE OSORIO,20,438,5,463,1934
PUEBLA,ACATLAN DE OSORIO,9,380,2,391,1922
PUEBLA,ACATLAN DE OSORIO,18,518,5,541,1922
PUEBLA,ACATLAN DE OSORIO,23,362,2,387,1399
PUEBLA,ACATLAN DE OSORIO,13,314,2,329,1399
PUEBLA,ACATLAN DE OSORIO,8,283,1,292,1254
PUEBLA,ACATLAN DE OSORIO,7,260,0,267,1254
PUEBLA,ACATLAN DE OSORIO,9,545,8,562,2062
PUEBLA,ACATLAN DE OSORIO,9,517,3,529,2062
PUEBLA,ACATLAN DE OSORIO,20,510,8,538,2000
PUEBLA,ACATLAN DE OSORIO,17,436,11,464,1999
PUEBLA,ACATLAN DE OSORIO,6,381,5,392,1594
PUEBLA,ACATLAN DE OSORIO,12,317,7,336,1594
PUEBLA,ACATLAN DE OSORIO,16,341,10,367,1390
PUEBLA,ACATLAN DE OSORIO,12,334,11,357,1389
PUEBLA,ACATLAN DE OSORIO,6,375,7,388,1687
PUEBLA,ACATLAN DE OSORIO,12,334,6,352,1686
PUEBLA,ACATLAN DE OSORIO,8,309,11,328,1352
PUEBLA,ACATLAN DE OSORIO,11,282,7,300,1351
PUEBLA,ACATLAN DE OSORIO,16,313,4,333,1787
PUEBLA,ACATLAN DE OSORIO,12,329,5,346,1787
PUEBLA,ACATLAN DE OSORIO,9,234,2,245,1687
PUEBLA,ACATLAN DE OSORIO,16,243,9,268,1687
PUEBLA,ACATLAN DE OSORIO,19,446,8,473,1711
PUEBLA,ACATLAN DE OSORIO,1,137,1,139,1547
PUEBLA,ACATLAN DE OSORIO,4,114,3,121,1546
PUEBLA,ACATLAN DE OSORIO,3,136,0,139,1546
PUEBLA,ACATLAN DE OSORIO,7,367,5,379,1952
PUEBLA,ACATLAN DE OSORIO,3,363,0,366,1952
PUEBLA,ACATLAN DE OSORIO,15,413,12,440,1910
PUEBLA,ACATLAN DE OSORIO,16,358,3,377,1910
PUEBLA,ACATLAN DE OSORIO,16,409,9,434,1910
PUEBLA,ACATLAN DE OSORIO,19,312,20,351,1594
PUEBLA,ACATLAN DE OSORIO,17,361,17,395,1593
PUEBLA,ACATLAN DE OSORIO,8,292,5,305,1287
PUEBLA,ACATLAN DE OSORIO,7,311,2,320,1286
PUEBLA,ACATLAN DE OSORIO,11,370,12,393,2003
PUEBLA,ACATLAN DE OSORIO,9,342,9,360,2003
PUEBLA,ACATLAN DE OSORIO,13,321,4,338,2002
PUEBLA,ACATLAN DE OSORIO,9,250,8,267,1964
PUEBLA,ACATLAN DE OSORIO,9,280,4,293,1963
PUEBLA,ACATLAN DE OSORIO,12,284,14,310,1150
PUEBLA,ACATLAN DE OSORIO,8,239,11,258,1150
PUEBLA,ACATLAN DE OSORIO,5,366,5,376,1492
PUEBLA,ACATLAN DE OSORIO,6,352,10,368,1491
PUEBLA,ACATLAN DE OSORIO,27,395,1,423,1436
PUEBLA,ACATLAN DE OSORIO,34,400,4,438,1436
PUEBLA,ACATLAN DE OSORIO,15,315,4,334,1724
PUEBLA,ACATLAN DE OSORIO,36,326,9,371,1723
PUEBLA,ACATLAN DE OSORIO,13,475,5,493,1825
PUEBLA,ACATLAN DE OSORIO,24,511,6,541,1825
PUEBLA,ACATLAN DE OSORIO,12,643,16,671,1824
PUEBLA,ACATLAN DE OSORIO,15,356,2,373,1464
PUEBLA,ACATLAN DE OSORIO,22,356,4,382,1464
PUEBLA,ACATLAN DE OSORIO,8,448,3,459,1463
PUEBLA,ACATLAN DE OSORIO,20,406,2,428,1520
PUEBLA,ACATLAN DE OSORIO,21,435,9,465,1520
PUEBLA,ACATLAN DE OSORIO,14,535,4,553,1706
PUEBLA,ACATLAN DE OSORIO,11,331,7,349,955
PUEBLA,ACATLAN DE OSORIO,4,239,1,244,1709
PUEBLA,ACATLAN DE OSORIO,11,245,3,259,1708
PUEBLA,ACATLAN DE OSORIO,9,234,0,243,1892
PUEBLA,ACATLAN DE OSORIO,8,255,7,270,1892
PUEBLA,ACATLAN DE OSORIO,9,33,0,42,1281
PUEBLA,ACATLAN DE OSORIO,10,43,0,53,1280
PUEBLA,ACATLAN DE OSORIO,13,161,1,175,1268
PUEBLA,ACATLAN DE OSORIO,5,73,3,81,1268
PUEBLA,ACATLAN DE OSORIO,8,474,9,491,1388
PUEBLA,ACATLAN DE OSORIO,24,312,3,339,1068
PUEBLA,ACATLAN DE OSORIO,10,332,5,347,1623
PUEBLA,ACATLAN DE OSORIO,18,363,3,384,1623
PUEBLA,ACATLAN DE OSORIO,17,338,5,360,1623
PUEBLA,ACATLAN DE OSORIO,9,400,5,414,1736
PUEBLA,ACATLAN DE OSORIO,7,355,10,372,1736
PUEBLA,ACATLAN DE OSORIO,9,420,5,434,1736
PUEBLA,ACATLAN DE OSORIO,9,364,10,383,1285
PUEBLA,ACATLAN DE OSORIO,10,426,4,440,1995
PUEBLA,ACATLAN DE OSORIO,6,385,7,398,1994
PUEBLA,ACATLAN DE OSORIO,14,393,7,414,1994
PUEBLA,ACATLAN DE OSORIO,11,371,4,386,1671
PUEBLA,ACATLAN DE OSORIO,13,412,3,428,1671
PUEBLA,ACATLAN DE OSORIO,6,409,0,415,1670
PUEBLA,ACATLAN DE OSORIO,5,250,6,261,1626
PUEBLA,ACATLAN DE OSORIO,4,229,4,237,1625
PUEBLA,ACATLAN DE OSORIO,2,413,7,422,1611
PUEBLA,ACATLAN DE OSORIO,9,400,1,410,1610
PUEBLA,ACATLAN DE OSORIO,3,314,1,318,1061
PUEBLA,ACATLAN DE OSORIO,9,245,3,257,1061
PUEBLA,TEHUACAN,12,274,9,295,1620
PUEBLA,TEHUACAN,14,302,6,322,1620
PUEBLA,TEHUACAN,10,360,3,373,1409
PUEBLA,TEHUACAN,10,319,8,337,1409
PUEBLA,TEHUACAN,13,378,6,397,1409
PUEBLA,TEHUACAN,19,421,6,446,1613
PUEBLA,TEHUACAN,10,431,5,446,1612
PUEBLA,TEHUACAN,9,198,3,210,1158
PUEBLA,TEHUACAN,6,213,0,219,1157
PUEBLA,TEHUACAN,12,328,7,347,1094
PUEBLA,TEHUACAN,8,307,6,321,1093
PUEBLA,TEHUACAN,28,405,11,444,1520
PUEBLA,TEHUACAN,18,354,10,382,1519
PUEBLA,TEHUACAN,32,474,13,519,1834
PUEBLA,TEHUACAN,20,449,12,481,1834
PUEBLA,TEHUACAN,34,531,15,580,1833
PUEBLA,TEHUACAN,20,445,11,476,1442
PUEBLA,TEHUACAN,17,489,3,509,1441
PUEBLA,TEHUACAN,22,349,17,388,1979
PUEBLA,TEHUACAN,18,361,10,389,1978
PUEBLA,TEHUACAN,31,341,14,386,1978
PUEBLA,TEHUACAN,15,343,2,360,1850
PUEBLA,TEHUACAN,15,331,7,353,1850
PUEBLA,TEHUACAN,5,321,3,329,1850
PUEBLA,TEHUACAN,12,317,5,334,1850
PUEBLA,TEHUACAN,10,306,5,321,1850
PUEBLA,TEHUACAN,3,309,9,321,1850
PUEBLA,TEHUACAN,11,304,8,323,1849
PUEBLA,TEHUACAN,5,295,7,307,1849
PUEBLA,TEHUACAN,11,307,5,323,1524
PUEBLA,TEHUACAN,15,301,7,323,1524
PUEBLA,TEHUACAN,21,264,7,292,1743
PUEBLA,TEHUACAN,15,269,4,288,1743
PUEBLA,TEHUACAN,11,322,2,335,1742
PUEBLA,TEHUACAN,15,281,3,299,1742
PUEBLA,TEHUACAN,14,312,2,328,1742
PUEBLA,TEHUACAN,9,292,2,303,1742
PUEBLA,TEHUACAN,12,294,3,309,1815
PUEBLA,TEHUACAN,13,339,5,357,1815
PUEBLA,TEHUACAN,16,282,7,305,1815
PUEBLA,TEHUACAN,17,299,5,321,1814
PUEBLA,TEHUACAN,14,385,1,400,1638
PUEBLA,TEHUACAN,12,360,2,374,1637
PUEBLA,TEHUACAN,7,379,3,389,1637
PUEBLA,TEHUACAN,18,306,5,329,1637
PUEBLA,TEHUACAN,15,292,9,316,1648
PUEBLA,TEHUACAN,17,328,5,350,1647
PUEBLA,TEHUACAN,20,364,3,387,1767
PUEBLA,TEHUACAN,11,392,17,420,1766
PUEBLA,TEHUACAN,12,324,5,341,1949
PUEBLA,TEHUACAN,12,313,11,336,1619
PUEBLA,TEHUACAN,11,322,4,337,1618
PUEBLA,TEHUACAN,17,324,4,345,1618
PUEBLA,TEHUACAN,16,394,7,417,1696
PUEBLA,TEHUACAN,10,348,4,362,1695
PUEBLA,TEHUACAN,19,400,4,423,1897
PUEBLA,TEHUACAN,18,402,6,426,1896
PUEBLA,TEHUACAN,26,328,0,354,1581
PUEBLA,TEHUACAN,13,330,5,348,1580
PUEBLA,TEHUACAN,15,368,2,385,1665
PUEBLA,TEHUACAN,18,361,4,383,1665
PUEBLA,TEHUACAN,21,358,3,382,1756
PUEBLA,TEHUACAN,27,367,1,395,1755
PUEBLA,TEHUACAN,12,327,5,344,1755
PUEBLA,TEHUACAN,14,385,7,406,1755
PUEBLA,TEHUACAN,20,239,3,262,1424
PUEBLA,TEHUACAN,16,280,2,298,1423
PUEBLA,TEHUACAN,63,1726,22,1811,0
PUEBLA,TEHUACAN,22,386,6,414,1910
PUEBLA,TEHUACAN,27,349,9,385,1910
PUEBLA,TEHUACAN,19,372,5,396,1754
PUEBLA,TEHUACAN,19,376,7,402,1753
PUEBLA,TEHUACAN,9,288,3,300,1443
PUEBLA,TEHUACAN,12,308,4,324,1443
PUEBLA,TEHUACAN,20,351,9,380,1334
PUEBLA,TEHUACAN,12,297,6,315,1333
PUEBLA,TEHUACAN,11,320,4,335,1333
PUEBLA,TEHUACAN,12,368,0,380,1807
PUEBLA,TEHUACAN,7,384,0,391,1807
PUEBLA,TEHUACAN,13,261,4,278,1540
PUEBLA,TEHUACAN,19,261,3,283,1540
PUEBLA,TEHUACAN,11,275,2,288,1428
PUEBLA,TEHUACAN,25,264,3,292,1428
PUEBLA,TEHUACAN,9,251,1,261,1193
PUEBLA,TEHUACAN,12,259,4,275,1193
PUEBLA,TEHUACAN,15,354,9,378,1601
PUEBLA,TEHUACAN,15,383,5,403,1600
PUEBLA,TEHUACAN,19,296,2,317,1518
PUEBLA,TEHUACAN,20,321,5,346,1517
PUEBLA,TEHUACAN,23,361,4,388,1921
PUEBLA,TEHUACAN,19,356,7,382,1920
PUEBLA,TEHUACAN,17,303,6,326,1468
PUEBLA,TEHUACAN,9,348,4,361,1468
PUEBLA,TEHUACAN,6,314,7,327,1468
PUEBLA,TEHUACAN,20,313,5,338,2018
PUEBLA,TEHUACAN,7,291,4,302,2017
PUEBLA,TEHUACAN,18,336,7,361,2017
PUEBLA,TEHUACAN,7,285,6,298,2017
PUEBLA,TEHUACAN,2,339,7,348,2017
PUEBLA,TEHUACAN,8,282,2,292,2017
PUEBLA,TEHUACAN,10,269,3,282,1312
PUEBLA,TEHUACAN,17,304,2,323,1312
PUEBLA,TEHUACAN,9,239,4,252,1042
PUEBLA,TEHUACAN,10,250,6,266,1041
PUEBLA,TEHUACAN,28,439,3,470,1898
PUEBLA,TEHUACAN,22,462,15,499,1898
PUEBLA,TEHUACAN,12,196,1,209,1038
PUEBLA,TEHUACAN,10,226,6,242,1038
PUEBLA,TEHUACAN,12,282,4,298,1410
PUEBLA,TEHUACAN,10,277,5,292,1410
PUEBLA,TEHUACAN,19,274,10,303,1433
PUEBLA,TEHUACAN,9,293,5,307,1432
PUEBLA,TEHUACAN,12,336,5,353,1523
PUEBLA,TEHUACAN,9,267,6,282,1523
PUEBLA,TEHUACAN,28,481,6,515,1894
PUEBLA,TEHUACAN,29,458,8,495,1893
PUEBLA,TEHUACAN,12,376,4,392,1644
PUEBLA,TEHUACAN,12,384,9,405,1643
PUEBLA,TEHUACAN,15,307,2,324,1940
PUEBLA,TEHUACAN,8,314,7,329,1940
PUEBLA,TEHUACAN,14,311,1,326,1940
PUEBLA,TEHUACAN,8,315,2,325,1940
PUEBLA,TEHUACAN,8,314,5,327,1939
PUEBLA,TEHUACAN,19,325,2,346,1939
PUEBLA,TEHUACAN,18,321,6,345,1840
PUEBLA,TEHUACAN,26,341,4,371,1839
PUEBLA,TEHUACAN,8,318,4,330,1279
PUEBLA,TEHUACAN,16,309,3,328,1279
PUEBLA,TEHUACAN,13,310,6,329,1479
PUEBLA,TEHUACAN,9,335,3,347,1479
PUEBLA,TEHUACAN,10,291,2,303,1211
PUEBLA,TEHUACAN,6,257,3,266,1210
PUEBLA,TEHUACAN,18,383,3,404,1798
PUEBLA,TEHUACAN,15,384,10,409,1797
PUEBLA,TEHUACAN,15,271,4,290,1864
PUEBLA,TEHUACAN,7,257,4,268,1864
PUEBLA,TEHUACAN,8,290,4,302,1864
PUEBLA,TEHUACAN,11,259,1,271,1864
PUEBLA,TEHUACAN,8,236,6,250,1864
PUEBLA,TEHUACAN,14,183,7,204,1336
PUEBLA,TEHUACAN,12,209,12,233,1336
PUEBLA,TEHUACAN,12,245,4,261,1457
PUEBLA,TEHUACAN,15,252,11,278,1457
PUEBLA,TEHUACAN,13,211,8,232,1457
PUEBLA,TEHUACAN,7,255,9,271,1619
PUEBLA,TEHUACAN,10,266,5,281,1619
PUEBLA,TEHUACAN,43,230,27,300,1149
PUEBLA,TEHUACAN,10,265,3,278,1793
PUEBLA,TEHUACAN,10,269,5,284,1792
PUEBLA,TEHUACAN,12,256,7,275,1792
PUEBLA,TEHUACAN,13,280,5,298,1792
PUEBLA,TEHUACAN,11,248,7,266,1792
PUEBLA,TEHUACAN,4,175,7,186,1428
PUEBLA,TEHUACAN,10,200,5,215,1428
PUEBLA,TEHUACAN,7,158,3,168,1427
PUEBLA,TEHUACAN,12,300,9,321,1467
PUEBLA,TEHUACAN,15,327,8,350,1466
PUEBLA,TEHUACAN,11,312,9,332,1911
PUEBLA,TEHUACAN,15,326,9,350,1910
PUEBLA,TEHUACAN,3,172,8,183,1132
PUEBLA,TEHUACAN,13,218,9,240,1132
PUEBLA,TEHUACAN,16,366,10,392,1313
PUEBLA,TEHUACAN,13,368,3,384,1313
PUEBLA,TEHUACAN,8,331,8,347,1460
PUEBLA,TEHUACAN,9,406,13,428,1460
PUEBLA,TEHUACAN,11,272,9,292,1459
PUEBLA,TEHUACAN,17,383,6,406,1580
PUEBLA,TEHUACAN,24,387,9,420,1580
PUEBLA,TEHUACAN,10,368,8,386,1579
PUEBLA,TEHUACAN,11,481,11,503,1649
PUEBLA,TEHUACAN,13,453,16,482,1648
PUEBLA,TEHUACAN,11,476,13,500,1648
PUEBLA,TEHUACAN,7,338,1,346,1743
PUEBLA,TEHUACAN,9,321,2,332,1742
PUEBLA,TEHUACAN,11,264,5,280,1524
PUEBLA,TEHUACAN,9,282,3,294,1524
PUEBLA,TEHUACAN,17,413,26,456,1642
PUEBLA,TEHUACAN,11,460,24,495,1642
PUEBLA,TEHUACAN,9,456,10,475,1641
PUEBLA,TEHUACAN,5,260,12,277,1404
PUEBLA,TEHUACAN,11,280,7,298,1403
PUEBLA,TEHUACAN,19,234,6,259,1403
PUEBLA,TEHUACAN,9,253,3,265,1349
PUEBLA,TEHUACAN,8,261,11,280,1348
PUEBLA,TEHUACAN,8,345,7,360,1872
PUEBLA,TEHUACAN,5,338,13,356,1872
PUEBLA,TEHUACAN,12,249,9,270,1811
PUEBLA,TEHUACAN,13,314,8,335,1811
PUEBLA,TEHUACAN,14,377,5,396,1874
PUEBLA,TEHUACAN,12,376,7,395,1874
PUEBLA,TEHUACAN,11,444,8,463,1817
PUEBLA,TEHUACAN,8,460,13,481,1817
PUEBLA,TEHUACAN,12,471,9,492,1817
PUEBLA,TEHUACAN,16,292,13,321,1415
PUEBLA,TEHUACAN,12,336,14,362,1415
PUEBLA,TEHUACAN,10,290,14,314,1414
QUERÉTARO,CADEREYTA DE MONTES,13,204,2,219,1413
QUERÉTARO,CADEREYTA DE MONTES,9,200,1,210,1412
QUERÉTARO,CADEREYTA DE MONTES,7,154,3,164,1806
QUERÉTARO,CADEREYTA DE MONTES,8,193,7,208,1805
QUERÉTARO,CADEREYTA DE MONTES,9,176,6,191,1758
QUERÉTARO,CADEREYTA DE MONTES,8,209,2,219,1757
QUERÉTARO,CADEREYTA DE MONTES,10,192,0,202,1636
QUERÉTARO,CADEREYTA DE MONTES,15,173,6,194,1635
QUERÉTARO,CADEREYTA DE MONTES,12,137,4,153,1101
QUERÉTARO,CADEREYTA DE MONTES,14,124,2,140,1100
QUERÉTARO,CADEREYTA DE MONTES,20,147,2,169,1070
QUERÉTARO,CADEREYTA DE MONTES,19,144,1,164,1069
QUERÉTARO,CADEREYTA DE MONTES,46,383,5,434,0
QUERÉTARO,CADEREYTA DE MONTES,30,153,3,186,1249
QUERÉTARO,CADEREYTA DE MONTES,18,138,1,157,1248
QUERÉTARO,CADEREYTA DE MONTES,2,119,1,122,1964
QUERÉTARO,CADEREYTA DE MONTES,2,110,4,116,1964
QUERÉTARO,CADEREYTA DE MONTES,13,126,4,143,1962
QUERÉTARO,CADEREYTA DE MONTES,9,139,11,159,1962
QUERÉTARO,CADEREYTA DE MONTES,8,151,5,164,1715
QUERÉTARO,CADEREYTA DE MONTES,11,144,2,157,1715
QUERÉTARO,CADEREYTA DE MONTES,13,126,8,147,1715
QUERÉTARO,CADEREYTA DE MONTES,13,145,4,162,1474
QUERÉTARO,CADEREYTA DE MONTES,7,117,3,127,1473
QUERÉTARO,CADEREYTA DE MONTES,9,124,9,142,1473
QUERÉTARO,CADEREYTA DE MONTES,14,136,6,156,1865
QUERÉTARO,CADEREYTA DE MONTES,11,151,4,166,1864
QUERÉTARO,CADEREYTA DE MONTES,13,218,3,234,1609
QUERÉTARO,CADEREYTA DE MONTES,8,224,2,234,1609
QUERÉTARO,CADEREYTA DE MONTES,12,244,9,265,1510
QUERÉTARO,CADEREYTA DE MONTES,14,221,5,240,1510
QUERÉTARO,CADEREYTA DE MONTES,10,95,3,108,1641
QUERÉTARO,CADEREYTA DE MONTES,17,115,2,134,1640
QUERÉTARO,CADEREYTA DE MONTES,25,138,2,165,1412
QUERÉTARO,CADEREYTA DE MONTES,14,116,4,134,1411
QUERÉTARO,CADEREYTA DE MONTES,7,269,4,280,1976
QUERÉTARO,CADEREYTA DE MONTES,9,251,7,267,1976
QUERÉTARO,CADEREYTA DE MONTES,28,121,13,162,1082
QUERÉTARO,CADEREYTA DE MONTES,11,170,6,187,1082
QUERÉTARO,CADEREYTA DE MONTES,5,43,5,53,1596
QUERÉTARO,CADEREYTA DE MONTES,9,53,1,63,1596
QUERÉTARO,CADEREYTA DE MONTES,6,54,4,64,1596
QUERÉTARO,CADEREYTA DE MONTES,20,117,2,139,1641
QUERÉTARO,CADEREYTA DE MONTES,12,107,2,121,1640
QUERÉTARO,CADEREYTA DE MONTES,12,97,2,111,1949
QUERÉTARO,CADEREYTA DE MONTES,9,118,1,128,1949
QUERÉTARO,CADEREYTA DE MONTES,24,90,14,128,1599
QUERÉTARO,CADEREYTA DE MONTES,16,88,2,106,1598
QUERÉTARO,CADEREYTA DE MONTES,13,84,4,101,1727
QUERÉTARO,CADEREYTA DE MONTES,11,84,1,96,1727
QUERÉTARO,CADEREYTA DE MONTES,10,163,5,178,1904
QUERÉTARO,CADEREYTA DE MONTES,13,157,3,173,1903
QUERÉTARO,CADEREYTA DE MONTES,14,164,9,187,1926
QUERÉTARO,CADEREYTA DE MONTES,12,166,3,181,1926
QUERÉTARO,CADEREYTA DE MONTES,15,74,3,92,1489
QUERÉTARO,CADEREYTA DE MONTES,5,103,6,114,1489
QUERÉTARO,CADEREYTA DE MONTES,7,99,0,106,1448
QUERÉTARO,CADEREYTA DE MONTES,3,86,0,89,1448
QUERÉTARO,CADEREYTA DE MONTES,7,74,1,82,1447
QUERÉTARO,CADEREYTA DE MONTES,19,80,1,100,1586
QUERÉTARO,CADEREYTA DE MONTES,11,80,3,94,1586
QUERÉTARO,CADEREYTA DE MONTES,10,63,2,75,1213
QUERÉTARO,CADEREYTA DE MONTES,9,66,2,77,1213
QUERÉTARO,CADEREYTA DE MONTES,9,206,0,215,1544
QUERÉTARO,CADEREYTA DE MONTES,8,170,7,185,1544
QUERÉTARO,CADEREYTA DE MONTES,13,261,6,280,1925
QUERÉTARO,CADEREYTA DE MONTES,10,227,3,240,1925
QUERÉTARO,CADEREYTA DE MONTES,6,104,3,113,1742
QUERÉTARO,CADEREYTA DE MONTES,9,146,1,156,1742
QUERÉTARO,CADEREYTA DE MONTES,9,187,3,199,1511
QUERÉTARO,CADEREYTA DE MONTES,5,185,3,193,1510
QUERÉTARO,CADEREYTA DE MONTES,4,113,2,119,1097
QUERÉTARO,CADEREYTA DE MONTES,2,119,1,122,1097
QUERÉTARO,CADEREYTA DE MONTES,9,137,15,161,1387
QUERÉTARO,CADEREYTA DE MONTES,4,119,10,133,1387
QUERÉTARO,CADEREYTA DE MONTES,1,84,4,89,1607
QUERÉTARO,CADEREYTA DE MONTES,1,97,3,101,1607
QUERÉTARO,CADEREYTA DE MONTES,1,88,0,89,1606
QUERÉTARO,CADEREYTA DE MONTES,11,159,6,176,1434
QUERÉTARO,CADEREYTA DE MONTES,2,185,2,189,1433
QUERÉTARO,CADEREYTA DE MONTES,8,184,8,200,1481
QUERÉTARO,CADEREYTA DE MONTES,14,128,7,149,1481
QUERÉTARO,CADEREYTA DE MONTES,8,72,13,93,1314
QUERÉTARO,CADEREYTA DE MONTES,6,115,2,123,1314
QUERÉTARO,CADEREYTA DE MONTES,7,100,4,111,1313
QUERÉTARO,CADEREYTA DE MONTES,7,177,6,190,1893
QUERÉTARO,CADEREYTA DE MONTES,6,153,11,170,1893
QUERÉTARO,CADEREYTA DE MONTES,8,164,3,175,1452
QUERÉTARO,CADEREYTA DE MONTES,7,126,0,133,1452
QUERÉTARO,CADEREYTA DE MONTES,11,176,3,190,1498
QUERÉTARO,CADEREYTA DE MONTES,16,187,2,205,1498
QUERÉTARO,CADEREYTA DE MONTES,7,204,6,217,1498
QUERÉTARO,CADEREYTA DE MONTES,7,99,1,107,1022
QUERÉTARO,CADEREYTA DE MONTES,15,120,3,138,1021
QUERÉTARO,CADEREYTA DE MONTES,12,165,2,179,1826
QUERÉTARO,CADEREYTA DE MONTES,11,163,0,174,1826
QUERÉTARO,CADEREYTA DE MONTES,11,190,3,204,1549
QUERÉTARO,CADEREYTA DE MONTES,10,154,0,164,1549
QUERÉTARO,CADEREYTA DE MONTES,4,247,2,253,1941
QUERÉTARO,CADEREYTA DE MONTES,19,272,5,296,1941
QUERÉTARO,CADEREYTA DE MONTES,8,278,7,293,1323
QUERÉTARO,CADEREYTA DE MONTES,12,299,5,316,1322
QUERÉTARO,CADEREYTA DE MONTES,12,149,2,163,1324
QUERÉTARO,CADEREYTA DE MONTES,14,155,5,174,1323
QUERÉTARO,CADEREYTA DE MONTES,12,166,2,180,1323
QUERÉTARO,CADEREYTA DE MONTES,5,230,4,239,1905
QUERÉTARO,CADEREYTA DE MONTES,5,177,3,185,1904
QUERÉTARO,CADEREYTA DE MONTES,10,192,2,204,1531
QUERÉTARO,CADEREYTA DE MONTES,7,173,6,186,1531
QUERÉTARO,CADEREYTA DE MONTES,23,198,3,224,1332
QUERÉTARO,CADEREYTA DE MONTES,18,188,4,210,1331
QUERÉTARO,CADEREYTA DE MONTES,7,146,3,156,1331
QUERÉTARO,CADEREYTA DE MONTES,9,324,5,338,1821
QUERÉTARO,CADEREYTA DE MONTES,13,335,6,354,1821
QUERÉTARO,CADEREYTA DE MONTES,9,156,3,168,1310
QUERÉTARO,CADEREYTA DE MONTES,16,156,5,177,1310
QUERÉTARO,CADEREYTA DE MONTES,13,218,7,238,1934
QUERÉTARO,CADEREYTA DE MONTES,20,208,7,235,1933
QUERÉTARO,CADEREYTA DE MONTES,7,115,2,124,1500
QUERÉTARO,CADEREYTA DE MONTES,10,144,2,156,1500
QUERÉTARO,CADEREYTA DE MONTES,9,139,2,150,1397
QUERÉTARO,CADEREYTA DE MONTES,14,131,4,149,1397
QUERÉTARO,CADEREYTA DE MONTES,15,126,8,149,1397
QUERÉTARO,CADEREYTA DE MONTES,10,167,8,185,1752
QUERÉTARO,CADEREYTA DE MONTES,16,167,3,186,1752
QUERÉTARO,CADEREYTA DE MONTES,12,301,1,314,1540
QUERÉTARO,CADEREYTA DE MONTES,12,256,1,269,1539
QUERÉTARO,CADEREYTA DE MONTES,7,319,0,326,1539
QUERÉTARO,CADEREYTA DE MONTES,9,246,6,261,1223
QUERÉTARO,CADEREYTA DE MONTES,15,252,7,274,1222
QUERÉTARO,CADEREYTA DE MONTES,7,180,10,197,1865
QUERÉTARO,CADEREYTA DE MONTES,8,164,4,176,1864
QUERÉTARO,CADEREYTA DE MONTES,16,235,5,256,1698
QUERÉTARO,CADEREYTA DE MONTES,12,188,4,204,1698
QUERÉTARO,CADEREYTA DE MONTES,10,142,4,156,1347
QUERÉTARO,CADEREYTA DE MONTES,3,150,5,158,1346
QUERÉTARO,CADEREYTA DE MONTES,9,147,5,161,1346
QUERÉTARO,CADEREYTA DE MONTES,8,123,4,135,1796
QUERÉTARO,CADEREYTA DE MONTES,8,88,5,101,1796
QUERÉTARO,CADEREYTA DE MONTES,7,68,2,77,1209
QUERÉTARO,CADEREYTA DE MONTES,14,80,5,99,1208
QUERÉTARO,CADEREYTA DE MONTES,14,70,7,91,1805
QUERÉTARO,CADEREYTA DE MONTES,8,54,5,67,1804
QUERÉTARO,CADEREYTA DE MONTES,10,108,2,120,1859
QUERÉTARO,CADEREYTA DE MONTES,7,98,0,105,1858
QUERÉTARO,CADEREYTA DE MONTES,8,84,4,96,1523
QUERÉTARO,CADEREYTA DE MONTES,6,100,7,113,1523
QUERÉTARO,CADEREYTA DE MONTES,1,104,5,110,1523
QUERÉTARO,CADEREYTA DE MONTES,8,80,3,91,1466
QUERÉTARO,CADEREYTA DE MONTES,8,54,1,63,1465
QUERÉTARO,CADEREYTA DE MONTES,17,113,2,132,1237
QUERÉTARO,CADEREYTA DE MONTES,6,142,6,154,1237
QUERÉTARO,CADEREYTA DE MONTES,11,234,8,253,1942
QUERÉTARO,CADEREYTA DE MONTES,8,191,14,213,1941
QUERÉTARO,CADEREYTA DE MONTES,13,392,6,411,1879
QUERÉTARO,CADEREYTA DE MONTES,12,406,7,425,1879
QUERÉTARO,CADEREYTA DE MONTES,9,282,8,299,1333
QUERÉTARO,CADEREYTA DE MONTES,11,283,9,303,1332
QUERÉTARO,CADEREYTA DE MONTES,8,188,6,202,1393
QUERÉTARO,CADEREYTA DE MONTES,7,175,3,185,1393
QUERÉTARO,CADEREYTA DE MONTES,9,170,3,182,1393
QUERÉTARO,CADEREYTA DE MONTES,12,363,3,378,1770
QUERÉTARO,CADEREYTA DE MONTES,14,339,6,359,1770
QUERÉTARO,CADEREYTA DE MONTES,16,222,7,245,1332
QUERÉTARO,CADEREYTA DE MONTES,6,229,6,241,1332
QUERÉTARO,CADEREYTA DE MONTES,8,270,1,279,1332
QUERÉTARO,CADEREYTA DE MONTES,9,121,2,132,1118
QUERÉTARO,CADEREYTA DE MONTES,6,119,2,127,1117
QUERÉTARO,CADEREYTA DE MONTES,22,220,1,243,1953
QUERÉTARO,CADEREYTA DE MONTES,22,170,2,194,1953
QUERÉTARO,CADEREYTA DE MONTES,6,28,1,35,1010
QUERÉTARO,CADEREYTA DE MONTES,10,26,1,37,1009
QUERÉTARO,CADEREYTA DE MONTES,10,216,2,228,1696
QUERÉTARO,CADEREYTA DE MONTES,18,221,2,241,1696
QUERÉTARO,SAN JUAN DEL RIO,13,158,2,173,1800
QUERÉTARO,SAN JUAN DEL RIO,12,127,1,140,1800
QUERÉTARO,SAN JUAN DEL RIO,12,133,1,146,1698
QUERÉTARO,SAN JUAN DEL RIO,14,168,1,183,1697
QUERÉTARO,SAN JUAN DEL RIO,10,166,0,176,1697
QUERÉTARO,SAN JUAN DEL RIO,5,204,4,213,1947
QUERÉTARO,SAN JUAN DEL RIO,16,210,2,228,1946
QUERÉTARO,SAN JUAN DEL RIO,20,166,2,188,1729
QUERÉTARO,SAN JUAN DEL RIO,15,161,1,177,1728
QUERÉTARO,SAN JUAN DEL RIO,9,129,1,139,1384
QUERÉTARO,SAN JUAN DEL RIO,8,114,2,124,1384
QUERÉTARO,SAN JUAN DEL RIO,11,122,1,134,1383
QUERÉTARO,SAN JUAN DEL RIO,8,87,2,97,1753
QUERÉTARO,SAN JUAN DEL RIO,8,105,0,113,1753
QUERÉTARO,SAN JUAN DEL RIO,3,73,1,77,1752
QUERÉTARO,SAN JUAN DEL RIO,7,252,2,261,1866
QUERÉTARO,SAN JUAN DEL RIO,9,226,9,244,1865
QUERÉTARO,SAN JUAN DEL RIO,11,255,6,272,1601
QUERÉTARO,SAN JUAN DEL RIO,7,214,4,225,1601
QUERÉTARO,SAN JUAN DEL RIO,20,183,2,205,1716
QUERÉTARO,SAN JUAN DEL RIO,13,193,5,211,1716
QUERÉTARO,SAN JUAN DEL RIO,14,211,1,226,1716
QUERÉTARO,SAN JUAN DEL RIO,15,163,0,178,1758
QUERÉTARO,SAN JUAN DEL RIO,18,182,1,201,1758
QUERÉTARO,SAN JUAN DEL RIO,17,163,0,180,1758
QUERÉTARO,SAN JUAN DEL RIO,20,186,0,206,1757
QUERÉTARO,SAN JUAN DEL RIO,16,159,0,175,1757
QUERÉTARO,SAN JUAN DEL RIO,14,181,1,196,1757
QUERÉTARO,SAN JUAN DEL RIO,10,156,1,167,1697
QUERÉTARO,SAN JUAN DEL RIO,20,194,3,217,1696
QUERÉTARO,SAN JUAN DEL RIO,22,268,0,290,1676
QUERÉTARO,SAN JUAN DEL RIO,24,254,2,280,1675
QUERÉTARO,SAN JUAN DEL RIO,8,200,3,211,1691
QUERÉTARO,SAN JUAN DEL RIO,15,187,1,203,1690
QUERÉTARO,SAN JUAN DEL RIO,24,141,3,168,1321
QUERÉTARO,SAN JUAN DEL RIO,13,150,1,164,1321
QUERÉTARO,SAN JUAN DEL RIO,19,166,0,185,1321
QUERÉTARO,SAN JUAN DEL RIO,16,189,1,206,1895
QUERÉTARO,SAN JUAN DEL RIO,26,194,2,222,1895
QUERÉTARO,SAN JUAN DEL RIO,15,158,4,177,1135
QUERÉTARO,SAN JUAN DEL RIO,12,176,3,191,1134
QUERÉTARO,SAN JUAN DEL RIO,22,233,2,257,1773
QUERÉTARO,SAN JUAN DEL RIO,18,228,1,247,1773
QUERÉTARO,SAN JUAN DEL RIO,18,260,3,281,1773
QUERÉTARO,SAN JUAN DEL RIO,21,242,2,265,1615
QUERÉTARO,SAN JUAN DEL RIO,18,264,0,282,1614
QUERÉTARO,SAN JUAN DEL RIO,24,258,1,283,1614
QUERÉTARO,SAN JUAN DEL RIO,19,215,1,235,1657
QUERÉTARO,SAN JUAN DEL RIO,18,212,0,230,1657
QUERÉTARO,SAN JUAN DEL RIO,13,225,1,239,1657
QUERÉTARO,SAN JUAN DEL RIO,231,11,5,247,1656
QUERÉTARO,SAN JUAN DEL RIO,17,171,2,190,1646
QUERÉTARO,SAN JUAN DEL RIO,16,209,0,225,1646
QUERÉTARO,SAN JUAN DEL RIO,10,210,1,221,1646
QUERÉTARO,SAN JUAN DEL RIO,17,186,2,205,1645
QUERÉTARO,SAN JUAN DEL RIO,11,202,2,215,1645
QUERÉTARO,SAN JUAN DEL RIO,12,211,2,225,1556
QUERÉTARO,SAN JUAN DEL RIO,9,201,1,211,1556
QUERÉTARO,SAN JUAN DEL RIO,13,209,0,222,1564
QUERÉTARO,SAN JUAN DEL RIO,16,208,1,225,1564
QUERÉTARO,SAN JUAN DEL RIO,22,231,3,256,1514
QUERÉTARO,SAN JUAN DEL RIO,18,193,1,212,1513
QUERÉTARO,SAN JUAN DEL RIO,19,200,2,221,1795
QUERÉTARO,SAN JUAN DEL RIO,36,222,1,259,1794
QUERÉTARO,SAN JUAN DEL RIO,12,192,0,204,1621
QUERÉTARO,SAN JUAN DEL RIO,11,163,0,174,1621
QUERÉTARO,SAN JUAN DEL RIO,14,180,2,196,1621
QUERÉTARO,SAN JUAN DEL RIO,15,225,4,244,1571
QUERÉTARO,SAN JUAN DEL RIO,8,223,2,233,1571
QUERÉTARO,SAN JUAN DEL RIO,12,257,2,271,1570
QUERÉTARO,SAN JUAN DEL RIO,17,186,2,205,1547
QUERÉTARO,SAN JUAN DEL RIO,22,205,4,231,1547
QUERÉTARO,SAN JUAN DEL RIO,15,212,1,228,1547
QUERÉTARO,SAN JUAN DEL RIO,12,169,1,182,1546
QUERÉTARO,SAN JUAN DEL RIO,7,168,2,177,1047
QUERÉTARO,SAN JUAN DEL RIO,10,163,3,176,1046
QUERÉTARO,SAN JUAN DEL RIO,11,159,4,174,1548
QUERÉTARO,SAN JUAN DEL RIO,12,220,0,232,1547
QUERÉTARO,SAN JUAN DEL RIO,22,176,4,202,1358
QUERÉTARO,SAN JUAN DEL RIO,17,178,3,198,1357
QUERÉTARO,SAN JUAN DEL RIO,15,171,1,187,1342
QUERÉTARO,SAN JUAN DEL RIO,19,182,4,205,1342
QUERÉTARO,SAN JUAN DEL RIO,93,1246,5,1344,0
QUERÉTARO,SAN JUAN DEL RIO,13,168,3,184,1543
QUERÉTARO,SAN JUAN DEL RIO,14,214,4,232,1543
QUERÉTARO,SAN JUAN DEL RIO,10,146,3,159,1402
QUERÉTARO,SAN JUAN DEL RIO,13,136,5,154,1401
QUERÉTARO,SAN JUAN DEL RIO,8,159,7,174,1806
QUERÉTARO,SAN JUAN DEL RIO,3,101,2,106,1805
QUERÉTARO,SAN JUAN DEL RIO,11,153,5,169,1377
QUERÉTARO,SAN JUAN DEL RIO,8,190,1,199,1377
QUERÉTARO,SAN JUAN DEL RIO,0,126,0,126,1278
QUERÉTARO,SAN JUAN DEL RIO,4,158,0,162,1277
QUERÉTARO,SAN JUAN DEL RIO,4,135,1,140,1391
QUERÉTARO,SAN JUAN DEL RIO,3,129,3,135,1391
QUERÉTARO,SAN JUAN DEL RIO,9,153,0,162,1647
QUERÉTARO,SAN JUAN DEL RIO,4,170,6,180,1647
QUERÉTARO,SAN JUAN DEL RIO,4,127,2,133,1646
QUERÉTARO,SAN JUAN DEL RIO,5,83,3,91,1480
QUERÉTARO,SAN JUAN DEL RIO,3,58,2,63,1479
QUERÉTARO,SAN JUAN DEL RIO,23,190,4,217,1377
QUERÉTARO,SAN JUAN DEL RIO,21,174,5,200,1377
QUERÉTARO,SAN JUAN DEL RIO,6,220,4,230,1776
QUERÉTARO,SAN JUAN DEL RIO,11,259,5,275,1775
QUERÉTARO,SAN JUAN DEL RIO,14,108,2,124,1571
QUERÉTARO,SAN JUAN DEL RIO,17,98,2,117,1571
QUERÉTARO,SAN JUAN DEL RIO,7,159,12,178,1433
QUERÉTARO,SAN JUAN DEL RIO,12,166,12,190,1432
QUERÉTARO,SAN JUAN DEL RIO,15,150,4,169,1432
QUERÉTARO,SAN JUAN DEL RIO,7,151,3,161,1634
QUERÉTARO,SAN JUAN DEL RIO,15,151,3,169,1634
QUERÉTARO,SAN JUAN DEL RIO,7,146,3,156,1634
QUERÉTARO,SAN JUAN DEL RIO,13,153,2,168,1634
QUERÉTARO,SAN JUAN DEL RIO,8,149,1,158,1633
QUERÉTARO,SAN JUAN DEL RIO,20,144,6,170,1751
QUERÉTARO,SAN JUAN DEL RIO,16,162,7,185,1751
QUERÉTARO,SAN JUAN DEL RIO,9,162,0,171,1734
QUERÉTARO,SAN JUAN DEL RIO,8,144,0,152,1734
QUERÉTARO,SAN JUAN DEL RIO,2,147,3,152,1734
QUERÉTARO,SAN JUAN DEL RIO,12,164,1,177,1734
QUERÉTARO,SAN JUAN DEL RIO,11,140,5,156,1733
QUERÉTARO,SAN JUAN DEL RIO,13,147,6,166,1733
QUERÉTARO,SAN JUAN DEL RIO,7,151,3,161,1733
QUERÉTARO,SAN JUAN DEL RIO,13,81,2,96,1769
QUERÉTARO,SAN JUAN DEL RIO,14,93,4,111,1768
QUERÉTARO,SAN JUAN DEL RIO,13,116,2,131,1534
QUERÉTARO,SAN JUAN DEL RIO,4,98,0,102,1533
QUERÉTARO,SAN JUAN DEL RIO,3,109,0,112,1533
QUERÉTARO,SAN JUAN DEL RIO,11,196,5,212,1476
QUERÉTARO,SAN JUAN DEL RIO,6,214,7,227,1475
QUERÉTARO,SAN JUAN DEL RIO,15,104,9,128,1126
QUERÉTARO,SAN JUAN DEL RIO,24,93,0,117,1125
QUERÉTARO,SAN JUAN DEL RIO,7,93,2,102,1390
QUERÉTARO,SAN JUAN DEL RIO,14,99,2,115,1390
QUERÉTARO,SAN JUAN DEL RIO,10,160,3,173,1937
QUERÉTARO,SAN JUAN DEL RIO,10,193,2,205,1936
QUERÉTARO,SAN JUAN DEL RIO,10,136,1,147,1496
QUERÉTARO,SAN JUAN DEL RIO,7,105,3,115,1496
QUERÉTARO,SAN JUAN DEL RIO,9,147,8,164,1496
QUERÉTARO,SAN JUAN DEL RIO,8,218,4,230,1555
QUERÉTARO,SAN JUAN DEL RIO,11,148,6,165,1554
QUERÉTARO,SAN JUAN DEL RIO,14,152,10,176,1554
QUERÉTARO,SAN JUAN DEL RIO,13,105,1,119,1762
QUERÉTARO,SAN JUAN DEL RIO,14,98,3,115,1762
QUERÉTARO,SAN JUAN DEL RIO,9,174,3,186,1411
QUERÉTARO,SAN JUAN DEL RIO,11,157,1,169,1411
QUERÉTARO,SAN JUAN DEL RIO,21,168,1,190,1679
QUERÉTARO,SAN JUAN DEL RIO,27,207,0,234,1678
QUERÉTARO,SAN JUAN DEL RIO,14,138,3,155,1032
QUERÉTARO,SAN JUAN DEL RIO,16,137,3,156,1031
QUERÉTARO,SAN JUAN DEL RIO,16,233,2,251,1780
QUERÉTARO,SAN JUAN DEL RIO,14,208,3,225,1779
QUERÉTARO,SAN JUAN DEL RIO,22,194,3,219,1779
QUERÉTARO,SAN JUAN DEL RIO,22,186,1,209,1456
QUERÉTARO,SAN JUAN DEL RIO,19,138,1,158,1455
QUERÉTARO,SAN JUAN DEL RIO,31,225,1,257,1783
QUERÉTARO,SAN JUAN DEL RIO,27,206,2,235,1783
QUERÉTARO,SAN JUAN DEL RIO,14,227,3,244,1742
QUERÉTARO,SAN JUAN DEL RIO,20,227,1,248,1742
QUERÉTARO,SAN JUAN DEL RIO,21,195,1,217,1816
QUERÉTARO,SAN JUAN DEL RIO,16,244,3,263,1815
QUERÉTARO,SAN JUAN DEL RIO,20,188,10,218,1959
QUERÉTARO,SAN JUAN DEL RIO,25,221,6,252,1959
QUERÉTARO,SAN JUAN DEL RIO,18,172,1,191,1823
QUERÉTARO,SAN JUAN DEL RIO,18,202,0,220,1823
QUERÉTARO,SAN JUAN DEL RIO,14,128,1,143,1924
QUERÉTARO,SAN JUAN DEL RIO,11,169,3,183,1924
QUERÉTARO,SAN JUAN DEL RIO,9,99,2,110,1338
QUERÉTARO,SAN JUAN DEL RIO,17,132,2,151,1337
QUERÉTARO,SAN JUAN DEL RIO,17,102,1,120,1710
QUERÉTARO,SAN JUAN DEL RIO,17,137,3,157,1710
QUERÉTARO,SAN JUAN DEL RIO,15,148,4,167,1785
QUERÉTARO,SAN JUAN DEL RIO,16,125,2,143,1785
QUERÉTARO,SAN JUAN DEL RIO,5,190,1,196,1525
QUERÉTARO,SAN JUAN DEL RIO,10,166,3,179,1525
QUERÉTARO,SAN JUAN DEL RIO,10,136,5,151,1257
QUERÉTARO,SAN JUAN DEL RIO,9,123,2,134,1257
QUERÉTARO,SAN JUAN DEL RIO,7,186,5,198,1393
QUERÉTARO,SAN JUAN DEL RIO,7,134,1,142,1392
QUERÉTARO,SAN JUAN DEL RIO,19,171,0,190,1285
QUERÉTARO,SAN JUAN DEL RIO,10,160,1,171,1285
QUERÉTARO,SAN JUAN DEL RIO,19,197,0,216,1328
QUERÉTARO,SAN JUAN DEL RIO,21,179,4,204,1328
QUERÉTARO,SAN JUAN DEL RIO,14,164,1,179,1327
QUERÉTARO,SAN JUAN DEL RIO,9,172,0,181,1405
QUERÉTARO,SAN JUAN DEL RIO,9,170,0,179,1405
QUERÉTARO,SAN JUAN DEL RIO,26,227,4,257,1614
QUERÉTARO,SAN JUAN DEL RIO,11,196,3,210,1614
QUERÉTARO,SAN JUAN DEL RIO,8,190,1,199,1614
QUERÉTARO,SAN JUAN DEL RIO,9,163,5,177,1825
QUERÉTARO,SAN JUAN DEL RIO,9,199,4,212,1825
QUERÉTARO,SAN JUAN DEL RIO,9,201,1,211,1825
QUERÉTARO,SAN JUAN DEL RIO,15,168,3,186,1167
QUERÉTARO,SAN JUAN DEL RIO,16,172,3,191,1166
QUERÉTARO,SANTIAGO DE QUERETARO,6,71,0,77,1317
QUERÉTARO,SANTIAGO DE QUERETARO,5,92,5,102,1316
QUERÉTARO,SANTIAGO DE QUERETARO,5,84,0,89,1316
QUERÉTARO,SANTIAGO DE QUERETARO,13,93,1,107,1479
QUERÉTARO,SANTIAGO DE QUERETARO,15,80,0,95,1479
QUERÉTARO,SANTIAGO DE QUERETARO,10,168,0,178,1920
QUERÉTARO,SANTIAGO DE QUERETARO,14,175,3,192,1920
QUERÉTARO,SANTIAGO DE QUERETARO,9,177,0,186,1920
QUERÉTARO,SANTIAGO DE QUERETARO,7,182,2,191,1920
QUERÉTARO,SANTIAGO DE QUERETARO,11,191,3,205,1919
QUERÉTARO,SANTIAGO DE QUERETARO,8,181,3,192,1919
QUERÉTARO,SANTIAGO DE QUERETARO,16,208,0,224,1710
QUERÉTARO,SANTIAGO DE QUERETARO,10,208,4,222,1709
QUERÉTARO,SANTIAGO DE QUERETARO,18,144,2,164,1962
QUERÉTARO,SANTIAGO DE QUERETARO,16,143,2,161,1962
QUERÉTARO,SANTIAGO DE QUERETARO,20,139,0,159,1962
QUERÉTARO,SANTIAGO DE QUERETARO,10,147,1,158,1962
QUERÉTARO,SANTIAGO DE QUERETARO,16,150,0,166,1962
QUERÉTARO,SANTIAGO DE QUERETARO,16,128,0,144,1962
QUERÉTARO,SANTIAGO DE QUERETARO,16,146,1,163,1962
QUERÉTARO,SANTIAGO DE QUERETARO,10,141,0,151,1962
QUERÉTARO,SANTIAGO DE QUERETARO,15,175,4,194,1962
QUERÉTARO,SANTIAGO DE QUERETARO,34,267,1,302,1726
QUERÉTARO,SANTIAGO DE QUERETARO,34,243,0,277,1725
QUERÉTARO,SANTIAGO DE QUERETARO,11,171,0,182,1348
QUERÉTARO,SANTIAGO DE QUERETARO,10,165,0,175,1348
QUERÉTARO,SANTIAGO DE QUERETARO,16,172,1,189,1348
QUERÉTARO,SANTIAGO DE QUERETARO,21,195,0,216,1728
QUERÉTARO,SANTIAGO DE QUERETARO,24,195,1,220,1728
QUERÉTARO,SANTIAGO DE QUERETARO,20,191,1,212,1727
QUERÉTARO,SANTIAGO DE QUERETARO,18,227,1,246,1727
QUERÉTARO,SANTIAGO DE QUERETARO,21,144,2,167,1683
QUERÉTARO,SANTIAGO DE QUERETARO,26,169,2,197,1683
QUERÉTARO,SANTIAGO DE QUERETARO,23,167,1,191,1683
QUERÉTARO,SANTIAGO DE QUERETARO,33,276,0,309,1830
QUERÉTARO,SANTIAGO DE QUERETARO,28,256,3,287,1830
QUERÉTARO,SANTIAGO DE QUERETARO,25,203,3,231,1967
QUERÉTARO,SANTIAGO DE QUERETARO,18,180,3,201,1966
QUERÉTARO,SANTIAGO DE QUERETARO,17,200,3,220,1155
QUERÉTARO,SANTIAGO DE QUERETARO,13,208,0,221,1154
QUERÉTARO,SANTIAGO DE QUERETARO,23,247,0,270,1657
QUERÉTARO,SANTIAGO DE QUERETARO,16,229,2,247,1656
QUERÉTARO,SANTIAGO DE QUERETARO,22,211,0,233,1630
QUERÉTARO,SANTIAGO DE QUERETARO,20,174,1,195,1629
QUERÉTARO,SANTIAGO DE QUERETARO,18,168,2,188,1617
QUERÉTARO,SANTIAGO DE QUERETARO,16,189,4,209,1617
QUERÉTARO,SANTIAGO DE QUERETARO,13,138,0,151,1616
QUERÉTARO,SANTIAGO DE QUERETARO,12,187,1,200,1478
QUERÉTARO,SANTIAGO DE QUERETARO,13,161,1,175,1477
QUERÉTARO,SANTIAGO DE QUERETARO,9,206,8,223,1477
QUERÉTARO,SANTIAGO DE QUERETARO,18,227,4,249,1791
QUERÉTARO,SANTIAGO DE QUERETARO,28,203,3,234,1790
QUERÉTARO,SANTIAGO DE QUERETARO,11,265,1,277,1796
QUERÉTARO,SANTIAGO DE QUERETARO,18,233,1,252,1795
QUERÉTARO,SANTIAGO DE QUERETARO,18,200,1,219,1923
QUERÉTARO,SANTIAGO DE QUERETARO,16,203,1,220,1923
QUERÉTARO,SANTIAGO DE QUERETARO,24,184,1,209,1923
QUERÉTARO,SANTIAGO DE QUERETARO,24,217,2,243,1922
QUERÉTARO,SANTIAGO DE QUERETARO,24,208,1,233,1922
QUERÉTARO,SANTIAGO DE QUERETARO,10,245,1,256,1874
QUERÉTARO,SANTIAGO DE QUERETARO,19,237,0,256,1874
QUERÉTARO,SANTIAGO DE QUERETARO,37,248,0,285,1769
QUERÉTARO,SANTIAGO DE QUERETARO,20,252,1,273,1768
QUERÉTARO,SANTIAGO DE QUERETARO,8,250,1,259,1894
QUERÉTARO,SANTIAGO DE QUERETARO,17,232,1,250,1893
QUERÉTARO,SANTIAGO DE QUERETARO,11,207,2,220,1698
QUERÉTARO,SANTIAGO DE QUERETARO,18,183,2,203,1698
QUERÉTARO,SANTIAGO DE QUERETARO,42,183,0,225,1659
QUERÉTARO,SANTIAGO DE QUERETARO,27,169,2,198,1659
QUERÉTARO,SANTIAGO DE QUERETARO,18,166,0,184,1482
QUERÉTARO,SANTIAGO DE QUERETARO,21,185,1,207,1481
QUERÉTARO,SANTIAGO DE QUERETARO,28,175,3,206,1481
QUERÉTARO,SANTIAGO DE QUERETARO,21,247,3,271,1869
QUERÉTARO,SANTIAGO DE QUERETARO,14,231,1,246,1869
QUERÉTARO,SANTIAGO DE QUERETARO,16,280,4,300,1829
QUERÉTARO,SANTIAGO DE QUERETARO,21,257,280,558,1829
QUERÉTARO,SANTIAGO DE QUERETARO,32,184,1,217,1611
QUERÉTARO,SANTIAGO DE QUERETARO,30,182,0,212,1611
QUERÉTARO,SANTIAGO DE QUERETARO,23,197,2,222,1611
QUERÉTARO,SANTIAGO DE QUERETARO,23,177,1,201,1611
QUERÉTARO,SANTIAGO DE QUERETARO,21,207,1,229,1610
QUERÉTARO,SANTIAGO DE QUERETARO,41,198,1,240,1696
QUERÉTARO,SANTIAGO DE QUERETARO,36,236,0,272,1695
QUERÉTARO,SANTIAGO DE QUERETARO,14,203,4,221,1794
QUERÉTARO,SANTIAGO DE QUERETARO,20,212,1,233,1793
QUERÉTARO,SANTIAGO DE QUERETARO,10,135,5,150,1331
QUERÉTARO,SANTIAGO DE QUERETARO,10,119,0,129,1330
QUERÉTARO,SANTIAGO DE QUERETARO,11,145,1,157,1330
QUERÉTARO,SANTIAGO DE QUERETARO,1,48,2,51,1073
QUERÉTARO,SANTIAGO DE QUERETARO,6,40,1,47,1073
QUERÉTARO,SANTIAGO DE QUERETARO,27,157,0,184,1715
QUERÉTARO,SANTIAGO DE QUERETARO,9,141,4,154,1715
QUERÉTARO,SANTIAGO DE QUERETARO,7,90,0,97,1332
QUERÉTARO,SANTIAGO DE QUERETARO,11,59,3,73,1331
QUERÉTARO,SANTIAGO DE QUERETARO,7,104,2,113,1943
QUERÉTARO,SANTIAGO DE QUERETARO,6,0,1,7,1942
QUERÉTARO,SANTIAGO DE QUERETARO,15,187,2,204,1909
QUERÉTARO,SANTIAGO DE QUERETARO,10,203,2,215,1909
QUERÉTARO,SANTIAGO DE QUERETARO,37,296,0,333,0
QUERÉTARO,SANTIAGO DE QUERETARO,9,184,0,193,1913
QUERÉTARO,SANTIAGO DE QUERETARO,13,206,3,222,1912
QUERÉTARO,SANTIAGO DE QUERETARO,8,209,5,222,1934
QUERÉTARO,SANTIAGO DE QUERETARO,11,176,3,190,1934
QUERÉTARO,SANTIAGO DE QUERETARO,5,66,2,73,1761
QUERÉTARO,SANTIAGO DE QUERETARO,10,47,0,57,1761
QUERÉTARO,SANTIAGO DE QUERETARO,9,63,0,72,1760
QUERÉTARO,SANTIAGO DE QUERETARO,9,125,0,134,1883
QUERÉTARO,SANTIAGO DE QUERETARO,13,114,0,127,1883
QUERÉTARO,SANTIAGO DE QUERETARO,6,138,2,146,1883
QUERÉTARO,SANTIAGO DE QUERETARO,11,137,2,150,1882
QUERÉTARO,SANTIAGO DE QUERETARO,8,130,0,138,1882
QUERÉTARO,SANTIAGO DE QUERETARO,4,9,0,13,1440
QUERÉTARO,SANTIAGO DE QUERETARO,12,24,0,36,1440
QUERÉTARO,SANTIAGO DE QUERETARO,12,36,0,48,1440
QUERÉTARO,SANTIAGO DE QUERETARO,8,164,1,173,1826
QUERÉTARO,SANTIAGO DE QUERETARO,10,161,4,175,1825
QUERÉTARO,SANTIAGO DE QUERETARO,11,119,5,135,1315
QUERÉTARO,SANTIAGO DE QUERETARO,10,129,2,141,1314
QUERÉTARO,SANTIAGO DE QUERETARO,9,119,1,129,1314
QUERÉTARO,SANTIAGO DE QUERETARO,11,134,3,148,1405
QUERÉTARO,SANTIAGO DE QUERETARO,11,143,3,157,1405
QUERÉTARO,SANTIAGO DE QUERETARO,12,99,0,111,1744
QUERÉTARO,SANTIAGO DE QUERETARO,11,138,0,149,1744
QUERÉTARO,SANTIAGO DE QUERETARO,20,181,1,202,1933
QUERÉTARO,SANTIAGO DE QUERETARO,18,172,1,191,1932
QUERÉTARO,SANTIAGO DE QUERETARO,2,52,0,54,1523
QUERÉTARO,SANTIAGO DE QUERETARO,3,40,0,43,1523
QUERÉTARO,SANTIAGO DE QUERETARO,3,51,2,56,1522
QUERÉTARO,SANTIAGO DE QUERETARO,17,107,2,126,1404
QUERÉTARO,SANTIAGO DE QUERETARO,13,71,3,87,1403
QUERÉTARO,SANTIAGO DE QUERETARO,24,157,3,184,1708
QUERÉTARO,SANTIAGO DE QUERETARO,26,211,0,237,1707
QUERÉTARO,SANTIAGO DE QUERETARO,1,141,3,145,1145
QUERÉTARO,SANTIAGO DE QUERETARO,15,129,0,144,1144
QUERÉTARO,SANTIAGO DE QUERETARO,4,99,0,103,1685
QUERÉTARO,SANTIAGO DE QUERETARO,5,82,2,89,1684
QUERÉTARO,SANTIAGO DE QUERETARO,10,97,0,107,1684
QUERÉTARO,SANTIAGO DE QUERETARO,3,92,1,96,1684
QUERÉTARO,SANTIAGO DE QUERETARO,6,94,0,100,1684
QUERÉTARO,SANTIAGO DE QUERETARO,14,144,0,158,1364
QUERÉTARO,SANTIAGO DE QUERETARO,10,182,0,192,1363
QUERÉTARO,SANTIAGO DE QUERETARO,8,96,2,106,1226
QUERÉTARO,SANTIAGO DE QUERETARO,5,105,3,113,1225
QUERÉTARO,SANTIAGO DE QUERETARO,27,166,1,194,1970
QUERÉTARO,SANTIAGO DE QUERETARO,19,194,0,213,1970
QUERÉTARO,SANTIAGO DE QUERETARO,13,117,3,133,1618
QUERÉTARO,SANTIAGO DE QUERETARO,9,142,0,151,1618
QUERÉTARO,SANTIAGO DE QUERETARO,11,157,4,172,1617
QUERÉTARO,SANTIAGO DE QUERETARO,16,152,0,168,1550
QUERÉTARO,SANTIAGO DE QUERETARO,13,183,1,197,1550
QUERÉTARO,SANTIAGO DE QUERETARO,17,153,2,172,1550
QUERÉTARO,SANTIAGO DE QUERETARO,8,170,1,179,1549
QUERÉTARO,SANTIAGO DE QUERETARO,8,136,0,144,1900
QUERÉTARO,SANTIAGO DE QUERETARO,8,113,4,125,1900
QUERÉTARO,SANTIAGO DE QUERETARO,20,158,0,178,1900
QUERÉTARO,SANTIAGO DE QUERETARO,11,133,1,145,1899
QUERÉTARO,SANTIAGO DE QUERETARO,12,123,3,138,1899
QUERÉTARO,SANTIAGO DE QUERETARO,17,102,1,120,1899
QUERÉTARO,SANTIAGO DE QUERETARO,12,134,0,146,1899
QUERÉTARO,SANTIAGO DE QUERETARO,12,125,2,139,1899
QUERÉTARO,SANTIAGO DE QUERETARO,9,123,2,134,1899
QUERÉTARO,SANTIAGO DE QUERETARO,10,80,1,91,1320
QUERÉTARO,SANTIAGO DE QUERETARO,15,78,1,94,1320
QUERÉTARO,SANTIAGO DE QUERETARO,14,67,0,81,1319
QUERÉTARO,SANTIAGO DE QUERETARO,19,191,0,210,1357
QUERÉTARO,SANTIAGO DE QUERETARO,8,152,5,165,1357
QUERÉTARO,SANTIAGO DE QUERETARO,32,194,0,226,1934
QUERÉTARO,SANTIAGO DE QUERETARO,26,211,3,240,1934
QUERÉTARO,SANTIAGO DE QUERETARO,21,145,0,166,1868
QUERÉTARO,SANTIAGO DE QUERETARO,17,140,0,157,1867
QUERÉTARO,SANTIAGO DE QUERETARO,24,173,0,197,1565
QUERÉTARO,SANTIAGO DE QUERETARO,17,191,1,209,1565
QUERÉTARO,SANTIAGO DE QUERETARO,21,158,0,179,1654
QUERÉTARO,SANTIAGO DE QUERETARO,17,162,1,180,1653
QUERÉTARO,SANTIAGO DE QUERETARO,13,127,0,140,1347
QUERÉTARO,SANTIAGO DE QUERETARO,10,140,1,151,1347
QUERÉTARO,SANTIAGO DE QUERETARO,15,142,0,157,1347
QUERÉTARO,SANTIAGO DE QUERETARO,19,193,0,212,1798
QUERÉTARO,SANTIAGO DE QUERETARO,17,158,0,175,1797
QUERÉTARO,SANTIAGO DE QUERETARO,24,218,2,244,1943
QUERÉTARO,SANTIAGO DE QUERETARO,25,239,1,265,1942
QUERÉTARO,SANTIAGO DE QUERETARO,21,135,1,157,1322
QUERÉTARO,SANTIAGO DE QUERETARO,14,131,4,149,1321
QUERÉTARO,SANTIAGO DE QUERETARO,12,141,0,153,1321
QUERÉTARO,SANTIAGO DE QUERETARO,21,180,2,203,1840
QUERÉTARO,SANTIAGO DE QUERETARO,27,190,1,218,1840
QUERÉTARO,SANTIAGO DE QUERETARO,20,170,1,191,1875
QUERÉTARO,SANTIAGO DE QUERETARO,19,175,1,195,1875
QUERÉTARO,SANTIAGO DE QUERETARO,16,196,1,213,1874
QUERÉTARO,SANTIAGO DE QUERETARO,20,114,1,135,1760
QUERÉTARO,SANTIAGO DE QUERETARO,15,157,2,174,1760
QUERÉTARO,SANTIAGO DE QUERETARO,13,119,0,132,1760
QUERÉTARO,SANTIAGO DE QUERETARO,19,121,3,143,1760
QUERÉTARO,SANTIAGO DE QUERETARO,18,121,0,139,1760
QUERÉTARO,SANTIAGO DE QUERETARO,14,122,0,136,1760
QUERÉTARO,SANTIAGO DE QUERETARO,12,119,0,131,1760
QUERÉTARO,SANTIAGO DE QUERETARO,18,126,0,144,1759
QUERÉTARO,SANTIAGO DE QUERETARO,17,147,2,166,1961
QUERÉTARO,SANTIAGO DE QUERETARO,20,169,3,192,1960
QUERÉTARO,SANTIAGO DE QUERETARO,26,151,3,180,1403
QUERÉTARO,SANTIAGO DE QUERETARO,24,131,2,157,1402
QUERÉTARO,SANTIAGO DE QUERETARO,159,9,0,168,1626
QUERÉTARO,SANTIAGO DE QUERETARO,9,129,1,139,1625
QUERÉTARO,SANTIAGO DE QUERETARO,12,144,1,157,1625
QUERÉTARO,SANTIAGO DE QUERETARO,12,143,0,155,1784
QUERÉTARO,SANTIAGO DE QUERETARO,10,148,1,159,1784
QUERÉTARO,SANTIAGO DE QUERETARO,12,167,0,179,1784
QUERÉTARO,SANTIAGO DE QUERETARO,15,158,0,173,1823
QUERÉTARO,SANTIAGO DE QUERETARO,21,153,4,178,1823
QUERÉTARO,SANTIAGO DE QUERETARO,12,153,0,165,1822
QUERÉTARO,SANTIAGO DE QUERETARO,14,162,3,179,1620
QUERÉTARO,SANTIAGO DE QUERETARO,8,153,1,162,1620
QUERÉTARO,SANTIAGO DE QUERETARO,8,124,1,133,1620
QUERÉTARO,SANTIAGO DE QUERETARO,11,166,0,177,1619
QUERÉTARO,SANTIAGO DE QUERETARO,14,154,1,169,1836
QUERÉTARO,SANTIAGO DE QUERETARO,11,147,2,160,1836
QUERÉTARO,SANTIAGO DE QUERETARO,9,129,2,140,1836
QUERÉTARO,SANTIAGO DE QUERETARO,7,96,1,104,1578
QUERÉTARO,SANTIAGO DE QUERETARO,16,94,0,110,1578
QUERÉTARO,SANTIAGO DE QUERETARO,12,145,0,157,1326
QUERÉTARO,SANTIAGO DE QUERETARO,12,124,0,136,1325
QUERÉTARO,SANTIAGO DE QUERETARO,9,150,0,159,1325
QUERÉTARO,SANTIAGO DE QUERETARO,9,163,1,173,1551
QUERÉTARO,SANTIAGO DE QUERETARO,10,140,2,152,1551
QUERÉTARO,SANTIAGO DE QUERETARO,9,101,0,110,1045
QUERÉTARO,SANTIAGO DE QUERETARO,11,106,0,117,1044
QUERÉTARO,SANTIAGO DE QUERETARO,7,114,1,122,1000
QUERÉTARO,SANTIAGO DE QUERETARO,10,92,2,104,999
QUERÉTARO,SANTIAGO DE QUERETARO,11,191,1,203,1888
QUERÉTARO,SANTIAGO DE QUERETARO,15,185,3,203,1887
QUERÉTARO,SANTIAGO DE QUERETARO,20,193,2,215,1772
QUERÉTARO,SANTIAGO DE QUERETARO,20,195,0,215,1772
QUERÉTARO,SANTIAGO DE QUERETARO,8,225,0,233,1935
QUERÉTARO,SANTIAGO DE QUERETARO,11,227,4,242,1935
QUERÉTARO,SANTIAGO DE QUERETARO,38,94,0,132,1901
QUERÉTARO,SANTIAGO DE QUERETARO,26,97,1,124,1901
QUERÉTARO,SANTIAGO DE QUERETARO,28,67,0,95,1503
QUERÉTARO,SANTIAGO DE QUERETARO,20,65,2,87,1503
QUERÉTARO,SANTIAGO DE QUERETARO,25,84,0,109,1503
QUERÉTARO,SANTIAGO DE QUERETARO,30,63,3,96,1221
QUERÉTARO,SANTIAGO DE QUERETARO,28,59,2,89,1221
QUERÉTARO,SANTIAGO DE QUERETARO,22,59,1,82,1343
QUERÉTARO,SANTIAGO DE QUERETARO,25,42,2,69,1343
QUERÉTARO,SANTIAGO DE QUERETARO,20,58,1,79,1578
QUERÉTARO,SANTIAGO DE QUERETARO,29,58,0,87,1577
QUERÉTARO,SANTIAGO DE QUERETARO,25,56,0,81,1342
QUERÉTARO,SANTIAGO DE QUERETARO,24,61,1,86,1342
QUERÉTARO,SANTIAGO DE QUERETARO,17,44,0,61,1342
QUERÉTARO,SANTIAGO DE QUERETARO,20,130,3,153,1594
QUERÉTARO,SANTIAGO DE QUERETARO,17,100,2,119,1593
QUERÉTARO,SANTIAGO DE QUERETARO,12,175,1,188,1541
QUERÉTARO,SANTIAGO DE QUERETARO,8,186,2,196,1541
QUERÉTARO,SANTIAGO DE QUERETARO,20,167,1,188,1602
QUERÉTARO,SANTIAGO DE QUERETARO,20,150,3,173,1602
QUERÉTARO,SANTIAGO DE QUERETARO,20,150,17,187,1601
QUERÉTARO,SANTIAGO DE QUERETARO,20,184,0,204,1601
QUERÉTARO,SANTIAGO DE QUERETARO,8,128,6,142,1715
QUERÉTARO,SANTIAGO DE QUERETARO,4,147,3,154,1715
QUERÉTARO,SANTIAGO DE QUERETARO,17,176,4,197,1497
QUERÉTARO,SANTIAGO DE QUERETARO,22,196,3,221,1497
QUERÉTARO,SANTIAGO DE QUERETARO,18,152,4,174,1730
QUERÉTARO,SANTIAGO DE QUERETARO,13,155,5,173,1730
QUERÉTARO,SANTIAGO DE QUERETARO,19,228,0,247,1478
QUERÉTARO,SANTIAGO DE QUERETARO,11,236,2,249,1478
QUERÉTARO,SANTIAGO DE QUERETARO,23,188,0,211,1810
QUERÉTARO,SANTIAGO DE QUERETARO,18,233,2,253,1810
QUERÉTARO,SANTIAGO DE QUERETARO,22,222,1,245,1810
QUERÉTARO,SANTIAGO DE QUERETARO,12,126,1,139,1349
QUERÉTARO,SANTIAGO DE QUERETARO,10,144,3,157,1348
QUERÉTARO,SANTIAGO DE QUERETARO,11,147,2,160,1475
QUERÉTARO,SANTIAGO DE QUERETARO,13,124,2,139,1475
QUERÉTARO,SANTIAGO DE QUERETARO,13,156,1,170,1475
QUERÉTARO,SANTIAGO DE QUERETARO,19,166,0,185,1609
QUERÉTARO,SANTIAGO DE QUERETARO,18,151,0,169,1609
QUERÉTARO,SANTIAGO DE QUERETARO,12,146,0,158,1609
QUERÉTARO,SANTIAGO DE QUERETARO,24,228,0,252,1489
QUERÉTARO,SANTIAGO DE QUERETARO,23,157,2,182,1489
QUERÉTARO,SANTIAGO DE QUERETARO,25,144,2,171,1488
QUERÉTARO,SANTIAGO DE QUERETARO,13,118,2,133,1225
QUERÉTARO,SANTIAGO DE QUERETARO,11,144,2,157,1224
QUERÉTARO,SANTIAGO DE QUERETARO,14,172,0,186,1675
QUERÉTARO,SANTIAGO DE QUERETARO,23,168,0,191,1674
QUERÉTARO,SANTIAGO DE QUERETARO,20,155,3,178,1538
QUERÉTARO,SANTIAGO DE QUERETARO,18,201,1,220,1537
QUERÉTARO,SANTIAGO DE QUERETARO,11,173,1,185,1937
QUERÉTARO,SANTIAGO DE QUERETARO,14,188,0,202,1936
QUERÉTARO,SANTIAGO DE QUERETARO,28,87,1,116,1369
QUERÉTARO,SANTIAGO DE QUERETARO,23,69,2,94,1369
QUERÉTARO,SANTIAGO DE QUERETARO,23,92,1,116,1368
QUERÉTARO,SANTIAGO DE QUERETARO,12,89,0,101,1288
QUERÉTARO,SANTIAGO DE QUERETARO,8,85,3,96,1287
QUERÉTARO,SANTIAGO DE QUERETARO,19,149,3,171,1813
QUERÉTARO,SANTIAGO DE QUERETARO,19,134,2,155,1813
QUERÉTARO,SANTIAGO DE QUERETARO,28,123,1,152,1759
QUERÉTARO,SANTIAGO DE QUERETARO,29,107,0,136,1759
QUERÉTARO,SANTIAGO DE QUERETARO,27,107,1,135,1460
QUERÉTARO,SANTIAGO DE QUERETARO,30,126,1,157,1460
QUERÉTARO,SANTIAGO DE QUERETARO,28,211,1,240,1780
QUERÉTARO,SANTIAGO DE QUERETARO,24,203,5,232,1779
QUERÉTARO,SANTIAGO DE QUERETARO,30,122,0,152,1420
QUERÉTARO,SANTIAGO DE QUERETARO,24,140,1,165,1420
QUERÉTARO,SANTIAGO DE QUERETARO,28,104,0,132,1636
QUERÉTARO,SANTIAGO DE QUERETARO,36,109,0,145,1636
QUERÉTARO,SANTIAGO DE QUERETARO,43,118,2,163,1635
QUERÉTARO,SANTIAGO DE QUERETARO,38,101,2,141,1635
QUERÉTARO,SANTIAGO DE QUERETARO,10,250,1,261,1926
QUERÉTARO,SANTIAGO DE QUERETARO,11,256,1,268,1926
QUERÉTARO,SANTIAGO DE QUERETARO,34,242,3,279,1899
QUERÉTARO,SANTIAGO DE QUERETARO,23,264,0,287,1899
QUERÉTARO,SANTIAGO DE QUERETARO,16,233,1,250,1944
QUERÉTARO,SANTIAGO DE QUERETARO,12,238,11,261,1944
QUERÉTARO,SANTIAGO DE QUERETARO,17,163,0,180,1627
QUERÉTARO,SANTIAGO DE QUERETARO,19,175,0,194,1626
QUERÉTARO,SANTIAGO DE QUERETARO,21,168,1,190,1626
QUERÉTARO,SANTIAGO DE QUERETARO,19,129,3,151,1340
QUERÉTARO,SANTIAGO DE QUERETARO,30,155,1,186,1339
QUERÉTARO,SANTIAGO DE QUERETARO,21,143,4,168,1339
QUERÉTARO,SANTIAGO DE QUERETARO,13,133,0,146,1488
QUERÉTARO,SANTIAGO DE QUERETARO,20,161,1,182,1488
QUERÉTARO,SANTIAGO DE QUERETARO,18,154,0,172,1487
QUERÉTARO,SANTIAGO DE QUERETARO,24,270,0,294,1910
QUERÉTARO,SANTIAGO DE QUERETARO,16,248,3,267,1910
QUERÉTARO,SANTIAGO DE QUERETARO,30,208,0,238,1951
QUERÉTARO,SANTIAGO DE QUERETARO,31,185,1,217,1950
QUERÉTARO,SANTIAGO DE QUERETARO,27,118,0,145,1524
QUERÉTARO,SANTIAGO DE QUERETARO,17,123,1,141,1524
QUERÉTARO,SANTIAGO DE QUERETARO,27,117,0,144,1524
QUERÉTARO,SANTIAGO DE QUERETARO,36,119,0,155,1490
QUERÉTARO,SANTIAGO DE QUERETARO,26,113,1,140,1490
QUERÉTARO,SANTIAGO DE QUERETARO,17,117,2,136,1490
QUERÉTARO,SANTIAGO DE QUERETARO,27,96,0,123,1752
QUERÉTARO,SANTIAGO DE QUERETARO,29,115,0,144,1752
QUERÉTARO,SANTIAGO DE QUERETARO,28,68,0,96,1796
QUERÉTARO,SANTIAGO DE QUERETARO,26,111,2,139,1796
QUERÉTARO,SANTIAGO DE QUERETARO,25,114,0,139,1796
QUERÉTARO,SANTIAGO DE QUERETARO,32,92,0,124,1796
QUERÉTARO,SANTIAGO DE QUERETARO,28,93,1,122,1796
QUERÉTARO,SANTIAGO DE QUERETARO,11,150,4,165,1451
QUERÉTARO,SANTIAGO DE QUERETARO,8,145,1,154,1450
QUERÉTARO,SANTIAGO DE QUERETARO,30,180,5,215,1928
QUERÉTARO,SANTIAGO DE QUERETARO,36,187,2,225,1928
QUERÉTARO,SANTIAGO DE QUERETARO,20,141,3,164,1553
QUERÉTARO,SANTIAGO DE QUERETARO,28,139,0,167,1552
QUERÉTARO,SANTIAGO DE QUERETARO,17,151,4,172,1552
QUERÉTARO,SANTIAGO DE QUERETARO,37,132,2,171,1918
QUERÉTARO,SANTIAGO DE QUERETARO,40,126,1,167,1918
QUERÉTARO,SANTIAGO DE QUERETARO,21,151,0,172,1707
QUERÉTARO,SANTIAGO DE QUERETARO,22,160,2,184,1706
QUERÉTARO,SANTIAGO DE QUERETARO,26,148,2,176,1731
QUERÉTARO,SANTIAGO DE QUERETARO,34,124,1,159,1731
QUERÉTARO,SANTIAGO DE QUERETARO,35,142,0,177,1731
QUERÉTARO,SANTIAGO DE QUERETARO,23,158,2,183,1731
QUERÉTARO,SANTIAGO DE QUERETARO,26,110,1,137,1386
QUERÉTARO,SANTIAGO DE QUERETARO,27,116,0,143,1385
QUERÉTARO,SANTIAGO DE QUERETARO,17,109,1,127,1385
QUERÉTARO,SANTIAGO DE QUERETARO,22,145,3,170,1917
QUERÉTARO,SANTIAGO DE QUERETARO,23,113,2,138,1917
QUERÉTARO,SANTIAGO DE QUERETARO,18,129,2,149,1604
QUERÉTARO,SANTIAGO DE QUERETARO,26,101,2,129,1603
QUERÉTARO,SANTIAGO DE QUERETARO,15,101,0,116,1603
QUERÉTARO,SANTIAGO DE QUERETARO,43,187,1,231,1846
QUERÉTARO,SANTIAGO DE QUERETARO,37,184,0,221,1845
QUERÉTARO,SANTIAGO DE QUERETARO,16,171,0,187,1425
QUERÉTARO,SANTIAGO DE QUERETARO,29,154,2,185,1425
QUERÉTARO,SANTIAGO DE QUERETARO,19,132,1,152,1653
QUERÉTARO,SANTIAGO DE QUERETARO,34,157,2,193,1653
QUERÉTARO,SANTIAGO DE QUERETARO,18,113,0,131,1638
QUERÉTARO,SANTIAGO DE QUERETARO,24,132,0,156,1638
QUERÉTARO,SANTIAGO DE QUERETARO,27,229,0,256,1895
QUERÉTARO,SANTIAGO DE QUERETARO,24,147,3,174,1895
QUERÉTARO,SANTIAGO DE QUERETARO,22,158,3,183,1186
QUERÉTARO,SANTIAGO DE QUERETARO,23,146,0,169,1185
QUERÉTARO,SANTIAGO DE QUERETARO,19,122,0,141,1402
QUERÉTARO,SANTIAGO DE QUERETARO,23,140,0,163,1401
QUERÉTARO,SANTIAGO DE QUERETARO,17,117,0,134,1401
QUERÉTARO,SANTIAGO DE QUERETARO,16,109,1,126,1354
QUERÉTARO,SANTIAGO DE QUERETARO,13,134,1,148,1353
QUERÉTARO,SANTIAGO DE QUERETARO,17,107,2,126,1346
QUERÉTARO,SANTIAGO DE QUERETARO,14,94,0,108,1345
QUERÉTARO,SANTIAGO DE QUERETARO,21,95,2,118,1345
QUERÉTARO,SANTIAGO DE QUERETARO,27,73,0,100,988
QUERÉTARO,SANTIAGO DE QUERETARO,23,58,1,82,987
QUERÉTARO,SANTIAGO DE QUERETARO,20,120,1,141,1674
QUERÉTARO,SANTIAGO DE QUERETARO,21,152,4,177,1674
QUERÉTARO,SANTIAGO DE QUERETARO,26,170,2,198,1817
QUERÉTARO,SANTIAGO DE QUERETARO,17,164,4,185,1817
QUERÉTARO,SANTIAGO DE QUERETARO,16,122,3,141,1480
QUERÉTARO,SANTIAGO DE QUERETARO,27,141,5,173,1480
QUERÉTARO,SANTIAGO DE QUERETARO,24,139,0,163,1480
QUERÉTARO,SANTIAGO DE QUERETARO,15,142,0,157,1479
QUERÉTARO,SANTIAGO DE QUERETARO,13,154,0,167,1438
QUERÉTARO,SANTIAGO DE QUERETARO,8,147,0,155,1438
QUERÉTARO,SANTIAGO DE QUERETARO,11,120,1,132,1827
QUERÉTARO,SANTIAGO DE QUERETARO,18,137,1,156,1826
QUERÉTARO,SANTIAGO DE QUERETARO,28,147,0,175,1504
QUERÉTARO,SANTIAGO DE QUERETARO,38,166,1,205,1504
QUERÉTARO,SANTIAGO DE QUERETARO,35,134,1,170,1504
QUERÉTARO,SANTIAGO DE QUERETARO,37,128,1,166,1471
QUERÉTARO,SANTIAGO DE QUERETARO,21,120,0,141,1470
QUERÉTARO,SANTIAGO DE QUERETARO,29,135,0,164,1470
QUERÉTARO,SANTIAGO DE QUERETARO,12,169,1,182,1522
QUERÉTARO,SANTIAGO DE QUERETARO,4,157,1,162,1522
QUERÉTARO,SANTIAGO DE QUERETARO,20,76,0,96,1680
QUERÉTARO,SANTIAGO DE QUERETARO,27,101,0,128,1680
QUERÉTARO,SANTIAGO DE QUERETARO,20,105,0,125,1679
QUERÉTARO,SANTIAGO DE QUERETARO,28,94,2,124,1679
QUERÉTARO,SANTIAGO DE QUERETARO,32,103,1,136,1679
QUERÉTARO,SANTIAGO DE QUERETARO,199,1783,8,1990,0
QUERÉTARO,SANTIAGO DE QUERETARO,22,232,3,257,1899
QUERÉTARO,SANTIAGO DE QUERETARO,22,222,1,245,1899
QUERÉTARO,SANTIAGO DE QUERETARO,17,190,2,209,1449
QUERÉTARO,SANTIAGO DE QUERETARO,15,173,0,188,1448
QUERÉTARO,SANTIAGO DE QUERETARO,12,146,2,160,1363
QUERÉTARO,SANTIAGO DE QUERETARO,14,142,2,158,1363
QUERÉTARO,SANTIAGO DE QUERETARO,8,169,1,178,1363
QUERÉTARO,SANTIAGO DE QUERETARO,9,152,1,162,1416
QUERÉTARO,SANTIAGO DE QUERETARO,15,139,1,155,1415
QUERÉTARO,SANTIAGO DE QUERETARO,15,136,2,153,1415
QUERÉTARO,SANTIAGO DE QUERETARO,7,186,2,195,1448
QUERÉTARO,SANTIAGO DE QUERETARO,11,149,2,162,1448
QUERÉTARO,SANTIAGO DE QUERETARO,26,138,2,166,1624
QUERÉTARO,SANTIAGO DE QUERETARO,8,128,2,138,1624
QUERÉTARO,SANTIAGO DE QUERETARO,20,148,0,168,1670
QUERÉTARO,SANTIAGO DE QUERETARO,9,160,4,173,1669
QUERÉTARO,SANTIAGO DE QUERETARO,12,163,2,177,1873
QUERÉTARO,SANTIAGO DE QUERETARO,18,174,2,194,1873
QUERÉTARO,SANTIAGO DE QUERETARO,17,158,5,180,1873
QUERÉTARO,SANTIAGO DE QUERETARO,23,170,1,194,1448
QUERÉTARO,SANTIAGO DE QUERETARO,19,195,0,214,1447
QUERÉTARO,SANTIAGO DE QUERETARO,11,178,4,193,1766
QUERÉTARO,SANTIAGO DE QUERETARO,29,179,3,211,1765
QUERÉTARO,SANTIAGO DE QUERETARO,11,178,3,192,1874
QUERÉTARO,SANTIAGO DE QUERETARO,14,197,2,213,1874
QUERÉTARO,SANTIAGO DE QUERETARO,8,125,1,134,1103
QUERÉTARO,SANTIAGO DE QUERETARO,6,85,2,93,1103
QUERÉTARO,SANTIAGO DE QUERETARO,10,127,0,137,1593
QUERÉTARO,SANTIAGO DE QUERETARO,11,136,1,148,1593
QUERÉTARO,SANTIAGO DE QUERETARO,9,138,0,147,1592
QUERÉTARO,SANTIAGO DE QUERETARO,17,115,1,133,1592
QUERÉTARO,SANTIAGO DE QUERETARO,17,134,1,152,1592
QUERÉTARO,SANTIAGO DE QUERETARO,25,164,2,191,1609
QUERÉTARO,SANTIAGO DE QUERETARO,22,115,0,137,1609
QUERÉTARO,SANTIAGO DE QUERETARO,7,125,0,132,1608
QUERÉTARO,SANTIAGO DE QUERETARO,20,190,0,210,1870
QUERÉTARO,SANTIAGO DE QUERETARO,33,170,2,205,1870
QUERÉTARO,SANTIAGO DE QUERETARO,51,106,1,158,1801
QUERÉTARO,SANTIAGO DE QUERETARO,44,108,0,152,1800
QUERÉTARO,SANTIAGO DE QUERETARO,25,111,1,137,1800
QUERÉTARO,SANTIAGO DE QUERETARO,39,94,1,134,1800
QUERÉTARO,SANTIAGO DE QUERETARO,16,214,6,236,1837
QUERÉTARO,SANTIAGO DE QUERETARO,28,160,2,190,1836
QUERÉTARO,SANTIAGO DE QUERETARO,18,186,7,211,1741
QUERÉTARO,SANTIAGO DE QUERETARO,25,219,1,245,1741
QUERÉTARO,SANTIAGO DE QUERETARO,12,185,6,203,1660
QUERÉTARO,SANTIAGO DE QUERETARO,10,176,2,188,1659
QUERÉTARO,SANTIAGO DE QUERETARO,26,177,3,206,1872
QUERÉTARO,SANTIAGO DE QUERETARO,20,184,2,206,1872
QUERÉTARO,SANTIAGO DE QUERETARO,32,250,2,284,1938
QUERÉTARO,SANTIAGO DE QUERETARO,21,250,3,274,1938
QUERÉTARO,SANTIAGO DE QUERETARO,18,141,4,163,1446
QUERÉTARO,SANTIAGO DE QUERETARO,12,178,1,191,1446
QUERÉTARO,SANTIAGO DE QUERETARO,14,172,1,187,1446
QUERÉTARO,SANTIAGO DE QUERETARO,24,199,0,223,1889
QUERÉTARO,SANTIAGO DE QUERETARO,22,234,1,257,1889
QUERÉTARO,SANTIAGO DE QUERETARO,23,187,0,210,1858
QUERÉTARO,SANTIAGO DE QUERETARO,17,175,0,192,1858
QUERÉTARO,SANTIAGO DE QUERETARO,12,111,0,123,1212
QUERÉTARO,SANTIAGO DE QUERETARO,16,115,3,134,1211
QUERÉTARO,SANTIAGO DE QUERETARO,30,59,0,89,1368
QUERÉTARO,SANTIAGO DE QUERETARO,35,75,0,110,1368
QUERÉTARO,SANTIAGO DE QUERETARO,23,88,5,116,1367
QUERÉTARO,SANTIAGO DE QUERETARO,11,75,4,90,1046
QUERÉTARO,SANTIAGO DE QUERETARO,4,79,3,86,1046
QUERÉTARO,SANTIAGO DE QUERETARO,5,101,2,108,1646
QUERÉTARO,SANTIAGO DE QUERETARO,3,89,2,94,1646
QUERÉTARO,SANTIAGO DE QUERETARO,12,129,1,142,1599
QUERÉTARO,SANTIAGO DE QUERETARO,6,131,6,143,1599
QUERÉTARO,SANTIAGO DE QUERETARO,10,131,1,142,1812
QUERÉTARO,SANTIAGO DE QUERETARO,6,149,1,156,1812
QUERÉTARO,SANTIAGO DE QUERETARO,5,84,0,89,1339
QUERÉTARO,SANTIAGO DE QUERETARO,8,84,1,93,1339
QUERÉTARO,SANTIAGO DE QUERETARO,11,86,1,98,1338
QUERÉTARO,SANTIAGO DE QUERETARO,6,137,4,147,1607
QUERÉTARO,SANTIAGO DE QUERETARO,5,176,3,184,1606
QUERÉTARO,EL PUEBLITO,11,73,3,87,1367
QUERÉTARO,EL PUEBLITO,13,72,3,88,1367
QUERÉTARO,EL PUEBLITO,22,116,1,139,1887
QUERÉTARO,EL PUEBLITO,18,146,3,167,1887
QUERÉTARO,EL PUEBLITO,9,127,2,138,1603
QUERÉTARO,EL PUEBLITO,10,124,4,138,1603
QUERÉTARO,EL PUEBLITO,8,61,4,73,1865
QUERÉTARO,EL PUEBLITO,9,48,1,58,1865
QUERÉTARO,EL PUEBLITO,15,72,4,91,1443
QUERÉTARO,EL PUEBLITO,14,92,2,108,1443
QUERÉTARO,EL PUEBLITO,31,246,10,287,1846
QUERÉTARO,EL PUEBLITO,27,211,7,245,1846
QUERÉTARO,EL PUEBLITO,15,66,8,89,1272
QUERÉTARO,EL PUEBLITO,17,73,5,95,1272
QUERÉTARO,EL PUEBLITO,19,319,11,349,1387
QUERÉTARO,EL PUEBLITO,16,294,8,318,1386
QUERÉTARO,EL PUEBLITO,6,285,4,295,1386
QUERÉTARO,EL PUEBLITO,12,208,2,222,1055
QUERÉTARO,EL PUEBLITO,17,232,8,257,1055
QUERÉTARO,EL PUEBLITO,26,175,5,206,1409
QUERÉTARO,EL PUEBLITO,32,159,6,197,1408
QUERÉTARO,EL PUEBLITO,27,235,17,279,1169
QUERÉTARO,EL PUEBLITO,21,234,20,275,1169
QUERÉTARO,EL PUEBLITO,20,153,11,184,1545
QUERÉTARO,EL PUEBLITO,30,212,9,251,1545
QUERÉTARO,EL PUEBLITO,20,183,9,212,1950
QUERÉTARO,EL PUEBLITO,23,176,8,207,1950
QUERÉTARO,EL PUEBLITO,10,121,6,137,1884
QUERÉTARO,EL PUEBLITO,16,136,5,157,1884
QUERÉTARO,EL PUEBLITO,13,115,12,140,1138
QUERÉTARO,EL PUEBLITO,14,131,18,163,1138
QUERÉTARO,EL PUEBLITO,13,122,0,135,1607
QUERÉTARO,EL PUEBLITO,13,104,18,135,1607
QUERÉTARO,EL PUEBLITO,14,98,1,113,1607
QUERÉTARO,EL PUEBLITO,24,111,1,136,1607
QUERÉTARO,EL PUEBLITO,15,115,1,131,1404
QUERÉTARO,EL PUEBLITO,14,103,0,117,1403
QUERÉTARO,EL PUEBLITO,10,105,1,116,1403
QUERÉTARO,EL PUEBLITO,21,120,0,141,1819
QUERÉTARO,EL PUEBLITO,29,119,0,148,1818
QUERÉTARO,EL PUEBLITO,20,111,0,131,1818
QUERÉTARO,EL PUEBLITO,22,117,1,140,1818
QUERÉTARO,EL PUEBLITO,11,141,1,153,1818
QUERÉTARO,EL PUEBLITO,13,127,0,140,1818
QUERÉTARO,EL PUEBLITO,20,147,1,168,1818
QUERÉTARO,EL PUEBLITO,19,132,1,152,1818
QUERÉTARO,EL PUEBLITO,21,130,0,151,1818
QUERÉTARO,EL PUEBLITO,18,62,0,80,1035
QUERÉTARO,EL PUEBLITO,15,79,1,95,1035
QUERÉTARO,EL PUEBLITO,21,108,0,129,1399
QUERÉTARO,EL PUEBLITO,11,105,1,117,1398
QUERÉTARO,EL PUEBLITO,19,104,1,124,1398
QUERÉTARO,EL PUEBLITO,18,151,2,171,1756
QUERÉTARO,EL PUEBLITO,16,175,2,193,1756
QUERÉTARO,EL PUEBLITO,15,175,2,192,1756
QUERÉTARO,EL PUEBLITO,187,1270,13,1470,0
QUERÉTARO,EL PUEBLITO,9,130,3,142,1715
QUERÉTARO,EL PUEBLITO,9,144,2,155,1715
QUERÉTARO,EL PUEBLITO,6,139,2,147,1715
QUERÉTARO,EL PUEBLITO,11,110,3,124,1715
QUERÉTARO,EL PUEBLITO,13,120,1,134,1715
QUERÉTARO,EL PUEBLITO,10,151,1,162,1714
QUERÉTARO,EL PUEBLITO,11,148,0,159,1098
QUERÉTARO,EL PUEBLITO,11,123,1,135,1097
QUERÉTARO,EL PUEBLITO,15,195,1,211,1872
QUERÉTARO,EL PUEBLITO,11,184,0,195,1871
QUERÉTARO,EL PUEBLITO,10,203,5,218,1871
QUERÉTARO,EL PUEBLITO,14,105,4,123,1198
QUERÉTARO,EL PUEBLITO,10,120,0,130,1197
QUERÉTARO,EL PUEBLITO,20,159,2,181,1058
QUERÉTARO,EL PUEBLITO,14,140,3,157,1057
QUERÉTARO,EL PUEBLITO,17,164,2,183,1510
QUERÉTARO,EL PUEBLITO,21,155,2,178,1510
QUERÉTARO,EL PUEBLITO,18,214,4,236,1899
QUERÉTARO,EL PUEBLITO,25,212,3,240,1899
QUERÉTARO,EL PUEBLITO,39,167,0,206,1948
QUERÉTARO,EL PUEBLITO,48,135,0,183,1947
QUERÉTARO,EL PUEBLITO,31,141,0,172,1947
QUERÉTARO,EL PUEBLITO,40,147,1,188,1947
QUERÉTARO,EL PUEBLITO,43,138,2,183,1947
QUERÉTARO,EL PUEBLITO,13,157,1,171,1634
QUERÉTARO,EL PUEBLITO,19,138,0,157,1633
QUERÉTARO,EL PUEBLITO,18,138,2,158,1633
QUERÉTARO,EL PUEBLITO,15,152,2,169,1633
QUERÉTARO,EL PUEBLITO,16,189,3,208,1633
QUERÉTARO,EL PUEBLITO,25,119,3,147,1961
QUERÉTARO,EL PUEBLITO,32,151,5,188,1960
QUERÉTARO,EL PUEBLITO,18,179,7,204,1960
QUERÉTARO,EL PUEBLITO,25,150,0,175,1960
QUERÉTARO,EL PUEBLITO,30,134,3,167,1960
QUERÉTARO,EL PUEBLITO,14,147,6,167,1590
QUERÉTARO,EL PUEBLITO,6,162,1,169,1590
QUERÉTARO,EL PUEBLITO,10,153,1,164,1590
QUERÉTARO,EL PUEBLITO,34,91,6,131,1970
QUERÉTARO,EL PUEBLITO,43,104,3,150,1969
QUERÉTARO,EL PUEBLITO,36,103,0,139,1969
QUERÉTARO,EL PUEBLITO,3,66,1,70,1489
QUERÉTARO,EL PUEBLITO,8,65,1,74,1488
QUERÉTARO,EL PUEBLITO,3,77,0,80,1488
QUERÉTARO,EL PUEBLITO,12,182,4,198,1560
QUERÉTARO,EL PUEBLITO,15,171,4,190,1560
QUERÉTARO,EL PUEBLITO,7,112,1,120,1765
QUERÉTARO,EL PUEBLITO,19,105,0,124,1764
QUERÉTARO,EL PUEBLITO,8,62,0,70,1262
QUERÉTARO,EL PUEBLITO,8,61,3,72,1261
QUERÉTARO,EL PUEBLITO,8,57,2,67,1369
QUERÉTARO,EL PUEBLITO,10,48,0,58,1368
QUERÉTARO,EL PUEBLITO,6,112,5,123,1932
QUERÉTARO,EL PUEBLITO,8,145,5,158,1931
QUERÉTARO,EL PUEBLITO,13,67,4,84,1036
QUERÉTARO,EL PUEBLITO,9,51,2,62,1035
QUERÉTARO,EL PUEBLITO,21,91,4,116,1970
QUERÉTARO,EL PUEBLITO,14,85,2,101,1969
QUERÉTARO,EL PUEBLITO,5,71,1,77,1204
QUERÉTARO,EL PUEBLITO,10,53,3,66,1204
QUERÉTARO,EL PUEBLITO,8,46,1,55,1642
QUERÉTARO,EL PUEBLITO,15,53,2,70,1642
QUERÉTARO,EL PUEBLITO,12,82,2,96,1551
QUERÉTARO,EL PUEBLITO,7,39,0,46,1550
QUERÉTARO,EL PUEBLITO,4,22,1,27,1752
QUERÉTARO,EL PUEBLITO,3,24,0,27,1752
QUERÉTARO,EL PUEBLITO,5,48,0,53,1330
QUERÉTARO,EL PUEBLITO,10,90,1,101,1329
QUERÉTARO,EL PUEBLITO,8,178,0,186,1511
QUERÉTARO,EL PUEBLITO,8,149,2,159,1511
QUERÉTARO,EL PUEBLITO,6,186,2,194,1329
QUERÉTARO,EL PUEBLITO,10,185,0,195,1329
QUERÉTARO,EL PUEBLITO,3,99,1,103,1445
QUERÉTARO,EL PUEBLITO,10,130,4,144,1445
QUERÉTARO,EL PUEBLITO,5,98,1,104,1444
QUERÉTARO,EL PUEBLITO,11,153,1,165,1094
QUERÉTARO,EL PUEBLITO,9,137,1,147,1094
QUERÉTARO,EL PUEBLITO,2,65,3,70,1705
QUERÉTARO,EL PUEBLITO,7,63,0,70,1704
QUERÉTARO,EL PUEBLITO,4,107,1,112,1467
QUERÉTARO,EL PUEBLITO,12,164,11,187,1467
QUERÉTARO,EL PUEBLITO,8,106,1,115,1616
QUERÉTARO,EL PUEBLITO,7,99,2,108,1616
QUERÉTARO,EL PUEBLITO,3,110,3,116,1798
QUERÉTARO,EL PUEBLITO,4,137,1,142,1797
QUERÉTARO,EL PUEBLITO,9,56,6,71,1567
QUERÉTARO,EL PUEBLITO,3,46,5,54,1567
QUERÉTARO,EL PUEBLITO,9,105,2,116,1851
QUERÉTARO,EL PUEBLITO,2,93,7,102,1850
QUERÉTARO,EL PUEBLITO,9,119,1,129,1929
QUERÉTARO,EL PUEBLITO,22,124,2,148,1928
QUERÉTARO,EL PUEBLITO,13,135,2,150,1928
QUERÉTARO,EL PUEBLITO,22,117,0,139,1928
QUERÉTARO,EL PUEBLITO,18,110,1,129,1928
QUERÉTARO,EL PUEBLITO,12,110,0,122,1928
QUERÉTARO,EL PUEBLITO,19,118,0,137,1928
QUERÉTARO,EL PUEBLITO,25,134,1,160,1928
QUERÉTARO,EL PUEBLITO,14,105,0,119,1928
QUERÉTARO,EL PUEBLITO,13,113,0,126,1928
QUERÉTARO,EL PUEBLITO,107,20,2,129,1928
QUERÉTARO,EL PUEBLITO,6,174,4,184,1866
QUERÉTARO,EL PUEBLITO,16,161,2,179,1866
QUERÉTARO,EL PUEBLITO,11,186,4,201,1664
QUERÉTARO,EL PUEBLITO,5,121,0,126,1664
QUERÉTARO,EL PUEBLITO,8,111,7,126,1663
QUERÉTARO,EL PUEBLITO,8,102,2,112,1449
QUERÉTARO,EL PUEBLITO,5,82,6,93,1448
QUERÉTARO,EL PUEBLITO,4,107,2,113,1448
QUERÉTARO,EL PUEBLITO,5,152,2,159,1935
QUERÉTARO,EL PUEBLITO,10,158,2,170,1935
QUERÉTARO,EL PUEBLITO,5,125,1,131,1905
QUERÉTARO,EL PUEBLITO,5,134,1,140,1905
QUERÉTARO,EL PUEBLITO,10,122,1,133,1905
QUERÉTARO,EL PUEBLITO,8,126,3,137,1905
QUERÉTARO,EL PUEBLITO,4,130,2,136,1905
QUERÉTARO,EL PUEBLITO,7,130,1,138,1905
QUERÉTARO,EL PUEBLITO,5,160,1,166,1904
QUERÉTARO,EL PUEBLITO,13,123,2,138,1655
QUERÉTARO,EL PUEBLITO,12,125,1,138,1655
QUERÉTARO,EL PUEBLITO,13,149,1,163,1654
QUERÉTARO,EL PUEBLITO,9,130,1,140,1654
QUERÉTARO,EL PUEBLITO,11,113,2,126,1654
QUERÉTARO,EL PUEBLITO,8,153,1,162,1654
QUERÉTARO,EL PUEBLITO,8,123,1,132,1901
QUERÉTARO,EL PUEBLITO,8,97,2,107,1901
QUERÉTARO,EL PUEBLITO,7,98,1,106,1900
QUERÉTARO,EL PUEBLITO,2,85,0,87,1900
QUERÉTARO,EL PUEBLITO,6,100,0,106,1900
QUERÉTARO,EL PUEBLITO,12,147,1,160,1879
QUERÉTARO,EL PUEBLITO,11,124,0,135,1879
QUERÉTARO,EL PUEBLITO,4,123,0,127,1879
QUERÉTARO,EL PUEBLITO,9,119,1,129,1879
QUERÉTARO,EL PUEBLITO,12,125,1,138,1879
QUERÉTARO,EL PUEBLITO,14,102,1,117,1878
QUERÉTARO,EL PUEBLITO,10,143,2,155,1878
QUERÉTARO,EL PUEBLITO,10,133,0,143,1878
QUERÉTARO,EL PUEBLITO,5,73,1,79,1326
QUERÉTARO,EL PUEBLITO,9,65,0,74,1325
QUERÉTARO,EL PUEBLITO,11,91,1,103,1325
QUERÉTARO,EL PUEBLITO,3,124,2,129,1456
QUERÉTARO,EL PUEBLITO,3,90,1,94,1456
QUERÉTARO,EL PUEBLITO,5,85,0,90,1455
QUERÉTARO,EL PUEBLITO,3,122,1,126,1433
QUERÉTARO,EL PUEBLITO,3,80,0,83,1432
QUERÉTARO,EL PUEBLITO,26,145,0,171,1960
QUERÉTARO,EL PUEBLITO,30,146,1,177,1959
QUERÉTARO,EL PUEBLITO,25,136,2,163,1565
QUERÉTARO,EL PUEBLITO,16,129,2,147,1565
QUERÉTARO,EL PUEBLITO,39,163,0,202,1861
QUERÉTARO,EL PUEBLITO,34,185,1,220,1861
QUERÉTARO,EL PUEBLITO,8,112,4,124,1318
QUERÉTARO,EL PUEBLITO,8,123,1,132,1318
QUERÉTARO,EL PUEBLITO,24,103,1,128,1712
QUERÉTARO,EL PUEBLITO,33,80,0,113,1712
QUERÉTARO,EL PUEBLITO,28,87,0,115,1712
QUERÉTARO,EL PUEBLITO,22,109,0,131,1712
QUERÉTARO,EL PUEBLITO,24,106,0,130,1712
QUERÉTARO,EL PUEBLITO,10,116,0,126,1944
QUERÉTARO,EL PUEBLITO,10,111,0,121,1943
QUERÉTARO,EL PUEBLITO,11,137,1,149,1726
QUERÉTARO,EL PUEBLITO,13,185,2,200,1726
QUERÉTARO,EL PUEBLITO,27,169,0,196,1909
QUERÉTARO,EL PUEBLITO,40,167,0,207,1909
QUERÉTARO,EL PUEBLITO,26,116,2,144,1530
QUERÉTARO,EL PUEBLITO,24,130,0,154,1529
QUERÉTARO,EL PUEBLITO,25,158,1,184,1926
QUERÉTARO,EL PUEBLITO,41,140,1,182,1925
QUERÉTARO,EL PUEBLITO,28,167,0,195,1893
QUERÉTARO,EL PUEBLITO,38,167,1,206,1893
QUERÉTARO,EL PUEBLITO,20,131,1,152,1840
QUERÉTARO,EL PUEBLITO,21,133,1,155,1839
QUERÉTARO,EL PUEBLITO,24,153,0,177,1819
QUERÉTARO,EL PUEBLITO,29,138,0,167,1819
QUERÉTARO,EL PUEBLITO,43,154,1,198,1780
QUERÉTARO,EL PUEBLITO,32,166,1,199,1779
QUERÉTARO,EL PUEBLITO,16,264,18,298,1625
QUERÉTARO,EL PUEBLITO,10,258,8,276,1625
QUERÉTARO,EL PUEBLITO,5,97,4,106,1337
QUERÉTARO,EL PUEBLITO,7,83,2,92,1336
QUERÉTARO,EL PUEBLITO,5,104,2,111,1336
QUINTANA ROO,PLAYA DEL CARMEN,8,291,4,303,1158
QUINTANA ROO,PLAYA DEL CARMEN,6,306,4,316,1158
QUINTANA ROO,PLAYA DEL CARMEN,8,321,0,329,1519
QUINTANA ROO,PLAYA DEL CARMEN,14,286,4,304,1518
QUINTANA ROO,PLAYA DEL CARMEN,16,491,4,511,1935
QUINTANA ROO,PLAYA DEL CARMEN,12,502,5,519,1934
QUINTANA ROO,PLAYA DEL CARMEN,11,524,8,543,1932
QUINTANA ROO,PLAYA DEL CARMEN,14,511,0,525,1931
QUINTANA ROO,PLAYA DEL CARMEN,18,442,2,462,1800
QUINTANA ROO,PLAYA DEL CARMEN,9,368,1,378,1799
QUINTANA ROO,PLAYA DEL CARMEN,12,427,7,446,1799
QUINTANA ROO,PLAYA DEL CARMEN,16,379,2,397,1884
QUINTANA ROO,PLAYA DEL CARMEN,12,426,2,440,1883
QUINTANA ROO,PLAYA DEL CARMEN,14,438,1,453,1976
QUINTANA ROO,PLAYA DEL CARMEN,13,469,3,485,1976
QUINTANA ROO,PLAYA DEL CARMEN,13,452,5,470,1976
QUINTANA ROO,PLAYA DEL CARMEN,7,425,3,435,1976
QUINTANA ROO,PLAYA DEL CARMEN,9,478,1,488,1976
QUINTANA ROO,PLAYA DEL CARMEN,17,447,2,466,1976
QUINTANA ROO,PLAYA DEL CARMEN,3,476,4,483,1975
QUINTANA ROO,PLAYA DEL CARMEN,18,386,2,406,1667
QUINTANA ROO,PLAYA DEL CARMEN,9,391,5,405,1667
QUINTANA ROO,PLAYA DEL CARMEN,5,401,5,411,1667
QUINTANA ROO,PLAYA DEL CARMEN,16,401,1,418,1666
QUINTANA ROO,PLAYA DEL CARMEN,14,335,3,352,1687
QUINTANA ROO,PLAYA DEL CARMEN,15,255,2,272,1686
QUINTANA ROO,PLAYA DEL CARMEN,13,352,3,368,1686
QUINTANA ROO,PLAYA DEL CARMEN,15,275,0,290,1433
QUINTANA ROO,PLAYA DEL CARMEN,15,213,6,234,1432
QUINTANA ROO,PLAYA DEL CARMEN,20,367,2,389,1807
QUINTANA ROO,PLAYA DEL CARMEN,22,345,6,373,1807
QUINTANA ROO,PLAYA DEL CARMEN,3,347,3,353,1140
QUINTANA ROO,PLAYA DEL CARMEN,15,347,0,362,1140
QUINTANA ROO,PLAYA DEL CARMEN,2,374,3,379,1156
QUINTANA ROO,PLAYA DEL CARMEN,9,348,6,363,1156
QUINTANA ROO,PLAYA DEL CARMEN,8,443,3,454,1842
QUINTANA ROO,PLAYA DEL CARMEN,12,487,3,502,1842
QUINTANA ROO,PLAYA DEL CARMEN,10,387,5,402,1842
QUINTANA ROO,PLAYA DEL CARMEN,11,413,3,427,1842
QUINTANA ROO,PLAYA DEL CARMEN,12,434,1,447,1842
QUINTANA ROO,PLAYA DEL CARMEN,15,392,1,408,1841
QUINTANA ROO,PLAYA DEL CARMEN,11,238,4,253,2041
QUINTANA ROO,PLAYA DEL CARMEN,13,207,2,222,2041
QUINTANA ROO,PLAYA DEL CARMEN,20,193,5,218,2041
QUINTANA ROO,PLAYA DEL CARMEN,9,235,2,246,2040
QUINTANA ROO,PLAYA DEL CARMEN,14,228,0,242,2040
QUINTANA ROO,PLAYA DEL CARMEN,17,761,2,780,2007
QUINTANA ROO,PLAYA DEL CARMEN,7,644,4,655,2006
QUINTANA ROO,PLAYA DEL CARMEN,18,685,11,714,1110
QUINTANA ROO,PLAYA DEL CARMEN,5,671,11,687,1110
QUINTANA ROO,PLAYA DEL CARMEN,14,427,9,450,1971
QUINTANA ROO,PLAYA DEL CARMEN,10,379,2,391,1970
QUINTANA ROO,PLAYA DEL CARMEN,3,241,5,249,1355
QUINTANA ROO,PLAYA DEL CARMEN,10,215,3,228,1355
QUINTANA ROO,PLAYA DEL CARMEN,9,184,2,195,1355
QUINTANA ROO,PLAYA DEL CARMEN,7,426,2,435,1922
QUINTANA ROO,PLAYA DEL CARMEN,12,413,1,426,1921
QUINTANA ROO,PLAYA DEL CARMEN,11,406,4,421,1921
QUINTANA ROO,PLAYA DEL CARMEN,9,434,4,447,2138
QUINTANA ROO,PLAYA DEL CARMEN,5,401,17,423,2138
QUINTANA ROO,PLAYA DEL CARMEN,7,424,5,436,2138
QUINTANA ROO,PLAYA DEL CARMEN,11,416,6,433,2138
QUINTANA ROO,PLAYA DEL CARMEN,14,589,7,610,1474
QUINTANA ROO,PLAYA DEL CARMEN,3,567,6,576,1474
QUINTANA ROO,PLAYA DEL CARMEN,9,524,6,539,1474
QUINTANA ROO,PLAYA DEL CARMEN,9,632,19,660,1931
QUINTANA ROO,PLAYA DEL CARMEN,7,666,9,682,1931
QUINTANA ROO,PLAYA DEL CARMEN,3,228,0,231,1045
QUINTANA ROO,PLAYA DEL CARMEN,5,183,1,189,1045
QUINTANA ROO,PLAYA DEL CARMEN,5,299,8,312,1226
QUINTANA ROO,PLAYA DEL CARMEN,5,300,2,307,1225
QUINTANA ROO,PLAYA DEL CARMEN,11,503,18,532,1472
QUINTANA ROO,PLAYA DEL CARMEN,16,508,3,527,1472
QUINTANA ROO,PLAYA DEL CARMEN,0,490,10,500,1471
QUINTANA ROO,PLAYA DEL CARMEN,7,634,9,650,1725
QUINTANA ROO,PLAYA DEL CARMEN,10,484,10,504,1724
QUINTANA ROO,PLAYA DEL CARMEN,6,514,17,537,1724
QUINTANA ROO,PLAYA DEL CARMEN,6,442,2,450,2029
QUINTANA ROO,PLAYA DEL CARMEN,12,380,2,394,2029
QUINTANA ROO,PLAYA DEL CARMEN,22,138,0,160,1954
QUINTANA ROO,PLAYA DEL CARMEN,28,146,0,174,1953
QUINTANA ROO,PLAYA DEL CARMEN,20,267,0,287,1986
QUINTANA ROO,PLAYA DEL CARMEN,14,297,5,316,1985
QUINTANA ROO,PLAYA DEL CARMEN,2,359,4,365,1678
QUINTANA ROO,PLAYA DEL CARMEN,9,365,0,374,1677
QUINTANA ROO,PLAYA DEL CARMEN,11,386,1,398,2041
QUINTANA ROO,PLAYA DEL CARMEN,13,367,2,382,2040
QUINTANA ROO,PLAYA DEL CARMEN,20,293,3,316,1972
QUINTANA ROO,PLAYA DEL CARMEN,17,346,2,365,1971
QUINTANA ROO,PLAYA DEL CARMEN,20,320,2,342,1971
QUINTANA ROO,PLAYA DEL CARMEN,11,285,8,304,1695
QUINTANA ROO,PLAYA DEL CARMEN,11,279,1,291,1695
QUINTANA ROO,PLAYA DEL CARMEN,10,231,3,244,1568
QUINTANA ROO,PLAYA DEL CARMEN,9,256,4,269,1568
QUINTANA ROO,PLAYA DEL CARMEN,11,268,4,283,1568
QUINTANA ROO,PLAYA DEL CARMEN,0,269,0,269,1714
QUINTANA ROO,PLAYA DEL CARMEN,4,243,2,249,1714
QUINTANA ROO,PLAYA DEL CARMEN,16,186,1,203,1415
QUINTANA ROO,PLAYA DEL CARMEN,8,186,0,194,1414
QUINTANA ROO,PLAYA DEL CARMEN,10,196,1,207,1414
QUINTANA ROO,PLAYA DEL CARMEN,9,234,0,243,1124
QUINTANA ROO,PLAYA DEL CARMEN,6,207,0,213,1123
QUINTANA ROO,PLAYA DEL CARMEN,7,331,1,339,1714
QUINTANA ROO,PLAYA DEL CARMEN,5,313,1,319,1713
QUINTANA ROO,PLAYA DEL CARMEN,8,299,2,309,1713
QUINTANA ROO,PLAYA DEL CARMEN,31,198,0,229,1905
QUINTANA ROO,PLAYA DEL CARMEN,25,171,0,196,1904
QUINTANA ROO,PLAYA DEL CARMEN,10,236,0,246,1554
QUINTANA ROO,PLAYA DEL CARMEN,19,253,1,273,1554
QUINTANA ROO,PLAYA DEL CARMEN,21,251,1,273,1794
QUINTANA ROO,PLAYA DEL CARMEN,15,275,1,291,1793
QUINTANA ROO,PLAYA DEL CARMEN,12,261,1,274,1714
QUINTANA ROO,PLAYA DEL CARMEN,19,219,0,238,1713
QUINTANA ROO,PLAYA DEL CARMEN,5,290,4,299,2051
QUINTANA ROO,PLAYA DEL CARMEN,11,317,3,331,2050
QUINTANA ROO,PLAYA DEL CARMEN,7,234,2,243,1548
QUINTANA ROO,PLAYA DEL CARMEN,10,160,2,172,1547
QUINTANA ROO,PLAYA DEL CARMEN,6,206,3,215,1547
QUINTANA ROO,PLAYA DEL CARMEN,3,234,3,240,1530
QUINTANA ROO,PLAYA DEL CARMEN,3,190,1,194,1530
QUINTANA ROO,PLAYA DEL CARMEN,4,218,6,228,1530
QUINTANA ROO,PLAYA DEL CARMEN,8,273,2,283,1896
QUINTANA ROO,PLAYA DEL CARMEN,10,249,1,260,1895
QUINTANA ROO,PLAYA DEL CARMEN,19,191,1,211,1544
QUINTANA ROO,PLAYA DEL CARMEN,14,190,4,208,1544
QUINTANA ROO,PLAYA DEL CARMEN,14,187,1,202,1543
QUINTANA ROO,PLAYA DEL CARMEN,7,285,1,293,1519
QUINTANA ROO,PLAYA DEL CARMEN,12,280,2,294,1519
QUINTANA ROO,PLAYA DEL CARMEN,14,193,0,207,1751
QUINTANA ROO,PLAYA DEL CARMEN,10,210,3,223,1750
QUINTANA ROO,PLAYA DEL CARMEN,20,134,0,154,1473
QUINTANA ROO,PLAYA DEL CARMEN,10,114,2,126,1473
QUINTANA ROO,PLAYA DEL CARMEN,14,119,1,134,1473
QUINTANA ROO,PLAYA DEL CARMEN,11,303,8,322,1654
QUINTANA ROO,PLAYA DEL CARMEN,17,232,1,250,1653
QUINTANA ROO,PLAYA DEL CARMEN,9,249,1,259,1551
QUINTANA ROO,PLAYA DEL CARMEN,8,203,6,217,1550
QUINTANA ROO,PLAYA DEL CARMEN,19,195,0,214,1697
QUINTANA ROO,PLAYA DEL CARMEN,19,206,1,226,1697
QUINTANA ROO,PLAYA DEL CARMEN,17,205,1,223,1696
QUINTANA ROO,PLAYA DEL CARMEN,11,84,3,98,1183
QUINTANA ROO,PLAYA DEL CARMEN,5,75,0,80,1182
QUINTANA ROO,PLAYA DEL CARMEN,0,52,0,52,1096
QUINTANA ROO,PLAYA DEL CARMEN,17,28,0,45,1095
QUINTANA ROO,PLAYA DEL CARMEN,10,72,0,82,1056
QUINTANA ROO,PLAYA DEL CARMEN,13,50,1,64,1056
QUINTANA ROO,PLAYA DEL CARMEN,0,279,4,283,1510
QUINTANA ROO,PLAYA DEL CARMEN,1,287,0,288,1510
QUINTANA ROO,PLAYA DEL CARMEN,4,363,1,368,2009
QUINTANA ROO,PLAYA DEL CARMEN,8,385,1,394,2009
QUINTANA ROO,PLAYA DEL CARMEN,4,382,0,386,2009
QUINTANA ROO,PLAYA DEL CARMEN,24,261,0,285,1991
QUINTANA ROO,PLAYA DEL CARMEN,14,284,5,303,1990
QUINTANA ROO,PLAYA DEL CARMEN,12,201,0,213,2087
QUINTANA ROO,PLAYA DEL CARMEN,13,219,0,232,2087
QUINTANA ROO,PLAYA DEL CARMEN,10,198,0,208,2087
QUINTANA ROO,PLAYA DEL CARMEN,13,189,2,204,2087
QUINTANA ROO,PLAYA DEL CARMEN,14,192,0,206,2087
QUINTANA ROO,PLAYA DEL CARMEN,12,182,0,194,2087
QUINTANA ROO,PLAYA DEL CARMEN,4,178,0,182,2086
QUINTANA ROO,PLAYA DEL CARMEN,10,187,2,199,2086
QUINTANA ROO,PLAYA DEL CARMEN,10,191,0,201,2086
QUINTANA ROO,PLAYA DEL CARMEN,5,301,1,307,1622
QUINTANA ROO,PLAYA DEL CARMEN,6,309,2,317,1621
QUINTANA ROO,PLAYA DEL CARMEN,5,281,1,287,1621
QUINTANA ROO,PLAYA DEL CARMEN,6,322,0,328,1726
QUINTANA ROO,PLAYA DEL CARMEN,4,305,2,311,1726
QUINTANA ROO,PLAYA DEL CARMEN,10,293,1,304,1726
QUINTANA ROO,PLAYA DEL CARMEN,12,287,1,300,1900
QUINTANA ROO,PLAYA DEL CARMEN,14,295,0,309,1900
QUINTANA ROO,PLAYA DEL CARMEN,13,252,0,265,1899
QUINTANA ROO,PLAYA DEL CARMEN,11,296,1,308,1899
QUINTANA ROO,PLAYA DEL CARMEN,15,226,0,241,1945
QUINTANA ROO,PLAYA DEL CARMEN,13,253,1,267,1944
QUINTANA ROO,PLAYA DEL CARMEN,10,189,0,199,1944
QUINTANA ROO,PLAYA DEL CARMEN,9,141,0,150,1556
QUINTANA ROO,PLAYA DEL CARMEN,12,137,1,150,1555
QUINTANA ROO,PLAYA DEL CARMEN,8,286,2,296,1522
QUINTANA ROO,PLAYA DEL CARMEN,3,267,2,272,1522
QUINTANA ROO,PLAYA DEL CARMEN,10,298,1,309,1521
QUINTANA ROO,PLAYA DEL CARMEN,14,212,0,226,1759
QUINTANA ROO,PLAYA DEL CARMEN,14,219,1,234,1759
QUINTANA ROO,PLAYA DEL CARMEN,8,236,1,245,1799
QUINTANA ROO,PLAYA DEL CARMEN,15,235,0,250,1798
QUINTANA ROO,PLAYA DEL CARMEN,9,224,0,233,1832
QUINTANA ROO,PLAYA DEL CARMEN,12,199,2,213,1831
QUINTANA ROO,PLAYA DEL CARMEN,8,228,3,239,1831
QUINTANA ROO,PLAYA DEL CARMEN,13,306,0,319,1999
QUINTANA ROO,PLAYA DEL CARMEN,92,1899,7,1998,0
QUINTANA ROO,PLAYA DEL CARMEN,11,379,5,395,1647
QUINTANA ROO,PLAYA DEL CARMEN,10,389,7,406,1647
QUINTANA ROO,PLAYA DEL CARMEN,6,358,1,365,1647
QUINTANA ROO,PLAYA DEL CARMEN,11,389,2,402,1680
QUINTANA ROO,PLAYA DEL CARMEN,4,345,3,352,1680
QUINTANA ROO,PLAYA DEL CARMEN,12,363,3,378,1680
QUINTANA ROO,PLAYA DEL CARMEN,7,254,2,263,1703
QUINTANA ROO,PLAYA DEL CARMEN,9,334,2,345,1703
QUINTANA ROO,PLAYA DEL CARMEN,9,399,0,408,1782
QUINTANA ROO,PLAYA DEL CARMEN,6,347,6,359,1782
QUINTANA ROO,PLAYA DEL CARMEN,8,348,2,358,1781
QUINTANA ROO,PLAYA DEL CARMEN,3,330,4,337,1631
QUINTANA ROO,PLAYA DEL CARMEN,4,301,2,307,1630
QUINTANA ROO,PLAYA DEL CARMEN,6,292,0,298,1460
QUINTANA ROO,PLAYA DEL CARMEN,9,322,2,333,1460
QUINTANA ROO,PLAYA DEL CARMEN,9,348,2,359,1449
QUINTANA ROO,PLAYA DEL CARMEN,14,302,5,321,1449
QUINTANA ROO,PLAYA DEL CARMEN,18,346,6,370,1955
QUINTANA ROO,PLAYA DEL CARMEN,6,190,0,196,1552
QUINTANA ROO,PLAYA DEL CARMEN,3,203,0,206,1552
QUINTANA ROO,PLAYA DEL CARMEN,5,174,1,180,1551
QUINTANA ROO,PLAYA DEL CARMEN,4,286,2,292,1941
QUINTANA ROO,PLAYA DEL CARMEN,0,238,1,239,1940
QUINTANA ROO,PLAYA DEL CARMEN,6,219,1,226,2071
QUINTANA ROO,PLAYA DEL CARMEN,3,229,3,235,2070
QUINTANA ROO,PLAYA DEL CARMEN,7,263,3,273,1746
QUINTANA ROO,PLAYA DEL CARMEN,2,250,1,253,1745
QUINTANA ROO,PLAYA DEL CARMEN,3,193,2,198,1485
QUINTANA ROO,PLAYA DEL CARMEN,5,191,0,196,1484
QUINTANA ROO,PLAYA DEL CARMEN,5,264,1,270,1762
QUINTANA ROO,PLAYA DEL CARMEN,2,267,1,270,1761
QUINTANA ROO,PLAYA DEL CARMEN,2,259,0,261,1786
QUINTANA ROO,PLAYA DEL CARMEN,6,280,0,286,1785
QUINTANA ROO,PLAYA DEL CARMEN,5,237,2,244,1540
QUINTANA ROO,PLAYA DEL CARMEN,8,222,1,231,1540
QUINTANA ROO,PLAYA DEL CARMEN,12,566,4,582,1955
QUINTANA ROO,PLAYA DEL CARMEN,16,511,5,532,1955
QUINTANA ROO,CHETUMAL,7,725,5,737,2010
QUINTANA ROO,CHETUMAL,9,701,13,723,2009
QUINTANA ROO,CHETUMAL,6,430,3,439,1497
QUINTANA ROO,CHETUMAL,4,445,2,451,1496
QUINTANA ROO,CHETUMAL,10,627,4,641,1998
QUINTANA ROO,CHETUMAL,18,659,5,682,1998
QUINTANA ROO,CHETUMAL,9,537,4,550,1868
QUINTANA ROO,CHETUMAL,10,512,11,533,1868
QUINTANA ROO,CHETUMAL,14,350,8,372,1280
QUINTANA ROO,CHETUMAL,5,442,2,449,1280
QUINTANA ROO,CHETUMAL,8,437,7,452,1954
QUINTANA ROO,CHETUMAL,2,470,6,478,1954
QUINTANA ROO,CHETUMAL,9,663,7,679,1931
QUINTANA ROO,CHETUMAL,12,653,0,665,1930
QUINTANA ROO,CHETUMAL,5,428,7,440,1146
QUINTANA ROO,CHETUMAL,3,418,4,425,1146
QUINTANA ROO,CHETUMAL,7,606,10,623,1372
QUINTANA ROO,CHETUMAL,0,639,21,660,1371
QUINTANA ROO,CHETUMAL,13,690,14,717,1801
QUINTANA ROO,CHETUMAL,6,663,14,683,1800
QUINTANA ROO,CHETUMAL,13,425,9,447,1105
QUINTANA ROO,CHETUMAL,17,402,11,430,1105
QUINTANA ROO,CHETUMAL,7,491,7,505,1730
QUINTANA ROO,CHETUMAL,7,417,12,436,1729
QUINTANA ROO,CHETUMAL,12,448,6,466,1383
QUINTANA ROO,CHETUMAL,2,491,3,496,1383
QUINTANA ROO,CHETUMAL,16,702,10,728,1394
QUINTANA ROO,CHETUMAL,12,641,13,666,1393
QUINTANA ROO,CHETUMAL,12,719,3,734,1662
QUINTANA ROO,CHETUMAL,21,685,16,722,1661
QUINTANA ROO,CHETUMAL,7,501,7,515,1491
QUINTANA ROO,CHETUMAL,6,535,4,545,1490
QUINTANA ROO,CHETUMAL,13,400,12,425,1160
QUINTANA ROO,CHETUMAL,25,391,11,427,1159
QUINTANA ROO,CHETUMAL,10,398,12,420,1662
QUINTANA ROO,CHETUMAL,6,444,7,457,1661
QUINTANA ROO,CHETUMAL,8,481,14,503,1496
QUINTANA ROO,CHETUMAL,9,529,7,545,1495
QUINTANA ROO,CHETUMAL,26,504,7,537,1495
QUINTANA ROO,CHETUMAL,10,701,9,720,1959
QUINTANA ROO,CHETUMAL,10,706,13,729,1958
QUINTANA ROO,CHETUMAL,12,591,11,614,1547
QUINTANA ROO,CHETUMAL,8,625,0,633,1547
QUINTANA ROO,CHETUMAL,11,530,9,550,1547
QUINTANA ROO,CHETUMAL,4,459,4,467,1009
QUINTANA ROO,CHETUMAL,5,427,1,433,1009
QUINTANA ROO,CHETUMAL,13,723,13,749,1976
QUINTANA ROO,CHETUMAL,3,734,14,751,1975
QUINTANA ROO,CHETUMAL,9,748,24,781,1807
QUINTANA ROO,CHETUMAL,12,708,18,738,1807
QUINTANA ROO,CHETUMAL,13,735,9,757,1695
QUINTANA ROO,CHETUMAL,8,772,7,787,1695
QUINTANA ROO,CHETUMAL,10,743,7,760,1368
QUINTANA ROO,CHETUMAL,11,671,16,698,1367
QUINTANA ROO,CHETUMAL,22,396,6,424,1897
QUINTANA ROO,CHETUMAL,17,452,4,473,1896
QUINTANA ROO,CHETUMAL,38,418,3,459,1690
QUINTANA ROO,CHETUMAL,27,342,6,375,1690
QUINTANA ROO,CHETUMAL,14,378,0,392,1690
QUINTANA ROO,CHETUMAL,17,449,7,473,1706
QUINTANA ROO,CHETUMAL,16,436,1,453,1706
QUINTANA ROO,CHETUMAL,39,576,2,617,2037
QUINTANA ROO,CHETUMAL,32,553,7,592,2036
QUINTANA ROO,CHETUMAL,14,496,6,516,2068
QUINTANA ROO,CHETUMAL,22,462,5,489,2068
QUINTANA ROO,CHETUMAL,18,460,9,487,2067
QUINTANA ROO,CHETUMAL,22,500,3,525,1918
QUINTANA ROO,CHETUMAL,26,405,6,437,1918
QUINTANA ROO,CHETUMAL,31,466,3,500,1918
QUINTANA ROO,CHETUMAL,16,489,7,512,1974
QUINTANA ROO,CHETUMAL,15,543,5,563,1974
QUINTANA ROO,CHETUMAL,17,452,7,476,1717
QUINTANA ROO,CHETUMAL,22,448,6,476,1717
QUINTANA ROO,CHETUMAL,22,480,5,507,1717
QUINTANA ROO,CHETUMAL,31,532,5,568,1949
QUINTANA ROO,CHETUMAL,26,533,7,566,1949
QUINTANA ROO,CHETUMAL,23,421,4,448,1591
QUINTANA ROO,CHETUMAL,22,376,3,401,1591
QUINTANA ROO,CHETUMAL,23,418,6,447,1590
QUINTANA ROO,CHETUMAL,96,1685,12,1793,0
QUINTANA ROO,CHETUMAL,36,463,7,506,1675
QUINTANA ROO,CHETUMAL,32,451,4,487,1675
QUINTANA ROO,CHETUMAL,20,447,3,470,1931
QUINTANA ROO,CHETUMAL,36,427,6,469,1931
QUINTANA ROO,CHETUMAL,23,533,4,560,1992
QUINTANA ROO,CHETUMAL,18,514,11,543,1992
QUINTANA ROO,CHETUMAL,23,348,6,377,1518
QUINTANA ROO,CHETUMAL,19,359,1,379,1517
QUINTANA ROO,CHETUMAL,20,339,5,364,1517
QUINTANA ROO,CHETUMAL,18,350,5,373,1517
QUINTANA ROO,CHETUMAL,23,359,5,387,1444
QUINTANA ROO,CHETUMAL,19,337,0,356,1443
QUINTANA ROO,CHETUMAL,18,357,2,377,1443
QUINTANA ROO,CHETUMAL,29,387,3,419,1306
QUINTANA ROO,CHETUMAL,18,391,1,410,1305
QUINTANA ROO,CHETUMAL,29,556,3,588,1947
QUINTANA ROO,CHETUMAL,21,575,3,599,1947
QUINTANA ROO,CHETUMAL,21,523,3,547,1885
QUINTANA ROO,CHETUMAL,35,492,8,535,1884
QUINTANA ROO,CHETUMAL,15,351,1,367,1487
QUINTANA ROO,CHETUMAL,20,309,5,334,1486
QUINTANA ROO,CHETUMAL,19,340,1,360,1486
QUINTANA ROO,CHETUMAL,26,346,0,372,1850
QUINTANA ROO,CHETUMAL,22,348,2,372,1850
QUINTANA ROO,CHETUMAL,24,430,5,459,1887
QUINTANA ROO,CHETUMAL,13,320,14,347,1613
QUINTANA ROO,CHETUMAL,7,364,5,376,1613
QUINTANA ROO,CHETUMAL,7,449,4,460,1363
QUINTANA ROO,CHETUMAL,0,386,7,393,1363
QUINTANA ROO,CHETUMAL,14,449,8,471,1363
QUINTANA ROO,CHETUMAL,13,333,6,352,1425
QUINTANA ROO,CHETUMAL,10,408,4,422,1425
QUINTANA ROO,CHETUMAL,4,294,3,301,1923
QUINTANA ROO,CHETUMAL,5,274,1,280,1922
QUINTANA ROO,CHETUMAL,2,296,3,301,1922
QUINTANA ROO,CHETUMAL,10,411,9,430,1324
QUINTANA ROO,CHETUMAL,7,331,5,343,1323
QUINTANA ROO,CHETUMAL,11,379,2,392,1323
QUINTANA ROO,CHETUMAL,10,400,3,413,1876
QUINTANA ROO,CHETUMAL,10,390,7,407,1876
QUINTANA ROO,CHETUMAL,8,373,3,384,1748
QUINTANA ROO,CHETUMAL,7,598,2,607,1748
QUINTANA ROO,CHETUMAL,7,388,3,398,1782
QUINTANA ROO,CHETUMAL,4,325,2,331,1782
QUINTANA ROO,CHETUMAL,5,349,3,357,1782
QUINTANA ROO,CHETUMAL,9,273,1,283,1455
QUINTANA ROO,CHETUMAL,8,316,1,325,1455
QUINTANA ROO,CHETUMAL,9,569,10,588,1313
QUINTANA ROO,CHETUMAL,16,498,11,525,1313
QUINTANA ROO,CHETUMAL,13,520,11,544,1657
QUINTANA ROO,CHETUMAL,23,542,8,573,1657
QUINTANA ROO,CHETUMAL,11,496,10,517,1808
QUINTANA ROO,CHETUMAL,3,443,10,456,1807
QUINTANA ROO,CHETUMAL,11,417,12,440,1807
QUINTANA ROO,CHETUMAL,6,515,5,526,1849
QUINTANA ROO,CHETUMAL,8,459,8,475,1848
QUINTANA ROO,CHETUMAL,11,314,3,328,1667
QUINTANA ROO,CHETUMAL,9,326,1,336,1666
QUINTANA ROO,CHETUMAL,9,395,3,407,1526
QUINTANA ROO,CHETUMAL,11,396,2,409,1525
QUINTANA ROO,CHETUMAL,15,339,6,360,1679
QUINTANA ROO,CHETUMAL,12,313,7,332,1678
QUINTANA ROO,CHETUMAL,9,316,3,328,1678
QUINTANA ROO,CHETUMAL,11,326,7,344,1678
QUINTANA ROO,CHETUMAL,8,444,6,458,1626
QUINTANA ROO,CHETUMAL,6,400,15,421,1626
QUINTANA ROO,CHETUMAL,13,434,9,456,1625
QUINTANA ROO,CHETUMAL,5,403,1,409,1416
QUINTANA ROO,CHETUMAL,10,367,9,386,1415
QUINTANA ROO,CHETUMAL,9,525,12,546,1814
QUINTANA ROO,CHETUMAL,13,501,6,520,1814
QUINTANA ROO,CHETUMAL,9,449,9,467,1497
QUINTANA ROO,CHETUMAL,4,494,9,507,1496
QUINTANA ROO,CHETUMAL,15,458,13,486,1599
QUINTANA ROO,CHETUMAL,11,509,21,541,1598
QUINTANA ROO,CHETUMAL,15,391,5,411,1977
QUINTANA ROO,CHETUMAL,13,391,1,405,1976
QUINTANA ROO,CHETUMAL,14,392,7,413,1976
QUINTANA ROO,CHETUMAL,14,323,2,339,1444
QUINTANA ROO,CHETUMAL,16,303,1,320,1444
QUINTANA ROO,CHETUMAL,7,316,2,325,1443
QUINTANA ROO,CHETUMAL,18,460,7,485,1945
QUINTANA ROO,CHETUMAL,11,426,4,441,1944
QUINTANA ROO,CHETUMAL,15,407,1,423,1874
QUINTANA ROO,CHETUMAL,11,358,1,370,1874
QUINTANA ROO,CHETUMAL,10,413,1,424,1874
QUINTANA ROO,CHETUMAL,12,374,1,387,1600
QUINTANA ROO,CHETUMAL,31,309,5,345,1599
QUINTANA ROO,CHETUMAL,15,305,1,321,1333
QUINTANA ROO,CHETUMAL,11,301,2,314,1333
QUINTANA ROO,CHETUMAL,9,341,6,356,1332
QUINTANA ROO,CHETUMAL,16,480,3,499,1991
QUINTANA ROO,CHETUMAL,14,412,7,433,1674
QUINTANA ROO,CHETUMAL,17,426,2,445,1674
QUINTANA ROO,CHETUMAL,11,394,4,409,1591
QUINTANA ROO,CHETUMAL,14,381,5,400,1591
QUINTANA ROO,CHETUMAL,12,213,12,237,1630
QUINTANA ROO,CHETUMAL,18,180,13,211,1630
QUINTANA ROO,CANCUN,20,443,3,466,1900
QUINTANA ROO,CANCUN,16,385,0,401,1900
QUINTANA ROO,CANCUN,15,419,8,442,1900
QUINTANA ROO,CANCUN,23,435,4,462,1900
QUINTANA ROO,CANCUN,16,274,4,294,1360
QUINTANA ROO,CANCUN,14,253,1,268,1360
QUINTANA ROO,CANCUN,18,300,2,320,1360
QUINTANA ROO,CANCUN,21,366,1,388,1976
QUINTANA ROO,CANCUN,30,349,3,382,1975
QUINTANA ROO,CANCUN,12,343,3,358,1588
QUINTANA ROO,CANCUN,12,367,8,387,1587
QUINTANA ROO,CANCUN,1,309,3,313,1472
QUINTANA ROO,CANCUN,15,305,3,323,1472
QUINTANA ROO,CANCUN,8,315,2,325,1472
QUINTANA ROO,CANCUN,23,373,2,398,1819
QUINTANA ROO,CANCUN,11,366,6,383,1819
QUINTANA ROO,CANCUN,19,308,2,329,1819
QUINTANA ROO,CANCUN,11,360,2,373,1819
QUINTANA ROO,CANCUN,5,392,2,399,1819
QUINTANA ROO,CANCUN,13,287,4,304,1348
QUINTANA ROO,CANCUN,10,285,3,298,1348
QUINTANA ROO,CANCUN,11,281,1,293,1347
QUINTANA ROO,CANCUN,23,389,3,415,1663
QUINTANA ROO,CANCUN,22,349,2,373,1663
QUINTANA ROO,CANCUN,20,347,4,371,1662
QUINTANA ROO,CANCUN,14,366,8,388,1959
QUINTANA ROO,CANCUN,9,383,0,392,1959
QUINTANA ROO,CANCUN,7,357,2,366,1429
QUINTANA ROO,CANCUN,10,297,3,310,1428
QUINTANA ROO,CANCUN,26,277,2,305,1428
QUINTANA ROO,CANCUN,20,337,11,368,1618
QUINTANA ROO,CANCUN,18,342,6,366,1617
QUINTANA ROO,CANCUN,10,422,6,438,1663
QUINTANA ROO,CANCUN,21,414,6,441,1663
QUINTANA ROO,CANCUN,11,497,2,510,1928
QUINTANA ROO,CANCUN,22,473,0,495,1928
QUINTANA ROO,CANCUN,22,454,1,477,1549
QUINTANA ROO,CANCUN,13,400,2,415,1548
QUINTANA ROO,CANCUN,26,441,5,472,1548
QUINTANA ROO,CANCUN,14,353,11,378,1610
QUINTANA ROO,CANCUN,16,306,4,326,1610
QUINTANA ROO,CANCUN,20,360,7,387,1609
QUINTANA ROO,CANCUN,17,485,5,507,1932
QUINTANA ROO,CANCUN,17,438,3,458,1932
QUINTANA ROO,CANCUN,27,261,5,293,1711
QUINTANA ROO,CANCUN,34,304,2,340,1710
QUINTANA ROO,CANCUN,27,370,5,402,1350
QUINTANA ROO,CANCUN,27,326,4,357,1350
QUINTANA ROO,CANCUN,12,206,4,222,1243
QUINTANA ROO,CANCUN,9,214,1,224,1242
QUINTANA ROO,CANCUN,33,404,1,438,1787
QUINTANA ROO,CANCUN,34,366,1,401,1786
QUINTANA ROO,CANCUN,25,353,3,381,1797
QUINTANA ROO,CANCUN,19,345,0,364,1797
QUINTANA ROO,CANCUN,15,352,7,374,1680
QUINTANA ROO,CANCUN,16,314,4,334,1680
QUINTANA ROO,CANCUN,10,327,3,340,1474
QUINTANA ROO,CANCUN,13,309,2,324,1473
QUINTANA ROO,CANCUN,9,255,8,272,1375
QUINTANA ROO,CANCUN,9,200,2,211,1374
QUINTANA ROO,CANCUN,11,177,1,189,1374
QUINTANA ROO,CANCUN,14,270,1,285,1839
QUINTANA ROO,CANCUN,11,236,1,248,1838
QUINTANA ROO,CANCUN,17,328,2,347,1902
QUINTANA ROO,CANCUN,18,216,4,238,1902
QUINTANA ROO,CANCUN,64,1511,9,1584,0
QUINTANA ROO,CANCUN,13,272,5,290,1468
QUINTANA ROO,CANCUN,14,222,2,238,1467
QUINTANA ROO,CANCUN,12,238,3,253,1467
QUINTANA ROO,CANCUN,11,134,2,147,1024
QUINTANA ROO,CANCUN,11,116,1,128,1023
QUINTANA ROO,CANCUN,20,403,6,429,1799
QUINTANA ROO,CANCUN,21,349,3,373,1799
QUINTANA ROO,CANCUN,17,384,3,404,1798
QUINTANA ROO,CANCUN,16,427,3,446,1861
QUINTANA ROO,CANCUN,9,405,2,416,1861
QUINTANA ROO,CANCUN,13,432,2,447,1860
QUINTANA ROO,CANCUN,13,358,6,377,1893
QUINTANA ROO,CANCUN,21,348,3,372,1892
QUINTANA ROO,CANCUN,9,337,4,350,1347
QUINTANA ROO,CANCUN,10,293,2,305,1347
QUINTANA ROO,CANCUN,14,311,7,332,1346
QUINTANA ROO,CANCUN,13,321,0,334,1447
QUINTANA ROO,CANCUN,2,317,4,323,1447
QUINTANA ROO,CANCUN,13,297,0,310,1447
QUINTANA ROO,CANCUN,24,398,7,429,1928
QUINTANA ROO,CANCUN,16,583,7,606,1928
QUINTANA ROO,CANCUN,14,439,2,455,1924
QUINTANA ROO,CANCUN,20,440,1,461,1923
QUINTANA ROO,CANCUN,12,309,1,322,1378
QUINTANA ROO,CANCUN,9,285,3,297,1378
QUINTANA ROO,CANCUN,9,274,2,285,1377
QUINTANA ROO,CANCUN,0,420,4,424,1793
QUINTANA ROO,CANCUN,14,388,3,405,1793
QUINTANA ROO,CANCUN,14,336,1,351,1792
QUINTANA ROO,CANCUN,18,358,4,380,2012
QUINTANA ROO,CANCUN,8,357,2,367,2012
QUINTANA ROO,CANCUN,3,220,4,227,1189
QUINTANA ROO,CANCUN,3,199,2,204,1188
QUINTANA ROO,CANCUN,6,285,1,292,1095
QUINTANA ROO,CANCUN,1,269,2,272,1095
QUINTANA ROO,CANCUN,14,368,1,383,1544
QUINTANA ROO,CANCUN,10,341,4,355,1544
QUINTANA ROO,CANCUN,8,355,2,365,1504
QUINTANA ROO,CANCUN,8,344,2,354,1504
QUINTANA ROO,CANCUN,10,389,2,401,1645
QUINTANA ROO,CANCUN,12,378,0,390,1645
QUINTANA ROO,CANCUN,6,326,1,333,1212
QUINTANA ROO,CANCUN,11,322,2,335,1212
QUINTANA ROO,CANCUN,17,421,1,439,1884
QUINTANA ROO,CANCUN,13,406,4,423,1883
QUINTANA ROO,CANCUN,17,431,1,449,1979
QUINTANA ROO,CANCUN,8,411,1,420,1978
QUINTANA ROO,CANCUN,17,434,2,453,1789
QUINTANA ROO,CANCUN,14,408,4,426,1789
QUINTANA ROO,CANCUN,20,417,7,444,1788
QUINTANA ROO,CANCUN,18,475,2,495,1788
QUINTANA ROO,CANCUN,19,411,3,433,1716
QUINTANA ROO,CANCUN,19,380,8,407,1716
QUINTANA ROO,CANCUN,16,389,2,407,1716
QUINTANA ROO,CANCUN,12,271,4,287,1346
QUINTANA ROO,CANCUN,8,283,4,295,1346
QUINTANA ROO,CANCUN,12,273,1,286,1345
QUINTANA ROO,CANCUN,3,334,2,339,1447
QUINTANA ROO,CANCUN,11,321,5,337,1447
QUINTANA ROO,CANCUN,11,313,3,327,1446
QUINTANA ROO,CANCUN,10,451,3,464,1614
QUINTANA ROO,CANCUN,14,416,8,438,1614
QUINTANA ROO,CANCUN,16,435,6,457,1923
QUINTANA ROO,CANCUN,0,465,1,466,1922
QUINTANA ROO,CANCUN,14,325,3,342,1421
QUINTANA ROO,CANCUN,20,398,1,419,1420
QUINTANA ROO,CANCUN,0,384,2,386,1420
QUINTANA ROO,CANCUN,14,381,6,401,1787
QUINTANA ROO,CANCUN,24,358,3,385,1787
QUINTANA ROO,CANCUN,27,400,3,430,1769
QUINTANA ROO,CANCUN,19,371,0,390,1769
QUINTANA ROO,CANCUN,21,378,5,404,1716
QUINTANA ROO,CANCUN,13,309,9,331,1716
QUINTANA ROO,CANCUN,3,300,0,303,1486
QUINTANA ROO,CANCUN,6,235,19,260,1485
QUINTANA ROO,CANCUN,8,241,2,251,1322
QUINTANA ROO,CANCUN,7,245,0,252,1322
QUINTANA ROO,CANCUN,10,229,0,239,1322
QUINTANA ROO,CANCUN,17,357,4,378,1844
QUINTANA ROO,CANCUN,13,344,2,359,1844
QUINTANA ROO,CANCUN,13,271,2,286,1290
QUINTANA ROO,CANCUN,10,301,2,313,1289
QUINTANA ROO,CANCUN,16,343,0,359,1899
QUINTANA ROO,CANCUN,17,349,4,370,1899
QUINTANA ROO,CANCUN,13,299,0,312,1397
QUINTANA ROO,CANCUN,16,292,2,310,1396
QUINTANA ROO,CANCUN,5,289,2,296,1396
QUINTANA ROO,CANCUN,8,295,1,304,1938
QUINTANA ROO,CANCUN,9,272,2,283,1938
QUINTANA ROO,CANCUN,9,333,3,345,1944
QUINTANA ROO,CANCUN,1,332,1,334,1944
QUINTANA ROO,CANCUN,10,258,3,271,1860
QUINTANA ROO,CANCUN,6,284,2,292,1859
QUINTANA ROO,CANCUN,9,353,1,363,1889
QUINTANA ROO,CANCUN,5,276,0,281,1889
QUINTANA ROO,CANCUN,11,258,0,269,1395
QUINTANA ROO,CANCUN,10,248,0,258,1394
QUINTANA ROO,CANCUN,8,276,2,286,1765
QUINTANA ROO,CANCUN,13,315,0,328,1765
QUINTANA ROO,CANCUN,7,271,4,282,1562
QUINTANA ROO,CANCUN,15,248,0,263,1561
QUINTANA ROO,CANCUN,8,445,5,458,1800
QUINTANA ROO,CANCUN,7,354,2,363,1800
QUINTANA ROO,CANCUN,15,389,2,406,1799
QUINTANA ROO,CANCUN,15,297,1,313,1511
QUINTANA ROO,CANCUN,17,289,2,308,1510
QUINTANA ROO,CANCUN,13,294,2,309,1510
QUINTANA ROO,CANCUN,0,349,6,355,1537
QUINTANA ROO,CANCUN,13,323,3,339,1536
QUINTANA ROO,CANCUN,14,291,4,309,1243
QUINTANA ROO,CANCUN,11,268,4,283,1243
QUINTANA ROO,CANCUN,18,364,5,387,1369
QUINTANA ROO,CANCUN,13,328,2,343,1369
QUINTANA ROO,CANCUN,18,332,5,355,1368
QUINTANA ROO,CANCUN,11,360,2,373,1375
QUINTANA ROO,CANCUN,10,341,6,357,1375
QUINTANA ROO,CANCUN,8,284,3,295,1064
QUINTANA ROO,CANCUN,11,267,4,282,1063
QUINTANA ROO,CANCUN,23,335,2,360,1493
QUINTANA ROO,CANCUN,24,280,2,306,1492
QUINTANA ROO,CANCUN,19,252,0,271,1539
QUINTANA ROO,CANCUN,16,261,3,280,1538
QUINTANA ROO,CANCUN,23,325,2,350,1437
QUINTANA ROO,CANCUN,18,351,5,374,1436
QUINTANA ROO,CANCUN,26,414,2,442,1902
QUINTANA ROO,CANCUN,24,364,2,390,1901
QUINTANA ROO,CANCUN,28,234,1,263,1121
QUINTANA ROO,CANCUN,26,230,2,258,1120
QUINTANA ROO,CANCUN,29,208,3,240,1850
QUINTANA ROO,CANCUN,21,203,1,225,1849
QUINTANA ROO,CANCUN,47,195,2,244,1899
QUINTANA ROO,CANCUN,23,193,5,221,1898
QUINTANA ROO,CANCUN,36,219,3,258,1898
QUINTANA ROO,CANCUN,13,357,3,373,1593
QUINTANA ROO,CANCUN,21,398,5,424,1593
QUINTANA ROO,CANCUN,23,179,2,204,1432
QUINTANA ROO,CANCUN,29,151,3,183,1432
QUINTANA ROO,CANCUN,19,152,1,172,1431
QUINTANA ROO,CANCUN,42,209,1,252,1600
QUINTANA ROO,CANCUN,19,220,1,240,1600
QUINTANA ROO,CANCUN,28,179,2,209,1600
QUINTANA ROO,CANCUN,14,208,2,224,1402
QUINTANA ROO,CANCUN,15,159,2,176,1402
QUINTANA ROO,CANCUN,19,205,1,225,1402
QUINTANA ROO,CANCUN,35,98,1,134,1918
QUINTANA ROO,CANCUN,26,90,1,117,1918
QUINTANA ROO,CANCUN,33,75,0,108,1918
QUINTANA ROO,CANCUN,45,179,2,226,1940
QUINTANA ROO,CANCUN,38,198,0,236,1940
QUINTANA ROO,CANCUN,40,186,2,228,1940
QUINTANA ROO,CANCUN,42,191,4,237,1939
QUINTANA ROO,CANCUN,28,318,2,348,1698
QUINTANA ROO,CANCUN,24,283,2,309,1697
QUINTANA ROO,CANCUN,30,358,0,388,1656
QUINTANA ROO,CANCUN,21,255,3,279,1656
QUINTANA ROO,CANCUN,22,261,2,285,1655
QUINTANA ROO,CANCUN,14,392,6,412,1536
QUINTANA ROO,CANCUN,17,341,1,359,1536
QUINTANA ROO,CANCUN,15,352,3,370,1536
QUINTANA ROO,CANCUN,16,376,4,396,1858
QUINTANA ROO,CANCUN,11,385,8,404,1858
QUINTANA ROO,CANCUN,10,331,4,345,1524
QUINTANA ROO,CANCUN,14,269,6,289,1523
QUINTANA ROO,CANCUN,15,289,6,310,1523
QUINTANA ROO,CANCUN,39,118,0,157,1783
QUINTANA ROO,CANCUN,29,102,0,131,1783
QUINTANA ROO,CANCUN,37,103,2,142,1783
QUINTANA ROO,CANCUN,25,376,1,402,1714
QUINTANA ROO,CANCUN,20,366,1,387,1714
QUINTANA ROO,CANCUN,36,334,0,370,1713
QUINTANA ROO,CANCUN,12,334,5,351,1772
QUINTANA ROO,CANCUN,18,357,5,380,1771
QUINTANA ROO,CANCUN,32,259,2,293,1931
QUINTANA ROO,CANCUN,20,209,89,318,1931
QUINTANA ROO,CANCUN,24,246,0,270,1931
QUINTANA ROO,CANCUN,23,270,2,295,1931
QUINTANA ROO,CANCUN,21,269,1,291,1930
QUINTANA ROO,CANCUN,39,230,2,271,1930
QUINTANA ROO,CANCUN,10,31,0,41,1291
QUINTANA ROO,CANCUN,13,26,0,39,1291
QUINTANA ROO,CANCUN,113,1574,9,1696,0
QUINTANA ROO,CANCUN,13,32,0,45,1299
QUINTANA ROO,CANCUN,22,35,0,57,1299
QUINTANA ROO,CANCUN,11,211,9,231,1259
QUINTANA ROO,CANCUN,16,366,8,390,1849
QUINTANA ROO,CANCUN,17,379,8,404,1848
QUINTANA ROO,CANCUN,25,290,0,315,1957
QUINTANA ROO,CANCUN,17,296,2,315,1957
QUINTANA ROO,CANCUN,15,199,1,215,2148
QUINTANA ROO,CANCUN,21,233,2,256,2148
QUINTANA ROO,CANCUN,18,186,3,207,2148
QUINTANA ROO,CANCUN,18,216,4,238,2148
QUINTANA ROO,CANCUN,22,207,3,232,2148
QUINTANA ROO,CANCUN,27,205,3,235,2148
QUINTANA ROO,CANCUN,215,22,1,238,2147
QUINTANA ROO,CANCUN,19,218,2,239,2147
QUINTANA ROO,CANCUN,8,462,11,481,1861
QUINTANA ROO,CANCUN,9,437,11,457,1860
QUINTANA ROO,CANCUN,6,332,6,344,1129
QUINTANA ROO,CANCUN,9,327,6,342,1129
QUINTANA ROO,CANCUN,10,344,4,358,2086
QUINTANA ROO,CANCUN,21,369,5,395,2086
QUINTANA ROO,CANCUN,19,356,1,376,2086
QUINTANA ROO,CANCUN,23,659,2,684,2086
QUINTANA ROO,CANCUN,11,351,3,365,2086
QUINTANA ROO,CANCUN,19,336,2,357,2086
QUINTANA ROO,CANCUN,17,337,5,359,2086
QUINTANA ROO,CANCUN,12,391,2,405,2086
QUINTANA ROO,CANCUN,6,339,1,346,1677
QUINTANA ROO,CANCUN,11,356,2,369,1677
QUINTANA ROO,CANCUN,10,349,2,361,1677
QUINTANA ROO,CANCUN,12,308,2,322,1777
QUINTANA ROO,CANCUN,11,303,3,317,1777
QUINTANA ROO,CANCUN,7,290,0,297,1776
QUINTANA ROO,CANCUN,7,301,5,313,1776
QUINTANA ROO,CANCUN,14,277,1,292,1776
QUINTANA ROO,CANCUN,7,358,3,368,1664
QUINTANA ROO,CANCUN,12,359,4,375,1664
QUINTANA ROO,CANCUN,23,346,4,373,1664
QUINTANA ROO,CANCUN,39,410,3,452,2068
QUINTANA ROO,CANCUN,35,374,4,413,2067
QUINTANA ROO,CANCUN,21,382,1,404,1958
QUINTANA ROO,CANCUN,21,376,3,400,1958
QUINTANA ROO,CANCUN,30,427,2,459,2007
QUINTANA ROO,CANCUN,34,372,1,407,2006
QUINTANA ROO,CANCUN,14,340,5,359,1980
QUINTANA ROO,CANCUN,12,345,3,360,1980
QUINTANA ROO,CANCUN,42,194,0,236,2031
QUINTANA ROO,CANCUN,31,200,2,233,2031
QUINTANA ROO,CANCUN,28,200,0,228,2030
QUINTANA ROO,CANCUN,30,196,3,229,2030
QUINTANA ROO,CANCUN,38,191,0,229,2030
QUINTANA ROO,CANCUN,35,200,0,235,2030
QUINTANA ROO,CANCUN,32,214,1,247,2030
QUINTANA ROO,CANCUN,33,279,1,313,1833
QUINTANA ROO,CANCUN,33,263,4,300,1833
QUINTANA ROO,CANCUN,27,264,4,295,2147
QUINTANA ROO,CANCUN,20,264,5,289,2147
QUINTANA ROO,CANCUN,15,323,5,343,1393
QUINTANA ROO,CANCUN,19,302,2,323,1393
QUINTANA ROO,CANCUN,12,294,4,310,2015
QUINTANA ROO,CANCUN,14,299,4,317,2014
QUINTANA ROO,CANCUN,11,315,0,326,2014
QUINTANA ROO,CANCUN,19,294,2,315,2014
QUINTANA ROO,CANCUN,10,243,1,254,1942
QUINTANA ROO,CANCUN,7,260,8,275,1942
QUINTANA ROO,CANCUN,5,285,7,297,1941
QUINTANA ROO,CANCUN,12,306,8,326,1886
QUINTANA ROO,CANCUN,29,297,5,331,1886
QUINTANA ROO,CANCUN,17,274,6,297,1886
QUINTANA ROO,CANCUN,23,186,1,210,1319
QUINTANA ROO,CANCUN,25,189,0,214,1319
QUINTANA ROO,CANCUN,29,122,3,154,1139
QUINTANA ROO,CANCUN,22,123,4,149,1139
QUINTANA ROO,CANCUN,17,190,0,207,1226
QUINTANA ROO,CANCUN,24,159,0,183,1225
QUINTANA ROO,CANCUN,19,143,2,164,1265
QUINTANA ROO,CANCUN,23,152,0,175,1265
QUINTANA ROO,CANCUN,30,224,2,256,1603
QUINTANA ROO,CANCUN,32,226,1,259,1603
QUINTANA ROO,CANCUN,42,176,1,219,1794
QUINTANA ROO,CANCUN,39,172,2,213,1794
QUINTANA ROO,CANCUN,33,156,1,190,1488
QUINTANA ROO,CANCUN,34,140,0,174,1487
QUINTANA ROO,CANCUN,32,159,1,192,1927
QUINTANA ROO,CANCUN,43,154,4,201,1927
QUINTANA ROO,CANCUN,6,239,3,248,1406
QUINTANA ROO,CANCUN,6,254,1,261,1405
QUINTANA ROO,CANCUN,3,264,3,270,1405
QUINTANA ROO,CANCUN,21,218,1,240,1168
QUINTANA ROO,CANCUN,11,207,2,220,1168
QUINTANA ROO,CANCUN,15,352,1,368,1955
QUINTANA ROO,CANCUN,14,354,0,368,1954
QUINTANA ROO,CANCUN,7,348,4,359,1950
QUINTANA ROO,CANCUN,15,304,5,324,1949
QUINTANA ROO,CANCUN,5,256,2,263,1922
QUINTANA ROO,CANCUN,5,238,3,246,1921
QUINTANA ROO,CANCUN,1,251,2,254,1921
QUINTANA ROO,CANCUN,3,228,0,231,1921
QUINTANA ROO,CANCUN,21,280,0,301,1525
QUINTANA ROO,CANCUN,11,270,1,282,1525
QUINTANA ROO,CANCUN,18,297,1,316,1525
QUINTANA ROO,CANCUN,21,283,1,305,1525
QUINTANA ROO,CANCUN,23,299,0,322,1422
QUINTANA ROO,CANCUN,19,311,0,330,1422
QUINTANA ROO,CANCUN,25,312,1,338,1422
QUINTANA ROO,CANCUN,15,375,3,393,1736
QUINTANA ROO,CANCUN,18,361,3,382,1736
QUINTANA ROO,CANCUN,10,370,3,383,1736
QUINTANA ROO,CANCUN,11,274,2,287,1642
QUINTANA ROO,CANCUN,13,276,1,290,1641
QUINTANA ROO,CANCUN,2,161,2,165,1935
QUINTANA ROO,CANCUN,3,168,0,171,1934
QUINTANA ROO,CANCUN,5,140,0,145,1790
QUINTANA ROO,CANCUN,4,183,0,187,1790
QUINTANA ROO,CANCUN,7,212,0,219,1499
QUINTANA ROO,CANCUN,10,164,0,174,1499
QUINTANA ROO,CANCUN,9,176,0,185,1498
QUINTANA ROO,CANCUN,16,406,2,424,2049
QUINTANA ROO,CANCUN,12,374,1,387,2048
QUINTANA ROO,CANCUN,12,264,0,276,1694
QUINTANA ROO,CANCUN,8,252,0,260,1693
QUINTANA ROO,CANCUN,8,149,0,157,1550
QUINTANA ROO,CANCUN,1,134,0,135,1550
QUINTANA ROO,CANCUN,9,159,0,168,1550
QUINTANA ROO,CANCUN,12,162,1,175,1257
QUINTANA ROO,CANCUN,4,191,0,195,1257
QUINTANA ROO,CANCUN,1,140,0,141,1294
QUINTANA ROO,CANCUN,2,102,0,104,1294
QUINTANA ROO,CANCUN,5,141,0,146,1520
QUINTANA ROO,CANCUN,9,134,1,144,1519
QUINTANA ROO,CANCUN,8,187,0,195,1771
QUINTANA ROO,CANCUN,6,164,0,170,1771
QUINTANA ROO,CANCUN,5,162,1,168,1133
QUINTANA ROO,CANCUN,5,142,0,147,1133
QUINTANA ROO,CANCUN,10,285,1,296,1901
QUINTANA ROO,CANCUN,6,268,7,281,1901
QUINTANA ROO,CANCUN,3,235,4,242,1864
QUINTANA ROO,CANCUN,7,234,1,242,1864
QUINTANA ROO,CANCUN,9,287,3,299,1864
QUINTANA ROO,CANCUN,9,211,3,223,1527
QUINTANA ROO,CANCUN,9,199,1,209,1526
QUINTANA ROO,CANCUN,6,212,0,218,1526
QUINTANA ROO,CANCUN,8,379,3,390,1974
QUINTANA ROO,CANCUN,8,308,0,316,1974
QUINTANA ROO,CANCUN,6,247,2,255,1817
QUINTANA ROO,CANCUN,4,203,2,209,1816
QUINTANA ROO,CANCUN,6,253,4,263,1581
QUINTANA ROO,CANCUN,5,223,2,230,1581
QUINTANA ROO,CANCUN,5,207,2,214,1581
SAN LUIS POTOSÍ,MATEHUALA,11,247,12,270,1872
SAN LUIS POTOSÍ,MATEHUALA,21,226,8,255,1871
SAN LUIS POTOSÍ,MATEHUALA,11,225,3,239,1871
SAN LUIS POTOSÍ,MATEHUALA,12,232,0,244,1702
SAN LUIS POTOSÍ,MATEHUALA,3,195,8,206,1702
SAN LUIS POTOSÍ,MATEHUALA,4,172,12,188,1062
SAN LUIS POTOSÍ,MATEHUALA,12,114,7,133,1061
SAN LUIS POTOSÍ,MATEHUALA,20,330,14,364,1918
SAN LUIS POTOSÍ,MATEHUALA,23,310,15,348,1917
SAN LUIS POTOSÍ,MATEHUALA,13,275,10,298,2004
SAN LUIS POTOSÍ,MATEHUALA,10,253,15,278,1401
SAN LUIS POTOSÍ,MATEHUALA,21,241,13,275,1400
SAN LUIS POTOSÍ,MATEHUALA,15,383,13,411,1931
SAN LUIS POTOSÍ,MATEHUALA,14,311,4,329,1888
SAN LUIS POTOSÍ,MATEHUALA,14,290,5,309,1888
SAN LUIS POTOSÍ,MATEHUALA,12,228,7,247,1716
SAN LUIS POTOSÍ,MATEHUALA,8,229,3,240,1716
SAN LUIS POTOSÍ,MATEHUALA,13,363,7,383,1861
SAN LUIS POTOSÍ,MATEHUALA,13,334,4,351,1861
SAN LUIS POTOSÍ,MATEHUALA,22,384,4,410,1861
SAN LUIS POTOSÍ,MATEHUALA,30,245,7,282,1541
SAN LUIS POTOSÍ,MATEHUALA,27,181,11,219,1495
SAN LUIS POTOSÍ,MATEHUALA,16,172,7,195,1495
SAN LUIS POTOSÍ,MATEHUALA,19,184,13,216,1495
SAN LUIS POTOSÍ,MATEHUALA,12,156,8,176,1332
SAN LUIS POTOSÍ,MATEHUALA,9,178,3,190,1332
SAN LUIS POTOSÍ,MATEHUALA,6,221,2,229,1332
SAN LUIS POTOSÍ,MATEHUALA,24,195,3,222,1710
SAN LUIS POTOSÍ,MATEHUALA,23,195,3,221,1710
SAN LUIS POTOSÍ,MATEHUALA,20,222,4,246,1710
SAN LUIS POTOSÍ,MATEHUALA,36,152,16,204,1950
SAN LUIS POTOSÍ,MATEHUALA,8,249,3,260,1604
SAN LUIS POTOSÍ,MATEHUALA,6,192,2,200,1604
SAN LUIS POTOSÍ,MATEHUALA,8,231,1,240,1604
SAN LUIS POTOSÍ,MATEHUALA,9,253,5,267,1637
SAN LUIS POTOSÍ,MATEHUALA,19,228,1,248,1637
SAN LUIS POTOSÍ,MATEHUALA,8,229,5,242,1637
SAN LUIS POTOSÍ,MATEHUALA,9,232,2,243,1701
SAN LUIS POTOSÍ,MATEHUALA,8,249,2,259,1700
SAN LUIS POTOSÍ,MATEHUALA,12,168,3,183,1625
SAN LUIS POTOSÍ,MATEHUALA,12,181,3,196,1624
SAN LUIS POTOSÍ,MATEHUALA,11,305,3,319,1863
SAN LUIS POTOSÍ,MATEHUALA,15,294,4,313,1863
SAN LUIS POTOSÍ,MATEHUALA,11,215,4,230,1689
SAN LUIS POTOSÍ,MATEHUALA,5,241,1,247,1689
SAN LUIS POTOSÍ,MATEHUALA,10,330,4,344,1890
SAN LUIS POTOSÍ,MATEHUALA,10,308,6,324,1890
SAN LUIS POTOSÍ,MATEHUALA,7,153,2,162,1179
SAN LUIS POTOSÍ,MATEHUALA,9,158,1,168,1179
SAN LUIS POTOSÍ,MATEHUALA,7,165,5,177,1786
SAN LUIS POTOSÍ,MATEHUALA,6,198,1,205,1786
SAN LUIS POTOSÍ,MATEHUALA,7,139,2,148,1786
SAN LUIS POTOSÍ,MATEHUALA,9,257,3,269,1475
SAN LUIS POTOSÍ,MATEHUALA,6,258,4,268,1475
SAN LUIS POTOSÍ,MATEHUALA,6,115,0,121,1295
SAN LUIS POTOSÍ,MATEHUALA,2,134,0,136,1294
SAN LUIS POTOSÍ,MATEHUALA,5,194,0,199,1211
SAN LUIS POTOSÍ,MATEHUALA,7,199,1,207,1210
SAN LUIS POTOSÍ,MATEHUALA,9,165,2,176,1846
SAN LUIS POTOSÍ,MATEHUALA,15,227,2,244,1845
SAN LUIS POTOSÍ,MATEHUALA,10,189,4,203,1845
SAN LUIS POTOSÍ,MATEHUALA,11,235,2,248,1690
SAN LUIS POTOSÍ,MATEHUALA,10,243,9,262,1690
SAN LUIS POTOSÍ,MATEHUALA,17,256,2,275,1757
SAN LUIS POTOSÍ,MATEHUALA,15,240,4,259,1756
SAN LUIS POTOSÍ,MATEHUALA,8,201,1,210,1756
SAN LUIS POTOSÍ,MATEHUALA,26,461,7,494,0
SAN LUIS POTOSÍ,MATEHUALA,7,198,2,207,1600
SAN LUIS POTOSÍ,MATEHUALA,15,199,4,218,1600
SAN LUIS POTOSÍ,MATEHUALA,3,181,2,186,1600
SAN LUIS POTOSÍ,MATEHUALA,7,156,6,169,1490
SAN LUIS POTOSÍ,MATEHUALA,12,186,5,203,1490
SAN LUIS POTOSÍ,MATEHUALA,7,197,1,205,1490
SAN LUIS POTOSÍ,MATEHUALA,4,77,2,83,1123
SAN LUIS POTOSÍ,MATEHUALA,4,124,3,131,1123
SAN LUIS POTOSÍ,MATEHUALA,13,127,9,149,1103
SAN LUIS POTOSÍ,MATEHUALA,15,109,14,138,1103
SAN LUIS POTOSÍ,MATEHUALA,8,167,3,178,1584
SAN LUIS POTOSÍ,MATEHUALA,8,166,4,178,1584
SAN LUIS POTOSÍ,MATEHUALA,3,223,8,234,1807
SAN LUIS POTOSÍ,MATEHUALA,9,237,2,248,1807
SAN LUIS POTOSÍ,MATEHUALA,5,218,1,224,1806
SAN LUIS POTOSÍ,MATEHUALA,14,213,10,237,1807
SAN LUIS POTOSÍ,MATEHUALA,15,253,7,275,1806
SAN LUIS POTOSÍ,MATEHUALA,8,233,5,246,1522
SAN LUIS POTOSÍ,MATEHUALA,4,230,13,247,1522
SAN LUIS POTOSÍ,MATEHUALA,7,187,5,199,1566
SAN LUIS POTOSÍ,MATEHUALA,12,194,5,211,1565
SAN LUIS POTOSÍ,MATEHUALA,12,300,24,336,1691
SAN LUIS POTOSÍ,MATEHUALA,10,317,9,336,2046
SAN LUIS POTOSÍ,MATEHUALA,9,286,8,303,2046
SAN LUIS POTOSÍ,MATEHUALA,6,180,1,187,1162
SAN LUIS POTOSÍ,MATEHUALA,5,146,0,151,1161
SAN LUIS POTOSÍ,MATEHUALA,19,226,8,253,1230
SAN LUIS POTOSÍ,MATEHUALA,12,242,15,269,1229
SAN LUIS POTOSÍ,MATEHUALA,11,241,0,252,1590
SAN LUIS POTOSÍ,MATEHUALA,13,249,2,264,1589
SAN LUIS POTOSÍ,MATEHUALA,14,404,12,430,1189
SAN LUIS POTOSÍ,MATEHUALA,16,363,19,398,1188
SAN LUIS POTOSÍ,MATEHUALA,11,263,2,276,1822
SAN LUIS POTOSÍ,MATEHUALA,9,214,4,227,1822
SAN LUIS POTOSÍ,MATEHUALA,9,262,2,273,1644
SAN LUIS POTOSÍ,MATEHUALA,17,248,2,267,1644
SAN LUIS POTOSÍ,MATEHUALA,7,199,3,209,1734
SAN LUIS POTOSÍ,MATEHUALA,5,199,1,205,1734
SAN LUIS POTOSÍ,MATEHUALA,8,194,7,209,1734
SAN LUIS POTOSÍ,MATEHUALA,18,281,23,322,1401
SAN LUIS POTOSÍ,MATEHUALA,19,311,9,339,1401
SAN LUIS POTOSÍ,MATEHUALA,9,341,1,351,1400
SAN LUIS POTOSÍ,MATEHUALA,7,280,59,346,1421
SAN LUIS POTOSÍ,MATEHUALA,14,353,9,376,1421
SAN LUIS POTOSÍ,MATEHUALA,16,310,18,344,1939
SAN LUIS POTOSÍ,MATEHUALA,15,325,12,352,1939
SAN LUIS POTOSÍ,MATEHUALA,14,345,15,374,1939
SAN LUIS POTOSÍ,MATEHUALA,37,643,13,693,1933
SAN LUIS POTOSÍ,MATEHUALA,16,132,4,152,1270
SAN LUIS POTOSÍ,MATEHUALA,12,108,6,126,1269
SAN LUIS POTOSÍ,MATEHUALA,17,160,3,180,1416
SAN LUIS POTOSÍ,MATEHUALA,7,140,4,151,1416
SAN LUIS POTOSÍ,MATEHUALA,12,131,5,148,1416
SAN LUIS POTOSÍ,MATEHUALA,12,156,0,168,1385
SAN LUIS POTOSÍ,MATEHUALA,15,158,0,173,1384
SAN LUIS POTOSÍ,MATEHUALA,11,114,2,127,1036
SAN LUIS POTOSÍ,MATEHUALA,9,109,2,120,1035
SAN LUIS POTOSÍ,MATEHUALA,15,226,4,245,1862
SAN LUIS POTOSÍ,MATEHUALA,17,200,7,224,1861
SAN LUIS POTOSÍ,MATEHUALA,27,180,7,214,1289
SAN LUIS POTOSÍ,MATEHUALA,19,127,4,150,1288
SAN LUIS POTOSÍ,MATEHUALA,23,205,5,233,1953
SAN LUIS POTOSÍ,MATEHUALA,12,113,4,129,1088
SAN LUIS POTOSÍ,MATEHUALA,14,126,0,140,1088
SAN LUIS POTOSÍ,MATEHUALA,9,132,2,143,1853
SAN LUIS POTOSÍ,MATEHUALA,10,165,2,177,1852
SAN LUIS POTOSÍ,MATEHUALA,18,268,15,301,1686
SAN LUIS POTOSÍ,MATEHUALA,10,271,1,282,1686
SAN LUIS POTOSÍ,MATEHUALA,11,270,8,289,1686
SAN LUIS POTOSÍ,MATEHUALA,17,435,12,464,1819
SAN LUIS POTOSÍ,MATEHUALA,22,383,13,418,1819
SAN LUIS POTOSÍ,MATEHUALA,20,452,14,486,1819
SAN LUIS POTOSÍ,MATEHUALA,15,219,2,236,1782
SAN LUIS POTOSÍ,MATEHUALA,16,194,10,220,1782
SAN LUIS POTOSÍ,MATEHUALA,14,208,15,237,1539
SAN LUIS POTOSÍ,MATEHUALA,16,219,7,242,1538
SAN LUIS POTOSÍ,MATEHUALA,15,160,13,188,1142
SAN LUIS POTOSÍ,MATEHUALA,11,114,15,140,1142
SAN LUIS POTOSÍ,MATEHUALA,26,129,15,170,1655
SAN LUIS POTOSÍ,MATEHUALA,15,193,9,217,1342
SAN LUIS POTOSÍ,MATEHUALA,6,170,6,182,1620
SAN LUIS POTOSÍ,MATEHUALA,1,151,3,155,1620
SAN LUIS POTOSÍ,MATEHUALA,5,128,5,138,1620
SAN LUIS POTOSÍ,MATEHUALA,6,131,1,138,1402
SAN LUIS POTOSÍ,MATEHUALA,33,597,16,646,1984
SAN LUIS POTOSÍ,MATEHUALA,43,556,19,618,1983
SAN LUIS POTOSÍ,MATEHUALA,7,100,0,107,1843
SAN LUIS POTOSÍ,MATEHUALA,11,105,4,120,1842
SAN LUIS POTOSÍ,MATEHUALA,16,60,1,77,1422
SAN LUIS POTOSÍ,MATEHUALA,9,81,0,90,1421
SAN LUIS POTOSÍ,MATEHUALA,16,106,1,123,1842
SAN LUIS POTOSÍ,MATEHUALA,10,93,2,105,1841
SAN LUIS POTOSÍ,MATEHUALA,8,195,3,206,1184
SAN LUIS POTOSÍ,MATEHUALA,7,202,2,211,1184
SAN LUIS POTOSÍ,MATEHUALA,11,77,3,91,1733
SAN LUIS POTOSÍ,MATEHUALA,9,77,2,88,1733
SAN LUIS POTOSÍ,MATEHUALA,12,197,4,213,1609
SAN LUIS POTOSÍ,MATEHUALA,8,187,3,198,1609
SAN LUIS POTOSÍ,MATEHUALA,5,210,5,220,1608
SAN LUIS POTOSÍ,MATEHUALA,10,122,6,138,1818
SAN LUIS POTOSÍ,MATEHUALA,11,171,0,182,1818
SAN LUIS POTOSÍ,MATEHUALA,11,215,1,227,1497
SAN LUIS POTOSÍ,MATEHUALA,10,210,3,223,1496
SAN LUIS POTOSÍ,MATEHUALA,9,197,2,208,1496
SAN LUIS POTOSÍ,SOLEDAD DE GRACIANO SANCHEZ,15,131,2,148,1465
SAN LUIS POTOSÍ,SOLEDAD DE GRACIANO SANCHEZ,16,175,2,193,1465
SAN LUIS POTOSÍ,SOLEDAD DE GRACIANO SANCHEZ,16,166,5,187,1464
SAN LUIS POTOSÍ,SOLEDAD DE GRACIANO SANCHEZ,19,197,4,220,1756
SAN LUIS POTOSÍ,SOLEDAD DE GRACIANO SANCHEZ,17,184,3,204,1755
SAN LUIS POTOSÍ,SOLEDAD DE GRACIANO SANCHEZ,3,138,4,145,1386
SAN LUIS POTOSÍ,SOLEDAD DE GRACIANO SANCHEZ,3,111,5,119,1385
SAN LUIS POTOSÍ,SOLEDAD DE GRACIANO SANCHEZ,15,205,3,223,1693
SAN LUIS POTOSÍ,SOLEDAD DE GRACIANO SANCHEZ,20,215,2,237,1692
SAN LUIS POTOSÍ,SOLEDAD DE GRACIANO SANCHEZ,36,244,4,284,0
SAN LUIS POTOSÍ,SOLEDAD DE GRACIANO SANCHEZ,6,152,3,161,1404
SAN LUIS POTOSÍ,SOLEDAD DE GRACIANO SANCHEZ,4,162,6,172,1404
SAN LUIS POTOSÍ,SOLEDAD DE GRACIANO SANCHEZ,3,101,2,106,1407
SAN LUIS POTOSÍ,SOLEDAD DE GRACIANO SANCHEZ,11,121,1,133,1407
SAN LUIS POTOSÍ,SOLEDAD DE GRACIANO SANCHEZ,11,145,2,158,1859
SAN LUIS POTOSÍ,SOLEDAD DE GRACIANO SANCHEZ,8,132,7,147,1859
SAN LUIS POTOSÍ,SOLEDAD DE GRACIANO SANCHEZ,9,161,1,171,1858
SAN LUIS POTOSÍ,SOLEDAD DE GRACIANO SANCHEZ,9,67,4,80,1288
SAN LUIS POTOSÍ,SOLEDAD DE GRACIANO SANCHEZ,10,75,4,89,1288
SAN LUIS POTOSÍ,SOLEDAD DE GRACIANO SANCHEZ,7,150,5,162,2033
SAN LUIS POTOSÍ,SOLEDAD DE GRACIANO SANCHEZ,6,158,8,172,2032
SAN LUIS POTOSÍ,SOLEDAD DE GRACIANO SANCHEZ,2,96,1,99,1099
SAN LUIS POTOSÍ,SOLEDAD DE GRACIANO SANCHEZ,4,78,1,83,1099
SAN LUIS POTOSÍ,SOLEDAD DE GRACIANO SANCHEZ,10,267,7,284,1784
SAN LUIS POTOSÍ,SOLEDAD DE GRACIANO SANCHEZ,20,233,15,268,1784
SAN LUIS POTOSÍ,SOLEDAD DE GRACIANO SANCHEZ,14,185,7,206,1749
SAN LUIS POTOSÍ,SOLEDAD DE GRACIANO SANCHEZ,6,172,1,179,1748
SAN LUIS POTOSÍ,SOLEDAD DE GRACIANO SANCHEZ,10,291,2,303,1365
SAN LUIS POTOSÍ,SOLEDAD DE GRACIANO SANCHEZ,12,195,5,212,1365
SAN LUIS POTOSÍ,SOLEDAD DE GRACIANO SANCHEZ,15,199,2,216,1941
SAN LUIS POTOSÍ,SOLEDAD DE GRACIANO SANCHEZ,13,179,1,193,1940
SAN LUIS POTOSÍ,SOLEDAD DE GRACIANO SANCHEZ,15,159,2,176,1940
SAN LUIS POTOSÍ,SOLEDAD DE GRACIANO SANCHEZ,162,21,2,185,1940
SAN LUIS POTOSÍ,SOLEDAD DE GRACIANO SANCHEZ,10,181,0,191,1940
SAN LUIS POTOSÍ,SOLEDAD DE GRACIANO SANCHEZ,16,180,1,197,1940
SAN LUIS POTOSÍ,SOLEDAD DE GRACIANO SANCHEZ,19,212,0,231,1940
SAN LUIS POTOSÍ,SOLEDAD DE GRACIANO SANCHEZ,20,303,1,324,1699
SAN LUIS POTOSÍ,SOLEDAD DE GRACIANO SANCHEZ,21,316,4,341,1699
SAN LUIS POTOSÍ,SOLEDAD DE GRACIANO SANCHEZ,21,238,3,262,1683
SAN LUIS POTOSÍ,SOLEDAD DE GRACIANO SANCHEZ,12,276,3,291,1683
SAN LUIS POTOSÍ,SOLEDAD DE GRACIANO SANCHEZ,30,215,9,254,1866
SAN LUIS POTOSÍ,SOLEDAD DE GRACIANO SANCHEZ,25,264,7,296,1866
SAN LUIS POTOSÍ,SOLEDAD DE GRACIANO SANCHEZ,10,356,2,368,1517
SAN LUIS POTOSÍ,SOLEDAD DE GRACIANO SANCHEZ,10,203,2,215,1517
SAN LUIS POTOSÍ,SOLEDAD DE GRACIANO SANCHEZ,11,241,5,257,1835
SAN LUIS POTOSÍ,SOLEDAD DE GRACIANO SANCHEZ,13,388,2,403,1835
SAN LUIS POTOSÍ,SOLEDAD DE GRACIANO SANCHEZ,25,581,0,606,1835
SAN LUIS POTOSÍ,SOLEDAD DE GRACIANO SANCHEZ,6,536,4,546,1834
SAN LUIS POTOSÍ,SOLEDAD DE GRACIANO SANCHEZ,18,220,2,240,1834
SAN LUIS POTOSÍ,SOLEDAD DE GRACIANO SANCHEZ,25,267,5,297,1694
SAN LUIS POTOSÍ,SOLEDAD DE GRACIANO SANCHEZ,23,243,3,269,1694
SAN LUIS POTOSÍ,SOLEDAD DE GRACIANO SANCHEZ,21,248,2,271,1897
SAN LUIS POTOSÍ,SOLEDAD DE GRACIANO SANCHEZ,18,228,2,248,1896
SAN LUIS POTOSÍ,SOLEDAD DE GRACIANO SANCHEZ,17,177,1,195,1396
SAN LUIS POTOSÍ,SOLEDAD DE GRACIANO SANCHEZ,24,160,1,185,1396
SAN LUIS POTOSÍ,SOLEDAD DE GRACIANO SANCHEZ,7,155,2,164,1396
SAN LUIS POTOSÍ,SOLEDAD DE GRACIANO SANCHEZ,17,216,8,241,1454
SAN LUIS POTOSÍ,SOLEDAD DE GRACIANO SANCHEZ,16,211,0,227,1453
SAN LUIS POTOSÍ,SOLEDAD DE GRACIANO SANCHEZ,16,204,0,220,1453
SAN LUIS POTOSÍ,SOLEDAD DE GRACIANO SANCHEZ,25,260,6,291,1559
SAN LUIS POTOSÍ,SOLEDAD DE GRACIANO SANCHEZ,15,218,3,236,1559
SAN LUIS POTOSÍ,SOLEDAD DE GRACIANO SANCHEZ,18,190,5,213,1468
SAN LUIS POTOSÍ,SOLEDAD DE GRACIANO SANCHEZ,15,193,12,220,1468
SAN LUIS POTOSÍ,SOLEDAD DE GRACIANO SANCHEZ,21,199,3,223,1838
SAN LUIS POTOSÍ,SOLEDAD DE GRACIANO SANCHEZ,15,219,2,236,1838
SAN LUIS POTOSÍ,SOLEDAD DE GRACIANO SANCHEZ,17,173,4,194,1838
SAN LUIS POTOSÍ,SOLEDAD DE GRACIANO SANCHEZ,19,195,1,215,1838
SAN LUIS POTOSÍ,SOLEDAD DE GRACIANO SANCHEZ,16,178,0,194,1838
SAN LUIS POTOSÍ,SOLEDAD DE GRACIANO SANCHEZ,8,199,0,207,1838
SAN LUIS POTOSÍ,SOLEDAD DE GRACIANO SANCHEZ,17,180,3,200,1837
SAN LUIS POTOSÍ,SOLEDAD DE GRACIANO SANCHEZ,21,244,0,265,2006
SAN LUIS POTOSÍ,SOLEDAD DE GRACIANO SANCHEZ,22,243,4,269,2006
SAN LUIS POTOSÍ,SOLEDAD DE GRACIANO SANCHEZ,15,189,4,208,2006
SAN LUIS POTOSÍ,SOLEDAD DE GRACIANO SANCHEZ,16,198,1,215,2006
SAN LUIS POTOSÍ,SOLEDAD DE GRACIANO SANCHEZ,10,225,5,240,2006
SAN LUIS POTOSÍ,SOLEDAD DE GRACIANO SANCHEZ,15,194,2,211,2006
SAN LUIS POTOSÍ,SOLEDAD DE GRACIANO SANCHEZ,23,230,0,253,2005
SAN LUIS POTOSÍ,SOLEDAD DE GRACIANO SANCHEZ,18,219,2,239,2005
SAN LUIS POTOSÍ,SOLEDAD DE GRACIANO SANCHEZ,26,262,0,288,1905
SAN LUIS POTOSÍ,SOLEDAD DE GRACIANO SANCHEZ,27,1093,9,1129,1905
SAN LUIS POTOSÍ,SOLEDAD DE GRACIANO SANCHEZ,13,203,4,220,1448
SAN LUIS POTOSÍ,SOLEDAD DE GRACIANO SANCHEZ,16,187,4,207,1448
SAN LUIS POTOSÍ,SOLEDAD DE GRACIANO SANCHEZ,23,205,3,231,1447
SAN LUIS POTOSÍ,SOLEDAD DE GRACIANO SANCHEZ,10,267,2,279,1478
SAN LUIS POTOSÍ,SOLEDAD DE GRACIANO SANCHEZ,9,270,2,281,1478
SAN LUIS POTOSÍ,SOLEDAD DE GRACIANO SANCHEZ,14,290,3,307,1803
SAN LUIS POTOSÍ,SOLEDAD DE GRACIANO SANCHEZ,30,783,0,813,1802
SAN LUIS POTOSÍ,SOLEDAD DE GRACIANO SANCHEZ,17,232,3,252,1409
SAN LUIS POTOSÍ,SOLEDAD DE GRACIANO SANCHEZ,14,221,5,240,1408
SAN LUIS POTOSÍ,SOLEDAD DE GRACIANO SANCHEZ,9,239,1,249,1408
SAN LUIS POTOSÍ,SOLEDAD DE GRACIANO SANCHEZ,19,296,12,327,1598
SAN LUIS POTOSÍ,SOLEDAD DE GRACIANO SANCHEZ,15,294,6,315,1598
SAN LUIS POTOSÍ,SOLEDAD DE GRACIANO SANCHEZ,22,177,1,200,1569
SAN LUIS POTOSÍ,SOLEDAD DE GRACIANO SANCHEZ,22,186,1,209,1569
SAN LUIS POTOSÍ,SOLEDAD DE GRACIANO SANCHEZ,17,200,0,217,1569
SAN LUIS POTOSÍ,SOLEDAD DE GRACIANO SANCHEZ,17,303,3,323,1568
SAN LUIS POTOSÍ,SOLEDAD DE GRACIANO SANCHEZ,26,219,1,246,1664
SAN LUIS POTOSÍ,SOLEDAD DE GRACIANO SANCHEZ,21,180,8,209,1664
SAN LUIS POTOSÍ,SOLEDAD DE GRACIANO SANCHEZ,19,184,5,208,1663
SAN LUIS POTOSÍ,SOLEDAD DE GRACIANO SANCHEZ,15,184,3,202,1663
SAN LUIS POTOSÍ,SOLEDAD DE GRACIANO SANCHEZ,16,151,4,171,2030
SAN LUIS POTOSÍ,SOLEDAD DE GRACIANO SANCHEZ,26,163,1,190,2030
SAN LUIS POTOSÍ,SOLEDAD DE GRACIANO SANCHEZ,17,301,12,330,1600
SAN LUIS POTOSÍ,SOLEDAD DE GRACIANO SANCHEZ,26,298,0,324,1599
SAN LUIS POTOSÍ,SOLEDAD DE GRACIANO SANCHEZ,23,338,4,365,1844
SAN LUIS POTOSÍ,SOLEDAD DE GRACIANO SANCHEZ,16,327,5,348,1844
SAN LUIS POTOSÍ,SOLEDAD DE GRACIANO SANCHEZ,20,211,2,233,1442
SAN LUIS POTOSÍ,SOLEDAD DE GRACIANO SANCHEZ,23,226,4,253,1442
SAN LUIS POTOSÍ,SOLEDAD DE GRACIANO SANCHEZ,15,198,2,215,1442
SAN LUIS POTOSÍ,SOLEDAD DE GRACIANO SANCHEZ,14,245,3,262,1556
SAN LUIS POTOSÍ,SOLEDAD DE GRACIANO SANCHEZ,12,158,6,176,1556
SAN LUIS POTOSÍ,SOLEDAD DE GRACIANO SANCHEZ,9,142,5,156,1556
SAN LUIS POTOSÍ,SOLEDAD DE GRACIANO SANCHEZ,18,188,6,212,1556
SAN LUIS POTOSÍ,SOLEDAD DE GRACIANO SANCHEZ,13,195,1,209,1816
SAN LUIS POTOSÍ,SOLEDAD DE GRACIANO SANCHEZ,14,180,8,202,1816
SAN LUIS POTOSÍ,SOLEDAD DE GRACIANO SANCHEZ,8,224,6,238,1815
SAN LUIS POTOSÍ,SOLEDAD DE GRACIANO SANCHEZ,15,204,0,219,1986
SAN LUIS POTOSÍ,SOLEDAD DE GRACIANO SANCHEZ,14,258,1,273,1986
SAN LUIS POTOSÍ,SOLEDAD DE GRACIANO SANCHEZ,17,216,3,236,1962
SAN LUIS POTOSÍ,SOLEDAD DE GRACIANO SANCHEZ,16,232,5,253,1962
SAN LUIS POTOSÍ,SOLEDAD DE GRACIANO SANCHEZ,15,228,0,243,1962
SAN LUIS POTOSÍ,SOLEDAD DE GRACIANO SANCHEZ,26,225,2,253,1962
SAN LUIS POTOSÍ,SOLEDAD DE GRACIANO SANCHEZ,17,271,4,292,1962
SAN LUIS POTOSÍ,SOLEDAD DE GRACIANO SANCHEZ,22,216,1,239,1962
SAN LUIS POTOSÍ,SOLEDAD DE GRACIANO SANCHEZ,12,142,1,155,1962
SAN LUIS POTOSÍ,SOLEDAD DE GRACIANO SANCHEZ,11,225,4,240,1961
SAN LUIS POTOSÍ,SOLEDAD DE GRACIANO SANCHEZ,15,183,2,200,1538
SAN LUIS POTOSÍ,SOLEDAD DE GRACIANO SANCHEZ,19,205,2,226,1538
SAN LUIS POTOSÍ,SOLEDAD DE GRACIANO SANCHEZ,19,231,3,253,1538
SAN LUIS POTOSÍ,SOLEDAD DE GRACIANO SANCHEZ,15,192,0,207,1538
SAN LUIS POTOSÍ,SOLEDAD DE GRACIANO SANCHEZ,15,279,2,296,1821
SAN LUIS POTOSÍ,SOLEDAD DE GRACIANO SANCHEZ,17,260,4,281,1820
SAN LUIS POTOSÍ,SOLEDAD DE GRACIANO SANCHEZ,7,180,2,189,1323
SAN LUIS POTOSÍ,SOLEDAD DE GRACIANO SANCHEZ,15,399,3,417,1322
SAN LUIS POTOSÍ,SOLEDAD DE GRACIANO SANCHEZ,25,213,2,240,1673
SAN LUIS POTOSÍ,SOLEDAD DE GRACIANO SANCHEZ,4,261,0,265,1672
SAN LUIS POTOSÍ,SOLEDAD DE GRACIANO SANCHEZ,21,168,0,189,1672
SAN LUIS POTOSÍ,SOLEDAD DE GRACIANO SANCHEZ,22,337,2,361,1672
SAN LUIS POTOSÍ,SOLEDAD DE GRACIANO SANCHEZ,14,436,1,451,1371
SAN LUIS POTOSÍ,SOLEDAD DE GRACIANO SANCHEZ,16,131,0,147,1371
SAN LUIS POTOSÍ,SOLEDAD DE GRACIANO SANCHEZ,12,155,1,168,1371
SAN LUIS POTOSÍ,SOLEDAD DE GRACIANO SANCHEZ,11,156,1,168,1767
SAN LUIS POTOSÍ,SOLEDAD DE GRACIANO SANCHEZ,13,137,5,155,1767
SAN LUIS POTOSÍ,SOLEDAD DE GRACIANO SANCHEZ,17,174,3,194,1767
SAN LUIS POTOSÍ,SOLEDAD DE GRACIANO SANCHEZ,14,175,3,192,1767
SAN LUIS POTOSÍ,SOLEDAD DE GRACIANO SANCHEZ,10,153,5,168,1766
SAN LUIS POTOSÍ,SOLEDAD DE GRACIANO SANCHEZ,10,129,10,149,1511
SAN LUIS POTOSÍ,SOLEDAD DE GRACIANO SANCHEZ,16,140,7,163,1511
SAN LUIS POTOSÍ,SOLEDAD DE GRACIANO SANCHEZ,13,121,4,138,1511
SAN LUIS POTOSÍ,SOLEDAD DE GRACIANO SANCHEZ,20,66,3,89,873
SAN LUIS POTOSÍ,SOLEDAD DE GRACIANO SANCHEZ,36,312,10,358,1727
SAN LUIS POTOSÍ,SOLEDAD DE GRACIANO SANCHEZ,0,275,15,290,1726
SAN LUIS POTOSÍ,SOLEDAD DE GRACIANO SANCHEZ,21,276,12,309,1442
SAN LUIS POTOSÍ,SOLEDAD DE GRACIANO SANCHEZ,33,279,7,319,1441
SAN LUIS POTOSÍ,SOLEDAD DE GRACIANO SANCHEZ,39,304,6,349,1441
SAN LUIS POTOSÍ,SOLEDAD DE GRACIANO SANCHEZ,18,385,9,412,1708
SAN LUIS POTOSÍ,SOLEDAD DE GRACIANO SANCHEZ,18,397,19,434,1708
SAN LUIS POTOSÍ,SOLEDAD DE GRACIANO SANCHEZ,16,272,14,302,1707
SAN LUIS POTOSÍ,SOLEDAD DE GRACIANO SANCHEZ,6,545,11,562,1374
SAN LUIS POTOSÍ,SOLEDAD DE GRACIANO SANCHEZ,10,219,1,230,1374
SAN LUIS POTOSÍ,SOLEDAD DE GRACIANO SANCHEZ,1,185,0,186,1374
SAN LUIS POTOSÍ,SOLEDAD DE GRACIANO SANCHEZ,8,270,6,284,1936
SAN LUIS POTOSÍ,SOLEDAD DE GRACIANO SANCHEZ,1,340,2,343,1935
SAN LUIS POTOSÍ,SOLEDAD DE GRACIANO SANCHEZ,12,180,3,195,1894
SAN LUIS POTOSÍ,SOLEDAD DE GRACIANO SANCHEZ,3,166,2,171,1894
SAN LUIS POTOSÍ,SOLEDAD DE GRACIANO SANCHEZ,4,135,1,140,1894
SAN LUIS POTOSÍ,SOLEDAD DE GRACIANO SANCHEZ,31,242,2,275,1285
SAN LUIS POTOSÍ,SOLEDAD DE GRACIANO SANCHEZ,25,266,2,293,1284
SAN LUIS POTOSÍ,SOLEDAD DE GRACIANO SANCHEZ,30,259,12,301,1136
SAN LUIS POTOSÍ,SOLEDAD DE GRACIANO SANCHEZ,13,308,9,330,1136
SAN LUIS POTOSÍ,SOLEDAD DE GRACIANO SANCHEZ,4,232,7,243,2045
SAN LUIS POTOSÍ,SOLEDAD DE GRACIANO SANCHEZ,9,252,2,263,2044
SAN LUIS POTOSÍ,SOLEDAD DE GRACIANO SANCHEZ,21,434,8,463,1834
SAN LUIS POTOSÍ,SOLEDAD DE GRACIANO SANCHEZ,6,407,21,434,1833
SAN LUIS POTOSÍ,SOLEDAD DE GRACIANO SANCHEZ,21,199,4,224,1081
SAN LUIS POTOSÍ,SOLEDAD DE GRACIANO SANCHEZ,13,168,5,186,1080
SAN LUIS POTOSÍ,SOLEDAD DE GRACIANO SANCHEZ,14,352,16,382,1665
SAN LUIS POTOSÍ,SOLEDAD DE GRACIANO SANCHEZ,6,585,2,593,1665
SAN LUIS POTOSÍ,SOLEDAD DE GRACIANO SANCHEZ,7,257,3,267,1831
SAN LUIS POTOSÍ,SOLEDAD DE GRACIANO SANCHEZ,14,261,24,299,1830
SAN LUIS POTOSÍ,SOLEDAD DE GRACIANO SANCHEZ,4,249,6,259,1474
SAN LUIS POTOSÍ,SOLEDAD DE GRACIANO SANCHEZ,9,270,4,283,1474
SAN LUIS POTOSÍ,SOLEDAD DE GRACIANO SANCHEZ,7,123,8,138,1373
SAN LUIS POTOSÍ,SOLEDAD DE GRACIANO SANCHEZ,6,122,3,131,1373
SAN LUIS POTOSÍ,SOLEDAD DE GRACIANO SANCHEZ,3,113,0,116,1373
SAN LUIS POTOSÍ,SOLEDAD DE GRACIANO SANCHEZ,13,169,4,186,1984
SAN LUIS POTOSÍ,SOLEDAD DE GRACIANO SANCHEZ,8,167,7,182,1984
SAN LUIS POTOSÍ,SOLEDAD DE GRACIANO SANCHEZ,10,147,3,160,1984
SAN LUIS POTOSÍ,SOLEDAD DE GRACIANO SANCHEZ,5,131,0,136,1698
SAN LUIS POTOSÍ,SOLEDAD DE GRACIANO SANCHEZ,9,121,2,132,1697
SAN LUIS POTOSÍ,SOLEDAD DE GRACIANO SANCHEZ,5,126,7,138,1697
SAN LUIS POTOSÍ,SOLEDAD DE GRACIANO SANCHEZ,13,168,0,181,1952
SAN LUIS POTOSÍ,SOLEDAD DE GRACIANO SANCHEZ,12,166,2,180,1952
SAN LUIS POTOSÍ,SOLEDAD DE GRACIANO SANCHEZ,26,216,4,246,1932
SAN LUIS POTOSÍ,SOLEDAD DE GRACIANO SANCHEZ,25,558,3,586,1932
SAN LUIS POTOSÍ,SOLEDAD DE GRACIANO SANCHEZ,23,160,4,187,1544
SAN LUIS POTOSÍ,SOLEDAD DE GRACIANO SANCHEZ,24,175,0,199,1544
SAN LUIS POTOSÍ,SOLEDAD DE GRACIANO SANCHEZ,28,189,0,217,1543
SAN LUIS POTOSÍ,SOLEDAD DE GRACIANO SANCHEZ,11,321,1,333,2002
SAN LUIS POTOSÍ,SOLEDAD DE GRACIANO SANCHEZ,25,221,0,246,1973
SAN LUIS POTOSÍ,SOLEDAD DE GRACIANO SANCHEZ,25,250,1,276,1973
SAN LUIS POTOSÍ,SOLEDAD DE GRACIANO SANCHEZ,9,169,1,179,1233
SAN LUIS POTOSÍ,SOLEDAD DE GRACIANO SANCHEZ,10,169,1,180,1232
SAN LUIS POTOSÍ,SOLEDAD DE GRACIANO SANCHEZ,13,176,0,189,1515
SAN LUIS POTOSÍ,SOLEDAD DE GRACIANO SANCHEZ,15,163,4,182,1514
SAN LUIS POTOSÍ,RIOVERDE,0,272,22,294,1688
SAN LUIS POTOSÍ,RIOVERDE,19,278,22,319,1688
SAN LUIS POTOSÍ,RIOVERDE,8,341,6,355,1553
SAN LUIS POTOSÍ,RIOVERDE,3,344,4,351,1553
SAN LUIS POTOSÍ,RIOVERDE,12,419,10,441,1870
SAN LUIS POTOSÍ,RIOVERDE,11,425,9,445,1869
SAN LUIS POTOSÍ,RIOVERDE,15,298,9,322,1612
SAN LUIS POTOSÍ,RIOVERDE,6,294,1,301,1611
SAN LUIS POTOSÍ,RIOVERDE,10,313,6,329,1611
SAN LUIS POTOSÍ,RIOVERDE,10,328,8,346,1662
SAN LUIS POTOSÍ,RIOVERDE,10,334,8,352,1662
SAN LUIS POTOSÍ,RIOVERDE,10,293,18,321,1661
SAN LUIS POTOSÍ,RIOVERDE,9,194,6,209,1463
SAN LUIS POTOSÍ,RIOVERDE,6,209,4,219,1462
SAN LUIS POTOSÍ,RIOVERDE,9,177,5,191,1462
SAN LUIS POTOSÍ,RIOVERDE,9,91,4,104,1636
SAN LUIS POTOSÍ,RIOVERDE,6,81,2,89,1636
SAN LUIS POTOSÍ,RIOVERDE,5,117,3,125,1636
SAN LUIS POTOSÍ,RIOVERDE,9,112,7,128,1635
SAN LUIS POTOSÍ,RIOVERDE,5,72,1,78,1635
SAN LUIS POTOSÍ,RIOVERDE,12,292,1,305,1844
SAN LUIS POTOSÍ,RIOVERDE,10,280,4,294,1844
SAN LUIS POTOSÍ,RIOVERDE,10,266,10,286,1843
SAN LUIS POTOSÍ,RIOVERDE,8,324,12,344,1721
SAN LUIS POTOSÍ,RIOVERDE,12,300,7,319,1721
SAN LUIS POTOSÍ,RIOVERDE,13,311,8,332,1683
SAN LUIS POTOSÍ,RIOVERDE,11,303,16,330,1683
SAN LUIS POTOSÍ,RIOVERDE,14,321,12,347,1683
SAN LUIS POTOSÍ,RIOVERDE,4,245,8,257,1541
SAN LUIS POTOSÍ,RIOVERDE,13,243,7,263,1540
SAN LUIS POTOSÍ,RIOVERDE,6,286,9,301,1540
SAN LUIS POTOSÍ,RIOVERDE,9,243,8,260,1540
SAN LUIS POTOSÍ,RIOVERDE,5,310,3,318,1716
SAN LUIS POTOSÍ,RIOVERDE,8,266,22,296,1716
SAN LUIS POTOSÍ,RIOVERDE,11,296,8,315,1715
SAN LUIS POTOSÍ,RIOVERDE,10,273,25,308,1715
SAN LUIS POTOSÍ,RIOVERDE,20,250,11,281,1344
SAN LUIS POTOSÍ,RIOVERDE,17,273,13,303,1344
SAN LUIS POTOSÍ,RIOVERDE,16,384,19,419,1992
SAN LUIS POTOSÍ,RIOVERDE,20,259,10,289,1774
SAN LUIS POTOSÍ,RIOVERDE,3,250,2,255,1773
SAN LUIS POTOSÍ,RIOVERDE,6,294,7,307,1362
SAN LUIS POTOSÍ,RIOVERDE,5,243,3,251,1361
SAN LUIS POTOSÍ,RIOVERDE,13,265,1,279,1595
SAN LUIS POTOSÍ,RIOVERDE,23,269,3,295,1594
SAN LUIS POTOSÍ,RIOVERDE,12,270,1,283,1594
SAN LUIS POTOSÍ,RIOVERDE,21,329,4,354,1985
SAN LUIS POTOSÍ,RIOVERDE,22,335,1,358,1984
SAN LUIS POTOSÍ,RIOVERDE,4,185,2,191,1135
SAN LUIS POTOSÍ,RIOVERDE,6,177,3,186,1134
SAN LUIS POTOSÍ,RIOVERDE,6,334,2,342,1888
SAN LUIS POTOSÍ,RIOVERDE,11,318,2,331,1888
SAN LUIS POTOSÍ,RIOVERDE,7,248,5,260,1749
SAN LUIS POTOSÍ,RIOVERDE,18,277,5,300,1748
SAN LUIS POTOSÍ,RIOVERDE,13,251,5,269,1557
SAN LUIS POTOSÍ,RIOVERDE,6,235,4,245,1556
SAN LUIS POTOSÍ,RIOVERDE,9,227,6,242,1336
SAN LUIS POTOSÍ,RIOVERDE,6,231,14,251,1336
SAN LUIS POTOSÍ,RIOVERDE,12,201,13,226,1336
SAN LUIS POTOSÍ,RIOVERDE,21,246,4,271,1658
SAN LUIS POTOSÍ,RIOVERDE,14,253,3,270,1657
SAN LUIS POTOSÍ,RIOVERDE,13,82,12,107,1307
SAN LUIS POTOSÍ,RIOVERDE,22,104,11,137,1306
SAN LUIS POTOSÍ,RIOVERDE,23,146,8,177,1910
SAN LUIS POTOSÍ,RIOVERDE,23,160,9,192,1910
SAN LUIS POTOSÍ,RIOVERDE,19,141,8,168,1910
SAN LUIS POTOSÍ,RIOVERDE,10,64,3,77,1909
SAN LUIS POTOSÍ,RIOVERDE,10,135,2,147,1328
SAN LUIS POTOSÍ,RIOVERDE,2,258,5,265,1328
SAN LUIS POTOSÍ,RIOVERDE,9,126,6,141,1328
SAN LUIS POTOSÍ,RIOVERDE,6,117,3,126,1635
SAN LUIS POTOSÍ,RIOVERDE,4,102,0,106,1634
SAN LUIS POTOSÍ,RIOVERDE,10,266,6,282,1740
SAN LUIS POTOSÍ,RIOVERDE,12,300,10,322,1739
SAN LUIS POTOSÍ,RIOVERDE,12,239,9,260,1739
SAN LUIS POTOSÍ,RIOVERDE,15,258,14,287,1568
SAN LUIS POTOSÍ,RIOVERDE,14,279,15,308,1567
SAN LUIS POTOSÍ,RIOVERDE,9,228,16,253,1567
SAN LUIS POTOSÍ,RIOVERDE,42,422,17,481,1917
SAN LUIS POTOSÍ,RIOVERDE,40,330,30,400,1916
SAN LUIS POTOSÍ,RIOVERDE,13,248,14,275,1636
SAN LUIS POTOSÍ,RIOVERDE,20,243,6,269,1636
SAN LUIS POTOSÍ,RIOVERDE,14,238,8,260,1636
SAN LUIS POTOSÍ,RIOVERDE,17,289,4,310,1798
SAN LUIS POTOSÍ,RIOVERDE,17,303,3,323,1798
SAN LUIS POTOSÍ,RIOVERDE,18,294,2,314,1797
SAN LUIS POTOSÍ,RIOVERDE,25,274,2,301,1943
SAN LUIS POTOSÍ,RIOVERDE,12,275,1,288,1943
SAN LUIS POTOSÍ,RIOVERDE,24,192,3,219,1250
SAN LUIS POTOSÍ,RIOVERDE,11,216,2,229,1249
SAN LUIS POTOSÍ,RIOVERDE,8,208,0,216,1177
SAN LUIS POTOSÍ,RIOVERDE,12,201,1,214,1177
SAN LUIS POTOSÍ,RIOVERDE,15,244,5,264,1557
SAN LUIS POTOSÍ,RIOVERDE,20,246,2,268,1557
SAN LUIS POTOSÍ,RIOVERDE,26,301,7,334,1831
SAN LUIS POTOSÍ,RIOVERDE,20,319,1,340,1830
SAN LUIS POTOSÍ,RIOVERDE,19,239,2,260,1570
SAN LUIS POTOSÍ,RIOVERDE,9,224,3,236,1569
SAN LUIS POTOSÍ,RIOVERDE,13,211,0,224,1569
SAN LUIS POTOSÍ,RIOVERDE,23,346,3,372,1965
SAN LUIS POTOSÍ,RIOVERDE,31,355,2,388,1965
SAN LUIS POTOSÍ,RIOVERDE,21,228,7,256,1469
SAN LUIS POTOSÍ,RIOVERDE,18,204,9,231,1468
SAN LUIS POTOSÍ,RIOVERDE,11,225,5,241,1468
SAN LUIS POTOSÍ,RIOVERDE,37,540,6,583,0
SAN LUIS POTOSÍ,RIOVERDE,21,279,10,310,1490
SAN LUIS POTOSÍ,RIOVERDE,31,329,9,369,1489
SAN LUIS POTOSÍ,RIOVERDE,8,324,4,336,1418
SAN LUIS POTOSÍ,RIOVERDE,29,278,3,310,1417
SAN LUIS POTOSÍ,RIOVERDE,17,232,8,257,1378
SAN LUIS POTOSÍ,RIOVERDE,10,252,5,267,1377
SAN LUIS POTOSÍ,RIOVERDE,16,305,21,342,1069
SAN LUIS POTOSÍ,RIOVERDE,11,312,10,333,1068
SAN LUIS POTOSÍ,RIOVERDE,21,246,20,287,1442
SAN LUIS POTOSÍ,RIOVERDE,14,242,6,262,1441
SAN LUIS POTOSÍ,RIOVERDE,24,297,23,344,1898
SAN LUIS POTOSÍ,RIOVERDE,23,295,14,332,1897
SAN LUIS POTOSÍ,RIOVERDE,12,258,1,271,1396
SAN LUIS POTOSÍ,RIOVERDE,11,233,6,250,1395
SAN LUIS POTOSÍ,RIOVERDE,11,373,15,399,1836
SAN LUIS POTOSÍ,RIOVERDE,15,347,10,372,1836
SAN LUIS POTOSÍ,RIOVERDE,8,271,8,287,1540
SAN LUIS POTOSÍ,RIOVERDE,15,232,11,258,1539
SAN LUIS POTOSÍ,RIOVERDE,16,286,13,315,1734
SAN LUIS POTOSÍ,RIOVERDE,9,294,7,310,1733
SAN LUIS POTOSÍ,RIOVERDE,20,249,1,270,1559
SAN LUIS POTOSÍ,RIOVERDE,13,213,3,229,1558
SAN LUIS POTOSÍ,RIOVERDE,35,378,13,426,1840
SAN LUIS POTOSÍ,RIOVERDE,22,338,28,388,1839
SAN LUIS POTOSÍ,RIOVERDE,18,413,18,449,1633
SAN LUIS POTOSÍ,RIOVERDE,16,414,17,447,1633
SAN LUIS POTOSÍ,RIOVERDE,10,380,21,411,1632
SAN LUIS POTOSÍ,RIOVERDE,20,441,16,477,1863
SAN LUIS POTOSÍ,RIOVERDE,20,463,17,500,1863
SAN LUIS POTOSÍ,RIOVERDE,15,456,11,482,1862
SAN LUIS POTOSÍ,RIOVERDE,13,287,14,314,1686
SAN LUIS POTOSÍ,RIOVERDE,9,291,11,311,1685
SAN LUIS POTOSÍ,RIOVERDE,7,197,4,208,1546
SAN LUIS POTOSÍ,RIOVERDE,12,233,6,251,1546
SAN LUIS POTOSÍ,RIOVERDE,11,201,4,216,1546
SAN LUIS POTOSÍ,RIOVERDE,14,188,4,206,1545
SAN LUIS POTOSÍ,RIOVERDE,6,393,8,407,1420
SAN LUIS POTOSÍ,RIOVERDE,12,306,12,330,1419
SAN LUIS POTOSÍ,RIOVERDE,12,342,2,356,1419
SAN LUIS POTOSÍ,RIOVERDE,18,206,10,234,1075
SAN LUIS POTOSÍ,RIOVERDE,10,237,9,256,1074
SAN LUIS POTOSÍ,RIOVERDE,24,263,16,303,1200
SAN LUIS POTOSÍ,RIOVERDE,26,235,18,279,1199
SAN LUIS POTOSÍ,RIOVERDE,26,315,18,359,1181
SAN LUIS POTOSÍ,RIOVERDE,29,279,20,328,1181
SAN LUIS POTOSÍ,RIOVERDE,14,196,3,213,1519
SAN LUIS POTOSÍ,RIOVERDE,9,203,7,219,1519
SAN LUIS POTOSÍ,RIOVERDE,16,184,2,202,1519
SAN LUIS POTOSÍ,RIOVERDE,10,165,7,182,1519
SAN LUIS POTOSÍ,RIOVERDE,6,182,5,193,1540
SAN LUIS POTOSÍ,RIOVERDE,14,143,2,159,1540
SAN LUIS POTOSÍ,RIOVERDE,5,172,2,179,1540
SAN LUIS POTOSÍ,RIOVERDE,6,142,4,152,1540
SAN LUIS POTOSÍ,RIOVERDE,12,93,0,105,1073
SAN LUIS POTOSÍ,RIOVERDE,9,116,1,126,1073
SAN LUIS POTOSÍ,RIOVERDE,10,106,5,121,1983
SAN LUIS POTOSÍ,RIOVERDE,8,130,3,141,1982
SAN LUIS POTOSÍ,RIOVERDE,11,192,9,212,1724
SAN LUIS POTOSÍ,RIOVERDE,10,165,12,187,1724
SAN LUIS POTOSÍ,RIOVERDE,10,219,4,233,1724
SAN LUIS POTOSÍ,RIOVERDE,5,167,5,177,1723
SAN LUIS POTOSÍ,RIOVERDE,11,122,2,135,1578
SAN LUIS POTOSÍ,RIOVERDE,3,106,2,111,1577
SAN LUIS POTOSÍ,RIOVERDE,9,166,2,177,1577
SAN LUIS POTOSÍ,RIOVERDE,7,129,0,136,1577
SAN LUIS POTOSÍ,RIOVERDE,23,189,12,224,1585
SAN LUIS POTOSÍ,RIOVERDE,12,246,21,279,1584
SAN LUIS POTOSÍ,CIUDAD VALLES,18,302,4,324,1861
SAN LUIS POTOSÍ,CIUDAD VALLES,13,259,2,274,1861
SAN LUIS POTOSÍ,CIUDAD VALLES,10,283,2,295,1861
SAN LUIS POTOSÍ,CIUDAD VALLES,8,306,3,317,1860
SAN LUIS POTOSÍ,CIUDAD VALLES,13,289,4,306,1714
SAN LUIS POTOSÍ,CIUDAD VALLES,8,278,3,289,1714
SAN LUIS POTOSÍ,CIUDAD VALLES,2,236,5,243,1714
SAN LUIS POTOSÍ,CIUDAD VALLES,13,204,13,230,1165
SAN LUIS POTOSÍ,CIUDAD VALLES,8,180,9,197,1164
SAN LUIS POTOSÍ,CIUDAD VALLES,9,297,5,311,1675
SAN LUIS POTOSÍ,CIUDAD VALLES,12,282,8,302,1674
SAN LUIS POTOSÍ,CIUDAD VALLES,16,277,5,298,1674
SAN LUIS POTOSÍ,CIUDAD VALLES,12,335,3,350,1674
SAN LUIS POTOSÍ,CIUDAD VALLES,9,278,2,289,1674
SAN LUIS POTOSÍ,CIUDAD VALLES,16,489,6,511,1960
SAN LUIS POTOSÍ,CIUDAD VALLES,13,481,4,498,1959
SAN LUIS POTOSÍ,CIUDAD VALLES,8,416,5,429,1855
SAN LUIS POTOSÍ,CIUDAD VALLES,14,411,1,426,1854
SAN LUIS POTOSÍ,CIUDAD VALLES,23,353,10,386,1968
SAN LUIS POTOSÍ,CIUDAD VALLES,13,348,6,367,1968
SAN LUIS POTOSÍ,CIUDAD VALLES,4,280,2,286,1369
SAN LUIS POTOSÍ,CIUDAD VALLES,15,255,2,272,1369
SAN LUIS POTOSÍ,CIUDAD VALLES,20,261,1,282,1368
SAN LUIS POTOSÍ,CIUDAD VALLES,9,277,1,287,1189
SAN LUIS POTOSÍ,CIUDAD VALLES,10,303,2,315,1188
SAN LUIS POTOSÍ,CIUDAD VALLES,4,306,5,315,1594
SAN LUIS POTOSÍ,CIUDAD VALLES,12,313,2,327,1594
SAN LUIS POTOSÍ,CIUDAD VALLES,7,297,4,308,1593
SAN LUIS POTOSÍ,CIUDAD VALLES,16,363,8,387,1734
SAN LUIS POTOSÍ,CIUDAD VALLES,9,367,4,380,1733
SAN LUIS POTOSÍ,CIUDAD VALLES,17,342,5,364,1733
SAN LUIS POTOSÍ,CIUDAD VALLES,21,304,4,329,1896
SAN LUIS POTOSÍ,CIUDAD VALLES,27,336,0,363,1896
SAN LUIS POTOSÍ,CIUDAD VALLES,17,401,1,419,1800
SAN LUIS POTOSÍ,CIUDAD VALLES,16,379,7,402,1800
SAN LUIS POTOSÍ,CIUDAD VALLES,10,393,5,408,1628
SAN LUIS POTOSÍ,CIUDAD VALLES,6,376,7,389,1627
SAN LUIS POTOSÍ,CIUDAD VALLES,9,316,0,325,1507
SAN LUIS POTOSÍ,CIUDAD VALLES,6,337,4,347,1506
SAN LUIS POTOSÍ,CIUDAD VALLES,10,346,5,361,1506
SAN LUIS POTOSÍ,CIUDAD VALLES,31,291,6,328,1496
SAN LUIS POTOSÍ,CIUDAD VALLES,22,262,16,300,1495
SAN LUIS POTOSÍ,CIUDAD VALLES,27,345,3,375,1708
SAN LUIS POTOSÍ,CIUDAD VALLES,1,374,3,378,1708
SAN LUIS POTOSÍ,CIUDAD VALLES,16,299,6,321,1578
SAN LUIS POTOSÍ,CIUDAD VALLES,13,331,2,346,1577
SAN LUIS POTOSÍ,CIUDAD VALLES,14,340,4,358,1725
SAN LUIS POTOSÍ,CIUDAD VALLES,15,346,1,362,1725
SAN LUIS POTOSÍ,CIUDAD VALLES,20,261,2,283,1513
SAN LUIS POTOSÍ,CIUDAD VALLES,22,287,1,310,1512
SAN LUIS POTOSÍ,CIUDAD VALLES,24,215,9,248,1605
SAN LUIS POTOSÍ,CIUDAD VALLES,21,256,3,280,1605
SAN LUIS POTOSÍ,CIUDAD VALLES,26,377,4,407,1668
SAN LUIS POTOSÍ,CIUDAD VALLES,2,412,3,417,1667
SAN LUIS POTOSÍ,CIUDAD VALLES,11,317,2,330,1592
SAN LUIS POTOSÍ,CIUDAD VALLES,13,278,5,296,1591
SAN LUIS POTOSÍ,CIUDAD VALLES,9,256,1,266,1591
SAN LUIS POTOSÍ,CIUDAD VALLES,9,340,10,359,1700
SAN LUIS POTOSÍ,CIUDAD VALLES,4,264,6,274,1699
SAN LUIS POTOSÍ,CIUDAD VALLES,19,392,4,415,1939
SAN LUIS POTOSÍ,CIUDAD VALLES,13,395,2,410,1938
SAN LUIS POTOSÍ,CIUDAD VALLES,18,264,5,287,1606
SAN LUIS POTOSÍ,CIUDAD VALLES,15,311,4,330,1606
SAN LUIS POTOSÍ,CIUDAD VALLES,20,253,2,275,1493
SAN LUIS POTOSÍ,CIUDAD VALLES,22,292,2,316,1492
SAN LUIS POTOSÍ,CIUDAD VALLES,16,331,6,353,1674
SAN LUIS POTOSÍ,CIUDAD VALLES,8,350,3,361,1673
SAN LUIS POTOSÍ,CIUDAD VALLES,61,1068,7,1136,0
SAN LUIS POTOSÍ,CIUDAD VALLES,22,371,7,400,1768
SAN LUIS POTOSÍ,CIUDAD VALLES,16,352,3,371,1767
SAN LUIS POTOSÍ,CIUDAD VALLES,5,405,7,417,1291
SAN LUIS POTOSÍ,CIUDAD VALLES,10,380,9,399,1290
SAN LUIS POTOSÍ,CIUDAD VALLES,14,302,6,322,1609
SAN LUIS POTOSÍ,CIUDAD VALLES,9,370,7,386,1609
SAN LUIS POTOSÍ,CIUDAD VALLES,11,380,6,397,1609
SAN LUIS POTOSÍ,CIUDAD VALLES,8,379,1,388,1608
SAN LUIS POTOSÍ,CIUDAD VALLES,4,451,8,463,1152
SAN LUIS POTOSÍ,CIUDAD VALLES,8,420,6,434,1152
SAN LUIS POTOSÍ,CIUDAD VALLES,12,484,3,499,2030
SAN LUIS POTOSÍ,CIUDAD VALLES,6,292,1,299,1295
SAN LUIS POTOSÍ,CIUDAD VALLES,10,294,3,307,1294
SAN LUIS POTOSÍ,CIUDAD VALLES,25,302,28,355,1629
SAN LUIS POTOSÍ,CIUDAD VALLES,23,371,21,415,1628
SAN LUIS POTOSÍ,CIUDAD VALLES,13,338,17,368,1458
SAN LUIS POTOSÍ,CIUDAD VALLES,14,320,28,362,1458
SAN LUIS POTOSÍ,CIUDAD VALLES,16,320,26,362,1457
SAN LUIS POTOSÍ,CIUDAD VALLES,29,346,10,385,1492
SAN LUIS POTOSÍ,CIUDAD VALLES,19,360,19,398,1492
SAN LUIS POTOSÍ,CIUDAD VALLES,14,354,18,386,1491
SAN LUIS POTOSÍ,CIUDAD VALLES,8,472,6,486,1772
SAN LUIS POTOSÍ,CIUDAD VALLES,5,455,8,468,1772
SAN LUIS POTOSÍ,CIUDAD VALLES,6,285,1,292,1193
SAN LUIS POTOSÍ,CIUDAD VALLES,7,269,4,280,1193
SAN LUIS POTOSÍ,CIUDAD VALLES,7,471,4,482,1843
SAN LUIS POTOSÍ,CIUDAD VALLES,10,474,7,491,1842
SAN LUIS POTOSÍ,CIUDAD VALLES,17,478,8,503,1906
SAN LUIS POTOSÍ,CIUDAD VALLES,13,512,7,532,1905
SAN LUIS POTOSÍ,CIUDAD VALLES,3,392,6,401,1507
SAN LUIS POTOSÍ,CIUDAD VALLES,8,384,9,401,1507
SAN LUIS POTOSÍ,CIUDAD VALLES,4,366,5,375,1506
SAN LUIS POTOSÍ,CIUDAD VALLES,31,450,18,499,1987
SAN LUIS POTOSÍ,CIUDAD VALLES,31,446,27,504,1986
SAN LUIS POTOSÍ,CIUDAD VALLES,1,446,30,477,1986
SAN LUIS POTOSÍ,CIUDAD VALLES,19,293,14,326,1772
SAN LUIS POTOSÍ,CIUDAD VALLES,15,285,9,309,1771
SAN LUIS POTOSÍ,CIUDAD VALLES,9,287,5,301,1236
SAN LUIS POTOSÍ,CIUDAD VALLES,17,309,9,335,1236
SAN LUIS POTOSÍ,CIUDAD VALLES,13,458,13,484,1688
SAN LUIS POTOSÍ,CIUDAD VALLES,23,421,2,446,1688
SAN LUIS POTOSÍ,CIUDAD VALLES,23,456,7,486,1688
SAN LUIS POTOSÍ,CIUDAD VALLES,20,468,24,512,1688
SAN LUIS POTOSÍ,CIUDAD VALLES,11,363,22,396,1676
SAN LUIS POTOSÍ,CIUDAD VALLES,19,429,11,459,1676
SAN LUIS POTOSÍ,CIUDAD VALLES,10,439,16,465,1676
SAN LUIS POTOSÍ,CIUDAD VALLES,12,259,5,276,1530
SAN LUIS POTOSÍ,CIUDAD VALLES,8,326,12,346,1529
SAN LUIS POTOSÍ,CIUDAD VALLES,4,303,5,312,1529
SAN LUIS POTOSÍ,CIUDAD VALLES,13,416,10,439,1423
SAN LUIS POTOSÍ,CIUDAD VALLES,9,444,15,468,1422
SAN LUIS POTOSÍ,CIUDAD VALLES,18,276,7,301,1777
SAN LUIS POTOSÍ,CIUDAD VALLES,18,340,11,369,1776
SAN LUIS POTOSÍ,CIUDAD VALLES,9,355,7,371,1776
SAN LUIS POTOSÍ,CIUDAD VALLES,15,278,11,304,1748
SAN LUIS POTOSÍ,CIUDAD VALLES,9,268,9,286,1747
SAN LUIS POTOSÍ,CIUDAD VALLES,19,351,19,389,1535
SAN LUIS POTOSÍ,CIUDAD VALLES,21,337,14,372,1534
SAN LUIS POTOSÍ,CIUDAD VALLES,75,297,38,410,2023
SAN LUIS POTOSÍ,CIUDAD VALLES,53,305,15,373,2022
SAN LUIS POTOSÍ,CIUDAD VALLES,22,308,4,334,1877
SAN LUIS POTOSÍ,CIUDAD VALLES,13,367,12,392,1876
SAN LUIS POTOSÍ,CIUDAD VALLES,6,249,2,257,1470
SAN LUIS POTOSÍ,CIUDAD VALLES,13,231,5,249,1469
SAN LUIS POTOSÍ,CIUDAD VALLES,15,317,6,338,2016
SAN LUIS POTOSÍ,CIUDAD VALLES,9,296,3,308,2016
SAN LUIS POTOSÍ,CIUDAD VALLES,9,268,5,282,1853
SAN LUIS POTOSÍ,CIUDAD VALLES,7,272,3,282,1852
SAN LUIS POTOSÍ,CIUDAD VALLES,10,305,15,330,1616
SAN LUIS POTOSÍ,CIUDAD VALLES,8,334,8,350,1615
SAN LUIS POTOSÍ,CIUDAD VALLES,13,299,9,321,1615
SAN LUIS POTOSÍ,CIUDAD VALLES,13,306,14,333,1919
SAN LUIS POTOSÍ,CIUDAD VALLES,13,276,10,299,1918
SAN LUIS POTOSÍ,CIUDAD VALLES,10,314,8,332,1629
SAN LUIS POTOSÍ,CIUDAD VALLES,6,279,6,291,1628
SAN LUIS POTOSÍ,CIUDAD VALLES,19,365,9,393,1844
SAN LUIS POTOSÍ,CIUDAD VALLES,10,353,11,374,1843
SAN LUIS POTOSÍ,CIUDAD VALLES,23,461,10,494,1863
SAN LUIS POTOSÍ,CIUDAD VALLES,14,502,11,527,1862
SAN LUIS POTOSÍ,CIUDAD VALLES,14,308,6,328,1317
SAN LUIS POTOSÍ,CIUDAD VALLES,12,317,8,337,1317
SAN LUIS POTOSÍ,SAN LUIS POTOSI,18,262,1,281,1905
SAN LUIS POTOSÍ,SAN LUIS POTOSI,16,241,4,261,1905
SAN LUIS POTOSÍ,SAN LUIS POTOSI,15,210,0,225,1905
SAN LUIS POTOSÍ,SAN LUIS POTOSI,22,238,0,260,1905
SAN LUIS POTOSÍ,SAN LUIS POTOSI,27,227,0,254,1905
SAN LUIS POTOSÍ,SAN LUIS POTOSI,14,223,2,239,1932
SAN LUIS POTOSÍ,SAN LUIS POTOSI,7,193,2,202,1932
SAN LUIS POTOSÍ,SAN LUIS POTOSI,7,163,0,170,1932
SAN LUIS POTOSÍ,SAN LUIS POTOSI,6,201,1,208,1931
SAN LUIS POTOSÍ,SAN LUIS POTOSI,14,242,3,259,1931
SAN LUIS POTOSÍ,SAN LUIS POTOSI,10,140,4,154,1827
SAN LUIS POTOSÍ,SAN LUIS POTOSI,13,136,5,154,1827
SAN LUIS POTOSÍ,SAN LUIS POTOSI,7,148,0,155,1827
SAN LUIS POTOSÍ,SAN LUIS POTOSI,13,133,0,146,1827
SAN LUIS POTOSÍ,SAN LUIS POTOSI,10,146,2,158,1827
SAN LUIS POTOSÍ,SAN LUIS POTOSI,14,140,3,157,1826
SAN LUIS POTOSÍ,SAN LUIS POTOSI,0,187,2,189,1826
SAN LUIS POTOSÍ,SAN LUIS POTOSI,10,135,2,147,1826
SAN LUIS POTOSÍ,SAN LUIS POTOSI,7,156,1,164,1816
SAN LUIS POTOSÍ,SAN LUIS POTOSI,5,160,2,167,1816
SAN LUIS POTOSÍ,SAN LUIS POTOSI,7,126,3,136,1815
SAN LUIS POTOSÍ,SAN LUIS POTOSI,11,144,0,155,1815
SAN LUIS POTOSÍ,SAN LUIS POTOSI,17,145,3,165,1374
SAN LUIS POTOSÍ,SAN LUIS POTOSI,12,170,1,183,1374
SAN LUIS POTOSÍ,SAN LUIS POTOSI,19,178,0,197,1374
SAN LUIS POTOSÍ,SAN LUIS POTOSI,22,252,5,279,1858
SAN LUIS POTOSÍ,SAN LUIS POTOSI,9,244,0,253,1858
SAN LUIS POTOSÍ,SAN LUIS POTOSI,9,267,10,286,1858
SAN LUIS POTOSÍ,SAN LUIS POTOSI,9,128,0,137,1227
SAN LUIS POTOSÍ,SAN LUIS POTOSI,15,154,2,171,1227
SAN LUIS POTOSÍ,SAN LUIS POTOSI,11,149,2,162,1519
SAN LUIS POTOSÍ,SAN LUIS POTOSI,6,127,0,133,1519
SAN LUIS POTOSÍ,SAN LUIS POTOSI,11,143,2,156,1518
SAN LUIS POTOSÍ,SAN LUIS POTOSI,10,148,2,160,1249
SAN LUIS POTOSÍ,SAN LUIS POTOSI,15,139,3,157,1249
SAN LUIS POTOSÍ,SAN LUIS POTOSI,13,200,3,216,1618
SAN LUIS POTOSÍ,SAN LUIS POTOSI,10,192,3,205,1617
SAN LUIS POTOSÍ,SAN LUIS POTOSI,20,224,0,244,1617
SAN LUIS POTOSÍ,SAN LUIS POTOSI,16,209,2,227,1616
SAN LUIS POTOSÍ,SAN LUIS POTOSI,32,186,1,219,1663
SAN LUIS POTOSÍ,SAN LUIS POTOSI,30,186,1,217,1663
SAN LUIS POTOSÍ,SAN LUIS POTOSI,13,132,0,145,1724
SAN LUIS POTOSÍ,SAN LUIS POTOSI,16,156,3,175,1724
SAN LUIS POTOSÍ,SAN LUIS POTOSI,17,188,0,205,1724
SAN LUIS POTOSÍ,SAN LUIS POTOSI,13,160,0,173,1724
SAN LUIS POTOSÍ,SAN LUIS POTOSI,19,154,2,175,1723
SAN LUIS POTOSÍ,SAN LUIS POTOSI,14,173,2,189,1723
SAN LUIS POTOSÍ,SAN LUIS POTOSI,12,149,5,166,1723
SAN LUIS POTOSÍ,SAN LUIS POTOSI,21,167,3,191,1285
SAN LUIS POTOSÍ,SAN LUIS POTOSI,12,182,1,195,1285
SAN LUIS POTOSÍ,SAN LUIS POTOSI,17,176,2,195,1091
SAN LUIS POTOSÍ,SAN LUIS POTOSI,9,161,0,170,1091
SAN LUIS POTOSÍ,SAN LUIS POTOSI,13,204,1,218,1390
SAN LUIS POTOSÍ,SAN LUIS POTOSI,12,161,0,173,1390
SAN LUIS POTOSÍ,SAN LUIS POTOSI,15,213,0,228,1669
SAN LUIS POTOSÍ,SAN LUIS POTOSI,17,224,1,242,1669
SAN LUIS POTOSÍ,SAN LUIS POTOSI,9,116,4,129,1083
SAN LUIS POTOSÍ,SAN LUIS POTOSI,13,122,5,140,1082
SAN LUIS POTOSÍ,SAN LUIS POTOSI,9,174,4,187,1150
SAN LUIS POTOSÍ,SAN LUIS POTOSI,7,190,1,198,1150
SAN LUIS POTOSÍ,SAN LUIS POTOSI,11,134,2,147,1180
SAN LUIS POTOSÍ,SAN LUIS POTOSI,17,147,2,166,1180
SAN LUIS POTOSÍ,SAN LUIS POTOSI,18,201,1,220,1761
SAN LUIS POTOSÍ,SAN LUIS POTOSI,10,188,2,200,1761
SAN LUIS POTOSÍ,SAN LUIS POTOSI,14,193,9,216,1760
SAN LUIS POTOSÍ,SAN LUIS POTOSI,29,241,0,270,1928
SAN LUIS POTOSÍ,SAN LUIS POTOSI,33,230,0,263,1927
SAN LUIS POTOSÍ,SAN LUIS POTOSI,23,187,2,212,1704
SAN LUIS POTOSÍ,SAN LUIS POTOSI,25,156,3,184,1703
SAN LUIS POTOSÍ,SAN LUIS POTOSI,33,184,0,217,1819
SAN LUIS POTOSÍ,SAN LUIS POTOSI,41,159,3,203,1819
SAN LUIS POTOSÍ,SAN LUIS POTOSI,11,159,0,170,1658
SAN LUIS POTOSÍ,SAN LUIS POTOSI,4,148,0,152,1658
SAN LUIS POTOSÍ,SAN LUIS POTOSI,16,204,2,222,1657
SAN LUIS POTOSÍ,SAN LUIS POTOSI,15,152,0,167,1657
SAN LUIS POTOSÍ,SAN LUIS POTOSI,14,146,1,161,1657
SAN LUIS POTOSÍ,SAN LUIS POTOSI,16,198,0,214,1592
SAN LUIS POTOSÍ,SAN LUIS POTOSI,14,199,2,215,1591
SAN LUIS POTOSÍ,SAN LUIS POTOSI,9,199,1,209,1591
SAN LUIS POTOSÍ,SAN LUIS POTOSI,198,15,1,214,1646
SAN LUIS POTOSÍ,SAN LUIS POTOSI,24,186,0,210,1646
SAN LUIS POTOSÍ,SAN LUIS POTOSI,28,173,2,203,1646
SAN LUIS POTOSÍ,SAN LUIS POTOSI,24,163,3,190,1665
SAN LUIS POTOSÍ,SAN LUIS POTOSI,27,173,0,200,1665
SAN LUIS POTOSÍ,SAN LUIS POTOSI,16,177,2,195,1568
SAN LUIS POTOSÍ,SAN LUIS POTOSI,14,160,2,176,1568
SAN LUIS POTOSÍ,SAN LUIS POTOSI,32,235,2,269,1890
SAN LUIS POTOSÍ,SAN LUIS POTOSI,27,234,5,266,1889
SAN LUIS POTOSÍ,SAN LUIS POTOSI,26,203,5,234,1544
SAN LUIS POTOSÍ,SAN LUIS POTOSI,22,200,1,223,1544
SAN LUIS POTOSÍ,SAN LUIS POTOSI,29,183,0,212,1544
SAN LUIS POTOSÍ,SAN LUIS POTOSI,19,275,5,299,1765
SAN LUIS POTOSÍ,SAN LUIS POTOSI,19,244,3,266,1764
SAN LUIS POTOSÍ,SAN LUIS POTOSI,14,221,2,237,1694
SAN LUIS POTOSÍ,SAN LUIS POTOSI,22,185,4,211,1694
SAN LUIS POTOSÍ,SAN LUIS POTOSI,13,233,3,249,1694
SAN LUIS POTOSÍ,SAN LUIS POTOSI,11,159,4,174,1279
SAN LUIS POTOSÍ,SAN LUIS POTOSI,11,181,0,192,1279
SAN LUIS POTOSÍ,SAN LUIS POTOSI,22,239,4,265,1908
SAN LUIS POTOSÍ,SAN LUIS POTOSI,12,282,5,299,1907
SAN LUIS POTOSÍ,SAN LUIS POTOSI,17,244,3,264,1503
SAN LUIS POTOSÍ,SAN LUIS POTOSI,28,222,1,251,1502
SAN LUIS POTOSÍ,SAN LUIS POTOSI,26,286,5,317,1960
SAN LUIS POTOSÍ,SAN LUIS POTOSI,24,318,2,344,1959
SAN LUIS POTOSÍ,SAN LUIS POTOSI,27,226,3,256,1840
SAN LUIS POTOSÍ,SAN LUIS POTOSI,24,269,5,298,1840
SAN LUIS POTOSÍ,SAN LUIS POTOSI,29,108,2,139,1386
SAN LUIS POTOSÍ,SAN LUIS POTOSI,25,141,1,167,1386
SAN LUIS POTOSÍ,SAN LUIS POTOSI,21,110,2,133,1385
SAN LUIS POTOSÍ,SAN LUIS POTOSI,22,128,0,150,1926
SAN LUIS POTOSÍ,SAN LUIS POTOSI,15,139,4,158,1926
SAN LUIS POTOSÍ,SAN LUIS POTOSI,18,265,4,287,1792
SAN LUIS POTOSÍ,SAN LUIS POTOSI,0,261,2,263,1792
SAN LUIS POTOSÍ,SAN LUIS POTOSI,19,239,3,261,1518
SAN LUIS POTOSÍ,SAN LUIS POTOSI,12,220,2,234,1518
SAN LUIS POTOSÍ,SAN LUIS POTOSI,19,207,7,233,1517
SAN LUIS POTOSÍ,SAN LUIS POTOSI,31,176,3,210,1547
SAN LUIS POTOSÍ,SAN LUIS POTOSI,24,204,1,229,1547
SAN LUIS POTOSÍ,SAN LUIS POTOSI,26,173,2,201,1546
SAN LUIS POTOSÍ,SAN LUIS POTOSI,15,210,3,228,1867
SAN LUIS POTOSÍ,SAN LUIS POTOSI,15,217,5,237,1867
SAN LUIS POTOSÍ,SAN LUIS POTOSI,34,89,1,124,1939
SAN LUIS POTOSÍ,SAN LUIS POTOSI,21,107,0,128,1939
SAN LUIS POTOSÍ,SAN LUIS POTOSI,15,127,1,143,1418
SAN LUIS POTOSÍ,SAN LUIS POTOSI,33,124,5,162,1418
SAN LUIS POTOSÍ,SAN LUIS POTOSI,34,117,2,153,1417
SAN LUIS POTOSÍ,SAN LUIS POTOSI,18,149,0,167,1634
SAN LUIS POTOSÍ,SAN LUIS POTOSI,14,166,2,182,1634
SAN LUIS POTOSÍ,SAN LUIS POTOSI,24,166,0,190,1634
SAN LUIS POTOSÍ,SAN LUIS POTOSI,58,79,1,138,1835
SAN LUIS POTOSÍ,SAN LUIS POTOSI,37,77,0,114,1835
SAN LUIS POTOSÍ,SAN LUIS POTOSI,0,151,1,152,1729
SAN LUIS POTOSÍ,SAN LUIS POTOSI,43,128,3,174,1729
SAN LUIS POTOSÍ,SAN LUIS POTOSI,25,179,0,204,1806
SAN LUIS POTOSÍ,SAN LUIS POTOSI,26,170,0,196,1806
SAN LUIS POTOSÍ,SAN LUIS POTOSI,35,162,3,200,1805
SAN LUIS POTOSÍ,SAN LUIS POTOSI,34,151,1,186,1938
SAN LUIS POTOSÍ,SAN LUIS POTOSI,28,172,2,202,1938
SAN LUIS POTOSÍ,SAN LUIS POTOSI,26,72,0,98,1503
SAN LUIS POTOSÍ,SAN LUIS POTOSI,43,83,1,127,1503
SAN LUIS POTOSÍ,SAN LUIS POTOSI,30,71,2,103,1503
SAN LUIS POTOSÍ,SAN LUIS POTOSI,20,55,2,77,1025
SAN LUIS POTOSÍ,SAN LUIS POTOSI,23,55,1,79,1025
SAN LUIS POTOSÍ,SAN LUIS POTOSI,36,60,0,96,1797
SAN LUIS POTOSÍ,SAN LUIS POTOSI,24,71,2,97,1797
SAN LUIS POTOSÍ,SAN LUIS POTOSI,19,46,0,65,1104
SAN LUIS POTOSÍ,SAN LUIS POTOSI,32,55,0,87,1103
SAN LUIS POTOSÍ,SAN LUIS POTOSI,33,156,0,189,1280
SAN LUIS POTOSÍ,SAN LUIS POTOSI,20,145,0,165,1280
SAN LUIS POTOSÍ,SAN LUIS POTOSI,42,118,1,161,1696
SAN LUIS POTOSÍ,SAN LUIS POTOSI,23,143,2,168,1696
SAN LUIS POTOSÍ,SAN LUIS POTOSI,43,127,4,174,1695
SAN LUIS POTOSÍ,SAN LUIS POTOSI,35,114,2,151,1506
SAN LUIS POTOSÍ,SAN LUIS POTOSI,38,101,4,143,1505
SAN LUIS POTOSÍ,SAN LUIS POTOSI,33,75,0,108,1681
SAN LUIS POTOSÍ,SAN LUIS POTOSI,30,74,3,107,1680
SAN LUIS POTOSÍ,SAN LUIS POTOSI,36,99,0,135,1680
SAN LUIS POTOSÍ,SAN LUIS POTOSI,22,165,4,191,1914
SAN LUIS POTOSÍ,SAN LUIS POTOSI,20,137,1,158,1914
SAN LUIS POTOSÍ,SAN LUIS POTOSI,21,132,0,153,1610
SAN LUIS POTOSÍ,SAN LUIS POTOSI,18,137,1,156,1610
SAN LUIS POTOSÍ,SAN LUIS POTOSI,11,110,0,121,1609
SAN LUIS POTOSÍ,SAN LUIS POTOSI,30,67,1,98,2002
SAN LUIS POTOSÍ,SAN LUIS POTOSI,26,71,0,97,2002
SAN LUIS POTOSÍ,SAN LUIS POTOSI,20,79,0,99,2001
SAN LUIS POTOSÍ,SAN LUIS POTOSI,30,77,1,108,2001
SAN LUIS POTOSÍ,SAN LUIS POTOSI,28,83,0,111,2001
SAN LUIS POTOSÍ,SAN LUIS POTOSI,115,690,2,807,0
SAN LUIS POTOSÍ,SAN LUIS POTOSI,29,161,3,193,1393
SAN LUIS POTOSÍ,SAN LUIS POTOSI,20,165,0,185,1393
SAN LUIS POTOSÍ,SAN LUIS POTOSI,26,149,3,178,1862
SAN LUIS POTOSÍ,SAN LUIS POTOSI,16,153,9,178,1862
SAN LUIS POTOSÍ,SAN LUIS POTOSI,6,169,0,175,1861
SAN LUIS POTOSÍ,SAN LUIS POTOSI,24,175,2,201,1861
SAN LUIS POTOSÍ,SAN LUIS POTOSI,21,72,4,97,1390
SAN LUIS POTOSÍ,SAN LUIS POTOSI,20,100,6,126,1390
SAN LUIS POTOSÍ,SAN LUIS POTOSI,11,113,0,124,1451
SAN LUIS POTOSÍ,SAN LUIS POTOSI,4,105,8,117,1450
SAN LUIS POTOSÍ,SAN LUIS POTOSI,12,96,6,114,1361
SAN LUIS POTOSÍ,SAN LUIS POTOSI,12,112,3,127,1360
SAN LUIS POTOSÍ,SAN LUIS POTOSI,21,172,0,193,2000
SAN LUIS POTOSÍ,SAN LUIS POTOSI,16,97,0,113,1999
SAN LUIS POTOSÍ,SAN LUIS POTOSI,28,135,3,166,1999
SAN LUIS POTOSÍ,SAN LUIS POTOSI,12,70,1,83,1185
SAN LUIS POTOSÍ,SAN LUIS POTOSI,4,49,0,53,1184
SAN LUIS POTOSÍ,SAN LUIS POTOSI,5,98,3,106,1594
SAN LUIS POTOSÍ,SAN LUIS POTOSI,4,104,1,109,1594
SAN LUIS POTOSÍ,SAN LUIS POTOSI,3,112,0,115,1594
SAN LUIS POTOSÍ,SAN LUIS POTOSI,10,109,1,120,1593
SAN LUIS POTOSÍ,SAN LUIS POTOSI,12,110,3,125,1472
SAN LUIS POTOSÍ,SAN LUIS POTOSI,13,77,0,90,1472
SAN LUIS POTOSÍ,SAN LUIS POTOSI,8,95,1,104,1471
SAN LUIS POTOSÍ,SAN LUIS POTOSI,11,139,5,155,1409
SAN LUIS POTOSÍ,SAN LUIS POTOSI,13,157,1,171,1408
SAN LUIS POTOSÍ,SAN LUIS POTOSI,10,89,4,103,1604
SAN LUIS POTOSÍ,SAN LUIS POTOSI,8,100,0,108,1603
SAN LUIS POTOSÍ,SAN LUIS POTOSI,3,78,3,84,1603
SAN LUIS POTOSÍ,SAN LUIS POTOSI,18,188,4,210,1357
SAN LUIS POTOSÍ,SAN LUIS POTOSI,14,200,0,214,1357
SAN LUIS POTOSÍ,SAN LUIS POTOSI,23,366,0,389,1855
SAN LUIS POTOSÍ,SAN LUIS POTOSI,26,338,1,365,1854
SAN LUIS POTOSÍ,SAN LUIS POTOSI,34,251,3,288,1893
SAN LUIS POTOSÍ,SAN LUIS POTOSI,26,320,12,358,1892
SAN LUIS POTOSÍ,SAN LUIS POTOSI,28,266,2,296,1805
SAN LUIS POTOSÍ,SAN LUIS POTOSI,20,288,2,310,1805
SAN LUIS POTOSÍ,SAN LUIS POTOSI,30,279,2,311,1759
SAN LUIS POTOSÍ,SAN LUIS POTOSI,15,259,3,277,1758
SAN LUIS POTOSÍ,SAN LUIS POTOSI,102,1021,7,1130,0
SAN LUIS POTOSÍ,SAN LUIS POTOSI,22,157,3,182,1303
SAN LUIS POTOSÍ,SAN LUIS POTOSI,18,162,6,186,1302
SAN LUIS POTOSÍ,SAN LUIS POTOSI,22,248,1,271,1946
SAN LUIS POTOSÍ,SAN LUIS POTOSI,16,243,2,261,1945
SAN LUIS POTOSÍ,SAN LUIS POTOSI,21,202,0,223,1616
SAN LUIS POTOSÍ,SAN LUIS POTOSI,27,212,4,243,1616
SAN LUIS POTOSÍ,SAN LUIS POTOSI,47,246,4,297,1958
SAN LUIS POTOSÍ,SAN LUIS POTOSI,29,255,5,289,1958
SAN LUIS POTOSÍ,SAN LUIS POTOSI,24,253,1,278,1466
SAN LUIS POTOSÍ,SAN LUIS POTOSI,23,245,3,271,1466
SAN LUIS POTOSÍ,SAN LUIS POTOSI,34,173,1,208,1803
SAN LUIS POTOSÍ,SAN LUIS POTOSI,23,196,0,219,1802
SAN LUIS POTOSÍ,SAN LUIS POTOSI,18,214,6,238,1655
SAN LUIS POTOSÍ,SAN LUIS POTOSI,20,205,2,227,1654
SAN LUIS POTOSÍ,SAN LUIS POTOSI,14,152,0,166,1381
SAN LUIS POTOSÍ,SAN LUIS POTOSI,3,157,1,161,1381
SAN LUIS POTOSÍ,SAN LUIS POTOSI,19,195,1,215,1822
SAN LUIS POTOSÍ,SAN LUIS POTOSI,7,194,1,202,1822
SAN LUIS POTOSÍ,SAN LUIS POTOSI,13,221,2,236,1822
SAN LUIS POTOSÍ,SAN LUIS POTOSI,20,186,2,208,1822
SAN LUIS POTOSÍ,SAN LUIS POTOSI,14,202,1,217,1632
SAN LUIS POTOSÍ,SAN LUIS POTOSI,8,198,1,207,1631
SAN LUIS POTOSÍ,SAN LUIS POTOSI,17,168,2,187,1355
SAN LUIS POTOSÍ,SAN LUIS POTOSI,18,171,1,190,1355
SAN LUIS POTOSÍ,SAN LUIS POTOSI,19,174,2,195,1354
SAN LUIS POTOSÍ,SAN LUIS POTOSI,12,179,3,194,1066
SAN LUIS POTOSÍ,SAN LUIS POTOSI,24,169,0,193,1066
SAN LUIS POTOSÍ,SAN LUIS POTOSI,27,258,2,287,1662
SAN LUIS POTOSÍ,SAN LUIS POTOSI,23,257,6,286,1661
SAN LUIS POTOSÍ,SAN LUIS POTOSI,30,211,3,244,1865
SAN LUIS POTOSÍ,SAN LUIS POTOSI,30,208,1,239,1864
SAN LUIS POTOSÍ,SAN LUIS POTOSI,20,220,4,244,1763
SAN LUIS POTOSÍ,SAN LUIS POTOSI,17,252,1,270,1762
SAN LUIS POTOSÍ,SAN LUIS POTOSI,14,188,0,202,1824
SAN LUIS POTOSÍ,SAN LUIS POTOSI,6,205,0,211,1824
SAN LUIS POTOSÍ,SAN LUIS POTOSI,11,215,4,230,1824
SAN LUIS POTOSÍ,SAN LUIS POTOSI,16,164,3,183,1823
SAN LUIS POTOSÍ,SAN LUIS POTOSI,17,404,0,421,1603
SAN LUIS POTOSÍ,SAN LUIS POTOSI,15,232,3,250,1603
SAN LUIS POTOSÍ,SAN LUIS POTOSI,16,283,1,300,1799
SAN LUIS POTOSÍ,SAN LUIS POTOSI,9,280,3,292,1799
SAN LUIS POTOSÍ,SAN LUIS POTOSI,21,149,0,170,1156
SAN LUIS POTOSÍ,SAN LUIS POTOSI,29,139,1,169,1155
SAN LUIS POTOSÍ,SAN LUIS POTOSI,45,164,1,210,1449
SAN LUIS POTOSÍ,SAN LUIS POTOSI,22,198,2,222,1449
SAN LUIS POTOSÍ,SAN LUIS POTOSI,20,162,0,182,1449
SAN LUIS POTOSÍ,SAN LUIS POTOSI,13,223,0,236,1955
SAN LUIS POTOSÍ,SAN LUIS POTOSI,12,207,4,223,1955
SAN LUIS POTOSÍ,SAN LUIS POTOSI,8,202,0,210,1955
SAN LUIS POTOSÍ,SAN LUIS POTOSI,7,190,0,197,1954
SAN LUIS POTOSÍ,SAN LUIS POTOSI,13,223,1,237,1954
SAN LUIS POTOSÍ,SAN LUIS POTOSI,9,159,1,169,1121
SAN LUIS POTOSÍ,SAN LUIS POTOSI,9,156,4,169,1120
SAN LUIS POTOSÍ,SAN LUIS POTOSI,16,208,3,227,1742
SAN LUIS POTOSÍ,SAN LUIS POTOSI,17,247,0,264,1741
SAN LUIS POTOSÍ,SAN LUIS POTOSI,0,213,3,216,1741
SAN LUIS POTOSÍ,SAN LUIS POTOSI,22,443,2,467,1518
SAN LUIS POTOSÍ,SAN LUIS POTOSI,19,200,1,220,1518
SAN LUIS POTOSÍ,SAN LUIS POTOSI,21,201,1,223,1562
SAN LUIS POTOSÍ,SAN LUIS POTOSI,14,172,1,187,1561
SAN LUIS POTOSÍ,SAN LUIS POTOSI,17,117,3,137,1219
SAN LUIS POTOSÍ,SAN LUIS POTOSI,11,129,3,143,1218
SAN LUIS POTOSÍ,SAN LUIS POTOSI,18,167,0,185,1380
SAN LUIS POTOSÍ,SAN LUIS POTOSI,11,155,1,167,1380
SAN LUIS POTOSÍ,SAN LUIS POTOSI,19,164,2,185,1379
SAN LUIS POTOSÍ,SAN LUIS POTOSI,27,142,1,170,1888
SAN LUIS POTOSÍ,SAN LUIS POTOSI,15,181,0,196,1888
SAN LUIS POTOSÍ,SAN LUIS POTOSI,20,171,1,192,1887
SAN LUIS POTOSÍ,SAN LUIS POTOSI,26,312,3,341,1942
SAN LUIS POTOSÍ,SAN LUIS POTOSI,33,284,2,319,1942
SAN LUIS POTOSÍ,SAN LUIS POTOSI,17,152,0,169,1692
SAN LUIS POTOSÍ,SAN LUIS POTOSI,8,154,2,164,1692
SAN LUIS POTOSÍ,SAN LUIS POTOSI,19,165,1,185,1691
SAN LUIS POTOSÍ,SAN LUIS POTOSI,15,142,0,157,1691
SAN LUIS POTOSÍ,SAN LUIS POTOSI,12,186,1,199,1745
SAN LUIS POTOSÍ,SAN LUIS POTOSI,10,184,4,198,1744
SAN LUIS POTOSÍ,SAN LUIS POTOSI,23,147,7,177,1560
SAN LUIS POTOSÍ,SAN LUIS POTOSI,29,167,0,196,1559
SAN LUIS POTOSÍ,SAN LUIS POTOSI,27,182,2,211,1559
SAN LUIS POTOSÍ,SAN LUIS POTOSI,26,163,1,190,1397
SAN LUIS POTOSÍ,SAN LUIS POTOSI,24,154,1,179,1397
SAN LUIS POTOSÍ,SAN LUIS POTOSI,29,200,4,233,1936
SAN LUIS POTOSÍ,SAN LUIS POTOSI,21,228,0,249,1936
SAN LUIS POTOSÍ,SAN LUIS POTOSI,12,170,3,185,1454
SAN LUIS POTOSÍ,SAN LUIS POTOSI,15,150,1,166,1453
SAN LUIS POTOSÍ,SAN LUIS POTOSI,29,165,2,196,1464
SAN LUIS POTOSÍ,SAN LUIS POTOSI,13,159,2,174,1464
SAN LUIS POTOSÍ,SAN LUIS POTOSI,24,161,2,187,1464
SAN LUIS POTOSÍ,SAN LUIS POTOSI,35,213,2,250,1688
SAN LUIS POTOSÍ,SAN LUIS POTOSI,16,174,3,193,1688
SAN LUIS POTOSÍ,SAN LUIS POTOSI,23,169,3,195,1688
SAN LUIS POTOSÍ,SAN LUIS POTOSI,20,239,7,266,1709
SAN LUIS POTOSÍ,SAN LUIS POTOSI,15,238,4,257,1709
SAN LUIS POTOSÍ,SAN LUIS POTOSI,24,176,5,205,1526
SAN LUIS POTOSÍ,SAN LUIS POTOSI,17,155,2,174,1525
SAN LUIS POTOSÍ,SAN LUIS POTOSI,18,207,1,226,1881
SAN LUIS POTOSÍ,SAN LUIS POTOSI,8,199,2,209,1880
SAN LUIS POTOSÍ,SAN LUIS POTOSI,23,161,0,184,1276
SAN LUIS POTOSÍ,SAN LUIS POTOSI,13,177,3,193,1275
SAN LUIS POTOSÍ,SAN LUIS POTOSI,20,152,4,176,1498
SAN LUIS POTOSÍ,SAN LUIS POTOSI,12,164,5,181,1498
SAN LUIS POTOSÍ,SAN LUIS POTOSI,15,201,7,223,1912
SAN LUIS POTOSÍ,SAN LUIS POTOSI,13,235,4,252,1911
SAN LUIS POTOSÍ,SAN LUIS POTOSI,19,226,2,247,1939
SAN LUIS POTOSÍ,SAN LUIS POTOSI,29,229,2,260,1938
SAN LUIS POTOSÍ,SAN LUIS POTOSI,25,206,0,231,1465
SAN LUIS POTOSÍ,SAN LUIS POTOSI,14,187,3,204,1464
SAN LUIS POTOSÍ,SAN LUIS POTOSI,8,198,0,206,1630
SAN LUIS POTOSÍ,SAN LUIS POTOSI,11,171,1,183,1629
SAN LUIS POTOSÍ,SAN LUIS POTOSI,1,195,3,199,1486
SAN LUIS POTOSÍ,SAN LUIS POTOSI,14,218,3,235,1486
SAN LUIS POTOSÍ,SAN LUIS POTOSI,14,177,2,193,1746
SAN LUIS POTOSÍ,SAN LUIS POTOSI,0,200,2,202,1745
SAN LUIS POTOSÍ,SAN LUIS POTOSI,9,151,1,161,1240
SAN LUIS POTOSÍ,SAN LUIS POTOSI,11,147,1,159,1240
SAN LUIS POTOSÍ,SAN LUIS POTOSI,9,143,0,152,1099
SAN LUIS POTOSÍ,SAN LUIS POTOSI,9,137,1,147,1098
SAN LUIS POTOSÍ,SAN LUIS POTOSI,15,183,4,202,1666
SAN LUIS POTOSÍ,SAN LUIS POTOSI,13,232,0,245,1666
SAN LUIS POTOSÍ,SAN LUIS POTOSI,14,227,3,244,1912
SAN LUIS POTOSÍ,SAN LUIS POTOSI,13,228,4,245,1911
SAN LUIS POTOSÍ,SAN LUIS POTOSI,9,162,0,171,1609
SAN LUIS POTOSÍ,SAN LUIS POTOSI,13,176,2,191,1608
SAN LUIS POTOSÍ,SAN LUIS POTOSI,7,167,4,178,1686
SAN LUIS POTOSÍ,SAN LUIS POTOSI,19,194,3,216,1686
SAN LUIS POTOSÍ,SAN LUIS POTOSI,12,170,1,183,1685
SAN LUIS POTOSÍ,SAN LUIS POTOSI,8,162,0,170,1685
SAN LUIS POTOSÍ,SAN LUIS POTOSI,15,176,6,197,1370
SAN LUIS POTOSÍ,SAN LUIS POTOSI,8,176,1,185,1369
SAN LUIS POTOSÍ,SAN LUIS POTOSI,15,216,5,236,1790
SAN LUIS POTOSÍ,SAN LUIS POTOSI,14,217,5,236,1789
SAN LUIS POTOSÍ,SAN LUIS POTOSI,4,142,4,150,1046
SAN LUIS POTOSÍ,SAN LUIS POTOSI,6,130,2,138,1045
SAN LUIS POTOSÍ,SAN LUIS POTOSI,6,183,2,191,1872
SAN LUIS POTOSÍ,SAN LUIS POTOSI,11,146,6,163,1872
SAN LUIS POTOSÍ,SAN LUIS POTOSI,8,166,1,175,1872
SAN LUIS POTOSÍ,SAN LUIS POTOSI,11,152,3,166,1872
SAN LUIS POTOSÍ,SAN LUIS POTOSI,9,158,3,170,1872
SAN LUIS POTOSÍ,SAN LUIS POTOSI,12,178,0,190,1872
SAN LUIS POTOSÍ,SAN LUIS POTOSI,12,135,0,147,1809
SAN LUIS POTOSÍ,SAN LUIS POTOSI,7,143,0,150,1809
SAN LUIS POTOSÍ,SAN LUIS POTOSI,15,151,1,167,1809
SAN LUIS POTOSÍ,SAN LUIS POTOSI,11,127,5,143,1809
SAN LUIS POTOSÍ,SAN LUIS POTOSI,6,161,2,169,1809
SAN LUIS POTOSÍ,SAN LUIS POTOSI,11,124,2,137,1809
SAN LUIS POTOSÍ,SAN LUIS POTOSI,15,142,3,160,1809
SAN LUIS POTOSÍ,SAN LUIS POTOSI,11,122,2,135,1808
SAN LUIS POTOSÍ,SAN LUIS POTOSI,9,158,0,167,1617
SAN LUIS POTOSÍ,SAN LUIS POTOSI,11,146,1,158,1617
SAN LUIS POTOSÍ,SAN LUIS POTOSI,14,184,0,198,1617
SAN LUIS POTOSÍ,SAN LUIS POTOSI,0,164,2,166,1617
SAN LUIS POTOSÍ,SAN LUIS POTOSI,15,147,2,164,1339
SAN LUIS POTOSÍ,SAN LUIS POTOSI,14,128,3,145,1338
SAN LUIS POTOSÍ,SAN LUIS POTOSI,4,140,0,144,1338
SAN LUIS POTOSÍ,SAN LUIS POTOSI,7,159,0,166,1964
SAN LUIS POTOSÍ,SAN LUIS POTOSI,9,130,1,140,1964
SAN LUIS POTOSÍ,SAN LUIS POTOSI,5,176,3,184,1964
SAN LUIS POTOSÍ,SAN LUIS POTOSI,9,147,0,156,1963
SAN LUIS POTOSÍ,SAN LUIS POTOSI,9,156,0,165,1963
SAN LUIS POTOSÍ,SAN LUIS POTOSI,9,160,0,169,1963
SAN LUIS POTOSÍ,SAN LUIS POTOSI,8,139,0,147,1963
SAN LUIS POTOSÍ,SAN LUIS POTOSI,10,150,0,160,1963
SAN LUIS POTOSÍ,SAN LUIS POTOSI,14,156,0,170,1363
SAN LUIS POTOSÍ,SAN LUIS POTOSI,7,132,2,141,1362
SAN LUIS POTOSÍ,SAN LUIS POTOSI,7,115,0,122,1074
SAN LUIS POTOSÍ,SAN LUIS POTOSI,7,135,0,142,1073
SAN LUIS POTOSÍ,SAN LUIS POTOSI,10,140,5,155,1502
SAN LUIS POTOSÍ,SAN LUIS POTOSI,20,179,2,201,1502
SAN LUIS POTOSÍ,SAN LUIS POTOSI,20,168,3,191,1502
SAN LUIS POTOSÍ,SAN LUIS POTOSI,19,139,6,164,1744
SAN LUIS POTOSÍ,SAN LUIS POTOSI,19,151,0,170,1744
SAN LUIS POTOSÍ,SAN LUIS POTOSI,9,120,1,130,1401
SAN LUIS POTOSÍ,SAN LUIS POTOSI,6,86,1,93,1400
SAN LUIS POTOSÍ,SAN LUIS POTOSI,6,107,3,116,1400
SAN LUIS POTOSÍ,SAN LUIS POTOSI,3,140,4,147,1384
SAN LUIS POTOSÍ,SAN LUIS POTOSI,12,136,6,154,1383
SAN LUIS POTOSÍ,SAN LUIS POTOSI,27,188,1,216,1799
SAN LUIS POTOSÍ,SAN LUIS POTOSI,24,158,2,184,1798
SAN LUIS POTOSÍ,SAN LUIS POTOSI,23,170,3,196,1562
SAN LUIS POTOSÍ,SAN LUIS POTOSI,10,132,0,142,1561
SAN LUIS POTOSÍ,SAN LUIS POTOSI,16,162,9,187,1571
SAN LUIS POTOSÍ,SAN LUIS POTOSI,6,188,3,197,1571
SAN LUIS POTOSÍ,SAN LUIS POTOSI,16,153,2,171,1239
SAN LUIS POTOSÍ,SAN LUIS POTOSI,20,144,1,165,1238
SAN LUIS POTOSÍ,SAN LUIS POTOSI,17,147,2,166,1363
SAN LUIS POTOSÍ,SAN LUIS POTOSI,13,153,0,166,1363
SAN LUIS POTOSÍ,SAN LUIS POTOSI,13,150,0,163,1362
SAN LUIS POTOSÍ,TAMAZUNCHALE,30,238,25,293,1420
SAN LUIS POTOSÍ,TAMAZUNCHALE,25,204,21,250,1420
SAN LUIS POTOSÍ,TAMAZUNCHALE,31,242,18,291,1420
SAN LUIS POTOSÍ,TAMAZUNCHALE,17,297,13,327,1501
SAN LUIS POTOSÍ,TAMAZUNCHALE,11,345,11,367,1501
SAN LUIS POTOSÍ,TAMAZUNCHALE,15,318,5,338,1500
SAN LUIS POTOSÍ,TAMAZUNCHALE,84,302,36,422,1390
SAN LUIS POTOSÍ,TAMAZUNCHALE,78,276,34,388,1389
SAN LUIS POTOSÍ,TAMAZUNCHALE,42,242,32,316,1862
SAN LUIS POTOSÍ,TAMAZUNCHALE,38,230,34,302,1862
SAN LUIS POTOSÍ,TAMAZUNCHALE,59,212,48,319,1915
SAN LUIS POTOSÍ,TAMAZUNCHALE,48,212,47,307,1914
SAN LUIS POTOSÍ,TAMAZUNCHALE,23,291,29,343,1667
SAN LUIS POTOSÍ,TAMAZUNCHALE,45,262,27,334,1667
SAN LUIS POTOSÍ,TAMAZUNCHALE,57,293,19,369,1667
SAN LUIS POTOSÍ,TAMAZUNCHALE,58,344,43,445,1799
SAN LUIS POTOSÍ,TAMAZUNCHALE,59,353,37,449,1799
SAN LUIS POTOSÍ,TAMAZUNCHALE,71,175,33,279,1088
SAN LUIS POTOSÍ,TAMAZUNCHALE,98,178,34,310,1087
SAN LUIS POTOSÍ,TAMAZUNCHALE,41,320,26,387,1525
SAN LUIS POTOSÍ,TAMAZUNCHALE,53,293,52,398,1524
SAN LUIS POTOSÍ,TAMAZUNCHALE,48,292,62,402,1524
SAN LUIS POTOSÍ,TAMAZUNCHALE,17,321,7,345,1406
SAN LUIS POTOSÍ,TAMAZUNCHALE,19,323,5,347,1405
SAN LUIS POTOSÍ,TAMAZUNCHALE,13,416,12,441,1419
SAN LUIS POTOSÍ,TAMAZUNCHALE,13,479,5,497,1419
SAN LUIS POTOSÍ,TAMAZUNCHALE,27,471,13,511,1156
SAN LUIS POTOSÍ,TAMAZUNCHALE,11,504,13,528,1156
SAN LUIS POTOSÍ,TAMAZUNCHALE,54,394,18,466,2031
SAN LUIS POTOSÍ,TAMAZUNCHALE,41,383,27,451,2030
SAN LUIS POTOSÍ,TAMAZUNCHALE,37,235,11,283,1433
SAN LUIS POTOSÍ,TAMAZUNCHALE,39,245,14,298,1432
SAN LUIS POTOSÍ,TAMAZUNCHALE,21,397,33,451,1474
SAN LUIS POTOSÍ,TAMAZUNCHALE,18,342,30,390,1474
SAN LUIS POTOSÍ,TAMAZUNCHALE,17,420,21,458,1473
SAN LUIS POTOSÍ,TAMAZUNCHALE,31,323,8,362,1598
SAN LUIS POTOSÍ,TAMAZUNCHALE,25,262,13,300,1598
SAN LUIS POTOSÍ,TAMAZUNCHALE,38,359,20,417,1598
SAN LUIS POTOSÍ,TAMAZUNCHALE,27,329,14,370,1424
SAN LUIS POTOSÍ,TAMAZUNCHALE,35,345,37,417,1424
SAN LUIS POTOSÍ,TAMAZUNCHALE,29,398,30,457,1380
SAN LUIS POTOSÍ,TAMAZUNCHALE,31,410,17,458,1380
SAN LUIS POTOSÍ,TAMAZUNCHALE,63,419,42,524,1770
SAN LUIS POTOSÍ,TAMAZUNCHALE,59,362,52,473,1770
SAN LUIS POTOSÍ,TAMAZUNCHALE,48,363,20,431,1769
SAN LUIS POTOSÍ,TAMAZUNCHALE,17,435,6,458,1542
SAN LUIS POTOSÍ,TAMAZUNCHALE,5,488,8,501,1542
SAN LUIS POTOSÍ,TAMAZUNCHALE,30,510,25,565,1524
SAN LUIS POTOSÍ,TAMAZUNCHALE,38,538,20,596,1524
SAN LUIS POTOSÍ,TAMAZUNCHALE,43,490,23,556,1524
SAN LUIS POTOSÍ,TAMAZUNCHALE,34,516,25,575,1276
SAN LUIS POTOSÍ,TAMAZUNCHALE,37,600,16,653,1276
SAN LUIS POTOSÍ,TAMAZUNCHALE,16,496,29,541,1771
SAN LUIS POTOSÍ,TAMAZUNCHALE,11,498,23,532,1771
SAN LUIS POTOSÍ,TAMAZUNCHALE,20,565,26,611,1985
SAN LUIS POTOSÍ,TAMAZUNCHALE,16,557,41,614,1985
SAN LUIS POTOSÍ,TAMAZUNCHALE,25,617,33,675,2098
SAN LUIS POTOSÍ,TAMAZUNCHALE,15,645,20,680,2098
SAN LUIS POTOSÍ,TAMAZUNCHALE,25,646,31,702,1921
SAN LUIS POTOSÍ,TAMAZUNCHALE,27,662,33,722,1921
SAN LUIS POTOSÍ,TAMAZUNCHALE,9,320,8,337,1590
SAN LUIS POTOSÍ,TAMAZUNCHALE,15,308,5,328,1590
SAN LUIS POTOSÍ,TAMAZUNCHALE,9,405,8,422,1688
SAN LUIS POTOSÍ,TAMAZUNCHALE,12,384,6,402,1688
SAN LUIS POTOSÍ,TAMAZUNCHALE,33,468,5,506,0
SAN LUIS POTOSÍ,TAMAZUNCHALE,17,511,10,538,2107
SAN LUIS POTOSÍ,TAMAZUNCHALE,12,352,6,370,1584
SAN LUIS POTOSÍ,TAMAZUNCHALE,5,361,5,371,1583
SAN LUIS POTOSÍ,TAMAZUNCHALE,13,360,11,384,1579
SAN LUIS POTOSÍ,TAMAZUNCHALE,7,317,8,332,1579
SAN LUIS POTOSÍ,TAMAZUNCHALE,16,386,4,406,1579
SAN LUIS POTOSÍ,TAMAZUNCHALE,13,358,6,377,1591
SAN LUIS POTOSÍ,TAMAZUNCHALE,11,357,5,373,1590
SAN LUIS POTOSÍ,TAMAZUNCHALE,21,338,23,382,1734
SAN LUIS POTOSÍ,TAMAZUNCHALE,15,299,22,336,1734
SAN LUIS POTOSÍ,TAMAZUNCHALE,18,255,26,299,1734
SAN LUIS POTOSÍ,TAMAZUNCHALE,28,419,19,466,1981
SAN LUIS POTOSÍ,TAMAZUNCHALE,16,400,19,435,1980
SAN LUIS POTOSÍ,TAMAZUNCHALE,30,393,14,437,1828
SAN LUIS POTOSÍ,TAMAZUNCHALE,21,386,20,427,1828
SAN LUIS POTOSÍ,TAMAZUNCHALE,13,407,30,450,1668
SAN LUIS POTOSÍ,TAMAZUNCHALE,4,423,15,442,1667
SAN LUIS POTOSÍ,TAMAZUNCHALE,31,204,27,262,1712
SAN LUIS POTOSÍ,TAMAZUNCHALE,24,193,12,229,1711
SAN LUIS POTOSÍ,TAMAZUNCHALE,23,462,29,514,1683
SAN LUIS POTOSÍ,TAMAZUNCHALE,14,458,19,491,1682
SAN LUIS POTOSÍ,TAMAZUNCHALE,12,158,11,181,1593
SAN LUIS POTOSÍ,TAMAZUNCHALE,17,167,8,192,1592
SAN LUIS POTOSÍ,TAMAZUNCHALE,71,241,35,347,1629
SAN LUIS POTOSÍ,TAMAZUNCHALE,55,247,26,328,1629
SAN LUIS POTOSÍ,TAMAZUNCHALE,9,151,10,170,1786
SAN LUIS POTOSÍ,TAMAZUNCHALE,10,181,21,212,1785
SAN LUIS POTOSÍ,TAMAZUNCHALE,15,242,21,278,1769
SAN LUIS POTOSÍ,TAMAZUNCHALE,14,265,19,298,1769
SAN LUIS POTOSÍ,TAMAZUNCHALE,7,294,16,317,1769
SAN LUIS POTOSÍ,TAMAZUNCHALE,14,252,7,273,1673
SAN LUIS POTOSÍ,TAMAZUNCHALE,24,211,16,251,1673
SAN LUIS POTOSÍ,TAMAZUNCHALE,4,187,16,207,1673
SAN LUIS POTOSÍ,TAMAZUNCHALE,11,247,15,273,1486
SAN LUIS POTOSÍ,TAMAZUNCHALE,14,251,14,279,1486
SAN LUIS POTOSÍ,TAMAZUNCHALE,14,228,6,248,1486
SAN LUIS POTOSÍ,TAMAZUNCHALE,23,136,20,179,1290
SAN LUIS POTOSÍ,TAMAZUNCHALE,13,174,10,197,1290
SAN LUIS POTOSÍ,TAMAZUNCHALE,28,290,20,338,1746
SAN LUIS POTOSÍ,TAMAZUNCHALE,29,299,26,354,1746
SAN LUIS POTOSÍ,TAMAZUNCHALE,25,168,2,195,1130
SAN LUIS POTOSÍ,TAMAZUNCHALE,16,137,9,162,1130
SAN LUIS POTOSÍ,TAMAZUNCHALE,24,413,28,465,1757
SAN LUIS POTOSÍ,TAMAZUNCHALE,21,435,10,466,1757
SAN LUIS POTOSÍ,TAMAZUNCHALE,12,443,41,496,1757
SAN LUIS POTOSÍ,TAMAZUNCHALE,21,186,24,231,1436
SAN LUIS POTOSÍ,TAMAZUNCHALE,11,163,21,195,1436
SAN LUIS POTOSÍ,TAMAZUNCHALE,31,171,14,216,1432
SAN LUIS POTOSÍ,TAMAZUNCHALE,35,141,8,184,1432
SAN LUIS POTOSÍ,TAMAZUNCHALE,27,189,20,236,1108
SAN LUIS POTOSÍ,TAMAZUNCHALE,31,172,33,236,1108
SAN LUIS POTOSÍ,TAMAZUNCHALE,13,330,7,350,1698
SAN LUIS POTOSÍ,TAMAZUNCHALE,15,357,4,376,1697
SAN LUIS POTOSÍ,TAMAZUNCHALE,22,670,11,703,1702
SAN LUIS POTOSÍ,TAMAZUNCHALE,25,669,16,710,1701
SAN LUIS POTOSÍ,TAMAZUNCHALE,16,513,11,540,1418
SAN LUIS POTOSÍ,TAMAZUNCHALE,14,460,9,483,1417
SAN LUIS POTOSÍ,TAMAZUNCHALE,16,480,17,513,1417
SAN LUIS POTOSÍ,TAMAZUNCHALE,11,491,16,518,1449
SAN LUIS POTOSÍ,TAMAZUNCHALE,19,489,19,527,1449
SAN LUIS POTOSÍ,TAMAZUNCHALE,14,552,14,580,1449
SAN LUIS POTOSÍ,TAMAZUNCHALE,16,585,12,613,1727
SAN LUIS POTOSÍ,TAMAZUNCHALE,29,565,25,619,1726
SAN LUIS POTOSÍ,TAMAZUNCHALE,10,590,20,620,1726
SAN LUIS POTOSÍ,TAMAZUNCHALE,24,523,19,566,1712
SAN LUIS POTOSÍ,TAMAZUNCHALE,26,507,28,561,1712
SAN LUIS POTOSÍ,TAMAZUNCHALE,33,534,14,581,1712
SAN LUIS POTOSÍ,TAMAZUNCHALE,21,483,15,519,1796
SAN LUIS POTOSÍ,TAMAZUNCHALE,24,451,16,491,1795
SAN LUIS POTOSÍ,TAMAZUNCHALE,20,499,16,535,1795
SAN LUIS POTOSÍ,TAMAZUNCHALE,29,340,12,381,1441
SAN LUIS POTOSÍ,TAMAZUNCHALE,25,392,13,430,1441
SAN LUIS POTOSÍ,TAMAZUNCHALE,17,356,7,380,1441
SAN LUIS POTOSÍ,TAMAZUNCHALE,24,464,25,513,2012
SAN LUIS POTOSÍ,TAMAZUNCHALE,17,505,15,537,2012
SAN LUIS POTOSÍ,TAMAZUNCHALE,27,472,22,521,1976
SAN LUIS POTOSÍ,TAMAZUNCHALE,14,485,17,516,1976
SAN LUIS POTOSÍ,TAMAZUNCHALE,10,455,10,475,1975
SAN LUIS POTOSÍ,TAMAZUNCHALE,9,470,9,488,1901
SAN LUIS POTOSÍ,TAMAZUNCHALE,12,454,8,474,1901
SAN LUIS POTOSÍ,TAMAZUNCHALE,15,451,16,482,1836
SAN LUIS POTOSÍ,TAMAZUNCHALE,12,436,7,455,1836
SAN LUIS POTOSÍ,TAMAZUNCHALE,18,473,14,505,1647
SAN LUIS POTOSÍ,TAMAZUNCHALE,11,412,21,444,1647
SAN LUIS POTOSÍ,TAMAZUNCHALE,9,543,7,559,1640
SAN LUIS POTOSÍ,TAMAZUNCHALE,4,568,9,581,1640
SAN LUIS POTOSÍ,TAMAZUNCHALE,26,288,8,322,1345
SAN LUIS POTOSÍ,TAMAZUNCHALE,19,279,17,315,1345
SAN LUIS POTOSÍ,TAMAZUNCHALE,22,303,32,357,1241
SAN LUIS POTOSÍ,TAMAZUNCHALE,14,352,15,381,1241
SAN LUIS POTOSÍ,TAMAZUNCHALE,25,374,15,414,1618
SAN LUIS POTOSÍ,TAMAZUNCHALE,25,378,6,409,1617
SAN LUIS POTOSÍ,TAMAZUNCHALE,14,340,12,366,1938
SAN LUIS POTOSÍ,TAMAZUNCHALE,21,342,12,375,1938
SAN LUIS POTOSÍ,TAMAZUNCHALE,57,369,37,463,1439
SAN LUIS POTOSÍ,TAMAZUNCHALE,43,333,32,408,1438
SAN LUIS POTOSÍ,TAMAZUNCHALE,34,327,23,384,1172
SAN LUIS POTOSÍ,TAMAZUNCHALE,22,307,29,358,1172
SAN LUIS POTOSÍ,TAMAZUNCHALE,26,280,14,320,1224
SAN LUIS POTOSÍ,TAMAZUNCHALE,31,251,13,295,1224
SAN LUIS POTOSÍ,TAMAZUNCHALE,23,340,22,385,1955
SAN LUIS POTOSÍ,TAMAZUNCHALE,0,370,22,392,1954
SAN LUIS POTOSÍ,TAMAZUNCHALE,34,296,27,357,1248
SAN LUIS POTOSÍ,TAMAZUNCHALE,45,267,28,340,1247
SAN LUIS POTOSÍ,TAMAZUNCHALE,70,273,23,366,1544
SAN LUIS POTOSÍ,TAMAZUNCHALE,51,274,34,359,1543
SAN LUIS POTOSÍ,TAMAZUNCHALE,26,253,25,304,1876
SAN LUIS POTOSÍ,TAMAZUNCHALE,28,256,20,304,1876
SAN LUIS POTOSÍ,TAMAZUNCHALE,35,280,23,338,1875
SAN LUIS POTOSÍ,TAMAZUNCHALE,28,298,46,372,1717
SAN LUIS POTOSÍ,TAMAZUNCHALE,30,325,39,394,1717
SAN LUIS POTOSÍ,TAMAZUNCHALE,26,289,33,348,1717
SINALOA,MAZATLAN,9,394,9,412,1829
SINALOA,MAZATLAN,7,409,7,423,1828
SINALOA,MAZATLAN,5,387,10,402,1828
SINALOA,MAZATLAN,5,431,6,442,1828
SINALOA,MAZATLAN,6,433,7,446,1857
SINALOA,MAZATLAN,9,445,8,462,1857
SINALOA,MAZATLAN,4,450,13,467,1856
SINALOA,MAZATLAN,16,421,6,443,1856
SINALOA,MAZATLAN,6,271,10,287,1148
SINALOA,MAZATLAN,8,272,13,293,1148
SINALOA,MAZATLAN,20,289,8,317,1292
SINALOA,MAZATLAN,1,287,12,300,1292
SINALOA,MAZATLAN,5,302,3,310,1429
SINALOA,MAZATLAN,2,200,5,207,1156
SINALOA,MAZATLAN,3,192,2,197,1156
SINALOA,MAZATLAN,7,308,6,321,1673
SINALOA,MAZATLAN,7,272,8,287,1673
SINALOA,MAZATLAN,14,320,5,339,1673
SINALOA,MAZATLAN,13,366,0,379,1490
SINALOA,MAZATLAN,7,395,2,404,1490
SINALOA,MAZATLAN,9,401,2,412,1489
SINALOA,MAZATLAN,4,439,8,451,1873
SINALOA,MAZATLAN,8,407,2,417,1872
SINALOA,MAZATLAN,10,494,8,512,2005
SINALOA,MAZATLAN,22,489,4,515,2005
SINALOA,MAZATLAN,6,337,1,344,1395
SINALOA,MAZATLAN,7,330,0,337,1394
SINALOA,MAZATLAN,12,315,7,334,1394
SINALOA,MAZATLAN,8,313,5,326,1957
SINALOA,MAZATLAN,4,316,2,322,1956
SINALOA,MAZATLAN,9,274,2,285,1956
SINALOA,MAZATLAN,10,321,10,341,1602
SINALOA,MAZATLAN,1,327,5,333,1601
SINALOA,MAZATLAN,6,289,7,302,1601
SINALOA,MAZATLAN,6,327,6,339,1601
SINALOA,MAZATLAN,8,333,7,348,1417
SINALOA,MAZATLAN,2,356,2,360,1416
SINALOA,MAZATLAN,6,354,8,368,1416
SINALOA,MAZATLAN,5,243,1,249,1613
SINALOA,MAZATLAN,5,212,0,217,1612
SINALOA,MAZATLAN,7,240,1,248,1612
SINALOA,MAZATLAN,5,245,2,252,1612
SINALOA,MAZATLAN,9,310,1,320,2081
SINALOA,MAZATLAN,9,338,4,351,2081
SINALOA,MAZATLAN,6,302,1,309,2081
SINALOA,MAZATLAN,5,297,5,307,2081
SINALOA,MAZATLAN,16,429,5,450,1792
SINALOA,MAZATLAN,12,446,6,464,1791
SINALOA,MAZATLAN,3,188,3,194,1685
SINALOA,MAZATLAN,5,223,2,230,1685
SINALOA,MAZATLAN,4,231,3,238,1685
SINALOA,MAZATLAN,6,236,2,244,1685
SINALOA,MAZATLAN,5,356,8,369,1456
SINALOA,MAZATLAN,8,352,7,367,1456
SINALOA,MAZATLAN,3,368,6,377,1456
SINALOA,MAZATLAN,13,392,2,407,1841
SINALOA,MAZATLAN,11,419,5,435,1840
SINALOA,MAZATLAN,10,394,10,414,1840
SINALOA,MAZATLAN,10,338,7,355,1840
SINALOA,MAZATLAN,10,351,6,367,1666
SINALOA,MAZATLAN,14,381,7,402,1665
SINALOA,MAZATLAN,14,390,1,405,1665
SINALOA,MAZATLAN,25,407,5,437,1665
SINALOA,MAZATLAN,14,294,4,312,1201
SINALOA,MAZATLAN,15,279,5,299,1200
SINALOA,MAZATLAN,29,378,11,418,1280
SINALOA,MAZATLAN,7,364,12,383,1280
SINALOA,MAZATLAN,25,446,9,480,1961
SINALOA,MAZATLAN,5,361,2,368,1912
SINALOA,MAZATLAN,12,395,4,411,1912
SINALOA,MAZATLAN,67,1757,15,1839,0
SINALOA,MAZATLAN,11,386,1,398,1753
SINALOA,MAZATLAN,9,417,4,430,1752
SINALOA,MAZATLAN,6,296,1,303,1431
SINALOA,MAZATLAN,9,303,6,318,1431
SINALOA,MAZATLAN,9,310,2,321,1431
SINALOA,MAZATLAN,8,256,1,265,1182
SINALOA,MAZATLAN,7,239,4,250,1182
SINALOA,MAZATLAN,8,285,1,294,1471
SINALOA,MAZATLAN,11,340,3,354,1471
SINALOA,MAZATLAN,4,295,5,304,1591
SINALOA,MAZATLAN,10,298,5,313,1591
SINALOA,MAZATLAN,5,231,4,240,1164
SINALOA,MAZATLAN,5,266,4,275,1164
SINALOA,MAZATLAN,20,395,0,415,1884
SINALOA,MAZATLAN,12,400,2,414,1884
SINALOA,MAZATLAN,15,329,5,349,1562
SINALOA,MAZATLAN,11,356,5,372,1562
SINALOA,MAZATLAN,12,383,1,396,1561
SINALOA,MAZATLAN,6,354,3,363,1657
SINALOA,MAZATLAN,8,355,5,368,1656
SINALOA,MAZATLAN,6,379,11,396,1656
SINALOA,MAZATLAN,3,414,0,417,2077
SINALOA,MAZATLAN,12,418,9,439,2077
SINALOA,MAZATLAN,8,425,2,435,2076
SINALOA,MAZATLAN,13,277,2,292,1548
SINALOA,MAZATLAN,9,337,3,349,1548
SINALOA,MAZATLAN,13,304,2,319,1548
SINALOA,MAZATLAN,3,277,4,284,1767
SINALOA,MAZATLAN,3,307,2,312,1767
SINALOA,MAZATLAN,7,263,1,271,1536
SINALOA,MAZATLAN,7,250,1,258,1535
SINALOA,MAZATLAN,3,254,4,261,1535
SINALOA,MAZATLAN,4,210,4,218,1215
SINALOA,MAZATLAN,10,186,4,200,1215
SINALOA,MAZATLAN,13,379,6,398,1481
SINALOA,MAZATLAN,8,400,7,415,1481
SINALOA,MAZATLAN,23,389,2,414,1818
SINALOA,MAZATLAN,9,407,4,420,1817
SINALOA,MAZATLAN,7,276,5,288,1438
SINALOA,MAZATLAN,11,289,2,302,1438
SINALOA,MAZATLAN,2,325,6,333,1438
SINALOA,MAZATLAN,9,323,4,336,1425
SINALOA,MAZATLAN,15,305,1,321,1425
SINALOA,MAZATLAN,11,283,2,296,1777
SINALOA,MAZATLAN,5,289,5,299,1777
SINALOA,MAZATLAN,3,152,1,156,1110
SINALOA,MAZATLAN,3,153,3,159,1109
SINALOA,MAZATLAN,12,334,7,353,1944
SINALOA,MAZATLAN,3,385,1,389,1943
SINALOA,MAZATLAN,8,351,10,369,1943
SINALOA,MAZATLAN,5,361,5,371,1943
SINALOA,MAZATLAN,8,367,2,377,1751
SINALOA,MAZATLAN,7,424,8,439,1751
SINALOA,MAZATLAN,0,295,4,299,1514
SINALOA,MAZATLAN,21,320,1,342,1513
SINALOA,MAZATLAN,8,322,0,330,1513
SINALOA,MAZATLAN,3,428,6,437,2070
SINALOA,MAZATLAN,13,480,4,497,2069
SINALOA,MAZATLAN,13,368,6,387,1828
SINALOA,MAZATLAN,10,369,2,381,1828
SINALOA,MAZATLAN,25,326,5,356,1828
SINALOA,MAZATLAN,7,479,2,488,1988
SINALOA,MAZATLAN,9,368,1,378,1824
SINALOA,MAZATLAN,6,383,3,392,1824
SINALOA,MAZATLAN,16,372,4,392,1824
SINALOA,MAZATLAN,13,380,3,396,1824
SINALOA,MAZATLAN,5,398,3,406,1933
SINALOA,MAZATLAN,5,447,5,457,1932
SINALOA,MAZATLAN,8,462,2,472,1932
SINALOA,MAZATLAN,11,424,2,437,1932
SINALOA,MAZATLAN,3,243,2,248,1634
SINALOA,MAZATLAN,7,238,2,247,1634
SINALOA,MAZATLAN,7,269,0,276,1633
SINALOA,MAZATLAN,4,228,4,236,1633
SINALOA,MAZATLAN,15,326,9,350,1471
SINALOA,MAZATLAN,9,276,4,289,1954
SINALOA,MAZATLAN,4,248,4,256,1743
SINALOA,MAZATLAN,4,221,1,226,1743
SINALOA,MAZATLAN,12,273,2,287,1743
SINALOA,MAZATLAN,4,248,0,252,1742
SINALOA,MAZATLAN,5,271,0,276,1742
SINALOA,MAZATLAN,4,259,2,265,1742
SINALOA,MAZATLAN,3,248,1,252,1742
SINALOA,MAZATLAN,2,345,1,348,1538
SINALOA,MAZATLAN,6,328,5,339,1537
SINALOA,MAZATLAN,6,388,14,408,1895
SINALOA,MAZATLAN,7,368,15,390,1895
SINALOA,MAZATLAN,13,376,11,400,1895
SINALOA,MAZATLAN,8,395,4,407,1894
SINALOA,MAZATLAN,8,388,8,404,1737
SINALOA,MAZATLAN,4,417,5,426,1737
SINALOA,MAZATLAN,6,418,5,429,1737
SINALOA,MAZATLAN,5,396,4,405,1736
SINALOA,MAZATLAN,6,410,5,421,1736
SINALOA,MAZATLAN,8,346,9,363,1740
SINALOA,MAZATLAN,15,340,5,360,1740
SINALOA,MAZATLAN,14,303,8,325,1740
SINALOA,MAZATLAN,21,342,14,377,1739
SINALOA,MAZATLAN,10,342,1,353,1562
SINALOA,MAZATLAN,5,325,8,338,1562
SINALOA,MAZATLAN,2,510,7,519,1879
SINALOA,MAZATLAN,4,334,10,348,1878
SINALOA,MAZATLAN,2,420,7,429,1878
SINALOA,MAZATLAN,2,465,7,474,1878
SINALOA,MAZATLAN,2,438,7,447,1878
SINALOA,MAZATLAN,2,481,7,490,1878
SINALOA,MAZATLAN,12,316,1,329,1670
SINALOA,MAZATLAN,8,319,2,329,1669
SINALOA,MAZATLAN,6,286,2,294,1492
SINALOA,MAZATLAN,0,285,0,285,1491
SINALOA,MAZATLAN,14,303,2,319,1491
SINALOA,MAZATLAN,3,229,4,236,1125
SINALOA,MAZATLAN,13,234,3,250,1125
SINALOA,MAZATLAN,12,211,1,224,1057
SINALOA,MAZATLAN,8,193,0,201,1057
SINALOA,LOS MOCHIS,12,357,4,373,1734
SINALOA,LOS MOCHIS,12,391,7,410,1733
SINALOA,LOS MOCHIS,11,184,3,198,1546
SINALOA,LOS MOCHIS,10,198,1,209,1545
SINALOA,LOS MOCHIS,12,210,0,222,1545
SINALOA,LOS MOCHIS,20,229,0,249,1559
SINALOA,LOS MOCHIS,15,234,0,249,1559
SINALOA,LOS MOCHIS,6,181,3,190,1529
SINALOA,LOS MOCHIS,9,196,2,207,1528
SINALOA,LOS MOCHIS,75,1610,7,1692,0
SINALOA,LOS MOCHIS,10,430,6,446,1905
SINALOA,LOS MOCHIS,10,395,2,407,1905
SINALOA,LOS MOCHIS,10,387,6,403,1904
SINALOA,LOS MOCHIS,15,373,6,394,1904
SINALOA,LOS MOCHIS,5,234,0,239,1647
SINALOA,LOS MOCHIS,13,274,5,292,1646
SINALOA,LOS MOCHIS,14,315,5,334,1592
SINALOA,LOS MOCHIS,1,301,2,304,1592
SINALOA,LOS MOCHIS,5,263,0,268,1306
SINALOA,LOS MOCHIS,8,288,1,297,1306
SINALOA,LOS MOCHIS,13,343,2,358,1531
SINALOA,LOS MOCHIS,10,306,2,318,1530
SINALOA,LOS MOCHIS,15,280,0,295,1584
SINALOA,LOS MOCHIS,14,316,2,332,1583
SINALOA,LOS MOCHIS,9,267,2,278,1488
SINALOA,LOS MOCHIS,10,173,8,191,1488
SINALOA,LOS MOCHIS,9,261,3,273,1487
SINALOA,LOS MOCHIS,12,267,1,280,1615
SINALOA,LOS MOCHIS,13,273,2,288,1614
SINALOA,LOS MOCHIS,13,390,5,408,1930
SINALOA,LOS MOCHIS,21,388,2,411,1929
SINALOA,LOS MOCHIS,10,354,3,367,1659
SINALOA,LOS MOCHIS,13,335,2,350,1659
SINALOA,LOS MOCHIS,13,369,6,388,1912
SINALOA,LOS MOCHIS,12,396,8,416,1912
SINALOA,LOS MOCHIS,28,241,0,269,1905
SINALOA,LOS MOCHIS,29,222,2,253,1905
SINALOA,LOS MOCHIS,15,271,7,293,1803
SINALOA,LOS MOCHIS,19,284,2,305,1803
SINALOA,LOS MOCHIS,17,249,1,267,1598
SINALOA,LOS MOCHIS,9,264,0,273,1598
SINALOA,LOS MOCHIS,10,254,4,268,1598
SINALOA,LOS MOCHIS,11,220,1,232,1111
SINALOA,LOS MOCHIS,14,206,0,220,1111
SINALOA,LOS MOCHIS,16,114,3,133,1320
SINALOA,LOS MOCHIS,16,123,3,142,1319
SINALOA,LOS MOCHIS,12,241,1,254,1804
SINALOA,LOS MOCHIS,22,235,2,259,1804
SINALOA,LOS MOCHIS,19,265,1,285,1803
SINALOA,LOS MOCHIS,15,253,2,270,1803
SINALOA,LOS MOCHIS,13,292,2,307,1780
SINALOA,LOS MOCHIS,17,288,6,311,1780
SINALOA,LOS MOCHIS,19,380,6,405,1870
SINALOA,LOS MOCHIS,10,382,3,395,1870
SINALOA,LOS MOCHIS,5,274,3,282,1778
SINALOA,LOS MOCHIS,7,268,3,278,1778
SINALOA,LOS MOCHIS,15,297,1,313,1778
SINALOA,LOS MOCHIS,5,267,2,274,1777
SINALOA,LOS MOCHIS,10,295,2,307,1741
SINALOA,LOS MOCHIS,11,304,5,320,1741
SINALOA,LOS MOCHIS,14,272,5,291,1740
SINALOA,LOS MOCHIS,19,354,1,374,1764
SINALOA,LOS MOCHIS,10,338,4,352,1764
SINALOA,LOS MOCHIS,14,329,6,349,1930
SINALOA,LOS MOCHIS,7,329,0,336,1930
SINALOA,LOS MOCHIS,4,212,21,237,1491
SINALOA,LOS MOCHIS,3,268,4,275,1491
SINALOA,LOS MOCHIS,9,308,6,323,1584
SINALOA,LOS MOCHIS,3,271,3,277,1584
SINALOA,LOS MOCHIS,3,271,4,278,1584
SINALOA,LOS MOCHIS,2,241,0,243,1439
SINALOA,LOS MOCHIS,2,283,4,289,1438
SINALOA,LOS MOCHIS,5,246,5,256,1438
SINALOA,LOS MOCHIS,5,300,7,312,1390
SINALOA,LOS MOCHIS,0,280,10,290,1389
SINALOA,LOS MOCHIS,8,305,3,316,1389
SINALOA,LOS MOCHIS,8,329,0,337,1742
SINALOA,LOS MOCHIS,8,348,5,361,1742
SINALOA,LOS MOCHIS,12,307,3,322,1742
SINALOA,LOS MOCHIS,10,352,3,365,1604
SINALOA,LOS MOCHIS,15,361,5,381,1604
SINALOA,LOS MOCHIS,4,210,4,218,1265
SINALOA,LOS MOCHIS,3,220,1,224,1265
SINALOA,LOS MOCHIS,1,373,0,374,1549
SINALOA,LOS MOCHIS,7,329,4,340,1549
SINALOA,LOS MOCHIS,7,362,0,369,1548
SINALOA,LOS MOCHIS,11,272,5,288,1592
SINALOA,LOS MOCHIS,12,329,7,348,1592
SINALOA,LOS MOCHIS,11,302,2,315,1592
SINALOA,LOS MOCHIS,8,239,0,247,1174
SINALOA,LOS MOCHIS,1,233,2,236,1173
SINALOA,LOS MOCHIS,12,350,4,366,1681
SINALOA,LOS MOCHIS,12,378,8,398,1680
SINALOA,LOS MOCHIS,1,290,7,298,1404
SINALOA,LOS MOCHIS,4,292,3,299,1404
SINALOA,LOS MOCHIS,10,328,1,339,1404
SINALOA,LOS MOCHIS,10,308,6,324,1747
SINALOA,LOS MOCHIS,10,330,7,347,1746
SINALOA,LOS MOCHIS,6,348,8,362,1808
SINALOA,LOS MOCHIS,11,376,2,389,1808
SINALOA,LOS MOCHIS,2,321,4,327,1807
SINALOA,LOS MOCHIS,13,347,6,366,1664
SINALOA,LOS MOCHIS,11,373,6,390,1663
SINALOA,LOS MOCHIS,7,356,7,370,1532
SINALOA,LOS MOCHIS,4,347,1,352,1532
SINALOA,LOS MOCHIS,4,350,1,355,1531
SINALOA,LOS MOCHIS,9,304,11,324,1406
SINALOA,LOS MOCHIS,8,324,4,336,1406
SINALOA,LOS MOCHIS,7,295,5,307,1405
SINALOA,LOS MOCHIS,15,356,4,375,2013
SINALOA,LOS MOCHIS,14,359,7,380,2012
SINALOA,LOS MOCHIS,11,289,2,302,1930
SINALOA,LOS MOCHIS,16,317,5,338,1930
SINALOA,LOS MOCHIS,1,205,0,206,1767
SINALOA,LOS MOCHIS,5,208,2,215,1767
SINALOA,LOS MOCHIS,9,220,3,232,1766
SINALOA,LOS MOCHIS,14,358,5,377,1530
SINALOA,LOS MOCHIS,15,378,3,396,1530
SINALOA,LOS MOCHIS,11,351,8,370,1550
SINALOA,LOS MOCHIS,10,393,4,407,1550
SINALOA,LOS MOCHIS,17,347,6,370,1609
SINALOA,LOS MOCHIS,4,321,1,326,1608
SINALOA,LOS MOCHIS,9,306,3,318,1608
SINALOA,LOS MOCHIS,7,333,4,344,1608
SINALOA,LOS MOCHIS,9,397,6,412,1735
SINALOA,LOS MOCHIS,8,427,1,436,1735
SINALOA,LOS MOCHIS,17,457,8,482,1838
SINALOA,LOS MOCHIS,16,403,4,423,1838
SINALOA,LOS MOCHIS,11,295,1,307,1339
SINALOA,LOS MOCHIS,14,322,5,341,1338
SINALOA,LOS MOCHIS,9,304,9,322,1338
SINALOA,LOS MOCHIS,14,337,5,356,1423
SINALOA,LOS MOCHIS,6,324,2,332,1423
SINALOA,LOS MOCHIS,12,447,5,464,1876
SINALOA,LOS MOCHIS,7,452,7,466,1875
SINALOA,LOS MOCHIS,13,492,4,509,1592
SINALOA,LOS MOCHIS,10,487,7,504,1591
SINALOA,LOS MOCHIS,9,393,2,404,1617
SINALOA,LOS MOCHIS,8,345,8,361,1616
SINALOA,LOS MOCHIS,4,393,4,401,1616
SINALOA,LOS MOCHIS,2,402,8,412,1616
SINALOA,LOS MOCHIS,0,458,3,461,1447
SINALOA,LOS MOCHIS,3,426,6,435,1446
SINALOA,LOS MOCHIS,4,364,8,376,1446
SINALOA,LOS MOCHIS,13,253,3,269,1810
SINALOA,LOS MOCHIS,15,332,5,352,1810
SINALOA,LOS MOCHIS,6,310,4,320,1659
SINALOA,LOS MOCHIS,6,353,3,362,1659
SINALOA,LOS MOCHIS,4,313,2,319,1658
SINALOA,LOS MOCHIS,5,242,1,248,1417
SINALOA,LOS MOCHIS,8,198,0,206,1417
SINALOA,LOS MOCHIS,14,236,3,253,1359
SINALOA,LOS MOCHIS,11,195,1,207,1358
SINALOA,LOS MOCHIS,9,225,2,236,1313
SINALOA,LOS MOCHIS,7,226,0,233,1313
SINALOA,LOS MOCHIS,10,308,2,320,1577
SINALOA,LOS MOCHIS,7,345,1,353,1577
SINALOA,LOS MOCHIS,10,218,1,229,1570
SINALOA,LOS MOCHIS,7,192,5,204,1569
SINALOA,LOS MOCHIS,5,224,0,229,1898
SINALOA,LOS MOCHIS,7,194,2,203,1897
SINALOA,LOS MOCHIS,7,201,1,209,1897
SINALOA,LOS MOCHIS,11,214,3,228,1897
SINALOA,LOS MOCHIS,23,208,1,232,1173
SINALOA,LOS MOCHIS,5,201,0,206,1173
SINALOA,LOS MOCHIS,6,292,0,298,1971
SINALOA,LOS MOCHIS,14,253,1,268,1971
SINALOA,LOS MOCHIS,8,278,1,287,1479
SINALOA,LOS MOCHIS,3,294,2,299,1478
SINALOA,LOS MOCHIS,8,309,0,317,1478
SINALOA,LOS MOCHIS,1,254,2,257,1593
SINALOA,LOS MOCHIS,6,265,1,272,1593
SINALOA,LOS MOCHIS,9,232,0,241,1425
SINALOA,LOS MOCHIS,9,265,1,275,1425
SINALOA,LOS MOCHIS,20,339,3,362,1927
SINALOA,LOS MOCHIS,7,336,1,344,1926
SINALOA,LOS MOCHIS,6,343,1,350,1782
SINALOA,LOS MOCHIS,9,302,3,314,1782
SINALOA,LOS MOCHIS,11,297,1,309,1842
SINALOA,LOS MOCHIS,8,295,1,304,1842
SINALOA,LOS MOCHIS,14,241,1,256,1320
SINALOA,LOS MOCHIS,5,221,5,231,1320
SINALOA,LOS MOCHIS,5,223,0,228,1946
SINALOA,LOS MOCHIS,6,212,3,221,1946
SINALOA,LOS MOCHIS,4,211,2,217,1474
SINALOA,LOS MOCHIS,5,210,0,215,1474
SINALOA,LOS MOCHIS,2,180,2,184,1222
SINALOA,LOS MOCHIS,2,173,0,175,1222
SINALOA,LOS MOCHIS,3,189,1,193,999
SINALOA,LOS MOCHIS,6,181,0,187,998
SINALOA,LOS MOCHIS,3,147,0,150,1163
SINALOA,LOS MOCHIS,4,163,1,168,1163
SINALOA,LOS MOCHIS,4,146,0,150,1448
SINALOA,LOS MOCHIS,1,159,0,160,1448
SINALOA,LOS MOCHIS,4,244,2,250,1582
SINALOA,LOS MOCHIS,8,257,2,267,1582
SINALOA,LOS MOCHIS,10,281,1,292,1703
SINALOA,LOS MOCHIS,11,320,2,333,1703
SINALOA,LOS MOCHIS,7,184,1,192,1233
SINALOA,LOS MOCHIS,6,186,3,195,1232
SINALOA,LOS MOCHIS,8,301,0,309,1975
SINALOA,LOS MOCHIS,8,289,2,299,1974
SINALOA,LOS MOCHIS,6,174,1,181,1326
SINALOA,LOS MOCHIS,12,186,2,200,1326
SINALOA,LOS MOCHIS,9,211,0,220,1412
SINALOA,LOS MOCHIS,12,209,1,222,1411
SINALOA,LOS MOCHIS,3,303,0,306,1525
SINALOA,LOS MOCHIS,15,281,5,301,1524
SINALOA,LOS MOCHIS,9,174,0,183,1244
SINALOA,LOS MOCHIS,15,180,2,197,1244
SINALOA,LOS MOCHIS,13,180,2,195,1493
SINALOA,LOS MOCHIS,15,186,4,205,1492
SINALOA,GUAMUCHIL,8,324,2,334,1622
SINALOA,GUAMUCHIL,7,306,1,314,1622
SINALOA,GUAMUCHIL,6,323,0,329,1622
SINALOA,GUAMUCHIL,12,291,6,309,1621
SINALOA,GUAMUCHIL,7,311,2,320,1621
SINALOA,GUAMUCHIL,10,292,4,306,1615
SINALOA,GUAMUCHIL,4,274,3,281,1614
SINALOA,GUAMUCHIL,7,255,4,266,1614
SINALOA,GUAMUCHIL,10,260,2,272,1614
SINALOA,GUAMUCHIL,11,377,2,390,1910
SINALOA,GUAMUCHIL,8,423,2,433,1909
SINALOA,GUAMUCHIL,9,369,1,379,1909
SINALOA,GUAMUCHIL,8,355,9,372,1909
SINALOA,GUAMUCHIL,4,300,1,305,1938
SINALOA,GUAMUCHIL,2,332,3,337,1938
SINALOA,GUAMUCHIL,8,317,3,328,1938
SINALOA,GUAMUCHIL,1,289,4,294,1937
SINALOA,GUAMUCHIL,6,329,5,340,1937
SINALOA,GUAMUCHIL,6,302,4,312,1597
SINALOA,GUAMUCHIL,4,304,1,309,1597
SINALOA,GUAMUCHIL,1,307,1,309,1597
SINALOA,GUAMUCHIL,7,290,0,297,1596
SINALOA,GUAMUCHIL,7,305,3,315,1596
SINALOA,GUAMUCHIL,8,278,7,293,1465
SINALOA,GUAMUCHIL,2,302,7,311,1465
SINALOA,GUAMUCHIL,4,282,3,289,1465
SINALOA,GUAMUCHIL,14,345,9,368,1656
SINALOA,GUAMUCHIL,13,374,21,408,1655
SINALOA,GUAMUCHIL,13,305,16,334,1655
SINALOA,GUAMUCHIL,1,169,1,171,1828
SINALOA,GUAMUCHIL,4,116,1,121,1828
SINALOA,GUAMUCHIL,3,130,0,133,1828
SINALOA,GUAMUCHIL,2,839,2,843,1806
SINALOA,GUAMUCHIL,1,95,1,97,1806
SINALOA,GUAMUCHIL,3,143,4,150,1806
SINALOA,GUAMUCHIL,3,313,6,322,1805
SINALOA,GUAMUCHIL,4,710,5,719,1805
SINALOA,GUAMUCHIL,2,77,1,80,1805
SINALOA,GUAMUCHIL,0,268,1,269,1605
SINALOA,GUAMUCHIL,8,273,8,289,1605
SINALOA,GUAMUCHIL,6,287,18,311,1605
SINALOA,GUAMUCHIL,1,294,0,295,1605
SINALOA,GUAMUCHIL,4,284,9,297,1604
SINALOA,GUAMUCHIL,7,278,14,299,1738
SINALOA,GUAMUCHIL,11,298,8,317,1738
SINALOA,GUAMUCHIL,15,295,2,312,1738
SINALOA,GUAMUCHIL,10,304,7,321,1738
SINALOA,GUAMUCHIL,8,299,6,313,1737
SINALOA,GUAMUCHIL,8,314,8,330,1737
SINALOA,GUAMUCHIL,7,136,3,146,1316
SINALOA,GUAMUCHIL,8,140,2,150,1316
SINALOA,GUAMUCHIL,6,152,3,161,1315
SINALOA,GUAMUCHIL,4,164,2,170,1639
SINALOA,GUAMUCHIL,6,229,0,235,1639
SINALOA,GUAMUCHIL,4,178,1,183,1638
SINALOA,GUAMUCHIL,6,217,5,228,1638
SINALOA,GUAMUCHIL,0,255,0,255,1638
SINALOA,GUAMUCHIL,2,167,5,174,1081
SINALOA,GUAMUCHIL,4,188,2,194,1081
SINALOA,GUAMUCHIL,11,351,4,366,1849
SINALOA,GUAMUCHIL,7,367,6,380,1848
SINALOA,GUAMUCHIL,16,341,5,362,1848
SINALOA,GUAMUCHIL,9,310,6,325,1581
SINALOA,GUAMUCHIL,12,299,4,315,1581
SINALOA,GUAMUCHIL,11,328,4,343,1581
SINALOA,GUAMUCHIL,15,297,6,318,1580
SINALOA,GUAMUCHIL,15,391,4,410,1900
SINALOA,GUAMUCHIL,8,373,6,387,1900
SINALOA,GUAMUCHIL,9,354,6,369,1900
SINALOA,GUAMUCHIL,7,304,2,313,1957
SINALOA,GUAMUCHIL,17,304,3,324,1957
SINALOA,GUAMUCHIL,20,263,2,285,1957
SINALOA,GUAMUCHIL,19,373,2,394,1791
SINALOA,GUAMUCHIL,12,466,3,481,1791
SINALOA,GUAMUCHIL,45,1252,13,1310,0
SINALOA,GUAMUCHIL,27,412,7,446,1887
SINALOA,GUAMUCHIL,23,434,2,459,1887
SINALOA,GUAMUCHIL,11,276,5,292,1484
SINALOA,GUAMUCHIL,7,274,4,285,1484
SINALOA,GUAMUCHIL,5,281,1,287,1483
SINALOA,GUAMUCHIL,4,306,0,310,1694
SINALOA,GUAMUCHIL,9,286,2,297,1694
SINALOA,GUAMUCHIL,8,262,0,270,1694
SINALOA,GUAMUCHIL,9,246,0,255,1693
SINALOA,GUAMUCHIL,8,353,2,363,1366
SINALOA,GUAMUCHIL,8,303,6,317,1366
SINALOA,GUAMUCHIL,10,275,8,293,1390
SINALOA,GUAMUCHIL,4,280,1,285,1390
SINALOA,GUAMUCHIL,7,248,12,267,1389
SINALOA,GUAMUCHIL,13,365,6,384,1816
SINALOA,GUAMUCHIL,16,439,3,458,1815
SINALOA,GUAMUCHIL,14,339,4,357,1815
SINALOA,GUAMUCHIL,15,520,6,541,1962
SINALOA,GUAMUCHIL,13,509,10,532,1962
SINALOA,GUAMUCHIL,8,495,4,507,1961
SINALOA,GUAMUCHIL,0,341,7,348,1968
SINALOA,GUAMUCHIL,10,358,4,372,1968
SINALOA,GUAMUCHIL,10,292,11,313,1968
SINALOA,GUAMUCHIL,2,300,4,306,1967
SINALOA,GUAMUCHIL,5,292,4,301,1967
SINALOA,GUAMUCHIL,5,194,2,201,1596
SINALOA,GUAMUCHIL,2,193,4,199,1596
SINALOA,GUAMUCHIL,4,208,2,214,1596
SINALOA,GUAMUCHIL,8,215,4,227,1596
SINALOA,GUAMUCHIL,4,243,8,255,1596
SINALOA,GUAMUCHIL,76,1158,11,1245,1708
SINALOA,GUAMUCHIL,1,299,0,300,1708
SINALOA,GUAMUCHIL,4,318,2,324,1707
SINALOA,GUAMUCHIL,10,248,7,265,1707
SINALOA,GUAMUCHIL,7,279,4,290,1707
SINALOA,GUAMUCHIL,3,249,6,258,1707
SINALOA,GUAMUCHIL,10,234,5,249,1747
SINALOA,GUAMUCHIL,6,213,1,220,1746
SINALOA,GUAMUCHIL,9,213,7,229,1746
SINALOA,GUAMUCHIL,2,312,7,321,1518
SINALOA,GUAMUCHIL,7,286,5,298,1518
SINALOA,GUAMUCHIL,2,282,6,290,1518
SINALOA,GUAMUCHIL,5,288,8,301,1517
SINALOA,GUAMUCHIL,10,502,13,525,1934
SINALOA,GUAMUCHIL,6,831,4,841,1934
SINALOA,GUAMUCHIL,6,805,7,818,1934
SINALOA,GUAMUCHIL,3,658,15,676,1933
SINALOA,GUAMUCHIL,12,238,6,256,1933
SINALOA,GUAMUCHIL,6,226,7,239,1745
SINALOA,GUAMUCHIL,5,229,1,235,1744
SINALOA,GUAMUCHIL,6,244,3,253,1744
SINALOA,GUAMUCHIL,8,206,8,222,1902
SINALOA,GUAMUCHIL,6,200,8,214,1902
SINALOA,GUAMUCHIL,187,2,7,196,1901
SINALOA,GUAMUCHIL,4,196,2,202,1901
SINALOA,GUAMUCHIL,3,311,5,319,1805
SINALOA,GUAMUCHIL,6,299,6,311,1805
SINALOA,GUAMUCHIL,3,332,0,335,1805
SINALOA,GUAMUCHIL,3,337,9,349,1804
SINALOA,GUAMUCHIL,8,541,4,553,1978
SINALOA,GUAMUCHIL,10,476,3,489,1978
SINALOA,GUAMUCHIL,4,441,3,448,1977
SINALOA,GUAMUCHIL,6,212,1,219,1020
SINALOA,GUAMUCHIL,6,232,2,240,1020
SINALOA,GUAMUCHIL,9,306,5,320,1385
SINALOA,GUAMUCHIL,8,351,4,363,1384
SINALOA,GUAMUCHIL,10,303,5,318,1384
SINALOA,GUAMUCHIL,1,340,1,342,1866
SINALOA,GUAMUCHIL,7,355,7,369,1865
SINALOA,GUAMUCHIL,9,343,3,355,1865
SINALOA,GUAMUCHIL,10,331,3,344,1664
SINALOA,GUAMUCHIL,8,475,3,486,1664
SINALOA,GUAMUCHIL,13,365,6,384,1664
SINALOA,GUAMUCHIL,9,388,7,404,1663
SINALOA,GUAMUCHIL,18,314,6,338,1137
SINALOA,GUAMUCHIL,17,290,8,315,1137
SINALOA,GUAMUCHIL,3,268,0,271,1531
SINALOA,GUAMUCHIL,11,298,2,311,1531
SINALOA,GUAMUCHIL,8,355,5,368,1580
SINALOA,GUAMUCHIL,11,356,2,369,1580
SINALOA,GUAMUCHIL,9,324,0,333,1580
SINALOA,GUAMUCHIL,9,335,6,350,1580
SINALOA,GUAMUCHIL,2,234,2,238,1794
SINALOA,GUAMUCHIL,9,299,2,310,1794
SINALOA,GUAMUCHIL,2,235,4,241,1793
SINALOA,GUAMUCHIL,7,239,5,251,1793
SINALOA,GUAMUCHIL,6,251,8,265,1683
SINALOA,GUAMUCHIL,6,278,1,285,1683
SINALOA,GUAMUCHIL,4,262,7,273,1683
SINALOA,GUAMUCHIL,5,283,7,295,1682
SINALOA,GUAMUCHIL,4,339,3,346,1679
SINALOA,GUAMUCHIL,5,355,7,367,1678
SINALOA,GUAMUCHIL,3,350,5,358,1678
SINALOA,GUAMUCHIL,13,352,9,374,1678
SINALOA,GUAMUCHIL,15,361,6,382,1516
SINALOA,GUAMUCHIL,7,327,7,341,1515
SINALOA,GUAMUCHIL,5,379,4,388,1864
SINALOA,GUAMUCHIL,11,353,3,367,1864
SINALOA,GUAMUCHIL,12,324,4,340,1503
SINALOA,GUAMUCHIL,19,352,5,376,1503
SINALOA,GUAMUCHIL,6,348,0,354,1502
SINALOA,GUAMUCHIL,5,240,0,245,1818
SINALOA,GUAMUCHIL,6,227,8,241,1817
SINALOA,GUAMUCHIL,2,220,5,227,1817
SINALOA,GUAMUCHIL,7,181,4,192,1133
SINALOA,GUAMUCHIL,9,178,2,189,1132
SINALOA,GUAMUCHIL,9,300,8,317,1470
SINALOA,GUAMUCHIL,8,336,14,358,1469
SINALOA,GUAMUCHIL,6,331,51,388,1223
SINALOA,GUAMUCHIL,7,356,5,368,1223
SINALOA,GUAMUCHIL,9,163,10,182,1265
SINALOA,GUAMUCHIL,5,159,7,171,1264
SINALOA,GUAMUCHIL,2,241,3,246,1367
SINALOA,GUAMUCHIL,11,221,5,237,1366
SINALOA,GUAMUCHIL,8,230,4,242,1844
SINALOA,GUAMUCHIL,6,204,16,226,1844
SINALOA,GUAMUCHIL,5,234,6,245,1844
SINALOA,GUAMUCHIL,227,7,5,239,1844
SINALOA,GUAMUCHIL,6,381,6,393,1893
SINALOA,GUAMUCHIL,6,342,6,354,1892
SINALOA,GUAMUCHIL,9,418,3,430,1892
SINALOA,GUAMUCHIL,2,329,6,337,1892
SINALOA,GUAMUCHIL,0,382,3,385,1892
SINALOA,GUASAVE,18,400,12,430,1782
SINALOA,GUASAVE,12,418,9,439,1782
SINALOA,GUASAVE,18,409,18,445,1782
SINALOA,GUASAVE,15,400,16,431,1782
SINALOA,GUASAVE,3,351,6,360,1652
SINALOA,GUASAVE,10,348,13,371,1652
SINALOA,GUASAVE,0,314,1,315,1651
SINALOA,GUASAVE,14,329,10,353,1651
SINALOA,GUASAVE,11,337,7,355,1651
SINALOA,GUASAVE,7,340,6,353,1651
SINALOA,GUASAVE,11,253,4,268,1336
SINALOA,GUASAVE,12,295,3,310,1336
SINALOA,GUASAVE,11,274,7,292,1335
SINALOA,GUASAVE,8,330,5,343,1768
SINALOA,GUASAVE,9,361,10,380,1768
SINALOA,GUASAVE,12,325,6,343,1768
SINALOA,GUASAVE,11,335,6,352,1768
SINALOA,GUASAVE,6,341,1,348,1768
SINALOA,GUASAVE,8,353,8,369,1768
SINALOA,GUASAVE,5,354,3,362,1767
SINALOA,GUASAVE,8,398,6,412,1652
SINALOA,GUASAVE,10,396,7,413,1652
SINALOA,GUASAVE,5,375,5,385,1720
SINALOA,GUASAVE,7,327,4,338,1720
SINALOA,GUASAVE,13,346,3,362,1719
SINALOA,GUASAVE,7,345,6,358,1719
SINALOA,GUASAVE,3,347,7,357,1719
SINALOA,GUASAVE,6,363,11,380,1719
SINALOA,GUASAVE,14,312,5,331,1719
SINALOA,GUASAVE,9,417,6,432,1368
SINALOA,GUASAVE,8,381,7,396,1367
SINALOA,GUASAVE,11,410,11,432,1367
SINALOA,GUASAVE,4,290,4,298,1793
SINALOA,GUASAVE,1,340,5,346,1793
SINALOA,GUASAVE,9,323,5,337,1793
SINALOA,GUASAVE,4,1058,1,1063,1477
SINALOA,GUASAVE,4,618,3,625,1476
SINALOA,GUASAVE,4,438,2,444,1931
SINALOA,GUASAVE,7,403,2,412,1931
SINALOA,GUASAVE,9,319,3,331,1931
SINALOA,GUASAVE,2,426,1,429,1931
SINALOA,GUASAVE,7,416,4,427,1930
SINALOA,GUASAVE,7,415,5,427,1930
SINALOA,GUASAVE,5,384,0,389,1669
SINALOA,GUASAVE,3,384,2,389,1669
SINALOA,GUASAVE,5,361,5,371,1669
SINALOA,GUASAVE,6,350,3,359,1669
SINALOA,GUASAVE,4,366,3,373,1668
SINALOA,GUASAVE,8,437,5,450,1730
SINALOA,GUASAVE,9,336,3,348,1730
SINALOA,GUASAVE,6,397,0,403,1730
SINALOA,GUASAVE,10,347,3,360,1729
SINALOA,GUASAVE,3,378,6,387,1851
SINALOA,GUASAVE,4,446,4,454,1851
SINALOA,GUASAVE,3,354,6,363,1851
SINALOA,GUASAVE,3,294,4,301,1809
SINALOA,GUASAVE,5,307,9,321,1809
SINALOA,GUASAVE,5,257,5,267,1808
SINALOA,GUASAVE,8,275,4,287,1808
SINALOA,GUASAVE,6,262,4,272,1350
SINALOA,GUASAVE,6,249,3,258,1349
SINALOA,GUASAVE,8,271,1,280,1758
SINALOA,GUASAVE,8,297,2,307,1758
SINALOA,GUASAVE,3,299,10,312,1771
SINALOA,GUASAVE,9,320,5,334,1770
SINALOA,GUASAVE,7,304,1,312,1770
SINALOA,GUASAVE,12,363,3,378,1770
SINALOA,GUASAVE,16,286,1,303,1647
SINALOA,GUASAVE,4,394,2,400,1647
SINALOA,GUASAVE,17,304,3,324,1533
SINALOA,GUASAVE,22,282,7,311,1533
SINALOA,GUASAVE,52,1798,12,1862,0
SINALOA,GUASAVE,8,242,1,251,1526
SINALOA,GUASAVE,13,238,0,251,1526
SINALOA,GUASAVE,9,248,1,258,1526
SINALOA,GUASAVE,18,223,4,245,1525
SINALOA,GUASAVE,13,276,0,289,1970
SINALOA,GUASAVE,9,297,0,306,1970
SINALOA,GUASAVE,9,275,3,287,1970
SINALOA,GUASAVE,6,267,0,273,1970
SINALOA,GUASAVE,16,317,1,334,1963
SINALOA,GUASAVE,17,323,11,351,1962
SINALOA,GUASAVE,7,350,4,361,1962
SINALOA,GUASAVE,14,373,2,389,1724
SINALOA,GUASAVE,18,364,3,385,1724
SINALOA,GUASAVE,3,304,3,310,1400
SINALOA,GUASAVE,6,288,4,298,1399
SINALOA,GUASAVE,7,352,1,360,1912
SINALOA,GUASAVE,15,330,3,348,1912
SINALOA,GUASAVE,13,387,5,405,1911
SINALOA,GUASAVE,3,303,4,310,1681
SINALOA,GUASAVE,7,288,1,296,1681
SINALOA,GUASAVE,7,300,4,311,1681
SINALOA,GUASAVE,12,279,3,294,1680
SINALOA,GUASAVE,9,251,0,260,1747
SINALOA,GUASAVE,2,262,1,265,1747
SINALOA,GUASAVE,5,210,2,217,1747
SINALOA,GUASAVE,6,560,7,573,2023
SINALOA,GUASAVE,15,488,6,509,2022
SINALOA,GUASAVE,7,345,2,354,1516
SINALOA,GUASAVE,7,351,2,360,1516
SINALOA,GUASAVE,7,363,6,376,1516
SINALOA,GUASAVE,8,305,2,315,1516
SINALOA,GUASAVE,8,365,3,376,1696
SINALOA,GUASAVE,11,334,6,351,1696
SINALOA,GUASAVE,2,351,8,361,1696
SINALOA,GUASAVE,7,367,6,380,1696
SINALOA,GUASAVE,6,239,0,245,1489
SINALOA,GUASAVE,5,265,1,271,1489
SINALOA,GUASAVE,16,253,1,270,1489
SINALOA,GUASAVE,7,268,5,280,1489
SINALOA,GUASAVE,2,167,11,180,1666
SINALOA,GUASAVE,4,172,1,177,1666
SINALOA,GUASAVE,3,178,0,181,1665
SINALOA,GUASAVE,4,171,2,177,1665
SINALOA,GUASAVE,0,305,0,305,1735
SINALOA,GUASAVE,13,260,2,275,1734
SINALOA,GUASAVE,1,262,3,266,1605
SINALOA,GUASAVE,5,302,3,310,1605
SINALOA,GUASAVE,9,223,0,232,1188
SINALOA,GUASAVE,5,194,3,202,1187
SINALOA,GUASAVE,1,252,3,256,1434
SINALOA,GUASAVE,5,287,4,296,1434
SINALOA,GUASAVE,2,274,5,281,1556
SINALOA,GUASAVE,6,279,3,288,1556
SINALOA,GUASAVE,8,307,5,320,1826
SINALOA,GUASAVE,8,316,5,329,1826
SINALOA,GUASAVE,4,228,4,236,1345
SINALOA,GUASAVE,1,301,2,304,1345
SINALOA,GUASAVE,4,235,3,242,1345
SINALOA,GUASAVE,2,215,3,220,1601
SINALOA,GUASAVE,1,198,4,203,1601
SINALOA,GUASAVE,3,230,2,235,1601
SINALOA,GUASAVE,8,158,5,171,1146
SINALOA,GUASAVE,1,154,0,155,1145
SINALOA,GUASAVE,11,337,2,350,1590
SINALOA,GUASAVE,9,287,2,298,1590
SINALOA,GUASAVE,12,311,0,323,1520
SINALOA,GUASAVE,9,350,5,364,1519
SINALOA,GUASAVE,11,343,2,356,1598
SINALOA,GUASAVE,10,354,6,370,1597
SINALOA,GUASAVE,14,275,10,299,1440
SINALOA,GUASAVE,9,274,4,287,1439
SINALOA,GUASAVE,11,298,7,316,1439
SINALOA,GUASAVE,4,259,2,265,1877
SINALOA,GUASAVE,7,275,8,290,1876
SINALOA,GUASAVE,3,270,7,280,1475
SINALOA,GUASAVE,8,259,7,274,1475
SINALOA,GUASAVE,11,219,1,231,1499
SINALOA,GUASAVE,7,277,3,287,1498
SINALOA,GUASAVE,6,241,3,250,1498
SINALOA,GUASAVE,14,283,1,298,1498
SINALOA,GUASAVE,5,245,3,253,1608
SINALOA,GUASAVE,3,284,0,287,1607
SINALOA,GUASAVE,3,211,3,217,1607
SINALOA,GUASAVE,7,212,3,222,1424
SINALOA,GUASAVE,4,233,1,238,1423
SINALOA,GUASAVE,6,223,0,229,1423
SINALOA,GUASAVE,3,284,1,288,1800
SINALOA,GUASAVE,5,293,3,301,1800
SINALOA,GUASAVE,4,292,2,298,1800
SINALOA,GUASAVE,8,324,4,336,1642
SINALOA,GUASAVE,4,341,1,346,1642
SINALOA,GUASAVE,11,320,7,338,1641
SINALOA,GUASAVE,2,316,3,321,1641
SINALOA,GUASAVE,5,364,0,369,1785
SINALOA,GUASAVE,3,391,10,404,1784
SINALOA,GUASAVE,13,272,1,286,1746
SINALOA,GUASAVE,6,327,2,335,1745
SINALOA,GUASAVE,14,315,0,329,1745
SINALOA,GUASAVE,10,291,3,304,1745
SINALOA,GUASAVE,4,249,1,254,1745
SINALOA,GUASAVE,8,387,6,401,1631
SINALOA,GUASAVE,6,391,9,406,1630
SINALOA,GUASAVE,10,318,1,329,1414
SINALOA,GUASAVE,5,329,5,339,1413
SINALOA,GUASAVE,6,330,4,340,1413
SINALOA,GUASAVE,4,190,4,198,1463
SINALOA,GUASAVE,8,177,2,187,1463
SINALOA,GUASAVE,6,196,3,205,1462
SINALOA,GUASAVE,13,316,4,333,1329
SINALOA,GUASAVE,11,300,3,314,1329
SINALOA,GUASAVE,0,268,1,269,1328
SINALOA,GUASAVE,15,557,4,576,1888
SINALOA,GUASAVE,17,545,4,566,1888
SINALOA,GUASAVE,11,489,7,507,1794
SINALOA,GUASAVE,11,531,2,544,1793
SINALOA,GUASAVE,7,518,4,529,1864
SINALOA,GUASAVE,14,562,6,582,1864
SINALOA,CULIACAN DE ROSALES,18,278,0,296,1774
SINALOA,CULIACAN DE ROSALES,15,266,1,282,1774
SINALOA,CULIACAN DE ROSALES,15,280,0,295,1773
SINALOA,CULIACAN DE ROSALES,11,291,0,302,1773
SINALOA,CULIACAN DE ROSALES,21,265,0,286,1773
SINALOA,CULIACAN DE ROSALES,11,276,0,287,1773
SINALOA,CULIACAN DE ROSALES,21,282,2,305,1773
SINALOA,CULIACAN DE ROSALES,12,290,1,303,1773
SINALOA,CULIACAN DE ROSALES,26,288,1,315,1346
SINALOA,CULIACAN DE ROSALES,8,268,4,280,1346
SINALOA,CULIACAN DE ROSALES,8,254,2,264,1345
SINALOA,CULIACAN DE ROSALES,20,281,2,303,1763
SINALOA,CULIACAN DE ROSALES,24,277,1,302,1763
SINALOA,CULIACAN DE ROSALES,17,295,2,314,1763
SINALOA,CULIACAN DE ROSALES,13,273,2,288,1412
SINALOA,CULIACAN DE ROSALES,12,262,1,275,1412
SINALOA,CULIACAN DE ROSALES,10,281,1,292,1411
SINALOA,CULIACAN DE ROSALES,14,306,5,325,1670
SINALOA,CULIACAN DE ROSALES,11,309,3,323,1670
SINALOA,CULIACAN DE ROSALES,23,294,4,321,1670
SINALOA,CULIACAN DE ROSALES,20,328,9,357,1584
SINALOA,CULIACAN DE ROSALES,19,362,5,386,1584
SINALOA,CULIACAN DE ROSALES,14,356,0,370,1584
SINALOA,CULIACAN DE ROSALES,20,252,3,275,1787
SINALOA,CULIACAN DE ROSALES,11,282,1,294,1787
SINALOA,CULIACAN DE ROSALES,15,242,0,257,1786
SINALOA,CULIACAN DE ROSALES,11,353,4,368,1843
SINALOA,CULIACAN DE ROSALES,11,353,2,366,1842
SINALOA,CULIACAN DE ROSALES,24,327,1,352,1816
SINALOA,CULIACAN DE ROSALES,23,331,0,354,1815
SINALOA,CULIACAN DE ROSALES,20,296,4,320,1815
SINALOA,CULIACAN DE ROSALES,16,237,1,254,1383
SINALOA,CULIACAN DE ROSALES,16,218,0,234,1382
SINALOA,CULIACAN DE ROSALES,21,226,1,248,1382
SINALOA,CULIACAN DE ROSALES,5,296,4,305,1648
SINALOA,CULIACAN DE ROSALES,5,276,7,288,1647
SINALOA,CULIACAN DE ROSALES,9,315,0,324,1647
SINALOA,CULIACAN DE ROSALES,12,241,3,256,1987
SINALOA,CULIACAN DE ROSALES,20,240,2,262,1987
SINALOA,CULIACAN DE ROSALES,7,223,2,232,1987
SINALOA,CULIACAN DE ROSALES,8,246,0,254,1987
SINALOA,CULIACAN DE ROSALES,20,223,1,244,1986
SINALOA,CULIACAN DE ROSALES,17,253,0,270,1986
SINALOA,CULIACAN DE ROSALES,8,253,0,261,1986
SINALOA,CULIACAN DE ROSALES,96,1868,14,1978,0
SINALOA,CULIACAN DE ROSALES,8,267,1,276,1823
SINALOA,CULIACAN DE ROSALES,11,271,4,286,1823
SINALOA,CULIACAN DE ROSALES,11,268,1,280,1823
SINALOA,CULIACAN DE ROSALES,13,250,3,266,1823
SINALOA,CULIACAN DE ROSALES,15,271,2,288,1822
SINALOA,CULIACAN DE ROSALES,7,270,3,280,1972
SINALOA,CULIACAN DE ROSALES,8,317,0,325,1971
SINALOA,CULIACAN DE ROSALES,13,299,2,314,1911
SINALOA,CULIACAN DE ROSALES,10,287,2,299,1911
SINALOA,CULIACAN DE ROSALES,13,259,1,273,1910
SINALOA,CULIACAN DE ROSALES,12,239,3,254,1589
SINALOA,CULIACAN DE ROSALES,14,243,2,259,1588
SINALOA,CULIACAN DE ROSALES,9,268,6,283,1588
SINALOA,CULIACAN DE ROSALES,9,242,0,251,1588
SINALOA,CULIACAN DE ROSALES,19,253,1,273,1808
SINALOA,CULIACAN DE ROSALES,18,248,0,266,1808
SINALOA,CULIACAN DE ROSALES,17,248,0,265,1808
SINALOA,CULIACAN DE ROSALES,13,262,0,275,1808
SINALOA,CULIACAN DE ROSALES,11,244,1,256,1808
SINALOA,CULIACAN DE ROSALES,19,261,3,283,1808
SINALOA,CULIACAN DE ROSALES,11,381,1,393,1899
SINALOA,CULIACAN DE ROSALES,14,372,0,386,1898
SINALOA,CULIACAN DE ROSALES,8,288,0,296,1799
SINALOA,CULIACAN DE ROSALES,11,300,1,312,1799
SINALOA,CULIACAN DE ROSALES,10,288,4,302,1799
SINALOA,CULIACAN DE ROSALES,6,320,1,327,1799
SINALOA,CULIACAN DE ROSALES,7,304,1,312,1799
SINALOA,CULIACAN DE ROSALES,10,277,1,288,1799
SINALOA,CULIACAN DE ROSALES,14,200,0,214,1428
SINALOA,CULIACAN DE ROSALES,11,180,0,191,1427
SINALOA,CULIACAN DE ROSALES,12,166,2,180,1427
SINALOA,CULIACAN DE ROSALES,20,313,4,337,1887
SINALOA,CULIACAN DE ROSALES,10,386,5,401,1886
SINALOA,CULIACAN DE ROSALES,16,354,5,375,1886
SINALOA,CULIACAN DE ROSALES,8,358,7,373,1804
SINALOA,CULIACAN DE ROSALES,11,320,6,337,1804
SINALOA,CULIACAN DE ROSALES,7,374,2,383,1804
SINALOA,CULIACAN DE ROSALES,8,355,9,372,1803
SINALOA,CULIACAN DE ROSALES,14,314,0,328,1654
SINALOA,CULIACAN DE ROSALES,17,284,4,305,1653
SINALOA,CULIACAN DE ROSALES,3,365,3,371,1653
SINALOA,CULIACAN DE ROSALES,6,299,7,312,1653
SINALOA,CULIACAN DE ROSALES,10,324,1,335,1653
SINALOA,CULIACAN DE ROSALES,29,328,3,360,1890
SINALOA,CULIACAN DE ROSALES,21,305,0,326,1890
SINALOA,CULIACAN DE ROSALES,29,325,3,357,1889
SINALOA,CULIACAN DE ROSALES,7,315,4,326,1591
SINALOA,CULIACAN DE ROSALES,6,312,0,318,1591
SINALOA,CULIACAN DE ROSALES,2,245,6,253,1529
SINALOA,CULIACAN DE ROSALES,9,263,2,274,1529
SINALOA,CULIACAN DE ROSALES,11,264,1,276,1528
SINALOA,CULIACAN DE ROSALES,19,247,2,268,1528
SINALOA,CULIACAN DE ROSALES,8,266,3,277,1998
SINALOA,CULIACAN DE ROSALES,5,277,1,283,1997
SINALOA,CULIACAN DE ROSALES,4,166,2,172,1728
SINALOA,CULIACAN DE ROSALES,6,154,0,160,1728
SINALOA,CULIACAN DE ROSALES,6,198,2,206,1727
SINALOA,CULIACAN DE ROSALES,8,198,0,206,1727
SINALOA,CULIACAN DE ROSALES,7,195,3,205,1727
SINALOA,CULIACAN DE ROSALES,3,150,2,155,1727
SINALOA,CULIACAN DE ROSALES,5,185,0,190,1727
SINALOA,CULIACAN DE ROSALES,13,268,2,283,1553
SINALOA,CULIACAN DE ROSALES,12,286,2,300,1552
SINALOA,CULIACAN DE ROSALES,14,257,2,273,1632
SINALOA,CULIACAN DE ROSALES,9,242,0,251,1631
SINALOA,CULIACAN DE ROSALES,10,274,0,284,1239
SINALOA,CULIACAN DE ROSALES,11,258,3,272,1238
SINALOA,CULIACAN DE ROSALES,3,200,0,203,1517
SINALOA,CULIACAN DE ROSALES,5,157,2,164,1516
SINALOA,CULIACAN DE ROSALES,7,167,0,174,1420
SINALOA,CULIACAN DE ROSALES,5,187,0,192,1420
SINALOA,CULIACAN DE ROSALES,7,190,3,200,1420
SINALOA,CULIACAN DE ROSALES,2,212,1,215,1361
SINALOA,CULIACAN DE ROSALES,3,175,4,182,1360
SINALOA,CULIACAN DE ROSALES,6,227,1,234,1555
SINALOA,CULIACAN DE ROSALES,9,221,2,232,1554
SINALOA,CULIACAN DE ROSALES,6,214,0,220,1849
SINALOA,CULIACAN DE ROSALES,9,188,3,200,1848
SINALOA,CULIACAN DE ROSALES,12,232,0,244,1848
SINALOA,CULIACAN DE ROSALES,13,206,1,220,1848
SINALOA,CULIACAN DE ROSALES,9,203,1,213,1848
SINALOA,CULIACAN DE ROSALES,8,213,1,222,1848
SINALOA,CULIACAN DE ROSALES,7,194,3,204,1573
SINALOA,CULIACAN DE ROSALES,7,241,1,249,1572
SINALOA,CULIACAN DE ROSALES,13,228,0,241,1276
SINALOA,CULIACAN DE ROSALES,3,228,2,233,1275
SINALOA,CULIACAN DE ROSALES,14,259,3,276,1701
SINALOA,CULIACAN DE ROSALES,9,278,1,288,1700
SINALOA,CULIACAN DE ROSALES,16,349,4,369,1942
SINALOA,CULIACAN DE ROSALES,10,344,3,357,1941
SINALOA,CULIACAN DE ROSALES,11,293,3,307,1910
SINALOA,CULIACAN DE ROSALES,14,305,1,320,1909
SINALOA,CULIACAN DE ROSALES,9,344,3,356,1963
SINALOA,CULIACAN DE ROSALES,13,267,2,282,1962
SINALOA,CULIACAN DE ROSALES,7,267,0,274,1643
SINALOA,CULIACAN DE ROSALES,8,242,0,250,1643
SINALOA,CULIACAN DE ROSALES,12,261,0,273,1643
SINALOA,CULIACAN DE ROSALES,14,256,0,270,1643
SINALOA,CULIACAN DE ROSALES,6,241,0,247,1480
SINALOA,CULIACAN DE ROSALES,13,252,0,265,1480
SINALOA,CULIACAN DE ROSALES,4,220,1,225,1631
SINALOA,CULIACAN DE ROSALES,11,215,1,227,1631
SINALOA,CULIACAN DE ROSALES,5,213,1,219,1631
SINALOA,CULIACAN DE ROSALES,7,172,1,180,1631
SINALOA,CULIACAN DE ROSALES,10,213,0,223,1631
SINALOA,CULIACAN DE ROSALES,11,412,5,428,1936
SINALOA,CULIACAN DE ROSALES,8,476,1,485,1935
SINALOA,CULIACAN DE ROSALES,7,212,2,221,1774
SINALOA,CULIACAN DE ROSALES,12,185,6,203,1773
SINALOA,CULIACAN DE ROSALES,6,232,2,240,1773
SINALOA,CULIACAN DE ROSALES,11,207,2,220,1773
SINALOA,CULIACAN DE ROSALES,7,181,3,191,1773
SINALOA,CULIACAN DE ROSALES,13,200,1,214,1773
SINALOA,CULIACAN DE ROSALES,10,229,1,240,1773
SINALOA,CULIACAN DE ROSALES,24,247,3,274,1946
SINALOA,CULIACAN DE ROSALES,21,212,0,233,1945
SINALOA,CULIACAN DE ROSALES,12,235,1,248,1945
SINALOA,CULIACAN DE ROSALES,25,228,3,256,1945
SINALOA,CULIACAN DE ROSALES,18,264,4,286,1945
SINALOA,CULIACAN DE ROSALES,21,229,2,252,1945
SINALOA,CULIACAN DE ROSALES,18,227,2,247,1945
SINALOA,CULIACAN DE ROSALES,18,227,3,248,1945
SINALOA,CULIACAN DE ROSALES,6,310,2,318,1943
SINALOA,CULIACAN DE ROSALES,9,337,8,354,1942
SINALOA,CULIACAN DE ROSALES,7,336,4,347,1942
SINALOA,CULIACAN DE ROSALES,11,287,2,300,1406
SINALOA,CULIACAN DE ROSALES,7,278,5,290,1406
SINALOA,CULIACAN DE ROSALES,12,403,2,417,1406
SINALOA,CULIACAN DE ROSALES,19,318,1,338,1943
SINALOA,CULIACAN DE ROSALES,23,305,5,333,1942
SINALOA,CULIACAN DE ROSALES,19,294,0,313,1942
SINALOA,CULIACAN DE ROSALES,11,215,0,226,1749
SINALOA,CULIACAN DE ROSALES,15,220,4,239,1748
SINALOA,CULIACAN DE ROSALES,17,371,1,389,2020
SINALOA,CULIACAN DE ROSALES,22,325,1,348,2019
SINALOA,CULIACAN DE ROSALES,4,194,1,199,1355
SINALOA,CULIACAN DE ROSALES,17,181,2,200,1354
SINALOA,CULIACAN DE ROSALES,14,185,0,199,1529
SINALOA,CULIACAN DE ROSALES,13,214,1,228,1528
SINALOA,CULIACAN DE ROSALES,21,185,2,208,1346
SINALOA,CULIACAN DE ROSALES,10,203,1,214,1345
SINALOA,MAZATLAN,7,1473,22,1502,1996
SINALOA,MAZATLAN,11,1888,6,1905,1995
SINALOA,MAZATLAN,12,1045,9,1066,1688
SINALOA,MAZATLAN,11,1281,2,1294,1687
SINALOA,MAZATLAN,4,1359,13,1376,1736
SINALOA,MAZATLAN,3,1311,14,1328,1736
SINALOA,MAZATLAN,5,1365,7,1377,1735
SINALOA,MAZATLAN,5,282,1,288,1612
SINALOA,MAZATLAN,6,286,2,294,1611
SINALOA,MAZATLAN,3,298,2,303,1611
SINALOA,MAZATLAN,7,269,4,280,1634
SINALOA,MAZATLAN,4,271,6,281,1634
SINALOA,MAZATLAN,13,253,5,271,1634
SINALOA,MAZATLAN,10,240,2,252,1492
SINALOA,MAZATLAN,5,282,0,287,1491
SINALOA,MAZATLAN,2,267,1,270,1491
SINALOA,MAZATLAN,8,331,3,342,1800
SINALOA,MAZATLAN,7,316,8,331,1799
SINALOA,MAZATLAN,5,300,13,318,1799
SINALOA,MAZATLAN,9,159,0,168,1559
SINALOA,MAZATLAN,7,162,0,169,1559
SINALOA,MAZATLAN,3,153,6,162,1558
SINALOA,MAZATLAN,10,282,3,295,1723
SINALOA,MAZATLAN,4,247,4,255,1723
SINALOA,MAZATLAN,4,257,0,261,1722
SINALOA,MAZATLAN,5,356,6,367,1973
SINALOA,MAZATLAN,10,323,4,337,1973
SINALOA,MAZATLAN,8,331,3,342,1973
SINALOA,MAZATLAN,9,354,4,367,1973
SINALOA,MAZATLAN,8,270,1,279,1607
SINALOA,MAZATLAN,9,271,9,289,1607
SINALOA,MAZATLAN,13,402,11,426,2209
SINALOA,MAZATLAN,8,387,10,405,2209
SINALOA,MAZATLAN,10,470,10,490,2209
SINALOA,MAZATLAN,5,266,4,275,1712
SINALOA,MAZATLAN,7,243,6,256,1712
SINALOA,MAZATLAN,3,244,4,251,1711
SINALOA,MAZATLAN,4,266,3,273,1481
SINALOA,MAZATLAN,4,265,3,272,1480
SINALOA,MAZATLAN,9,440,9,458,2096
SINALOA,MAZATLAN,10,422,5,437,2096
SINALOA,MAZATLAN,3,392,3,398,1916
SINALOA,MAZATLAN,9,419,9,437,1915
SINALOA,MAZATLAN,4,341,2,347,1529
SINALOA,MAZATLAN,5,348,5,358,1529
SINALOA,MAZATLAN,3,354,2,359,1838
SINALOA,MAZATLAN,7,307,4,318,1837
SINALOA,MAZATLAN,8,343,6,357,1837
SINALOA,MAZATLAN,8,331,7,346,1341
SINALOA,MAZATLAN,4,306,2,312,1340
SINALOA,MAZATLAN,334,9,2,345,2232
SINALOA,MAZATLAN,15,433,9,457,1884
SINALOA,MAZATLAN,3,396,4,403,1883
SINALOA,MAZATLAN,4,361,14,379,1976
SINALOA,MAZATLAN,8,368,7,383,1975
SINALOA,MAZATLAN,10,328,8,346,1958
SINALOA,MAZATLAN,10,332,13,355,1958
SINALOA,MAZATLAN,3,260,6,269,1473
SINALOA,MAZATLAN,5,217,2,224,1472
SINALOA,MAZATLAN,12,301,0,313,1566
SINALOA,MAZATLAN,18,287,8,313,1566
SINALOA,MAZATLAN,7,292,6,305,1565
SINALOA,MAZATLAN,13,363,7,383,1842
SINALOA,MAZATLAN,15,357,8,380,1842
SINALOA,MAZATLAN,2,205,7,214,1579
SINALOA,MAZATLAN,12,258,9,279,1578
SINALOA,MAZATLAN,7,359,7,373,1910
SINALOA,MAZATLAN,9,369,11,389,1910
SINALOA,MAZATLAN,12,345,5,362,1909
SINALOA,MAZATLAN,19,537,9,565,2205
SINALOA,MAZATLAN,9,356,9,374,2019
SINALOA,MAZATLAN,4,360,2,366,2019
SINALOA,MAZATLAN,13,219,4,236,1601
SINALOA,MAZATLAN,4,230,1,235,1601
SINALOA,MAZATLAN,5,276,0,281,1600
SINALOA,MAZATLAN,16,364,55,435,1781
SINALOA,MAZATLAN,13,377,23,413,1781
SINALOA,MAZATLAN,13,358,7,378,1781
SINALOA,MAZATLAN,16,359,7,382,1995
SINALOA,MAZATLAN,14,382,2,398,1995
SINALOA,MAZATLAN,16,379,3,398,1995
SINALOA,MAZATLAN,20,383,1,404,1995
SINALOA,MAZATLAN,13,353,3,369,1994
SINALOA,MAZATLAN,12,385,3,400,1994
SINALOA,MAZATLAN,21,373,4,398,1994
SINALOA,MAZATLAN,20,309,3,332,1917
SINALOA,MAZATLAN,24,367,3,394,1917
SINALOA,MAZATLAN,29,162,0,191,1756
SINALOA,MAZATLAN,20,180,0,200,1755
SINALOA,MAZATLAN,21,165,2,188,1755
SINALOA,MAZATLAN,100,991,3,1094,0
SINALOA,MAZATLAN,7,244,0,251,1492
SINALOA,MAZATLAN,11,256,0,267,1492
SINALOA,MAZATLAN,5,279,8,292,1491
SINALOA,MAZATLAN,3,315,5,323,1849
SINALOA,MAZATLAN,6,350,4,360,1848
SINALOA,MAZATLAN,7,264,4,275,1869
SINALOA,MAZATLAN,15,275,2,292,1869
SINALOA,MAZATLAN,24,100,2,126,1842
SINALOA,MAZATLAN,19,111,1,131,1841
SINALOA,MAZATLAN,29,208,5,242,1736
SINALOA,MAZATLAN,31,204,2,237,1735
SINALOA,MAZATLAN,21,321,1,343,1891
SINALOA,MAZATLAN,16,316,3,335,1890
SINALOA,MAZATLAN,240,3,2,245,1106
SINALOA,MAZATLAN,5,247,5,257,1106
SINALOA,MAZATLAN,19,364,5,388,1861
SINALOA,MAZATLAN,12,368,3,383,1861
SINALOA,MAZATLAN,23,336,0,359,2075
SINALOA,MAZATLAN,27,330,2,359,2075
SINALOA,MAZATLAN,23,326,2,351,2074
SINALOA,MAZATLAN,19,334,0,353,2074
SINALOA,MAZATLAN,9,273,3,285,2074
SINALOA,MAZATLAN,21,336,0,357,2074
SINALOA,MAZATLAN,19,402,1,422,2011
SINALOA,MAZATLAN,22,374,6,402,2011
SINALOA,MAZATLAN,12,321,1,334,1781
SINALOA,MAZATLAN,18,335,2,355,1780
SINALOA,MAZATLAN,6,308,3,317,1780
SINALOA,MAZATLAN,9,325,2,336,1780
SINALOA,MAZATLAN,14,441,2,457,1964
SINALOA,MAZATLAN,18,479,5,502,1964
SINALOA,MAZATLAN,18,506,4,528,2161
SINALOA,MAZATLAN,15,449,9,473,2161
SINALOA,MAZATLAN,6,429,3,438,1823
SINALOA,MAZATLAN,19,460,2,481,1823
SINALOA,MAZATLAN,17,443,2,462,1823
SINALOA,MAZATLAN,17,413,4,434,1823
SINALOA,MAZATLAN,15,372,1,388,1865
SINALOA,MAZATLAN,20,347,8,375,1865
SINALOA,MAZATLAN,17,333,1,351,1864
SINALOA,MAZATLAN,20,359,3,382,1864
SINALOA,MAZATLAN,15,218,0,233,1604
SINALOA,MAZATLAN,23,263,1,287,1604
SINALOA,MAZATLAN,17,256,0,273,1603
SINALOA,MAZATLAN,8,318,3,329,1599
SINALOA,MAZATLAN,7,336,5,348,1599
SINALOA,MAZATLAN,6,332,4,342,1598
SINALOA,MAZATLAN,4,341,8,353,1833
SINALOA,MAZATLAN,4,340,12,356,1832
SINALOA,MAZATLAN,7,283,8,298,1461
SINALOA,MAZATLAN,11,265,14,290,1461
SINALOA,MAZATLAN,11,310,2,323,1461
SINALOA,MAZATLAN,7,305,5,317,1460
SINALOA,MAZATLAN,28,507,3,538,2442
SINALOA,MAZATLAN,12,244,2,258,1941
SINALOA,MAZATLAN,20,226,1,247,1941
SINALOA,MAZATLAN,13,265,3,281,1941
SINALOA,MAZATLAN,14,274,5,293,1941
SINALOA,MAZATLAN,8,226,4,238,1941
SINALOA,MAZATLAN,15,238,4,257,1941
SINALOA,MAZATLAN,13,218,2,233,1941
SINALOA,MAZATLAN,11,232,1,244,1941
SINALOA,MAZATLAN,9,442,6,457,1843
SINALOA,MAZATLAN,9,447,11,467,1842
SINALOA,MAZATLAN,11,468,10,489,1842
SINALOA,MAZATLAN,20,440,20,480,1830
SINALOA,MAZATLAN,10,406,14,430,1830
SINALOA,MAZATLAN,10,174,5,189,1330
SINALOA,MAZATLAN,4,186,7,197,1329
SINALOA,MAZATLAN,6,219,3,228,1911
SINALOA,MAZATLAN,0,257,4,261,1911
SINALOA,MAZATLAN,7,242,3,252,1489
SINALOA,MAZATLAN,5,226,3,234,1488
SINALOA,MAZATLAN,8,187,5,200,1488
SINALOA,MAZATLAN,14,345,3,362,1888
SINALOA,MAZATLAN,5,351,2,358,1887
SINALOA,MAZATLAN,7,342,0,349,1887
SINALOA,MAZATLAN,18,447,3,468,2074
SINALOA,MAZATLAN,16,369,2,387,1626
SINALOA,MAZATLAN,10,306,0,316,1625
SINALOA,MAZATLAN,11,213,3,227,1267
SINALOA,MAZATLAN,5,228,0,233,1267
SINALOA,MAZATLAN,13,309,2,324,2093
SINALOA,MAZATLAN,11,313,0,324,2093
SINALOA,CULIACAN DE ROSALES,5,212,2,219,1544
SINALOA,CULIACAN DE ROSALES,4,214,4,222,1543
SINALOA,CULIACAN DE ROSALES,4,188,1,193,1822
SINALOA,CULIACAN DE ROSALES,8,201,3,212,1821
SINALOA,CULIACAN DE ROSALES,6,138,0,144,1506
SINALOA,CULIACAN DE ROSALES,4,118,0,122,1506
SINALOA,CULIACAN DE ROSALES,2,112,0,114,1506
SINALOA,CULIACAN DE ROSALES,10,274,1,285,1573
SINALOA,CULIACAN DE ROSALES,11,260,4,275,1572
SINALOA,CULIACAN DE ROSALES,11,261,3,275,1572
SINALOA,CULIACAN DE ROSALES,23,225,4,252,1621
SINALOA,CULIACAN DE ROSALES,17,248,1,266,1621
SINALOA,CULIACAN DE ROSALES,17,192,0,209,1427
SINALOA,CULIACAN DE ROSALES,15,202,0,217,1427
SINALOA,CULIACAN DE ROSALES,14,218,2,234,1427
SINALOA,CULIACAN DE ROSALES,11,248,0,259,1577
SINALOA,CULIACAN DE ROSALES,21,216,7,244,1577
SINALOA,CULIACAN DE ROSALES,24,288,0,312,1840
SINALOA,CULIACAN DE ROSALES,31,310,4,345,1839
SINALOA,CULIACAN DE ROSALES,20,235,0,255,1332
SINALOA,CULIACAN DE ROSALES,12,234,4,250,1332
SINALOA,CULIACAN DE ROSALES,18,217,1,236,1331
SINALOA,CULIACAN DE ROSALES,22,309,1,332,1808
SINALOA,CULIACAN DE ROSALES,13,323,5,341,1808
SINALOA,CULIACAN DE ROSALES,22,193,1,216,1761
SINALOA,CULIACAN DE ROSALES,18,219,1,238,1761
SINALOA,CULIACAN DE ROSALES,11,179,0,190,1624
SINALOA,CULIACAN DE ROSALES,17,176,1,194,1624
SINALOA,CULIACAN DE ROSALES,11,176,1,188,1624
SINALOA,CULIACAN DE ROSALES,15,196,1,212,1623
SINALOA,CULIACAN DE ROSALES,10,188,0,198,1623
SINALOA,CULIACAN DE ROSALES,89,1601,24,1714,0
SINALOA,CULIACAN DE ROSALES,14,221,1,236,1757
SINALOA,CULIACAN DE ROSALES,22,197,0,219,1757
SINALOA,CULIACAN DE ROSALES,20,192,2,214,1757
SINALOA,CULIACAN DE ROSALES,30,193,3,226,1757
SINALOA,CULIACAN DE ROSALES,19,225,1,245,1763
SINALOA,CULIACAN DE ROSALES,13,240,3,256,1763
SINALOA,CULIACAN DE ROSALES,7,305,6,318,1848
SINALOA,CULIACAN DE ROSALES,20,322,4,346,1847
SINALOA,CULIACAN DE ROSALES,20,251,6,277,1696
SINALOA,CULIACAN DE ROSALES,20,282,3,305,1695
SINALOA,CULIACAN DE ROSALES,16,248,1,265,1397
SINALOA,CULIACAN DE ROSALES,0,236,4,240,1397
SINALOA,CULIACAN DE ROSALES,11,247,2,260,1396
SINALOA,CULIACAN DE ROSALES,9,107,2,118,1434
SINALOA,CULIACAN DE ROSALES,18,108,1,127,1434
SINALOA,CULIACAN DE ROSALES,12,123,2,137,1433
SINALOA,CULIACAN DE ROSALES,3,210,1,214,1610
SINALOA,CULIACAN DE ROSALES,2,203,6,211,1610
SINALOA,CULIACAN DE ROSALES,12,286,2,300,1999
SINALOA,CULIACAN DE ROSALES,8,275,2,285,1999
SINALOA,CULIACAN DE ROSALES,7,246,3,256,1999
SINALOA,CULIACAN DE ROSALES,7,275,2,284,1999
SINALOA,CULIACAN DE ROSALES,14,278,2,294,1999
SINALOA,CULIACAN DE ROSALES,6,254,3,263,1999
SINALOA,CULIACAN DE ROSALES,15,270,0,285,1999
SINALOA,CULIACAN DE ROSALES,7,274,3,284,1998
SINALOA,CULIACAN DE ROSALES,10,219,4,233,1159
SINALOA,CULIACAN DE ROSALES,17,217,2,236,1158
SINALOA,CULIACAN DE ROSALES,6,204,4,214,1388
SINALOA,CULIACAN DE ROSALES,8,220,2,230,1387
SINALOA,CULIACAN DE ROSALES,8,200,5,213,1387
SINALOA,CULIACAN DE ROSALES,9,256,4,269,1867
SINALOA,CULIACAN DE ROSALES,10,253,0,263,1867
SINALOA,CULIACAN DE ROSALES,7,210,0,217,1866
SINALOA,CULIACAN DE ROSALES,8,234,2,244,1866
SINALOA,CULIACAN DE ROSALES,4,232,1,237,1701
SINALOA,CULIACAN DE ROSALES,3,264,9,276,1700
SINALOA,CULIACAN DE ROSALES,2,209,1,212,1374
SINALOA,CULIACAN DE ROSALES,9,168,4,181,1373
SINALOA,CULIACAN DE ROSALES,6,126,1,133,1373
SINALOA,CULIACAN DE ROSALES,1,223,2,226,1588
SINALOA,CULIACAN DE ROSALES,2,264,6,272,1588
SINALOA,CULIACAN DE ROSALES,1,210,1,212,1588
SINALOA,CULIACAN DE ROSALES,7,413,2,422,1499
SINALOA,CULIACAN DE ROSALES,7,417,5,429,1499
SINALOA,CULIACAN DE ROSALES,10,407,1,418,1499
SINALOA,CULIACAN DE ROSALES,8,277,4,289,1779
SINALOA,CULIACAN DE ROSALES,8,222,6,236,1778
SINALOA,CULIACAN DE ROSALES,6,200,0,206,1846
SINALOA,CULIACAN DE ROSALES,2,175,0,177,1846
SINALOA,CULIACAN DE ROSALES,4,185,0,189,1846
SINALOA,CULIACAN DE ROSALES,4,170,0,174,1846
SINALOA,CULIACAN DE ROSALES,6,166,0,172,1845
SINALOA,CULIACAN DE ROSALES,11,279,2,292,1950
SINALOA,CULIACAN DE ROSALES,8,262,2,272,1949
SINALOA,CULIACAN DE ROSALES,10,236,2,248,1530
SINALOA,CULIACAN DE ROSALES,9,244,4,257,1530
SINALOA,CULIACAN DE ROSALES,10,231,5,246,1529
SINALOA,CULIACAN DE ROSALES,10,287,4,301,1594
SINALOA,CULIACAN DE ROSALES,11,252,2,265,1594
SINALOA,CULIACAN DE ROSALES,18,291,3,312,1594
SINALOA,CULIACAN DE ROSALES,20,235,3,258,1593
SINALOA,CULIACAN DE ROSALES,10,267,3,280,1593
SINALOA,CULIACAN DE ROSALES,2,209,3,214,1332
SINALOA,CULIACAN DE ROSALES,6,249,2,257,1331
SINALOA,CULIACAN DE ROSALES,14,181,2,197,1466
SINALOA,CULIACAN DE ROSALES,18,207,1,226,1465
SINALOA,CULIACAN DE ROSALES,6,207,1,214,1465
SINALOA,CULIACAN DE ROSALES,5,181,6,192,1368
SINALOA,CULIACAN DE ROSALES,3,209,4,216,1368
SINALOA,CULIACAN DE ROSALES,7,224,5,236,1443
SINALOA,CULIACAN DE ROSALES,0,271,0,271,1443
SINALOA,CULIACAN DE ROSALES,7,258,0,265,1443
SINALOA,CULIACAN DE ROSALES,3,212,4,219,1566
SINALOA,CULIACAN DE ROSALES,4,229,3,236,1565
SINALOA,CULIACAN DE ROSALES,9,299,3,311,1782
SINALOA,CULIACAN DE ROSALES,6,311,8,325,1782
SINALOA,CULIACAN DE ROSALES,4,214,2,220,1495
SINALOA,CULIACAN DE ROSALES,1,235,5,241,1495
SINALOA,CULIACAN DE ROSALES,2,182,0,184,1275
SINALOA,CULIACAN DE ROSALES,3,179,4,186,1274
SINALOA,CULIACAN DE ROSALES,16,269,2,287,1647
SINALOA,CULIACAN DE ROSALES,5,248,4,257,1647
SINALOA,CULIACAN DE ROSALES,3,135,1,139,1613
SINALOA,CULIACAN DE ROSALES,2,149,0,151,1612
SINALOA,CULIACAN DE ROSALES,2,157,3,162,1612
SINALOA,CULIACAN DE ROSALES,6,144,3,153,1612
SINALOA,CULIACAN DE ROSALES,7,213,2,222,1367
SINALOA,CULIACAN DE ROSALES,5,239,2,246,1367
SINALOA,CULIACAN DE ROSALES,4,256,3,263,1367
SINALOA,CULIACAN DE ROSALES,8,237,3,248,1345
SINALOA,CULIACAN DE ROSALES,8,246,0,254,1345
SINALOA,CULIACAN DE ROSALES,11,220,5,236,1344
SINALOA,CULIACAN DE ROSALES,7,248,1,256,1321
SINALOA,CULIACAN DE ROSALES,5,248,2,255,1320
SINALOA,CULIACAN DE ROSALES,4,241,1,246,1320
SINALOA,CULIACAN DE ROSALES,8,231,2,241,1514
SINALOA,CULIACAN DE ROSALES,8,233,2,243,1513
SINALOA,CULIACAN DE ROSALES,3,246,0,249,1513
SINALOA,CULIACAN DE ROSALES,1,150,4,155,1093
SINALOA,CULIACAN DE ROSALES,8,167,1,176,1093
SINALOA,CULIACAN DE ROSALES,3,265,3,271,1822
SINALOA,CULIACAN DE ROSALES,8,276,4,288,1822
SINALOA,CULIACAN DE ROSALES,11,201,3,215,1424
SINALOA,CULIACAN DE ROSALES,5,191,0,196,1424
SINALOA,CULIACAN DE ROSALES,9,252,1,262,1424
SINALOA,CULIACAN DE ROSALES,4,237,2,243,1327
SINALOA,CULIACAN DE ROSALES,10,211,0,221,1327
SINALOA,CULIACAN DE ROSALES,2,230,2,234,1327
SINALOA,CULIACAN DE ROSALES,1,168,3,172,1362
SINALOA,CULIACAN DE ROSALES,4,168,3,175,1361
SINALOA,CULIACAN DE ROSALES,7,250,2,259,1671
SINALOA,CULIACAN DE ROSALES,11,271,5,287,1671
SINALOA,CULIACAN DE ROSALES,9,276,5,290,1670
SINALOA,CULIACAN DE ROSALES,19,266,4,289,1537
SINALOA,CULIACAN DE ROSALES,10,291,1,302,1537
SINALOA,CULIACAN DE ROSALES,13,273,3,289,1536
SINALOA,CULIACAN DE ROSALES,1,347,2,350,1712
SINALOA,CULIACAN DE ROSALES,3,246,0,249,1712
SINALOA,CULIACAN DE ROSALES,10,198,2,210,1588
SINALOA,CULIACAN DE ROSALES,6,208,1,215,1588
SINALOA,CULIACAN DE ROSALES,11,225,2,238,1587
SINALOA,CULIACAN DE ROSALES,5,178,2,185,1649
SINALOA,CULIACAN DE ROSALES,5,180,4,189,1649
SINALOA,CULIACAN DE ROSALES,5,185,2,192,1649
SINALOA,CULIACAN DE ROSALES,5,215,4,224,1361
SINALOA,CULIACAN DE ROSALES,6,218,0,224,1360
SINALOA,CULIACAN DE ROSALES,5,208,3,216,1460
SINALOA,CULIACAN DE ROSALES,11,232,1,244,1460
SINALOA,CULIACAN DE ROSALES,6,177,3,186,1460
SINALOA,CULIACAN DE ROSALES,5,190,2,197,1944
SINALOA,CULIACAN DE ROSALES,11,193,3,207,1944
SINALOA,CULIACAN DE ROSALES,9,179,2,190,1943
SINALOA,CULIACAN DE ROSALES,20,190,2,212,1943
SINALOA,CULIACAN DE ROSALES,11,189,1,201,1943
SINALOA,CULIACAN DE ROSALES,13,215,0,228,1943
SINALOA,CULIACAN DE ROSALES,8,185,2,195,1943
SINALOA,CULIACAN DE ROSALES,5,209,2,216,1708
SINALOA,CULIACAN DE ROSALES,0,247,2,249,1708
SINALOA,CULIACAN DE ROSALES,7,245,5,257,1707
SINALOA,CULIACAN DE ROSALES,4,232,3,239,1707
SINALOA,CULIACAN DE ROSALES,4,175,3,182,2030
SINALOA,CULIACAN DE ROSALES,5,182,6,193,2029
SINALOA,CULIACAN DE ROSALES,5,176,2,183,2029
SINALOA,CULIACAN DE ROSALES,6,178,0,184,2029
SINALOA,CULIACAN DE ROSALES,0,203,2,205,1811
SINALOA,CULIACAN DE ROSALES,4,196,2,202,1811
SINALOA,CULIACAN DE ROSALES,3,204,1,208,1811
SINALOA,CULIACAN DE ROSALES,3,180,6,189,1811
SINALOA,CULIACAN DE ROSALES,2,157,1,160,1428
SINALOA,CULIACAN DE ROSALES,4,118,3,125,1428
SINALOA,CULIACAN DE ROSALES,7,134,3,144,1368
SINALOA,CULIACAN DE ROSALES,6,132,0,138,1367
SINALOA,CULIACAN DE ROSALES,9,177,2,188,1261
SINALOA,CULIACAN DE ROSALES,5,171,9,185,1261
SINALOA,CULIACAN DE ROSALES,8,286,2,296,1967
SINALOA,CULIACAN DE ROSALES,7,270,8,285,1966
SINALOA,CULIACAN DE ROSALES,8,268,11,287,1966
SINALOA,CULIACAN DE ROSALES,4,121,0,125,1650
SINALOA,CULIACAN DE ROSALES,5,122,1,128,1649
SINALOA,CULIACAN DE ROSALES,3,107,1,111,1649
SINALOA,CULIACAN DE ROSALES,1,151,2,154,1698
SINALOA,CULIACAN DE ROSALES,3,151,2,156,1698
SINALOA,CULIACAN DE ROSALES,4,322,0,326,1838
SINALOA,CULIACAN DE ROSALES,7,277,3,287,1838
SINALOA,CULIACAN DE ROSALES,6,296,1,303,1838
SINALOA,CULIACAN DE ROSALES,4,287,1,292,1838
SINALOA,CULIACAN DE ROSALES,3,249,4,256,1838
SONORA,SAN LUIS RIO COLORADO,16,283,3,302,1789
SONORA,SAN LUIS RIO COLORADO,17,238,4,259,1788
SONORA,SAN LUIS RIO COLORADO,16,157,3,176,1941
SONORA,SAN LUIS RIO COLORADO,13,170,3,186,1940
SONORA,SAN LUIS RIO COLORADO,2,125,0,127,1123
SONORA,SAN LUIS RIO COLORADO,3,104,2,109,1100
SONORA,SAN LUIS RIO COLORADO,13,107,4,124,1846
SONORA,SAN LUIS RIO COLORADO,8,147,0,155,1846
SONORA,SAN LUIS RIO COLORADO,6,136,1,143,1845
SONORA,SAN LUIS RIO COLORADO,10,131,3,144,1711
SONORA,SAN LUIS RIO COLORADO,8,139,2,149,1711
SONORA,SAN LUIS RIO COLORADO,12,81,1,94,1766
SONORA,SAN LUIS RIO COLORADO,6,88,0,94,1765
SONORA,SAN LUIS RIO COLORADO,6,93,2,101,1765
SONORA,SAN LUIS RIO COLORADO,7,118,1,126,1768
SONORA,SAN LUIS RIO COLORADO,15,116,4,135,1767
SONORA,SAN LUIS RIO COLORADO,1,76,2,79,1873
SONORA,SAN LUIS RIO COLORADO,7,90,0,97,1873
SONORA,SAN LUIS RIO COLORADO,5,90,1,96,1873
SONORA,SAN LUIS RIO COLORADO,5,66,1,72,1092
SONORA,SAN LUIS RIO COLORADO,4,101,0,105,1091
SONORA,SAN LUIS RIO COLORADO,27,131,1,159,1823
SONORA,SAN LUIS RIO COLORADO,27,95,2,124,1822
SONORA,SAN LUIS RIO COLORADO,11,80,0,91,1581
SONORA,SAN LUIS RIO COLORADO,9,108,1,118,1580
SONORA,SAN LUIS RIO COLORADO,8,109,0,117,1580
SONORA,SAN LUIS RIO COLORADO,2,115,0,117,1395
SONORA,SAN LUIS RIO COLORADO,7,97,1,105,1395
SONORA,SAN LUIS RIO COLORADO,8,62,1,71,1172
SONORA,SAN LUIS RIO COLORADO,15,55,2,72,1171
SONORA,SAN LUIS RIO COLORADO,20,150,1,171,1804
SONORA,SAN LUIS RIO COLORADO,15,149,7,171,1804
SONORA,SAN LUIS RIO COLORADO,7,66,0,73,1115
SONORA,SAN LUIS RIO COLORADO,7,81,4,92,1115
SONORA,SAN LUIS RIO COLORADO,13,108,0,121,1429
SONORA,SAN LUIS RIO COLORADO,6,119,3,128,1428
SONORA,SAN LUIS RIO COLORADO,6,84,2,92,1368
SONORA,SAN LUIS RIO COLORADO,5,67,2,74,1368
SONORA,SAN LUIS RIO COLORADO,1,66,0,67,1367
SONORA,SAN LUIS RIO COLORADO,3,67,2,72,1558
SONORA,SAN LUIS RIO COLORADO,6,109,1,116,1557
SONORA,SAN LUIS RIO COLORADO,2,104,2,108,1557
SONORA,SAN LUIS RIO COLORADO,2,81,0,83,1557
SONORA,SAN LUIS RIO COLORADO,3,112,3,118,1611
SONORA,SAN LUIS RIO COLORADO,0,94,4,98,1611
SONORA,SAN LUIS RIO COLORADO,4,90,4,98,1775
SONORA,SAN LUIS RIO COLORADO,3,138,1,142,1774
SONORA,SAN LUIS RIO COLORADO,6,125,2,133,1473
SONORA,SAN LUIS RIO COLORADO,7,117,0,124,1472
SONORA,SAN LUIS RIO COLORADO,7,112,1,120,1472
SONORA,SAN LUIS RIO COLORADO,9,359,1,369,1639
SONORA,SAN LUIS RIO COLORADO,7,198,2,207,1732
SONORA,SAN LUIS RIO COLORADO,9,232,2,243,1731
SONORA,SAN LUIS RIO COLORADO,2,150,3,155,1367
SONORA,SAN LUIS RIO COLORADO,2,176,1,179,1367
SONORA,SAN LUIS RIO COLORADO,4,153,1,158,1367
SONORA,SAN LUIS RIO COLORADO,3,200,1,204,1920
SONORA,SAN LUIS RIO COLORADO,5,195,0,200,1920
SONORA,SAN LUIS RIO COLORADO,6,199,3,208,1919
SONORA,SAN LUIS RIO COLORADO,8,156,0,164,1183
SONORA,SAN LUIS RIO COLORADO,6,137,3,146,1183
SONORA,SAN LUIS RIO COLORADO,16,228,2,246,1893
SONORA,SAN LUIS RIO COLORADO,6,250,4,260,1892
SONORA,SAN LUIS RIO COLORADO,7,194,1,202,1967
SONORA,SAN LUIS RIO COLORADO,8,211,4,223,1967
SONORA,SAN LUIS RIO COLORADO,6,207,0,213,1967
SONORA,SAN LUIS RIO COLORADO,9,205,2,216,1967
SONORA,SAN LUIS RIO COLORADO,3,206,1,210,1966
SONORA,SAN LUIS RIO COLORADO,8,194,1,203,1966
SONORA,SAN LUIS RIO COLORADO,5,220,2,227,1966
SONORA,SAN LUIS RIO COLORADO,7,184,2,193,1966
SONORA,SAN LUIS RIO COLORADO,11,295,3,309,1917
SONORA,SAN LUIS RIO COLORADO,18,263,3,284,1917
SONORA,SAN LUIS RIO COLORADO,0,193,4,197,1434
SONORA,SAN LUIS RIO COLORADO,8,134,0,142,1434
SONORA,SAN LUIS RIO COLORADO,0,153,2,155,1434
SONORA,SAN LUIS RIO COLORADO,13,225,0,238,1413
SONORA,SAN LUIS RIO COLORADO,7,203,1,211,1413
SONORA,SAN LUIS RIO COLORADO,2,180,1,183,1664
SONORA,SAN LUIS RIO COLORADO,7,165,1,173,1664
SONORA,SAN LUIS RIO COLORADO,6,187,2,195,1469
SONORA,SAN LUIS RIO COLORADO,9,185,4,198,1469
SONORA,SAN LUIS RIO COLORADO,22,527,4,553,0
SONORA,SAN LUIS RIO COLORADO,16,123,1,140,1361
SONORA,SAN LUIS RIO COLORADO,22,129,1,152,1361
SONORA,SAN LUIS RIO COLORADO,13,140,4,157,1360
SONORA,SAN LUIS RIO COLORADO,6,168,0,174,1830
SONORA,SAN LUIS RIO COLORADO,8,149,1,158,1830
SONORA,SAN LUIS RIO COLORADO,8,135,1,144,1829
SONORA,SAN LUIS RIO COLORADO,7,150,4,161,1829
SONORA,SAN LUIS RIO COLORADO,5,156,0,161,1829
SONORA,SAN LUIS RIO COLORADO,4,128,3,135,1829
SONORA,SAN LUIS RIO COLORADO,7,135,2,144,1530
SONORA,SAN LUIS RIO COLORADO,12,129,2,143,1529
SONORA,SAN LUIS RIO COLORADO,9,186,5,200,1691
SONORA,SAN LUIS RIO COLORADO,13,175,2,190,1690
SONORA,SAN LUIS RIO COLORADO,6,153,1,160,1390
SONORA,SAN LUIS RIO COLORADO,9,122,2,133,1389
SONORA,SAN LUIS RIO COLORADO,11,210,1,222,1389
SONORA,SAN LUIS RIO COLORADO,9,74,1,84,1106
SONORA,SAN LUIS RIO COLORADO,4,74,1,79,1106
SONORA,SAN LUIS RIO COLORADO,10,156,1,167,1844
SONORA,SAN LUIS RIO COLORADO,16,186,2,204,1844
SONORA,SAN LUIS RIO COLORADO,9,301,3,313,1418
SONORA,SAN LUIS RIO COLORADO,3,325,0,328,1417
SONORA,SAN LUIS RIO COLORADO,15,184,4,203,1786
SONORA,SAN LUIS RIO COLORADO,11,171,2,184,1785
SONORA,SAN LUIS RIO COLORADO,14,147,2,163,1524
SONORA,SAN LUIS RIO COLORADO,16,152,2,170,1523
SONORA,SAN LUIS RIO COLORADO,11,170,1,182,1523
SONORA,SAN LUIS RIO COLORADO,14,190,3,207,1966
SONORA,SAN LUIS RIO COLORADO,9,182,7,198,1965
SONORA,SAN LUIS RIO COLORADO,9,155,7,171,1906
SONORA,SAN LUIS RIO COLORADO,8,166,2,176,1905
SONORA,SAN LUIS RIO COLORADO,4,124,1,129,1147
SONORA,SAN LUIS RIO COLORADO,10,125,1,136,1147
SONORA,SAN LUIS RIO COLORADO,15,149,5,169,1489
SONORA,SAN LUIS RIO COLORADO,10,126,4,140,1488
SONORA,SAN LUIS RIO COLORADO,10,127,0,137,1488
SONORA,SAN LUIS RIO COLORADO,6,210,2,218,1935
SONORA,SAN LUIS RIO COLORADO,12,175,3,190,1934
SONORA,SAN LUIS RIO COLORADO,12,120,1,133,1168
SONORA,SAN LUIS RIO COLORADO,14,140,0,154,1168
SONORA,SAN LUIS RIO COLORADO,11,134,2,147,1546
SONORA,SAN LUIS RIO COLORADO,14,140,0,154,1545
SONORA,SAN LUIS RIO COLORADO,15,129,4,148,1545
SONORA,SAN LUIS RIO COLORADO,7,138,1,146,1871
SONORA,SAN LUIS RIO COLORADO,11,219,2,232,1871
SONORA,SAN LUIS RIO COLORADO,12,109,2,123,1386
SONORA,SAN LUIS RIO COLORADO,4,261,1,266,1385
SONORA,SAN LUIS RIO COLORADO,6,115,1,122,1385
SONORA,SAN LUIS RIO COLORADO,11,172,3,186,1870
SONORA,SAN LUIS RIO COLORADO,13,174,3,190,1870
SONORA,SAN LUIS RIO COLORADO,12,166,4,182,1911
SONORA,SAN LUIS RIO COLORADO,8,176,3,187,1910
SONORA,SAN LUIS RIO COLORADO,13,108,1,122,1251
SONORA,SAN LUIS RIO COLORADO,7,145,1,153,1251
SONORA,SAN LUIS RIO COLORADO,5,109,1,115,1433
SONORA,SAN LUIS RIO COLORADO,5,145,2,152,1433
SONORA,SAN LUIS RIO COLORADO,7,161,2,170,1722
SONORA,SAN LUIS RIO COLORADO,19,138,0,157,1721
SONORA,SAN LUIS RIO COLORADO,2,133,1,136,1372
SONORA,SAN LUIS RIO COLORADO,4,120,1,125,1371
SONORA,SAN LUIS RIO COLORADO,7,126,2,135,1371
SONORA,SAN LUIS RIO COLORADO,5,139,3,147,1492
SONORA,SAN LUIS RIO COLORADO,4,127,2,133,1492
SONORA,SAN LUIS RIO COLORADO,2,119,3,124,1492
SONORA,SAN LUIS RIO COLORADO,5,124,1,130,1492
SONORA,SAN LUIS RIO COLORADO,5,140,1,146,1872
SONORA,SAN LUIS RIO COLORADO,6,163,0,169,1871
SONORA,SAN LUIS RIO COLORADO,2,93,1,96,1162
SONORA,SAN LUIS RIO COLORADO,1,80,0,81,1162
SONORA,SAN LUIS RIO COLORADO,3,144,1,148,1868
SONORA,SAN LUIS RIO COLORADO,7,118,1,126,1868
SONORA,SAN LUIS RIO COLORADO,6,128,2,136,1868
SONORA,SAN LUIS RIO COLORADO,3,133,0,136,1868
SONORA,SAN LUIS RIO COLORADO,4,147,0,151,1868
SONORA,SAN LUIS RIO COLORADO,9,156,0,165,1868
SONORA,SAN LUIS RIO COLORADO,2,130,3,135,1868
SONORA,SAN LUIS RIO COLORADO,0,166,2,168,1916
SONORA,SAN LUIS RIO COLORADO,5,147,0,152,1916
SONORA,SAN LUIS RIO COLORADO,5,128,0,133,1916
SONORA,SAN LUIS RIO COLORADO,7,133,3,143,1916
SONORA,SAN LUIS RIO COLORADO,5,128,1,134,1916
SONORA,SAN LUIS RIO COLORADO,7,122,2,131,1916
SONORA,SAN LUIS RIO COLORADO,9,117,0,126,1315
SONORA,SAN LUIS RIO COLORADO,3,105,5,113,1315
SONORA,SAN LUIS RIO COLORADO,8,165,6,179,1314
SONORA,SAN LUIS RIO COLORADO,5,136,4,145,1769
SONORA,SAN LUIS RIO COLORADO,7,120,1,128,1768
SONORA,SAN LUIS RIO COLORADO,5,136,2,143,1768
SONORA,SAN LUIS RIO COLORADO,6,144,4,154,1488
SONORA,SAN LUIS RIO COLORADO,4,108,1,113,1487
SONORA,SAN LUIS RIO COLORADO,6,385,5,396,1940
SONORA,SAN LUIS RIO COLORADO,8,180,4,192,1939
SONORA,SAN LUIS RIO COLORADO,21,156,3,180,1766
SONORA,SAN LUIS RIO COLORADO,18,146,4,168,1765
SONORA,SAN LUIS RIO COLORADO,11,233,2,246,1705
SONORA,SAN LUIS RIO COLORADO,9,202,9,220,1705
SONORA,SAN LUIS RIO COLORADO,10,188,5,203,1381
SONORA,SAN LUIS RIO COLORADO,9,177,4,190,1380
SONORA,SAN LUIS RIO COLORADO,7,202,1,210,1334
SONORA,SAN LUIS RIO COLORADO,7,162,4,173,1334
SONORA,SAN LUIS RIO COLORADO,4,183,2,189,1334
SONORA,SAN LUIS RIO COLORADO,9,160,4,173,1292
SONORA,SAN LUIS RIO COLORADO,11,156,2,169,1292
SONORA,NOGALES,9,208,2,219,2147
SONORA,NOGALES,11,194,4,209,2146
SONORA,NOGALES,9,103,0,112,1289
SONORA,NOGALES,5,108,0,113,1289
SONORA,NOGALES,17,158,1,176,1299
SONORA,NOGALES,17,120,1,138,1299
SONORA,NOGALES,3,135,0,138,1343
SONORA,NOGALES,1,115,1,117,1343
SONORA,NOGALES,8,200,2,210,1827
SONORA,NOGALES,6,216,0,222,1827
SONORA,NOGALES,11,157,2,170,1827
SONORA,NOGALES,7,131,0,138,1635
SONORA,NOGALES,5,137,3,145,1634
SONORA,NOGALES,6,167,1,174,1603
SONORA,NOGALES,2,150,2,154,1602
SONORA,NOGALES,10,175,1,186,1602
SONORA,NOGALES,6,156,0,162,1602
SONORA,NOGALES,7,248,3,258,1926
SONORA,NOGALES,6,145,1,152,1513
SONORA,NOGALES,11,146,2,159,1513
SONORA,NOGALES,11,184,1,196,1600
SONORA,NOGALES,1,189,0,190,1600
SONORA,NOGALES,10,167,0,177,1600
SONORA,NOGALES,7,152,1,160,1630
SONORA,NOGALES,6,177,4,187,1630
SONORA,NOGALES,9,149,1,159,1629
SONORA,NOGALES,7,138,0,145,1629
SONORA,NOGALES,4,164,0,168,1407
SONORA,NOGALES,2,169,0,171,1407
SONORA,NOGALES,2,140,0,142,1406
SONORA,NOGALES,7,119,1,127,1583
SONORA,NOGALES,3,137,0,140,1583
SONORA,NOGALES,6,138,4,148,1582
SONORA,NOGALES,5,130,1,136,1582
SONORA,NOGALES,4,148,0,152,1582
SONORA,NOGALES,9,253,3,265,2146
SONORA,NOGALES,4,134,2,140,1539
SONORA,NOGALES,10,141,0,151,1539
SONORA,NOGALES,3,174,0,177,1538
SONORA,NOGALES,11,190,5,206,1956
SONORA,NOGALES,9,265,3,277,1956
SONORA,NOGALES,8,142,5,155,2099
SONORA,NOGALES,10,118,3,131,2099
SONORA,NOGALES,7,229,4,240,1708
SONORA,NOGALES,11,199,3,213,1707
SONORA,NOGALES,3,145,4,152,1242
SONORA,NOGALES,2,148,3,153,1241
SONORA,NOGALES,8,110,1,119,1323
SONORA,NOGALES,1,108,3,112,1322
SONORA,NOGALES,4,132,2,138,1322
SONORA,NOGALES,4,140,1,145,1586
SONORA,NOGALES,6,148,2,156,1586
SONORA,NOGALES,9,149,0,158,1586
SONORA,NOGALES,9,148,1,158,1586
SONORA,NOGALES,3,137,0,140,1585
SONORA,NOGALES,7,210,1,218,1915
SONORA,NOGALES,9,247,3,259,1915
SONORA,NOGALES,2,166,1,169,1682
SONORA,NOGALES,7,193,0,200,1681
SONORA,NOGALES,7,283,2,292,1899
SONORA,NOGALES,4,278,4,286,1898
SONORA,NOGALES,2,122,3,127,1950
SONORA,NOGALES,2,116,9,127,1949
SONORA,NOGALES,1,148,4,153,1589
SONORA,NOGALES,9,140,3,152,1589
SONORA,NOGALES,5,154,0,159,1790
SONORA,NOGALES,2,128,1,131,1789
SONORA,NOGALES,5,129,1,135,1789
SONORA,NOGALES,2,94,3,99,1606
SONORA,NOGALES,1,92,1,94,1606
SONORA,NOGALES,3,102,0,105,1606
SONORA,NOGALES,8,124,7,139,1902
SONORA,NOGALES,12,118,2,132,1902
SONORA,NOGALES,15,146,3,164,1653
SONORA,NOGALES,8,137,2,147,1652
SONORA,NOGALES,7,147,1,155,1588
SONORA,NOGALES,14,121,0,135,1588
SONORA,NOGALES,4,80,0,84,1449
SONORA,NOGALES,5,94,0,99,1449
SONORA,NOGALES,4,73,2,79,1448
SONORA,NOGALES,4,114,1,119,1703
SONORA,NOGALES,11,114,0,125,1703
SONORA,NOGALES,5,116,2,123,1703
SONORA,NOGALES,9,58,0,67,1337
SONORA,NOGALES,6,81,1,88,1336
SONORA,NOGALES,5,72,0,77,1336
SONORA,NOGALES,7,137,2,146,2138
SONORA,NOGALES,10,99,0,109,1299
SONORA,NOGALES,3,116,1,120,1298
SONORA,NOGALES,11,72,0,83,1195
SONORA,NOGALES,4,76,1,81,1194
SONORA,NOGALES,9,97,2,108,1178
SONORA,NOGALES,8,96,2,106,1177
SONORA,NOGALES,6,165,1,172,1932
SONORA,NOGALES,7,128,2,137,1931
SONORA,NOGALES,3,97,0,100,1424
SONORA,NOGALES,1,75,2,78,1423
SONORA,NOGALES,6,121,0,127,1433
SONORA,NOGALES,4,96,0,100,1432
SONORA,NOGALES,8,85,0,93,1548
SONORA,NOGALES,8,84,0,92,1548
SONORA,NOGALES,3,82,1,86,1548
SONORA,NOGALES,17,183,4,204,1892
SONORA,NOGALES,16,160,4,180,1891
SONORA,NOGALES,4,115,0,119,1787
SONORA,NOGALES,7,135,2,144,1786
SONORA,NOGALES,6,104,1,111,1682
SONORA,NOGALES,6,122,1,129,1681
SONORA,NOGALES,6,81,0,87,1131
SONORA,NOGALES,12,86,1,99,1130
SONORA,NOGALES,13,121,1,135,1744
SONORA,NOGALES,7,89,1,97,1744
SONORA,NOGALES,13,114,3,130,1744
SONORA,NOGALES,9,170,0,179,1874
SONORA,NOGALES,11,166,0,177,1874
SONORA,NOGALES,1,247,1,249,1339
SONORA,NOGALES,4,190,46,240,1338
SONORA,NOGALES,4,119,0,123,1800
SONORA,NOGALES,5,137,2,144,1799
SONORA,NOGALES,3,130,6,139,1972
SONORA,NOGALES,4,101,2,107,1565
SONORA,NOGALES,2,91,1,94,1565
SONORA,NOGALES,6,125,0,131,1622
SONORA,NOGALES,2,142,1,145,1622
SONORA,NOGALES,4,105,0,109,1368
SONORA,NOGALES,2,102,1,105,1368
SONORA,NOGALES,3,88,1,92,1367
SONORA,NOGALES,3,126,1,130,1954
SONORA,NOGALES,6,115,0,121,1953
SONORA,NOGALES,4,90,0,94,1446
SONORA,NOGALES,5,101,0,106,1446
SONORA,NOGALES,3,115,0,118,1287
SONORA,NOGALES,5,116,0,121,1286
SONORA,NOGALES,3,146,0,149,1673
SONORA,NOGALES,6,180,1,187,1673
SONORA,NOGALES,4,114,1,119,1668
SONORA,NOGALES,4,131,3,138,1668
SONORA,NOGALES,15,137,0,152,1838
SONORA,NOGALES,7,147,1,155,1837
SONORA,NOGALES,10,168,2,180,1914
SONORA,NOGALES,8,150,1,159,1914
SONORA,NOGALES,7,135,0,142,1913
SONORA,NOGALES,12,154,2,168,1913
SONORA,NOGALES,8,164,1,173,1913
SONORA,NOGALES,5,135,0,140,1171
SONORA,NOGALES,3,108,1,112,1170
SONORA,NOGALES,12,191,0,203,1952
SONORA,NOGALES,24,176,0,200,1952
SONORA,NOGALES,7,158,1,166,1970
SONORA,NOGALES,8,172,0,180,1970
SONORA,NOGALES,12,188,1,201,1970
SONORA,NOGALES,10,170,0,180,1970
SONORA,NOGALES,6,176,3,185,1970
SONORA,NOGALES,10,161,0,171,1970
SONORA,NOGALES,6,148,0,154,1969
SONORA,NOGALES,4,85,1,90,1474
SONORA,NOGALES,4,64,0,68,1473
SONORA,NOGALES,7,72,0,79,1473
SONORA,NOGALES,8,215,1,224,1861
SONORA,NOGALES,9,184,3,196,1861
SONORA,NOGALES,9,179,1,189,1860
SONORA,NOGALES,10,192,1,203,1860
SONORA,NOGALES,6,116,1,123,1643
SONORA,NOGALES,3,141,0,144,1642
SONORA,NOGALES,3,128,1,132,1642
SONORA,NOGALES,13,180,0,193,1785
SONORA,NOGALES,9,184,0,193,1785
SONORA,NOGALES,4,165,0,169,1785
SONORA,NOGALES,6,190,1,197,1785
SONORA,NOGALES,4,178,2,184,1785
SONORA,NOGALES,7,157,0,164,1785
SONORA,NOGALES,29,765,6,800,0
SONORA,NOGALES,7,161,0,168,1380
SONORA,NOGALES,11,142,3,156,1379
SONORA,NOGALES,3,116,1,120,1448
SONORA,NOGALES,10,107,1,118,1447
SONORA,NOGALES,2,70,2,74,1644
SONORA,NOGALES,2,79,1,82,1644
SONORA,NOGALES,4,161,0,165,1887
SONORA,NOGALES,4,153,0,157,1887
SONORA,NOGALES,3,117,1,121,1342
SONORA,NOGALES,5,135,0,140,1341
SONORA,NOGALES,7,155,3,165,1879
SONORA,NOGALES,12,171,0,183,1879
SONORA,NOGALES,12,224,0,236,1685
SONORA,NOGALES,13,189,0,202,1685
SONORA,NOGALES,9,82,2,93,1323
SONORA,NOGALES,3,93,0,96,1323
SONORA,NOGALES,3,102,0,105,1323
SONORA,NOGALES,3,111,1,115,1316
SONORA,NOGALES,3,99,0,102,1315
SONORA,NOGALES,5,93,0,98,1315
SONORA,NOGALES,5,102,0,107,1823
SONORA,NOGALES,1,108,1,110,1822
SONORA,NOGALES,8,100,0,108,1822
SONORA,NOGALES,4,112,0,116,1682
SONORA,NOGALES,4,115,6,125,1681
SONORA,NOGALES,2,86,0,88,1681
SONORA,NOGALES,4,100,0,104,1681
SONORA,NOGALES,0,135,5,140,1909
SONORA,NOGALES,5,126,0,131,1909
SONORA,NOGALES,1,146,4,151,1909
SONORA,NOGALES,8,140,1,149,1749
SONORA,NOGALES,2,107,0,109,1749
SONORA,NOGALES,4,120,20,144,1748
SONORA,NOGALES,7,174,1,182,2077
SONORA,NOGALES,8,228,0,236,2077
SONORA,NOGALES,7,210,1,218,2076
SONORA,NOGALES,0,135,1,136,1876
SONORA,NOGALES,1,161,10,172,1876
SONORA,NOGALES,6,134,1,141,1372
SONORA,NOGALES,2,142,0,144,1372
SONORA,NOGALES,4,122,1,127,1372
SONORA,HERMOSILLO,8,202,2,212,1665
SONORA,HERMOSILLO,4,195,0,199,1665
SONORA,HERMOSILLO,7,187,4,198,1665
SONORA,HERMOSILLO,7,176,2,185,1664
SONORA,HERMOSILLO,2,201,3,206,1845
SONORA,HERMOSILLO,9,219,2,230,1845
SONORA,HERMOSILLO,8,224,2,234,1923
SONORA,HERMOSILLO,10,195,2,207,1923
SONORA,HERMOSILLO,10,210,1,221,1923
SONORA,HERMOSILLO,9,181,0,190,1683
SONORA,HERMOSILLO,15,205,1,221,1682
SONORA,HERMOSILLO,8,176,1,185,1773
SONORA,HERMOSILLO,6,179,0,185,1773
SONORA,HERMOSILLO,8,186,1,195,1772
SONORA,HERMOSILLO,11,178,3,192,1772
SONORA,HERMOSILLO,7,198,1,206,1772
SONORA,HERMOSILLO,13,182,2,197,1571
SONORA,HERMOSILLO,18,174,5,197,1571
SONORA,HERMOSILLO,17,174,3,194,1571
SONORA,HERMOSILLO,18,178,0,196,1788
SONORA,HERMOSILLO,16,191,4,211,1788
SONORA,HERMOSILLO,14,188,2,204,1787
SONORA,HERMOSILLO,11,198,4,213,1560
SONORA,HERMOSILLO,10,189,1,200,1559
SONORA,HERMOSILLO,8,213,2,223,1885
SONORA,HERMOSILLO,7,273,5,285,1884
SONORA,HERMOSILLO,7,203,1,211,1678
SONORA,HERMOSILLO,6,215,4,225,1678
SONORA,HERMOSILLO,10,181,2,193,1233
SONORA,HERMOSILLO,4,188,0,192,1233
SONORA,HERMOSILLO,11,221,1,233,1686
SONORA,HERMOSILLO,11,220,1,232,1685
SONORA,HERMOSILLO,21,159,3,183,1475
SONORA,HERMOSILLO,24,110,1,135,1474
SONORA,HERMOSILLO,20,160,0,180,1474
SONORA,HERMOSILLO,6,250,0,256,1812
SONORA,HERMOSILLO,10,261,1,272,1812
SONORA,HERMOSILLO,3,199,1,203,1608
SONORA,HERMOSILLO,5,220,3,228,1607
SONORA,HERMOSILLO,16,257,0,273,1636
SONORA,HERMOSILLO,15,254,1,270,1635
SONORA,HERMOSILLO,13,235,2,250,1635
SONORA,HERMOSILLO,10,274,0,284,1777
SONORA,HERMOSILLO,12,302,1,315,1776
SONORA,HERMOSILLO,14,182,1,197,1373
SONORA,HERMOSILLO,9,207,3,219,1373
SONORA,HERMOSILLO,9,204,1,214,1372
SONORA,HERMOSILLO,6,147,1,154,1744
SONORA,HERMOSILLO,8,174,2,184,1743
SONORA,HERMOSILLO,6,168,0,174,1743
SONORA,HERMOSILLO,7,190,4,201,1743
SONORA,HERMOSILLO,7,135,1,143,1743
SONORA,HERMOSILLO,5,155,0,160,1743
SONORA,HERMOSILLO,10,232,1,243,1934
SONORA,HERMOSILLO,23,202,4,229,1934
SONORA,HERMOSILLO,14,290,5,309,1939
SONORA,HERMOSILLO,11,279,1,291,1939
SONORA,HERMOSILLO,10,209,4,223,1537
SONORA,HERMOSILLO,14,225,3,242,1536
SONORA,HERMOSILLO,22,234,4,260,1656
SONORA,HERMOSILLO,14,245,2,261,1655
SONORA,HERMOSILLO,12,279,2,293,1945
SONORA,HERMOSILLO,12,258,1,271,1944
SONORA,HERMOSILLO,13,305,0,318,1976
SONORA,HERMOSILLO,20,280,5,305,1976
SONORA,HERMOSILLO,17,210,2,229,1381
SONORA,HERMOSILLO,13,236,0,249,1381
SONORA,HERMOSILLO,32,214,5,251,1742
SONORA,HERMOSILLO,20,225,1,246,1741
SONORA,HERMOSILLO,20,242,1,263,1630
SONORA,HERMOSILLO,18,239,3,260,1630
SONORA,HERMOSILLO,11,178,0,189,1174
SONORA,HERMOSILLO,5,166,1,172,1173
SONORA,HERMOSILLO,22,250,3,275,1844
SONORA,HERMOSILLO,17,274,0,291,1843
SONORA,HERMOSILLO,7,151,1,159,1052
SONORA,HERMOSILLO,4,149,1,154,1052
SONORA,HERMOSILLO,20,177,1,198,1391
SONORA,HERMOSILLO,24,157,2,183,1391
SONORA,HERMOSILLO,17,183,1,201,1391
SONORA,HERMOSILLO,24,278,2,304,1828
SONORA,HERMOSILLO,19,252,4,275,1828
SONORA,HERMOSILLO,13,160,0,173,1163
SONORA,HERMOSILLO,17,157,0,174,1162
SONORA,HERMOSILLO,18,231,2,251,1682
SONORA,HERMOSILLO,19,222,2,243,1682
SONORA,HERMOSILLO,6,230,3,239,1681
SONORA,HERMOSILLO,17,254,0,271,1813
SONORA,HERMOSILLO,11,254,6,271,1813
SONORA,HERMOSILLO,9,240,0,249,1719
SONORA,HERMOSILLO,20,266,0,286,1719
SONORA,HERMOSILLO,7,185,0,192,1427
SONORA,HERMOSILLO,9,156,2,167,1427
SONORA,HERMOSILLO,7,170,1,178,1427
SONORA,HERMOSILLO,13,255,3,271,1968
SONORA,HERMOSILLO,12,270,2,284,1968
SONORA,HERMOSILLO,8,172,2,182,1181
SONORA,HERMOSILLO,8,171,2,181,1180
SONORA,HERMOSILLO,5,208,1,214,1425
SONORA,HERMOSILLO,5,207,4,216,1425
SONORA,HERMOSILLO,3,255,1,259,1563
SONORA,HERMOSILLO,28,248,2,278,1562
SONORA,HERMOSILLO,6,205,0,211,1322
SONORA,HERMOSILLO,8,198,0,206,1321
SONORA,HERMOSILLO,19,218,1,238,1715
SONORA,HERMOSILLO,12,199,0,211,1715
SONORA,HERMOSILLO,28,219,0,247,1963
SONORA,HERMOSILLO,28,280,2,310,1963
SONORA,HERMOSILLO,31,182,0,213,1922
SONORA,HERMOSILLO,14,204,0,218,1922
SONORA,HERMOSILLO,21,180,3,204,1922
SONORA,HERMOSILLO,19,163,2,184,1921
SONORA,HERMOSILLO,125,1118,20,1263,0
SONORA,HERMOSILLO,6,198,4,208,1557
SONORA,HERMOSILLO,5,198,0,203,1557
SONORA,HERMOSILLO,0,248,2,250,1557
SONORA,HERMOSILLO,4,209,1,214,1556
SONORA,HERMOSILLO,5,93,2,100,1311
SONORA,HERMOSILLO,5,95,2,102,1310
SONORA,HERMOSILLO,3,145,5,153,1852
SONORA,HERMOSILLO,8,139,1,148,1852
SONORA,HERMOSILLO,2,135,1,138,1852
SONORA,HERMOSILLO,6,161,7,174,1852
SONORA,HERMOSILLO,0,143,3,146,1852
SONORA,HERMOSILLO,3,150,1,154,1851
SONORA,HERMOSILLO,4,134,0,138,1130
SONORA,HERMOSILLO,8,134,3,145,1129
SONORA,HERMOSILLO,3,127,6,136,1322
SONORA,HERMOSILLO,5,123,8,136,1322
SONORA,HERMOSILLO,8,151,2,161,1593
SONORA,HERMOSILLO,0,168,4,172,1592
SONORA,HERMOSILLO,3,142,3,148,1592
SONORA,HERMOSILLO,8,99,2,109,1966
SONORA,HERMOSILLO,4,94,0,98,1965
SONORA,HERMOSILLO,6,123,0,129,1965
SONORA,HERMOSILLO,5,105,2,112,1965
SONORA,HERMOSILLO,4,99,2,105,1965
SONORA,HERMOSILLO,8,114,0,122,1965
SONORA,HERMOSILLO,5,124,2,131,1965
SONORA,HERMOSILLO,8,102,2,112,1965
SONORA,HERMOSILLO,3,115,0,118,1965
SONORA,HERMOSILLO,3,109,1,113,1965
SONORA,HERMOSILLO,12,165,0,177,1875
SONORA,HERMOSILLO,10,170,4,184,1875
SONORA,HERMOSILLO,9,109,0,118,1508
SONORA,HERMOSILLO,9,130,1,140,1508
SONORA,HERMOSILLO,5,134,0,139,1508
SONORA,HERMOSILLO,1,136,0,137,1825
SONORA,HERMOSILLO,6,135,1,142,1825
SONORA,HERMOSILLO,5,134,0,139,1569
SONORA,HERMOSILLO,5,128,0,133,1569
SONORA,HERMOSILLO,8,182,3,193,1884
SONORA,HERMOSILLO,11,173,2,186,1884
SONORA,HERMOSILLO,12,185,3,200,1825
SONORA,HERMOSILLO,15,190,5,210,1825
SONORA,HERMOSILLO,13,151,2,166,1666
SONORA,HERMOSILLO,7,150,1,158,1665
SONORA,HERMOSILLO,6,180,3,189,1660
SONORA,HERMOSILLO,4,177,0,181,1660
SONORA,HERMOSILLO,10,190,0,200,1959
SONORA,HERMOSILLO,5,181,3,189,1958
SONORA,HERMOSILLO,4,146,1,151,1338
SONORA,HERMOSILLO,1,162,2,165,1337
SONORA,HERMOSILLO,2,214,3,219,1803
SONORA,HERMOSILLO,5,155,0,160,1802
SONORA,HERMOSILLO,16,172,0,188,1451
SONORA,HERMOSILLO,10,156,1,167,1451
SONORA,HERMOSILLO,13,194,2,209,1450
SONORA,HERMOSILLO,25,237,1,263,1691
SONORA,HERMOSILLO,14,202,1,217,1691
SONORA,HERMOSILLO,16,174,1,191,1933
SONORA,HERMOSILLO,20,199,4,223,1933
SONORA,HERMOSILLO,18,170,0,188,1714
SONORA,HERMOSILLO,19,177,0,196,1714
SONORA,HERMOSILLO,9,167,1,177,1763
SONORA,HERMOSILLO,12,178,1,191,1762
SONORA,HERMOSILLO,6,115,0,121,1585
SONORA,HERMOSILLO,5,110,1,116,1585
SONORA,HERMOSILLO,4,55,0,59,1405
SONORA,HERMOSILLO,1,59,1,61,1405
SONORA,HERMOSILLO,0,78,1,79,1404
SONORA,HERMOSILLO,17,145,1,163,1529
SONORA,HERMOSILLO,24,153,0,177,1528
SONORA,HERMOSILLO,8,123,1,132,1483
SONORA,HERMOSILLO,10,148,2,160,1483
SONORA,HERMOSILLO,13,129,1,143,1483
SONORA,HERMOSILLO,6,128,0,134,1626
SONORA,HERMOSILLO,5,117,1,123,1625
SONORA,HERMOSILLO,7,100,0,107,1625
SONORA,HERMOSILLO,6,132,0,138,1625
SONORA,HERMOSILLO,5,149,0,154,1625
SONORA,HERMOSILLO,7,135,7,149,1620
SONORA,HERMOSILLO,5,146,1,152,1620
SONORA,HERMOSILLO,21,114,0,135,1525
SONORA,HERMOSILLO,20,114,0,134,1525
SONORA,HERMOSILLO,24,125,2,151,1525
SONORA,HERMOSILLO,30,137,0,167,1849
SONORA,HERMOSILLO,19,133,0,152,1849
SONORA,GUAYMAS,5,158,0,163,1231
SONORA,GUAYMAS,3,161,2,166,1231
SONORA,GUAYMAS,6,257,4,267,1798
SONORA,GUAYMAS,5,161,3,169,1283
SONORA,GUAYMAS,15,210,3,228,1282
SONORA,GUAYMAS,12,283,6,301,1676
SONORA,GUAYMAS,4,296,4,304,1675
SONORA,GUAYMAS,14,165,2,181,1655
SONORA,GUAYMAS,16,182,1,199,1655
SONORA,GUAYMAS,5,245,1,251,1759
SONORA,GUAYMAS,10,198,8,216,1759
SONORA,GUAYMAS,16,279,0,295,1384
SONORA,GUAYMAS,19,262,2,283,1383
SONORA,GUAYMAS,15,315,9,339,1248
SONORA,GUAYMAS,21,301,2,324,1248
SONORA,GUAYMAS,1,207,0,208,1236
SONORA,GUAYMAS,1,236,0,237,1235
SONORA,GUAYMAS,16,196,2,214,1973
SONORA,GUAYMAS,0,194,2,196,1973
SONORA,GUAYMAS,3,141,2,146,1692
SONORA,GUAYMAS,6,140,0,146,1692
SONORA,GUAYMAS,10,156,4,170,1022
SONORA,GUAYMAS,4,125,0,129,1021
SONORA,GUAYMAS,3,137,0,140,1189
SONORA,GUAYMAS,10,103,0,113,1188
SONORA,GUAYMAS,3,192,7,202,1449
SONORA,GUAYMAS,3,206,6,215,1449
SONORA,GUAYMAS,25,253,4,282,1933
SONORA,GUAYMAS,21,252,3,276,1932
SONORA,GUAYMAS,7,177,8,192,1510
SONORA,GUAYMAS,10,178,2,190,1510
SONORA,GUAYMAS,9,172,2,183,1580
SONORA,GUAYMAS,3,153,1,157,1579
SONORA,GUAYMAS,1,191,4,196,1579
SONORA,GUAYMAS,5,201,0,206,1865
SONORA,GUAYMAS,10,175,2,187,1876
SONORA,GUAYMAS,16,186,2,204,1876
SONORA,GUAYMAS,1,129,1,131,1588
SONORA,GUAYMAS,5,120,1,126,1587
SONORA,GUAYMAS,8,109,0,117,1165
SONORA,GUAYMAS,6,113,1,120,1165
SONORA,GUAYMAS,6,100,1,107,1550
SONORA,GUAYMAS,1,89,1,91,1550
SONORA,GUAYMAS,3,101,0,104,1789
SONORA,GUAYMAS,4,188,3,195,1425
SONORA,GUAYMAS,1,145,1,147,1425
SONORA,GUAYMAS,7,182,2,191,1803
SONORA,GUAYMAS,5,191,2,198,1803
SONORA,GUAYMAS,3,120,0,123,1272
SONORA,GUAYMAS,2,118,2,122,1271
SONORA,GUAYMAS,20,279,5,304,1652
SONORA,GUAYMAS,6,253,3,262,1652
SONORA,GUAYMAS,3,164,0,167,988
SONORA,GUAYMAS,1,156,2,159,987
SONORA,GUAYMAS,12,365,6,383,1909
SONORA,GUAYMAS,11,104,2,117,1522
SONORA,GUAYMAS,4,101,3,108,1522
SONORA,GUAYMAS,4,131,4,139,1522
SONORA,GUAYMAS,5,93,5,103,1522
SONORA,GUAYMAS,5,166,1,172,1458
SONORA,GUAYMAS,4,221,0,225,1457
SONORA,GUAYMAS,8,281,4,293,1564
SONORA,GUAYMAS,8,258,5,271,1564
SONORA,GUAYMAS,7,335,7,349,1890
SONORA,GUAYMAS,5,388,2,395,1889
SONORA,GUAYMAS,9,265,2,276,1871
SONORA,GUAYMAS,3,257,3,263,1871
SONORA,GUAYMAS,4,203,0,207,1871
SONORA,GUAYMAS,5,232,0,237,1393
SONORA,GUAYMAS,8,392,0,400,1393
SONORA,GUAYMAS,11,245,1,257,1392
SONORA,GUAYMAS,9,340,3,352,1535
SONORA,GUAYMAS,4,321,2,327,1535
SONORA,GUAYMAS,5,352,3,360,1535
SONORA,GUAYMAS,6,307,3,316,1345
SONORA,GUAYMAS,4,303,1,308,1344
SONORA,GUAYMAS,1,144,4,149,1137
SONORA,GUAYMAS,3,152,1,156,1137
SONORA,GUAYMAS,6,296,1,303,1754
SONORA,GUAYMAS,3,278,5,286,1754
SONORA,GUAYMAS,1,207,1,209,1712
SONORA,GUAYMAS,0,171,5,176,1712
SONORA,GUAYMAS,1,214,3,218,1711
SONORA,GUAYMAS,5,183,0,188,1353
SONORA,GUAYMAS,3,184,1,188,1353
SONORA,GUAYMAS,2,158,0,160,1353
SONORA,GUAYMAS,1,440,0,441,1509
SONORA,GUAYMAS,3,261,2,266,1509
SONORA,GUAYMAS,7,261,2,270,1509
SONORA,GUAYMAS,0,265,5,270,1509
SONORA,GUAYMAS,5,333,1,339,1619
SONORA,GUAYMAS,8,223,0,231,1619
SONORA,GUAYMAS,0,213,2,215,1619
SONORA,GUAYMAS,3,313,2,318,1386
SONORA,GUAYMAS,3,278,2,283,1386
SONORA,GUAYMAS,0,240,6,246,1602
SONORA,GUAYMAS,4,267,6,277,1602
SONORA,GUAYMAS,2,200,3,205,1734
SONORA,GUAYMAS,2,202,4,208,1733
SONORA,GUAYMAS,3,212,1,216,1733
SONORA,GUAYMAS,5,225,1,231,1722
SONORA,GUAYMAS,3,229,1,233,1722
SONORA,GUAYMAS,6,245,3,254,1722
SONORA,GUAYMAS,14,174,3,191,1356
SONORA,GUAYMAS,13,178,1,192,1355
SONORA,GUAYMAS,8,200,0,208,1355
SONORA,GUAYMAS,6,279,1,286,1631
SONORA,GUAYMAS,7,268,1,276,1630
SONORA,GUAYMAS,9,317,2,328,1630
SONORA,GUAYMAS,3,405,2,410,1919
SONORA,GUAYMAS,11,350,5,366,1918
SONORA,GUAYMAS,4,184,2,190,1055
SONORA,GUAYMAS,3,445,2,450,1054
SONORA,GUAYMAS,7,149,0,156,1475
SONORA,GUAYMAS,13,136,0,149,1475
SONORA,GUAYMAS,11,142,0,153,1475
SONORA,GUAYMAS,15,285,2,302,1758
SONORA,GUAYMAS,17,267,10,294,1758
SONORA,GUAYMAS,13,283,2,298,1757
SONORA,GUAYMAS,16,210,2,228,1551
SONORA,GUAYMAS,9,188,1,198,1550
SONORA,GUAYMAS,7,240,1,248,1550
SONORA,GUAYMAS,82,1021,1,1104,0
SONORA,GUAYMAS,6,240,1,247,1491
SONORA,GUAYMAS,7,247,4,258,1490
SONORA,GUAYMAS,9,244,1,254,1349
SONORA,GUAYMAS,7,466,1,474,1348
SONORA,GUAYMAS,5,226,5,236,1694
SONORA,GUAYMAS,7,252,1,260,1694
SONORA,GUAYMAS,9,315,3,327,1762
SONORA,GUAYMAS,8,378,4,390,1762
SONORA,GUAYMAS,6,233,2,241,1543
SONORA,GUAYMAS,14,260,1,275,1543
SONORA,GUAYMAS,9,485,4,498,1832
SONORA,GUAYMAS,5,356,2,363,1832
SONORA,GUAYMAS,4,248,0,252,1831
SONORA,GUAYMAS,9,279,3,291,1667
SONORA,GUAYMAS,7,711,1,719,1667
SONORA,GUAYMAS,4,149,1,154,1053
SONORA,GUAYMAS,3,175,2,180,1053
SONORA,GUAYMAS,6,267,3,276,1746
SONORA,GUAYMAS,5,262,1,268,1746
SONORA,GUAYMAS,7,233,1,241,1642
SONORA,GUAYMAS,4,501,1,506,1642
SONORA,GUAYMAS,8,255,5,268,1641
SONORA,GUAYMAS,5,167,2,174,1406
SONORA,GUAYMAS,6,146,2,154,1406
SONORA,GUAYMAS,8,147,4,159,1405
SONORA,GUAYMAS,2,1022,2,1026,1321
SONORA,GUAYMAS,0,1123,0,1123,1321
SONORA,GUAYMAS,3,854,85,942,1321
SONORA,GUAYMAS,5,116,3,124,1242
SONORA,GUAYMAS,3,118,2,123,1242
SONORA,GUAYMAS,4,354,3,361,1540
SONORA,GUAYMAS,3,312,5,320,1540
SONORA,GUAYMAS,2,344,3,349,1540
SONORA,GUAYMAS,6,311,5,322,1421
SONORA,GUAYMAS,6,325,3,334,1420
SONORA,GUAYMAS,3,283,2,288,1852
SONORA,GUAYMAS,2,320,8,330,1852
SONORA,GUAYMAS,5,307,3,315,1852
SONORA,GUAYMAS,1,113,18,132,1125
SONORA,GUAYMAS,2,163,0,165,1124
SONORA,GUAYMAS,4,253,0,257,1820
SONORA,GUAYMAS,9,241,1,251,1819
SONORA,GUAYMAS,4,210,1,215,1324
SONORA,GUAYMAS,1,209,1,211,1324
SONORA,GUAYMAS,3,214,2,219,1324
SONORA,GUAYMAS,2,269,1,272,1368
SONORA,GUAYMAS,3,303,3,309,1367
SONORA,GUAYMAS,3,166,3,172,1400
SONORA,GUAYMAS,2,171,3,176,1400
SONORA,GUAYMAS,2,144,1,147,1399
SONORA,GUAYMAS,1,213,1,215,1400
SONORA,GUAYMAS,2,102,1,105,1400
SONORA,GUAYMAS,1,142,0,143,1400
SONORA,GUAYMAS,4,252,2,258,1815
SONORA,GUAYMAS,1,253,0,254,1815
SONORA,GUAYMAS,2,312,0,314,1815
SONORA,GUAYMAS,2,160,0,162,1622
SONORA,GUAYMAS,0,177,1,178,1621
SONORA,GUAYMAS,17,249,0,266,1733
SONORA,GUAYMAS,18,233,1,252,1732
SONORA,GUAYMAS,6,235,2,243,1795
SONORA,GUAYMAS,12,491,3,506,1795
SONORA,GUAYMAS,13,253,0,266,1818
SONORA,GUAYMAS,5,215,2,222,1818
SONORA,GUAYMAS,13,245,0,258,1818
SONORA,HERMOSILLO,15,206,1,222,1883
SONORA,HERMOSILLO,17,185,0,202,1883
SONORA,HERMOSILLO,16,204,0,220,1883
SONORA,HERMOSILLO,15,162,1,178,1883
SONORA,HERMOSILLO,11,197,1,209,1883
SONORA,HERMOSILLO,10,202,0,212,1883
SONORA,HERMOSILLO,19,204,0,223,1883
SONORA,HERMOSILLO,16,183,1,200,1882
SONORA,HERMOSILLO,14,191,1,206,1882
SONORA,HERMOSILLO,28,109,1,138,1722
SONORA,HERMOSILLO,26,127,0,153,1722
SONORA,HERMOSILLO,25,137,1,163,1721
SONORA,HERMOSILLO,26,126,0,152,1721
SONORA,HERMOSILLO,40,116,1,157,1920
SONORA,HERMOSILLO,35,132,2,169,1919
SONORA,HERMOSILLO,5,180,3,188,1424
SONORA,HERMOSILLO,7,190,2,199,1424
SONORA,HERMOSILLO,6,189,1,196,1424
SONORA,HERMOSILLO,13,193,2,208,1423
SONORA,HERMOSILLO,4,191,2,197,1423
SONORA,HERMOSILLO,17,116,1,134,1472
SONORA,HERMOSILLO,26,125,1,152,1472
SONORA,HERMOSILLO,25,109,0,134,1472
SONORA,HERMOSILLO,110,1612,25,1747,0
SONORA,HERMOSILLO,20,214,1,235,1803
SONORA,HERMOSILLO,28,212,0,240,1802
SONORA,HERMOSILLO,15,182,1,198,1442
SONORA,HERMOSILLO,8,196,1,205,1442
SONORA,HERMOSILLO,12,204,2,218,1441
SONORA,HERMOSILLO,20,301,4,325,1748
SONORA,HERMOSILLO,14,298,4,316,1748
SONORA,HERMOSILLO,16,151,1,168,1466
SONORA,HERMOSILLO,21,172,0,193,1466
SONORA,HERMOSILLO,15,167,1,183,1465
SONORA,HERMOSILLO,11,286,2,299,1745
SONORA,HERMOSILLO,20,279,5,304,1744
SONORA,HERMOSILLO,21,230,4,255,1847
SONORA,HERMOSILLO,20,266,2,288,1846
SONORA,HERMOSILLO,12,149,2,163,1494
SONORA,HERMOSILLO,29,134,0,163,1494
SONORA,HERMOSILLO,19,116,0,135,1493
SONORA,HERMOSILLO,25,134,0,159,1395
SONORA,HERMOSILLO,16,140,1,157,1394
SONORA,HERMOSILLO,33,152,2,187,1394
SONORA,HERMOSILLO,21,137,1,159,1433
SONORA,HERMOSILLO,21,111,2,134,1433
SONORA,HERMOSILLO,19,195,0,214,1746
SONORA,HERMOSILLO,18,200,4,222,1746
SONORA,HERMOSILLO,8,169,1,178,1762
SONORA,HERMOSILLO,14,155,1,170,1762
SONORA,HERMOSILLO,4,204,1,209,1159
SONORA,HERMOSILLO,3,204,5,212,1159
SONORA,HERMOSILLO,9,174,1,184,1554
SONORA,HERMOSILLO,24,172,1,197,1553
SONORA,HERMOSILLO,9,191,3,203,1553
SONORA,HERMOSILLO,5,201,4,210,1830
SONORA,HERMOSILLO,0,205,2,207,1830
SONORA,HERMOSILLO,8,290,5,303,1867
SONORA,HERMOSILLO,6,279,5,290,1867
SONORA,HERMOSILLO,23,189,1,213,1726
SONORA,HERMOSILLO,31,179,0,210,1726
SONORA,HERMOSILLO,30,158,1,189,1725
SONORA,HERMOSILLO,28,232,4,264,2049
SONORA,HERMOSILLO,225,18,0,243,1475
SONORA,HERMOSILLO,17,231,0,248,1475
SONORA,HERMOSILLO,13,254,3,270,1561
SONORA,HERMOSILLO,5,266,0,271,1561
SONORA,HERMOSILLO,13,257,0,270,1859
SONORA,HERMOSILLO,14,263,1,278,1858
SONORA,HERMOSILLO,17,288,1,306,1815
SONORA,HERMOSILLO,29,262,0,291,1814
SONORA,HERMOSILLO,25,140,2,167,1553
SONORA,HERMOSILLO,25,115,1,141,1552
SONORA,HERMOSILLO,18,106,0,124,1552
SONORA,HERMOSILLO,23,256,1,280,1930
SONORA,HERMOSILLO,34,278,1,313,1930
SONORA,HERMOSILLO,15,244,0,259,1692
SONORA,HERMOSILLO,11,218,1,230,1692
SONORA,HERMOSILLO,23,166,1,190,1781
SONORA,HERMOSILLO,27,158,1,186,1780
SONORA,HERMOSILLO,34,145,0,179,1780
SONORA,HERMOSILLO,22,184,2,208,1780
SONORA,HERMOSILLO,25,165,1,191,1780
SONORA,HERMOSILLO,20,146,4,170,1780
SONORA,HERMOSILLO,29,152,1,182,1780
SONORA,HERMOSILLO,29,169,2,200,1780
SONORA,HERMOSILLO,21,157,1,179,1780
SONORA,HERMOSILLO,6,116,2,124,1608
SONORA,HERMOSILLO,5,107,1,113,1608
SONORA,HERMOSILLO,10,122,1,133,1608
SONORA,HERMOSILLO,7,120,3,130,1607
SONORA,HERMOSILLO,6,112,0,118,1607
SONORA,HERMOSILLO,19,246,2,267,1796
SONORA,HERMOSILLO,26,223,2,251,1796
SONORA,HERMOSILLO,20,271,2,293,1796
SONORA,HERMOSILLO,9,174,4,187,1584
SONORA,HERMOSILLO,11,153,2,166,1584
SONORA,HERMOSILLO,13,157,2,172,1583
SONORA,HERMOSILLO,9,254,3,266,1777
SONORA,HERMOSILLO,11,326,2,339,1776
SONORA,HERMOSILLO,14,247,3,264,1782
SONORA,HERMOSILLO,7,253,3,263,1782
SONORA,HERMOSILLO,9,222,2,233,1548
SONORA,HERMOSILLO,11,227,0,238,1547
SONORA,HERMOSILLO,7,137,2,146,1144
SONORA,HERMOSILLO,7,154,1,162,1143
SONORA,HERMOSILLO,13,185,0,198,1459
SONORA,HERMOSILLO,15,217,3,235,1458
SONORA,HERMOSILLO,11,210,5,226,1458
SONORA,HERMOSILLO,18,218,0,236,1651
SONORA,HERMOSILLO,12,218,0,230,1651
SONORA,HERMOSILLO,16,237,0,253,1650
SONORA,HERMOSILLO,12,225,2,239,1580
SONORA,HERMOSILLO,8,232,4,244,1580
SONORA,HERMOSILLO,3,225,8,236,1579
SONORA,HERMOSILLO,13,189,1,203,1674
SONORA,HERMOSILLO,14,205,0,219,1674
SONORA,HERMOSILLO,12,192,2,206,1674
SONORA,HERMOSILLO,18,210,0,228,1674
SONORA,HERMOSILLO,8,179,0,187,1674
SONORA,HERMOSILLO,13,171,2,186,1673
SONORA,HERMOSILLO,13,233,0,246,1953
SONORA,HERMOSILLO,14,250,2,266,1952
SONORA,HERMOSILLO,10,252,1,263,1791
SONORA,HERMOSILLO,13,278,3,294,1790
SONORA,HERMOSILLO,5,133,0,138,1432
SONORA,HERMOSILLO,5,155,1,161,1432
SONORA,HERMOSILLO,10,164,6,180,1431
SONORA,HERMOSILLO,9,194,7,210,1756
SONORA,HERMOSILLO,13,197,2,212,1756
SONORA,HERMOSILLO,11,196,2,209,1756
SONORA,HERMOSILLO,9,190,4,203,1755
SONORA,HERMOSILLO,10,190,3,203,1755
SONORA,HERMOSILLO,12,172,1,185,1861
SONORA,HERMOSILLO,6,157,5,168,1861
SONORA,HERMOSILLO,5,180,3,188,1860
SONORA,HERMOSILLO,12,175,1,188,1860
SONORA,HERMOSILLO,6,179,2,187,1860
SONORA,HERMOSILLO,4,158,1,163,1860
SONORA,HERMOSILLO,4,179,2,185,1860
SONORA,HERMOSILLO,14,190,4,208,1243
SONORA,HERMOSILLO,18,188,2,208,1242
SONORA,HERMOSILLO,5,159,1,165,2073
SONORA,HERMOSILLO,3,126,0,129,2072
SONORA,HERMOSILLO,14,252,1,267,1560
SONORA,HERMOSILLO,18,237,1,256,1560
SONORA,HERMOSILLO,5,260,1,266,1500
SONORA,HERMOSILLO,7,236,1,244,1499
SONORA,HERMOSILLO,7,190,1,198,1326
SONORA,HERMOSILLO,6,203,1,210,1326
SONORA,HERMOSILLO,17,236,4,257,1913
SONORA,HERMOSILLO,18,283,1,302,1913
SONORA,HERMOSILLO,5,117,8,130,1455
SONORA,HERMOSILLO,2,112,3,117,1455
SONORA,HERMOSILLO,7,177,1,185,1984
SONORA,HERMOSILLO,4,224,5,233,1984
SONORA,HERMOSILLO,15,281,5,301,2130
SONORA,HERMOSILLO,3,299,1,303,2130
SONORA,HERMOSILLO,3,71,5,79,1272
SONORA,HERMOSILLO,6,88,0,94,1271
SONORA,HERMOSILLO,18,189,1,208,1802
SONORA,HERMOSILLO,23,170,0,193,1801
SONORA,HERMOSILLO,24,173,0,197,1801
SONORA,HERMOSILLO,7,157,0,164,1797
SONORA,HERMOSILLO,7,167,4,178,1797
SONORA,HERMOSILLO,4,98,2,104,1469
SONORA,HERMOSILLO,4,111,2,117,1468
SONORA,HERMOSILLO,9,104,2,115,1468
SONORA,HERMOSILLO,3,165,0,168,1341
SONORA,HERMOSILLO,3,156,1,160,1340
SONORA,HERMOSILLO,6,152,1,159,1340
SONORA,HERMOSILLO,9,131,0,140,1155
SONORA,HERMOSILLO,11,119,1,131,1154
SONORA,HERMOSILLO,5,166,3,174,1232
SONORA,HERMOSILLO,6,147,0,153,1232
SONORA,HERMOSILLO,6,195,1,202,1821
SONORA,HERMOSILLO,2,180,1,183,1820
SONORA,HERMOSILLO,7,178,0,185,1817
SONORA,HERMOSILLO,9,207,0,216,1817
SONORA,HERMOSILLO,2,115,0,117,1180
SONORA,HERMOSILLO,0,104,0,104,1180
SONORA,HERMOSILLO,4,140,0,144,1393
SONORA,HERMOSILLO,6,148,0,154,1392
SONORA,HERMOSILLO,8,127,0,135,1371
SONORA,HERMOSILLO,5,128,0,133,1371
SONORA,HERMOSILLO,2,151,3,156,1371
SONORA,HERMOSILLO,7,148,0,155,1991
SONORA,HERMOSILLO,7,190,0,197,1991
SONORA,CD. OBREGON,23,144,0,167,1397
SONORA,CD. OBREGON,26,191,2,219,1396
SONORA,CD. OBREGON,24,159,1,184,1396
SONORA,CD. OBREGON,20,152,1,173,1871
SONORA,CD. OBREGON,25,158,2,185,1870
SONORA,CD. OBREGON,7,190,7,204,1898
SONORA,CD. OBREGON,2,221,5,228,1898
SONORA,CD. OBREGON,6,211,4,221,1897
SONORA,CD. OBREGON,7,259,3,269,1703
SONORA,CD. OBREGON,5,247,4,256,1702
SONORA,CD. OBREGON,13,273,3,289,2166
SONORA,CD. OBREGON,8,258,6,272,2165
SONORA,CD. OBREGON,12,269,2,283,1582
SONORA,CD. OBREGON,13,275,3,291,1581
SONORA,CD. OBREGON,15,384,2,401,1736
SONORA,CD. OBREGON,12,404,4,420,1736
SONORA,CD. OBREGON,13,193,1,207,2110
SONORA,CD. OBREGON,5,210,2,217,2110
SONORA,CD. OBREGON,24,115,0,139,1458
SONORA,CD. OBREGON,25,140,0,165,1457
SONORA,CD. OBREGON,25,114,0,139,1457
SONORA,CD. OBREGON,13,186,0,199,1340
SONORA,CD. OBREGON,22,230,2,254,1339
SONORA,CD. OBREGON,7,258,0,265,1744
SONORA,CD. OBREGON,17,225,0,242,1744
SONORA,CD. OBREGON,24,266,0,290,1744
SONORA,CD. OBREGON,10,227,4,241,1744
SONORA,CD. OBREGON,21,232,1,254,1744
SONORA,CD. OBREGON,24,220,1,245,1743
SONORA,CD. OBREGON,13,239,1,253,1743
SONORA,CD. OBREGON,30,234,4,268,1901
SONORA,CD. OBREGON,29,188,1,218,1900
SONORA,CD. OBREGON,7,435,2,444,1801
SONORA,CD. OBREGON,8,445,4,457,1800
SONORA,CD. OBREGON,16,254,1,271,1381
SONORA,CD. OBREGON,16,259,0,275,1381
SONORA,CD. OBREGON,17,232,2,251,1456
SONORA,CD. OBREGON,13,217,0,230,1456
SONORA,CD. OBREGON,18,230,3,251,1456
SONORA,CD. OBREGON,13,398,5,416,1857
SONORA,CD. OBREGON,10,390,0,400,1857
SONORA,CD. OBREGON,14,257,2,273,1374
SONORA,CD. OBREGON,11,254,0,265,1374
SONORA,CD. OBREGON,18,274,0,292,1623
SONORA,CD. OBREGON,23,250,3,276,1623
SONORA,CD. OBREGON,19,288,2,309,1379
SONORA,CD. OBREGON,9,250,5,264,1378
SONORA,CD. OBREGON,11,297,3,311,1562
SONORA,CD. OBREGON,15,280,2,297,1562
SONORA,CD. OBREGON,100,1872,2,1974,0
SONORA,CD. OBREGON,15,278,3,296,1479
SONORA,CD. OBREGON,13,274,0,287,1478
SONORA,CD. OBREGON,15,356,0,371,1347
SONORA,CD. OBREGON,9,318,7,334,1347
SONORA,CD. OBREGON,0,449,3,452,2004
SONORA,CD. OBREGON,9,417,5,431,2004
SONORA,CD. OBREGON,9,294,7,310,1821
SONORA,CD. OBREGON,13,329,3,345,1821
SONORA,CD. OBREGON,17,307,2,326,1820
SONORA,CD. OBREGON,6,304,4,314,1748
SONORA,CD. OBREGON,14,301,0,315,1747
SONORA,CD. OBREGON,1,361,0,362,1779
SONORA,CD. OBREGON,4,423,4,431,1779
SONORA,CD. OBREGON,8,346,0,354,1901
SONORA,CD. OBREGON,11,390,2,403,1900
SONORA,CD. OBREGON,4,376,3,383,1865
SONORA,CD. OBREGON,6,342,6,354,1864
SONORA,CD. OBREGON,6,321,1,328,1548
SONORA,CD. OBREGON,12,328,2,342,1547
SONORA,CD. OBREGON,7,338,3,348,1547
SONORA,CD. OBREGON,8,300,6,314,1474
SONORA,CD. OBREGON,11,302,3,316,1474
SONORA,CD. OBREGON,5,298,2,305,1473
SONORA,CD. OBREGON,10,363,1,374,1893
SONORA,CD. OBREGON,7,397,0,404,1893
SONORA,CD. OBREGON,6,267,0,273,1923
SONORA,CD. OBREGON,7,291,4,302,1922
SONORA,CD. OBREGON,12,311,1,324,1922
SONORA,CD. OBREGON,7,260,3,270,1922
SONORA,CD. OBREGON,7,329,3,339,1768
SONORA,CD. OBREGON,3,353,1,357,1768
SONORA,CD. OBREGON,5,358,1,364,1795
SONORA,CD. OBREGON,3,303,0,306,1795
SONORA,CD. OBREGON,2,355,0,357,1564
SONORA,CD. OBREGON,7,324,6,337,1564
SONORA,CD. OBREGON,8,323,0,331,1564
SONORA,CD. OBREGON,4,257,4,265,1791
SONORA,CD. OBREGON,7,232,1,240,1790
SONORA,CD. OBREGON,9,285,1,295,1790
SONORA,CD. OBREGON,9,282,1,292,1924
SONORA,CD. OBREGON,10,323,2,335,1924
SONORA,CD. OBREGON,4,212,4,220,1192
SONORA,CD. OBREGON,2,209,4,215,1191
SONORA,CD. OBREGON,1,356,3,360,1900
SONORA,CD. OBREGON,3,368,0,371,1900
SONORA,CD. OBREGON,5,216,1,222,1383
SONORA,CD. OBREGON,6,211,1,218,1382
SONORA,CD. OBREGON,10,216,2,228,1382
SONORA,CD. OBREGON,6,174,1,181,1611
SONORA,CD. OBREGON,5,203,0,208,1610
SONORA,CD. OBREGON,3,199,1,203,1610
SONORA,CD. OBREGON,7,316,0,323,2152
SONORA,CD. OBREGON,8,281,0,289,2151
SONORA,CD. OBREGON,4,265,0,269,1863
SONORA,CD. OBREGON,8,236,3,247,1862
SONORA,CD. OBREGON,7,264,1,272,1921
SONORA,CD. OBREGON,11,240,2,253,1921
SONORA,CD. OBREGON,5,276,3,284,1634
SONORA,CD. OBREGON,6,247,1,254,1634
SONORA,CD. OBREGON,10,309,1,320,1456
SONORA,CD. OBREGON,2,313,0,315,1455
SONORA,CD. OBREGON,8,285,1,294,1455
SONORA,CD. OBREGON,4,273,3,280,1862
SONORA,CD. OBREGON,6,299,0,305,1861
SONORA,CD. OBREGON,5,341,0,346,1635
SONORA,CD. OBREGON,8,335,1,344,1635
SONORA,CD. OBREGON,8,352,1,361,1635
SONORA,CD. OBREGON,8,300,4,312,1463
SONORA,CD. OBREGON,1,282,3,286,1454
SONORA,CD. OBREGON,0,266,5,271,1454
SONORA,CD. OBREGON,6,145,4,155,1341
SONORA,CD. OBREGON,3,129,6,138,1341
SONORA,CD. OBREGON,6,270,2,278,1340
SONORA,CD. OBREGON,12,267,4,283,1870
SONORA,CD. OBREGON,4,273,4,281,1870
SONORA,CD. OBREGON,14,345,2,361,1963
SONORA,CD. OBREGON,6,319,3,328,1963
SONORA,CD. OBREGON,5,214,1,220,1302
SONORA,CD. OBREGON,6,193,2,201,1302
SONORA,CD. OBREGON,13,290,1,304,1807
SONORA,CD. OBREGON,17,316,0,333,1807
SONORA,CD. OBREGON,8,281,1,290,1807
SONORA,CD. OBREGON,5,184,1,190,1706
SONORA,CD. OBREGON,11,237,0,248,1706
SONORA,CD. OBREGON,10,222,2,234,1706
SONORA,CD. OBREGON,0,193,2,195,1706
SONORA,CD. OBREGON,9,206,0,215,1706
SONORA,CD. OBREGON,3,231,5,239,1705
SONORA,CD. OBREGON,4,191,0,195,1705
SONORA,CD. OBREGON,5,212,2,219,1705
SONORA,CD. OBREGON,14,261,2,277,2142
SONORA,CD. OBREGON,14,228,3,245,2142
SONORA,CD. OBREGON,6,184,0,190,1723
SONORA,CD. OBREGON,5,198,0,203,1723
SONORA,CD. OBREGON,6,195,1,202,1723
SONORA,CD. OBREGON,4,201,0,205,1723
SONORA,CD. OBREGON,17,190,2,209,1723
SONORA,CD. OBREGON,7,214,0,221,1723
SONORA,CD. OBREGON,9,193,1,203,1722
SONORA,CD. OBREGON,9,347,2,358,1748
SONORA,CD. OBREGON,7,351,1,359,1748
SONORA,CD. OBREGON,5,281,27,313,1540
SONORA,CD. OBREGON,6,274,4,284,1540
SONORA,CD. OBREGON,5,293,5,303,1540
SONORA,CD. OBREGON,5,324,3,332,1821
SONORA,CD. OBREGON,9,322,1,332,1820
SONORA,CD. OBREGON,5,241,2,248,1572
SONORA,CD. OBREGON,6,207,2,215,1572
SONORA,CD. OBREGON,3,219,0,222,1571
SONORA,CD. OBREGON,0,313,5,318,1555
SONORA,CD. OBREGON,12,350,6,368,1554
SONORA,CD. OBREGON,8,253,8,269,1477
SONORA,CD. OBREGON,1,273,0,274,1476
SONORA,CD. OBREGON,5,307,11,323,1578
SONORA,CD. OBREGON,12,286,2,300,1577
SONORA,CD. OBREGON,6,271,4,281,1577
SONORA,CD. OBREGON,3,279,1,283,1418
SONORA,CD. OBREGON,3,251,0,254,1417
SONORA,CD. OBREGON,9,232,4,245,1403
SONORA,CD. OBREGON,2,205,4,211,1402
SONORA,CD. OBREGON,4,340,1,345,1340
SONORA,CD. OBREGON,8,326,2,336,1340
SONORA,CD. OBREGON,6,262,0,268,1217
SONORA,CD. OBREGON,12,250,7,269,1216
SONORA,CD. OBREGON,4,251,3,258,1991
SONORA,CD. OBREGON,4,196,1,201,1990
SONORA,CD. OBREGON,9,254,3,266,1539
SONORA,CD. OBREGON,2,271,2,275,1539
SONORA,CD. OBREGON,7,268,1,276,1539
SONORA,CD. OBREGON,4,223,0,227,2003
SONORA,CD. OBREGON,2,205,1,208,2003
SONORA,CD. OBREGON,5,224,0,229,1657
SONORA,CD. OBREGON,7,193,1,201,1656
SONORA,CD. OBREGON,2,158,0,160,1407
SONORA,CD. OBREGON,5,152,1,158,1407
SONORA,CD. OBREGON,3,193,0,196,1633
SONORA,CD. OBREGON,0,166,0,166,1633
SONORA,CD. OBREGON,6,187,0,193,1632
SONORA,CD. OBREGON,4,265,0,269,1962
SONORA,CD. OBREGON,8,254,1,263,1962
SONORA,CD. OBREGON,4,247,0,251,1961
SONORA,NAVOJOA,4,186,5,195,1395
SONORA,NAVOJOA,5,204,1,210,1395
SONORA,NAVOJOA,5,184,1,190,1395
SONORA,NAVOJOA,3,202,3,208,1329
SONORA,NAVOJOA,5,235,1,241,1329
SONORA,NAVOJOA,8,206,3,217,1329
SONORA,NAVOJOA,1,277,1,279,1869
SONORA,NAVOJOA,3,244,2,249,1868
SONORA,NAVOJOA,5,168,2,175,1419
SONORA,NAVOJOA,1,201,6,208,1419
SONORA,NAVOJOA,1,136,4,141,1419
SONORA,NAVOJOA,12,419,8,439,1929
SONORA,NAVOJOA,8,371,3,382,1929
SONORA,NAVOJOA,10,333,2,345,1695
SONORA,NAVOJOA,7,328,4,339,1695
SONORA,NAVOJOA,8,371,5,384,1736
SONORA,NAVOJOA,8,328,3,339,1736
SONORA,NAVOJOA,2,300,6,308,1736
SONORA,NAVOJOA,6,320,6,332,1304
SONORA,NAVOJOA,2,332,2,336,1303
SONORA,NAVOJOA,6,422,7,435,1643
SONORA,NAVOJOA,7,408,7,422,1643
SONORA,NAVOJOA,6,328,5,339,1295
SONORA,NAVOJOA,9,333,3,345,1294
SONORA,NAVOJOA,8,364,4,376,1411
SONORA,NAVOJOA,11,326,1,338,1411
SONORA,NAVOJOA,14,439,6,459,1299
SONORA,NAVOJOA,12,416,3,431,1299
SONORA,NAVOJOA,15,441,4,460,1298
SONORA,NAVOJOA,6,344,6,356,1580
SONORA,NAVOJOA,7,353,10,370,1580
SONORA,NAVOJOA,4,468,2,474,1853
SONORA,NAVOJOA,3,450,1,454,1852
SONORA,NAVOJOA,4,312,3,319,1713
SONORA,NAVOJOA,8,347,1,356,1713
SONORA,NAVOJOA,7,309,4,320,1712
SONORA,NAVOJOA,3,287,2,292,1361
SONORA,NAVOJOA,1,273,3,277,1361
SONORA,NAVOJOA,3,295,0,298,1360
SONORA,NAVOJOA,10,389,6,405,1794
SONORA,NAVOJOA,5,426,4,435,1793
SONORA,NAVOJOA,7,432,4,443,1760
SONORA,NAVOJOA,11,442,4,457,1760
SONORA,NAVOJOA,6,405,8,419,1769
SONORA,NAVOJOA,10,371,5,386,1768
SONORA,NAVOJOA,3,334,1,338,1766
SONORA,NAVOJOA,2,313,4,319,1766
SONORA,NAVOJOA,6,343,1,350,1766
SONORA,NAVOJOA,9,301,2,312,1344
SONORA,NAVOJOA,18,259,0,277,1344
SONORA,NAVOJOA,15,336,2,353,1805
SONORA,NAVOJOA,12,328,2,342,1804
SONORA,NAVOJOA,11,211,2,224,1592
SONORA,NAVOJOA,9,224,1,234,1591
SONORA,NAVOJOA,13,282,2,297,1631
SONORA,NAVOJOA,5,342,6,353,1631
SONORA,NAVOJOA,8,314,1,323,1853
SONORA,NAVOJOA,10,271,6,287,1853
SONORA,NAVOJOA,5,235,5,245,1521
SONORA,NAVOJOA,3,280,0,283,1521
SONORA,NAVOJOA,4,284,1,289,1521
SONORA,NAVOJOA,2,286,3,291,1576
SONORA,NAVOJOA,5,276,3,284,1575
SONORA,NAVOJOA,6,192,1,199,1125
SONORA,NAVOJOA,5,195,9,209,1125
SONORA,NAVOJOA,3,405,6,414,1754
SONORA,NAVOJOA,5,425,5,435,1754
SONORA,NAVOJOA,8,403,8,419,1536
SONORA,NAVOJOA,5,383,3,391,1536
SONORA,NAVOJOA,9,338,2,349,1589
SONORA,NAVOJOA,4,343,3,350,1588
SONORA,NAVOJOA,4,336,1,341,1588
SONORA,NAVOJOA,2,261,3,266,1213
SONORA,NAVOJOA,0,280,2,282,1213
SONORA,NAVOJOA,8,452,4,464,1817
SONORA,NAVOJOA,4,479,10,493,1816
SONORA,NAVOJOA,8,379,6,393,1684
SONORA,NAVOJOA,10,375,2,387,1684
SONORA,NAVOJOA,9,390,5,404,1683
SONORA,NAVOJOA,3,562,1,566,1641
SONORA,NAVOJOA,1,330,5,336,1640
SONORA,NAVOJOA,5,700,1,706,1912
SONORA,NAVOJOA,2,407,1,410,1912
SONORA,NAVOJOA,11,362,5,378,1912
SONORA,NAVOJOA,10,650,1,661,1911
SONORA,NAVOJOA,3,229,2,234,1242
SONORA,NAVOJOA,3,219,4,226,1241
SONORA,NAVOJOA,14,261,2,277,1865
SONORA,NAVOJOA,17,280,1,298,1864
SONORA,NAVOJOA,22,239,0,261,1762
SONORA,NAVOJOA,17,249,0,266,1762
SONORA,NAVOJOA,23,211,1,235,1761
SONORA,NAVOJOA,83,1630,5,1718,0
SONORA,NAVOJOA,10,309,5,324,1647
SONORA,NAVOJOA,6,261,3,270,1647
SONORA,NAVOJOA,9,247,3,259,1646
SONORA,NAVOJOA,10,325,1,336,1919
SONORA,NAVOJOA,4,299,0,303,1919
SONORA,NAVOJOA,19,252,0,271,1580
SONORA,NAVOJOA,30,232,0,262,1580
SONORA,NAVOJOA,18,253,0,271,1579
SONORA,NAVOJOA,5,268,3,276,1426
SONORA,NAVOJOA,8,264,1,273,1426
SONORA,NAVOJOA,4,245,3,252,1425
SONORA,NAVOJOA,3,261,4,268,1268
SONORA,NAVOJOA,8,244,1,253,1268
SONORA,NAVOJOA,10,265,3,278,1208
SONORA,NAVOJOA,11,257,2,270,1207
SONORA,NAVOJOA,4,333,0,337,1687
SONORA,NAVOJOA,6,309,6,321,1686
SONORA,NAVOJOA,0,354,6,360,1686
SONORA,NAVOJOA,7,295,3,305,1498
SONORA,NAVOJOA,9,282,1,292,1497
SONORA,NAVOJOA,5,264,1,270,1497
SONORA,NAVOJOA,7,191,1,199,1507
SONORA,NAVOJOA,4,221,0,225,1507
SONORA,NAVOJOA,6,199,0,205,1507
SONORA,NAVOJOA,7,205,2,214,1506
SONORA,NAVOJOA,14,338,0,352,1849
SONORA,NAVOJOA,7,348,2,357,1849
SONORA,NAVOJOA,7,278,2,287,1794
SONORA,NAVOJOA,7,270,6,283,1793
SONORA,NAVOJOA,3,249,8,260,1344
SONORA,NAVOJOA,7,249,0,256,1344
SONORA,NAVOJOA,1,230,0,231,1567
SONORA,NAVOJOA,4,197,1,202,1567
SONORA,NAVOJOA,4,215,0,219,1566
SONORA,NAVOJOA,4,283,1,288,1511
SONORA,NAVOJOA,5,255,4,264,1511
SONORA,NAVOJOA,8,249,0,257,1539
SONORA,NAVOJOA,8,241,2,251,1538
SONORA,NAVOJOA,17,226,2,245,1538
SONORA,NAVOJOA,0,286,2,288,1492
SONORA,NAVOJOA,3,253,6,262,1491
SONORA,NAVOJOA,2,197,1,200,1496
SONORA,NAVOJOA,7,182,2,191,1496
SONORA,NAVOJOA,0,243,2,245,1495
SONORA,NAVOJOA,6,607,2,615,1495
SONORA,NAVOJOA,4,233,1,238,1366
SONORA,NAVOJOA,2,216,4,222,1366
SONORA,NAVOJOA,10,304,7,321,1547
SONORA,NAVOJOA,8,320,4,332,1546
SONORA,NAVOJOA,4,198,4,206,1383
SONORA,NAVOJOA,2,238,4,244,1382
SONORA,NAVOJOA,1,259,10,270,1382
SONORA,NAVOJOA,8,319,6,333,1724
SONORA,NAVOJOA,7,354,8,369,1724
SONORA,NAVOJOA,1,254,2,257,1291
SONORA,NAVOJOA,2,211,7,220,1290
SONORA,NAVOJOA,6,199,3,208,1387
SONORA,NAVOJOA,7,230,0,237,1387
SONORA,NAVOJOA,8,156,0,164,1386
SONORA,NAVOJOA,4,294,0,298,1379
SONORA,NAVOJOA,7,256,0,263,1379
SONORA,NAVOJOA,4,270,4,278,1379
SONORA,NAVOJOA,4,333,2,339,1396
SONORA,NAVOJOA,2,271,3,276,1396
SONORA,NAVOJOA,2,800,3,805,1395
SONORA,NAVOJOA,5,389,6,400,1723
SONORA,NAVOJOA,5,655,8,668,1723
SONORA,NAVOJOA,10,393,1,404,1722
SONORA,NAVOJOA,1,355,10,366,1562
SONORA,NAVOJOA,11,373,10,394,1562
SONORA,NAVOJOA,3,235,0,238,1645
SONORA,NAVOJOA,4,208,3,215,1645
SONORA,NAVOJOA,4,224,1,229,1644
SONORA,NAVOJOA,0,228,1,229,1644
SONORA,NAVOJOA,8,317,2,327,1761
SONORA,NAVOJOA,4,277,3,284,1761
SONORA,NAVOJOA,2,213,3,218,1438
SONORA,NAVOJOA,1,218,1,220,1438
SONORA,NAVOJOA,3,261,0,264,1438
TABASCO,MACUSPANA,12,575,9,596,1988
TABASCO,MACUSPANA,5,605,11,621,1988
TABASCO,MACUSPANA,4,581,5,590,1593
TABASCO,MACUSPANA,0,528,9,537,1593
TABASCO,MACUSPANA,7,537,7,551,1593
TABASCO,MACUSPANA,9,678,12,699,1811
TABASCO,MACUSPANA,10,726,4,740,1810
TABASCO,MACUSPANA,11,692,8,711,1789
TABASCO,MACUSPANA,5,689,7,701,1788
TABASCO,MACUSPANA,6,697,5,708,1788
TABASCO,MACUSPANA,4,564,8,576,1107
TABASCO,MACUSPANA,5,491,9,505,1106
TABASCO,MACUSPANA,0,797,1,798,2007
TABASCO,MACUSPANA,9,984,4,997,2007
TABASCO,MACUSPANA,7,1334,3,1344,1893
TABASCO,MACUSPANA,11,1422,6,1439,1893
TABASCO,MACUSPANA,9,762,4,775,1718
TABASCO,MACUSPANA,8,708,6,722,1718
TABASCO,MACUSPANA,3,639,13,655,1718
TABASCO,MACUSPANA,4,731,8,743,1640
TABASCO,MACUSPANA,9,1071,10,1090,1639
TABASCO,MACUSPANA,7,732,7,746,1680
TABASCO,MACUSPANA,12,620,3,635,1680
TABASCO,MACUSPANA,4,676,7,687,1680
TABASCO,MACUSPANA,10,684,16,710,1730
TABASCO,MACUSPANA,10,683,7,700,1730
TABASCO,MACUSPANA,12,788,10,810,1964
TABASCO,MACUSPANA,5,798,1,804,1964
TABASCO,MACUSPANA,6,922,10,938,1412
TABASCO,MACUSPANA,7,1060,0,1067,1412
TABASCO,MACUSPANA,4,1032,5,1041,1411
TABASCO,MACUSPANA,5,619,4,628,1871
TABASCO,MACUSPANA,5,704,5,714,1871
TABASCO,MACUSPANA,8,636,7,651,1806
TABASCO,MACUSPANA,2,757,7,766,1805
TABASCO,MACUSPANA,10,1292,5,1307,1475
TABASCO,MACUSPANA,4,1142,5,1151,1474
TABASCO,MACUSPANA,0,741,9,750,1747
TABASCO,MACUSPANA,3,599,4,606,1747
TABASCO,MACUSPANA,8,1808,5,1821,2012
TABASCO,MACUSPANA,7,1722,3,1732,2012
TABASCO,MACUSPANA,14,1319,18,1351,1547
TABASCO,MACUSPANA,2,1390,5,1397,1547
TABASCO,MACUSPANA,3,1238,45,1286,1546
TABASCO,MACUSPANA,18,1378,5,1401,1922
TABASCO,MACUSPANA,7,1615,13,1635,1921
TABASCO,MACUSPANA,9,1295,0,1304,1544
TABASCO,MACUSPANA,17,1183,0,1200,1543
TABASCO,MACUSPANA,1,1529,292,1822,1811
TABASCO,MACUSPANA,20,1509,6,1535,1811
TABASCO,MACUSPANA,12,1516,15,1543,1810
TABASCO,MACUSPANA,4,1351,5,1360,1484
TABASCO,MACUSPANA,8,1326,6,1340,1484
TABASCO,MACUSPANA,16,846,11,873,1585
TABASCO,MACUSPANA,13,930,7,950,1584
TABASCO,MACUSPANA,12,480,6,498,1910
TABASCO,MACUSPANA,2,505,11,518,1910
TABASCO,MACUSPANA,11,489,4,504,1792
TABASCO,MACUSPANA,11,456,2,469,1791
TABASCO,MACUSPANA,10,411,7,428,1577
TABASCO,MACUSPANA,8,418,0,426,1576
TABASCO,MACUSPANA,8,409,2,419,1576
TABASCO,MACUSPANA,5,414,1,420,1497
TABASCO,MACUSPANA,5,439,3,447,1497
TABASCO,MACUSPANA,5,418,3,426,1497
TABASCO,MACUSPANA,6,419,4,429,1588
TABASCO,MACUSPANA,13,479,2,494,1587
TABASCO,MACUSPANA,27,1381,8,1416,0
TABASCO,MACUSPANA,7,642,6,655,1930
TABASCO,MACUSPANA,1,767,2,770,1929
TABASCO,MACUSPANA,7,322,2,331,1108
TABASCO,MACUSPANA,2,332,4,338,1107
TABASCO,MACUSPANA,8,1281,15,1304,1453
TABASCO,MACUSPANA,6,1245,4,1255,1453
TABASCO,MACUSPANA,7,894,16,917,1452
TABASCO,MACUSPANA,6,760,13,779,1963
TABASCO,MACUSPANA,9,438,2,449,1629
TABASCO,MACUSPANA,6,427,8,441,1628
TABASCO,MACUSPANA,7,589,1,597,1832
TABASCO,MACUSPANA,4,528,7,539,1832
TABASCO,MACUSPANA,8,542,6,556,1832
TABASCO,MACUSPANA,7,421,4,432,1601
TABASCO,MACUSPANA,6,422,6,434,1601
TABASCO,MACUSPANA,11,348,28,387,1601
TABASCO,MACUSPANA,7,429,2,438,1305
TABASCO,MACUSPANA,4,490,2,496,1304
TABASCO,MACUSPANA,1,849,1,851,1850
TABASCO,MACUSPANA,6,551,8,565,1850
TABASCO,MACUSPANA,9,498,3,510,1869
TABASCO,MACUSPANA,5,517,3,525,1869
TABASCO,MACUSPANA,7,540,1,548,1678
TABASCO,MACUSPANA,2,638,2,642,1678
TABASCO,MACUSPANA,2,592,2,596,1677
TABASCO,MACUSPANA,8,387,4,399,1667
TABASCO,MACUSPANA,2,414,1,417,1666
TABASCO,MACUSPANA,6,698,2,706,1666
TABASCO,MACUSPANA,5,453,6,464,1880
TABASCO,MACUSPANA,5,457,3,465,1879
TABASCO,MACUSPANA,7,336,5,348,1026
TABASCO,MACUSPANA,4,332,7,343,1026
TABASCO,MACUSPANA,10,519,10,539,1819
TABASCO,MACUSPANA,12,649,6,667,1819
TABASCO,MACUSPANA,10,833,7,850,1996
TABASCO,MACUSPANA,4,807,5,816,1996
TABASCO,MACUSPANA,4,426,4,434,1709
TABASCO,MACUSPANA,8,398,5,411,1708
TABASCO,MACUSPANA,8,621,4,633,1598
TABASCO,MACUSPANA,14,990,5,1009,1598
TABASCO,MACUSPANA,1,794,1,796,1598
TABASCO,MACUSPANA,4,437,8,449,1735
TABASCO,MACUSPANA,3,465,7,475,1735
TABASCO,MACUSPANA,14,566,7,587,1507
TABASCO,MACUSPANA,0,1201,64,1265,1507
TABASCO,MACUSPANA,9,938,3,950,1506
TABASCO,MACUSPANA,6,601,4,611,1422
TABASCO,MACUSPANA,8,691,2,701,1421
TABASCO,MACUSPANA,0,739,7,746,1421
TABASCO,MACUSPANA,7,698,15,720,1882
TABASCO,MACUSPANA,2,400,10,412,1770
TABASCO,MACUSPANA,3,330,6,339,1770
TABASCO,MACUSPANA,2,430,15,447,1778
TABASCO,MACUSPANA,12,468,17,497,1778
TABASCO,MACUSPANA,7,398,15,420,1777
TABASCO,MACUSPANA,14,1323,12,1349,1580
TABASCO,MACUSPANA,3,1386,6,1395,1579
TABASCO,MACUSPANA,6,475,7,488,1257
TABASCO,MACUSPANA,5,485,17,507,1256
TABASCO,MACUSPANA,18,563,18,599,1698
TABASCO,MACUSPANA,16,505,22,543,1697
TABASCO,MACUSPANA,8,573,4,585,1790
TABASCO,MACUSPANA,12,564,3,579,1789
TABASCO,MACUSPANA,10,593,8,611,1789
TABASCO,MACUSPANA,6,419,2,427,1038
TABASCO,MACUSPANA,2,398,1,401,1038
TABASCO,MACUSPANA,7,427,4,438,1373
TABASCO,MACUSPANA,0,513,11,524,1373
TABASCO,MACUSPANA,12,419,9,440,1372
TABASCO,MACUSPANA,7,613,8,628,1670
TABASCO,MACUSPANA,8,859,11,878,1670
TABASCO,MACUSPANA,8,622,14,644,1670
TABASCO,MACUSPANA,9,439,6,454,1395
TABASCO,MACUSPANA,5,473,3,481,1394
TABASCO,MACUSPANA,2,477,5,484,1394
TABASCO,MACUSPANA,11,595,6,612,1574
TABASCO,MACUSPANA,1,529,6,536,1574
TABASCO,MACUSPANA,3,566,8,577,1574
TABASCO,MACUSPANA,2,563,7,572,1708
TABASCO,MACUSPANA,2,575,3,580,1708
TABASCO,MACUSPANA,3,574,0,577,1708
TABASCO,MACUSPANA,3,574,7,584,1707
TABASCO,MACUSPANA,7,851,6,864,1951
TABASCO,MACUSPANA,9,845,7,861,1950
TABASCO,MACUSPANA,7,780,6,793,1781
TABASCO,MACUSPANA,31,753,21,805,1781
TABASCO,MACUSPANA,20,643,14,677,1781
TABASCO,HEROICA CARDENAS,6,496,5,507,1761
TABASCO,HEROICA CARDENAS,2,437,6,445,1761
TABASCO,HEROICA CARDENAS,10,456,14,480,1761
TABASCO,HEROICA CARDENAS,8,884,9,901,1618
TABASCO,HEROICA CARDENAS,7,467,3,477,1617
TABASCO,HEROICA CARDENAS,9,412,4,425,1646
TABASCO,HEROICA CARDENAS,10,432,0,442,1646
TABASCO,HEROICA CARDENAS,7,635,7,649,1961
TABASCO,HEROICA CARDENAS,7,644,1,652,1961
TABASCO,HEROICA CARDENAS,12,606,11,629,1941
TABASCO,HEROICA CARDENAS,12,496,6,514,1941
TABASCO,HEROICA CARDENAS,10,461,2,473,1838
TABASCO,HEROICA CARDENAS,6,448,3,457,1838
TABASCO,HEROICA CARDENAS,8,571,4,583,1871
TABASCO,HEROICA CARDENAS,2,581,8,591,1870
TABASCO,HEROICA CARDENAS,10,501,1,512,1895
TABASCO,HEROICA CARDENAS,5,533,3,541,1895
TABASCO,HEROICA CARDENAS,12,508,4,524,1895
TABASCO,HEROICA CARDENAS,4,399,5,408,1462
TABASCO,HEROICA CARDENAS,1,939,3,943,1461
TABASCO,HEROICA CARDENAS,5,1106,53,1164,1461
TABASCO,HEROICA CARDENAS,8,469,5,482,1473
TABASCO,HEROICA CARDENAS,0,509,7,516,1472
TABASCO,HEROICA CARDENAS,29,1253,7,1289,0
TABASCO,HEROICA CARDENAS,10,658,4,672,1951
TABASCO,HEROICA CARDENAS,8,665,6,679,1951
TABASCO,HEROICA CARDENAS,14,462,5,481,1574
TABASCO,HEROICA CARDENAS,1,667,1,669,1574
TABASCO,HEROICA CARDENAS,7,453,6,466,1573
TABASCO,HEROICA CARDENAS,3,617,1,621,1895
TABASCO,HEROICA CARDENAS,10,523,4,537,1894
TABASCO,HEROICA CARDENAS,4,625,4,633,1894
TABASCO,HEROICA CARDENAS,6,421,1,428,1569
TABASCO,HEROICA CARDENAS,4,440,3,447,1568
TABASCO,HEROICA CARDENAS,7,512,4,523,1139
TABASCO,HEROICA CARDENAS,6,510,28,544,1138
TABASCO,HEROICA CARDENAS,13,797,0,810,1997
TABASCO,HEROICA CARDENAS,7,813,10,830,1903
TABASCO,HEROICA CARDENAS,7,705,7,719,1902
TABASCO,HEROICA CARDENAS,12,787,6,805,1680
TABASCO,HEROICA CARDENAS,11,776,13,800,1680
TABASCO,HEROICA CARDENAS,5,852,7,864,1674
TABASCO,HEROICA CARDENAS,14,686,16,716,1673
TABASCO,HEROICA CARDENAS,7,521,13,541,1734
TABASCO,HEROICA CARDENAS,1,543,9,553,1734
TABASCO,HEROICA CARDENAS,9,547,7,563,1733
TABASCO,HEROICA CARDENAS,10,714,11,735,1999
TABASCO,HEROICA CARDENAS,10,744,9,763,1999
TABASCO,HEROICA CARDENAS,15,571,14,600,1945
TABASCO,HEROICA CARDENAS,13,710,25,748,1944
TABASCO,HEROICA CARDENAS,3,425,3,431,1309
TABASCO,HEROICA CARDENAS,7,370,8,385,1308
TABASCO,HEROICA CARDENAS,5,957,5,967,1996
TABASCO,HEROICA CARDENAS,7,1115,6,1128,1996
TABASCO,HEROICA CARDENAS,15,722,15,752,1868
TABASCO,HEROICA CARDENAS,0,681,25,706,1867
TABASCO,HEROICA CARDENAS,10,811,7,828,1349
TABASCO,HEROICA CARDENAS,3,856,3,862,1349
TABASCO,HEROICA CARDENAS,6,562,15,583,1550
TABASCO,HEROICA CARDENAS,6,572,6,584,1549
TABASCO,HEROICA CARDENAS,12,569,4,585,1534
TABASCO,HEROICA CARDENAS,3,558,7,568,1533
TABASCO,HEROICA CARDENAS,8,516,7,531,1948
TABASCO,HEROICA CARDENAS,7,415,5,427,1947
TABASCO,HEROICA CARDENAS,0,576,12,588,1783
TABASCO,HEROICA CARDENAS,11,534,8,553,1782
TABASCO,HEROICA CARDENAS,7,530,16,553,1782
TABASCO,HEROICA CARDENAS,11,670,22,703,1751
TABASCO,HEROICA CARDENAS,10,678,21,709,1751
TABASCO,HEROICA CARDENAS,8,761,1,770,1891
TABASCO,HEROICA CARDENAS,9,1088,8,1105,1891
TABASCO,HEROICA CARDENAS,10,612,4,626,2002
TABASCO,HEROICA CARDENAS,6,602,8,616,2001
TABASCO,HEROICA CARDENAS,11,648,2,661,1726
TABASCO,HEROICA CARDENAS,12,634,3,649,1726
TABASCO,HEROICA CARDENAS,7,425,3,435,1505
TABASCO,HEROICA CARDENAS,8,456,6,470,1505
TABASCO,HEROICA CARDENAS,6,551,4,561,1701
TABASCO,HEROICA CARDENAS,10,525,12,547,1701
TABASCO,HEROICA CARDENAS,4,538,13,555,1701
TABASCO,HEROICA CARDENAS,5,513,9,527,1952
TABASCO,HEROICA CARDENAS,5,591,13,609,1951
TABASCO,HEROICA CARDENAS,27,1277,6,1310,1918
TABASCO,HEROICA CARDENAS,4,487,7,498,1917
TABASCO,HEROICA CARDENAS,4,470,7,481,1226
TABASCO,HEROICA CARDENAS,2,459,11,472,1225
TABASCO,HEROICA CARDENAS,11,632,16,659,1975
TABASCO,HEROICA CARDENAS,2,614,16,632,1975
TABASCO,HEROICA CARDENAS,4,690,3,697,1384
TABASCO,HEROICA CARDENAS,7,986,1,994,1383
TABASCO,HEROICA CARDENAS,7,616,4,627,1866
TABASCO,HEROICA CARDENAS,11,565,6,582,1865
TABASCO,HEROICA CARDENAS,6,477,6,489,1912
TABASCO,HEROICA CARDENAS,7,448,3,458,1912
TABASCO,HEROICA CARDENAS,8,728,5,741,1866
TABASCO,HEROICA CARDENAS,6,584,5,595,1865
TABASCO,HEROICA CARDENAS,10,687,2,699,1735
TABASCO,HEROICA CARDENAS,9,652,8,669,1735
TABASCO,HEROICA CARDENAS,3,632,5,640,1923
TABASCO,HEROICA CARDENAS,9,610,2,621,1922
TABASCO,HEROICA CARDENAS,5,373,7,385,1664
TABASCO,HEROICA CARDENAS,7,404,7,418,1663
TABASCO,HEROICA CARDENAS,12,1114,9,1135,1669
TABASCO,HEROICA CARDENAS,11,1159,5,1175,1668
TABASCO,HEROICA CARDENAS,7,1397,5,1409,1984
TABASCO,HEROICA CARDENAS,10,1015,4,1029,1983
TABASCO,HEROICA CARDENAS,0,691,5,696,1999
TABASCO,HEROICA CARDENAS,0,657,13,670,1999
TABASCO,HEROICA CARDENAS,20,523,6,549,1686
TABASCO,HEROICA CARDENAS,9,600,6,615,1685
TABASCO,HEROICA CARDENAS,15,614,3,632,2000
TABASCO,HEROICA CARDENAS,9,663,6,678,1999
TABASCO,HEROICA CARDENAS,5,596,11,612,1740
TABASCO,HEROICA CARDENAS,4,597,5,606,1740
TABASCO,HEROICA CARDENAS,0,579,8,587,1740
TABASCO,HEROICA CARDENAS,6,558,6,570,1739
TABASCO,HEROICA CARDENAS,9,1132,1,1142,1758
TABASCO,HEROICA CARDENAS,10,926,6,942,1757
TABASCO,HEROICA CARDENAS,9,868,8,885,1370
TABASCO,HEROICA CARDENAS,6,757,7,770,1369
TABASCO,HEROICA CARDENAS,5,1024,9,1038,1133
TABASCO,HEROICA CARDENAS,7,972,12,991,1133
TABASCO,HEROICA CARDENAS,6,1149,2,1157,1523
TABASCO,HEROICA CARDENAS,6,1112,6,1124,1522
TABASCO,HEROICA CARDENAS,8,746,7,761,1589
TABASCO,HEROICA CARDENAS,5,801,5,811,1589
TABASCO,HEROICA CARDENAS,6,756,4,766,1588
TABASCO,HEROICA CARDENAS,18,1218,5,1241,1868
TABASCO,HEROICA CARDENAS,9,1243,6,1258,1868
TABASCO,HEROICA CARDENAS,8,599,6,613,1951
TABASCO,HEROICA CARDENAS,16,937,6,959,1950
TABASCO,HEROICA CARDENAS,8,1038,4,1050,1467
TABASCO,HEROICA CARDENAS,6,1408,7,1421,1467
TABASCO,HEROICA CARDENAS,9,360,3,372,1106
TABASCO,HEROICA CARDENAS,4,350,3,357,1105
TABASCO,HEROICA CARDENAS,8,1090,8,1106,1931
TABASCO,HEROICA CARDENAS,7,1233,10,1250,1931
TABASCO,HEROICA CARDENAS,1,784,6,791,1606
TABASCO,HEROICA CARDENAS,10,771,111,892,1606
TABASCO,HEROICA CARDENAS,9,776,4,789,1605
TABASCO,HEROICA CARDENAS,5,529,6,540,1861
TABASCO,HEROICA CARDENAS,7,877,5,889,1861
TABASCO,HEROICA CARDENAS,1,618,14,633,2112
TABASCO,HEROICA CARDENAS,9,634,12,655,2111
TABASCO,HEROICA CARDENAS,8,1213,0,1221,1349
TABASCO,HEROICA CARDENAS,7,1104,8,1119,1349
TABASCO,HEROICA CARDENAS,15,1207,2,1224,1420
TABASCO,HEROICA CARDENAS,14,1198,7,1219,1420
TABASCO,HEROICA CARDENAS,4,439,2,445,1171
TABASCO,HEROICA CARDENAS,4,393,5,402,1170
TABASCO,HEROICA CARDENAS,8,1071,12,1091,1998
TABASCO,HEROICA CARDENAS,9,1261,3,1273,1997
TABASCO,HEROICA CARDENAS,9,706,13,728,1947
TABASCO,HEROICA CARDENAS,7,648,12,667,1947
TABASCO,HEROICA CARDENAS,11,1032,15,1058,2062
TABASCO,HEROICA CARDENAS,9,817,21,847,2062
TABASCO,HEROICA CARDENAS,10,1362,19,1391,2083
TABASCO,HEROICA CARDENAS,3,1014,3,1020,1551
TABASCO,HEROICA CARDENAS,4,991,8,1003,1550
TABASCO,HEROICA CARDENAS,0,1385,17,1402,1889
TABASCO,HEROICA CARDENAS,0,1090,33,1123,1889
TABASCO,HEROICA CARDENAS,6,757,4,767,1306
TABASCO,HEROICA CARDENAS,5,930,8,943,1305
TABASCO,HEROICA CARDENAS,6,698,7,711,1348
TABASCO,HEROICA CARDENAS,7,690,32,729,1348
TABASCO,HEROICA CARDENAS,6,947,5,958,1819
TABASCO,HEROICA CARDENAS,0,800,45,845,1819
TABASCO,HEROICA CARDENAS,6,801,4,811,1857
TABASCO,HEROICA CARDENAS,10,972,18,1000,1857
TABASCO,HEROICA CARDENAS,9,727,3,739,1748
TABASCO,HEROICA CARDENAS,9,648,4,661,1748
TABASCO,HEROICA CARDENAS,7,626,1,634,1747
TABASCO,HEROICA CARDENAS,16,1288,8,1312,1990
TABASCO,HEROICA CARDENAS,3,816,7,826,1455
TABASCO,HEROICA CARDENAS,6,740,11,757,1454
TABASCO,HEROICA CARDENAS,6,896,13,915,1975
TABASCO,HEROICA CARDENAS,11,577,13,601,1975
TABASCO,HEROICA CARDENAS,16,924,14,954,1785
TABASCO,HEROICA CARDENAS,14,881,12,907,1785
TABASCO,HEROICA CARDENAS,12,1211,6,1229,2036
TABASCO,HEROICA CARDENAS,20,875,9,904,2035
TABASCO,COMALCALCO,10,487,5,502,1728
TABASCO,COMALCALCO,9,482,1,492,1727
TABASCO,COMALCALCO,19,739,4,762,2058
TABASCO,COMALCALCO,13,686,8,707,2057
TABASCO,COMALCALCO,8,533,3,544,1648
TABASCO,COMALCALCO,7,522,10,539,1647
TABASCO,COMALCALCO,25,497,4,526,1481
TABASCO,COMALCALCO,20,519,4,543,1480
TABASCO,COMALCALCO,18,484,7,509,1480
TABASCO,COMALCALCO,14,588,4,606,1565
TABASCO,COMALCALCO,20,574,3,597,1565
TABASCO,COMALCALCO,8,456,2,466,1586
TABASCO,COMALCALCO,10,490,4,504,1586
TABASCO,COMALCALCO,44,1560,21,1625,0
TABASCO,COMALCALCO,17,546,6,569,1598
TABASCO,COMALCALCO,8,560,5,573,1597
TABASCO,COMALCALCO,11,645,6,662,1748
TABASCO,COMALCALCO,2,650,5,657,1748
TABASCO,COMALCALCO,12,712,7,731,1911
TABASCO,COMALCALCO,7,655,11,673,1911
TABASCO,COMALCALCO,22,691,25,738,1980
TABASCO,COMALCALCO,22,695,8,725,1980
TABASCO,COMALCALCO,14,402,11,427,1400
TABASCO,COMALCALCO,14,487,20,521,1399
TABASCO,COMALCALCO,13,584,10,607,1514
TABASCO,COMALCALCO,17,539,34,590,1513
TABASCO,COMALCALCO,23,612,1,636,2087
TABASCO,COMALCALCO,13,549,24,586,2087
TABASCO,COMALCALCO,7,624,7,638,1540
TABASCO,COMALCALCO,9,560,5,574,1540
TABASCO,COMALCALCO,15,613,3,631,1565
TABASCO,COMALCALCO,14,598,15,627,1565
TABASCO,COMALCALCO,12,623,13,648,1723
TABASCO,COMALCALCO,18,597,11,626,1723
TABASCO,COMALCALCO,13,616,21,650,1504
TABASCO,COMALCALCO,17,595,10,622,1504
TABASCO,COMALCALCO,17,733,10,760,2019
TABASCO,COMALCALCO,12,637,65,714,2018
TABASCO,COMALCALCO,13,517,1,531,1428
TABASCO,COMALCALCO,11,544,9,564,1428
TABASCO,COMALCALCO,10,737,6,753,1912
TABASCO,COMALCALCO,9,706,16,731,1912
TABASCO,COMALCALCO,10,662,17,689,1825
TABASCO,COMALCALCO,10,727,45,782,1825
TABASCO,COMALCALCO,52,579,15,646,1488
TABASCO,COMALCALCO,46,642,25,713,1487
TABASCO,COMALCALCO,21,605,5,631,1845
TABASCO,COMALCALCO,12,638,1,651,1844
TABASCO,COMALCALCO,12,599,8,619,1892
TABASCO,COMALCALCO,10,567,6,583,1891
TABASCO,COMALCALCO,14,625,17,656,2072
TABASCO,COMALCALCO,20,589,6,615,2072
TABASCO,COMALCALCO,11,608,12,631,1722
TABASCO,COMALCALCO,10,596,12,618,1722
TABASCO,COMALCALCO,14,537,13,564,1644
TABASCO,COMALCALCO,14,455,7,476,1643
TABASCO,COMALCALCO,15,549,13,577,1786
TABASCO,COMALCALCO,24,567,16,607,1785
TABASCO,COMALCALCO,10,527,9,546,1413
TABASCO,COMALCALCO,10,522,8,540,1413
TABASCO,COMALCALCO,12,612,11,635,1928
TABASCO,COMALCALCO,15,601,13,629,1928
TABASCO,COMALCALCO,10,518,13,541,1475
TABASCO,COMALCALCO,14,514,10,538,1474
TABASCO,COMALCALCO,3,551,7,561,1474
TABASCO,COMALCALCO,4,603,9,616,2016
TABASCO,COMALCALCO,17,619,12,648,2015
TABASCO,COMALCALCO,5,582,11,598,1254
TABASCO,COMALCALCO,6,493,10,509,1253
TABASCO,COMALCALCO,12,444,12,468,1312
TABASCO,COMALCALCO,4,457,9,470,1312
TABASCO,COMALCALCO,18,667,13,698,1558
TABASCO,COMALCALCO,25,573,25,623,1557
TABASCO,COMALCALCO,24,639,15,678,1557
TABASCO,COMALCALCO,8,535,6,549,1463
TABASCO,COMALCALCO,12,464,11,487,1462
TABASCO,COMALCALCO,15,635,15,665,1842
TABASCO,COMALCALCO,17,596,9,622,1841
TABASCO,COMALCALCO,17,667,17,701,1968
TABASCO,COMALCALCO,22,641,19,682,1967
TABASCO,COMALCALCO,14,550,4,568,1615
TABASCO,COMALCALCO,10,558,5,573,1614
TABASCO,COMALCALCO,8,510,22,540,2016
TABASCO,COMALCALCO,14,582,20,616,2016
TABASCO,COMALCALCO,16,548,22,586,1592
TABASCO,COMALCALCO,19,553,4,576,1592
TABASCO,COMALCALCO,15,518,14,547,1592
TABASCO,COMALCALCO,13,590,8,611,1652
TABASCO,COMALCALCO,10,602,14,626,1652
TABASCO,COMALCALCO,11,435,4,450,1537
TABASCO,COMALCALCO,5,460,0,465,1537
TABASCO,COMALCALCO,9,505,1,515,1549
TABASCO,COMALCALCO,8,485,3,496,1549
TABASCO,COMALCALCO,12,566,4,582,1903
TABASCO,COMALCALCO,6,501,5,512,1903
TABASCO,COMALCALCO,13,470,2,485,1660
TABASCO,COMALCALCO,5,493,3,501,1659
TABASCO,COMALCALCO,0,524,26,550,1121
TABASCO,COMALCALCO,3,571,3,577,1121
TABASCO,COMALCALCO,5,438,1,444,1487
TABASCO,COMALCALCO,5,520,6,531,1486
TABASCO,COMALCALCO,4,389,7,400,1488
TABASCO,COMALCALCO,5,462,2,469,1488
TABASCO,COMALCALCO,0,548,3,551,1488
TABASCO,COMALCALCO,3,346,7,356,1318
TABASCO,COMALCALCO,6,288,4,298,1318
TABASCO,COMALCALCO,9,610,5,624,1932
TABASCO,COMALCALCO,11,579,14,604,1931
TABASCO,COMALCALCO,5,679,6,690,1976
TABASCO,COMALCALCO,7,663,6,676,1975
TABASCO,COMALCALCO,5,286,4,295,1357
TABASCO,COMALCALCO,1,291,3,295,1356
TABASCO,COMALCALCO,9,351,3,363,1461
TABASCO,COMALCALCO,3,367,4,374,1461
TABASCO,COMALCALCO,7,360,9,376,1460
TABASCO,COMALCALCO,10,402,3,415,1671
TABASCO,COMALCALCO,9,395,6,410,1670
TABASCO,COMALCALCO,3,425,6,434,1621
TABASCO,COMALCALCO,3,354,8,365,1621
TABASCO,COMALCALCO,5,376,11,392,1551
TABASCO,COMALCALCO,3,333,3,339,1551
TABASCO,COMALCALCO,8,623,5,636,1972
TABASCO,COMALCALCO,11,656,19,686,1971
TABASCO,COMALCALCO,8,502,6,516,1816
TABASCO,COMALCALCO,1,585,1,587,1815
TABASCO,COMALCALCO,12,520,0,532,1815
TABASCO,COMALCALCO,6,548,5,559,1746
TABASCO,COMALCALCO,6,470,13,489,1745
TABASCO,COMALCALCO,4,297,4,305,1264
TABASCO,COMALCALCO,5,346,5,356,1264
TABASCO,COMALCALCO,8,537,5,550,2124
TABASCO,COMALCALCO,5,538,9,552,2124
TABASCO,COMALCALCO,7,755,5,767,1525
TABASCO,COMALCALCO,4,575,3,582,1525
TABASCO,COMALCALCO,7,392,7,406,1529
TABASCO,COMALCALCO,3,383,6,392,1528
TABASCO,COMALCALCO,3,756,0,759,1906
TABASCO,COMALCALCO,7,686,8,701,1906
TABASCO,COMALCALCO,5,316,5,326,1456
TABASCO,COMALCALCO,3,319,13,335,1455
TABASCO,COMALCALCO,12,590,5,607,1889
TABASCO,COMALCALCO,6,582,4,592,1888
TABASCO,COMALCALCO,6,441,4,451,1270
TABASCO,COMALCALCO,5,416,9,430,1270
TABASCO,COMALCALCO,4,551,10,565,1705
TABASCO,COMALCALCO,7,523,9,539,1704
TABASCO,COMALCALCO,7,387,1,395,1090
TABASCO,COMALCALCO,9,357,10,376,1090
TABASCO,COMALCALCO,5,463,9,477,1319
TABASCO,COMALCALCO,11,385,5,401,1318
TABASCO,COMALCALCO,12,665,15,692,1688
TABASCO,COMALCALCO,11,607,14,632,1688
TABASCO,COMALCALCO,13,521,9,543,1380
TABASCO,COMALCALCO,14,520,1,535,1380
TABASCO,VILLAHERMOSA,8,498,2,508,1903
TABASCO,VILLAHERMOSA,11,515,1,527,1902
TABASCO,VILLAHERMOSA,13,393,7,413,1902
TABASCO,VILLAHERMOSA,17,466,4,487,1902
TABASCO,VILLAHERMOSA,7,476,5,488,1902
TABASCO,VILLAHERMOSA,9,462,7,478,1902
TABASCO,VILLAHERMOSA,17,453,4,474,1902
TABASCO,VILLAHERMOSA,17,556,41,614,1957
TABASCO,VILLAHERMOSA,8,525,6,539,1956
TABASCO,VILLAHERMOSA,17,361,0,378,1901
TABASCO,VILLAHERMOSA,8,375,5,388,1901
TABASCO,VILLAHERMOSA,13,398,3,414,1901
TABASCO,VILLAHERMOSA,7,487,2,496,1941
TABASCO,VILLAHERMOSA,9,484,3,496,1940
TABASCO,VILLAHERMOSA,8,534,5,547,1611
TABASCO,VILLAHERMOSA,9,554,3,566,1611
TABASCO,VILLAHERMOSA,16,479,2,497,1597
TABASCO,VILLAHERMOSA,6,470,5,481,1597
TABASCO,VILLAHERMOSA,12,406,2,420,1403
TABASCO,VILLAHERMOSA,10,431,5,446,1402
TABASCO,VILLAHERMOSA,8,585,0,593,1851
TABASCO,VILLAHERMOSA,12,525,4,541,1851
TABASCO,VILLAHERMOSA,15,389,4,408,1615
TABASCO,VILLAHERMOSA,13,349,11,373,1614
TABASCO,VILLAHERMOSA,10,409,2,421,1614
TABASCO,VILLAHERMOSA,5,322,1,328,1479
TABASCO,VILLAHERMOSA,8,350,5,363,1479
TABASCO,VILLAHERMOSA,4,324,1,329,1478
TABASCO,VILLAHERMOSA,6,331,3,340,1478
TABASCO,VILLAHERMOSA,11,366,1,378,1546
TABASCO,VILLAHERMOSA,19,424,5,448,1546
TABASCO,VILLAHERMOSA,8,436,1,445,1532
TABASCO,VILLAHERMOSA,4,389,6,399,1532
TABASCO,VILLAHERMOSA,6,393,6,405,1532
TABASCO,VILLAHERMOSA,9,398,1,408,1531
TABASCO,VILLAHERMOSA,30,390,1,421,1831
TABASCO,VILLAHERMOSA,31,385,3,419,1831
TABASCO,VILLAHERMOSA,22,452,3,477,1831
TABASCO,VILLAHERMOSA,13,411,3,427,1531
TABASCO,VILLAHERMOSA,15,358,4,377,1530
TABASCO,VILLAHERMOSA,14,388,3,405,1530
TABASCO,VILLAHERMOSA,19,361,5,385,1530
TABASCO,VILLAHERMOSA,17,486,4,507,1836
TABASCO,VILLAHERMOSA,12,512,7,531,1836
TABASCO,VILLAHERMOSA,21,284,3,308,1214
TABASCO,VILLAHERMOSA,13,309,2,324,1214
TABASCO,VILLAHERMOSA,10,516,9,535,1801
TABASCO,VILLAHERMOSA,7,552,9,568,1801
TABASCO,VILLAHERMOSA,14,529,8,551,1800
TABASCO,VILLAHERMOSA,9,215,0,224,998
TABASCO,VILLAHERMOSA,5,240,2,247,997
TABASCO,VILLAHERMOSA,16,395,0,411,1650
TABASCO,VILLAHERMOSA,8,380,5,393,1650
TABASCO,VILLAHERMOSA,48,1950,9,2007,0
TABASCO,VILLAHERMOSA,21,512,3,536,1869
TABASCO,VILLAHERMOSA,20,548,1,569,1868
TABASCO,VILLAHERMOSA,11,495,6,512,1714
TABASCO,VILLAHERMOSA,13,481,3,497,1713
TABASCO,VILLAHERMOSA,8,450,5,463,1713
TABASCO,VILLAHERMOSA,12,447,2,461,1513
TABASCO,VILLAHERMOSA,10,418,2,430,1513
TABASCO,VILLAHERMOSA,7,417,3,427,1392
TABASCO,VILLAHERMOSA,14,407,4,425,1392
TABASCO,VILLAHERMOSA,8,490,2,500,1970
TABASCO,VILLAHERMOSA,16,522,6,544,1969
TABASCO,VILLAHERMOSA,20,432,4,456,1636
TABASCO,VILLAHERMOSA,16,442,1,459,1636
TABASCO,VILLAHERMOSA,9,273,2,284,997
TABASCO,VILLAHERMOSA,5,314,3,322,997
TABASCO,VILLAHERMOSA,10,362,3,375,1504
TABASCO,VILLAHERMOSA,13,346,1,360,1504
TABASCO,VILLAHERMOSA,8,329,4,341,1504
TABASCO,VILLAHERMOSA,19,410,2,431,1765
TABASCO,VILLAHERMOSA,9,424,1,434,1765
TABASCO,VILLAHERMOSA,12,503,6,521,1699
TABASCO,VILLAHERMOSA,10,453,6,469,1699
TABASCO,VILLAHERMOSA,14,547,3,564,1897
TABASCO,VILLAHERMOSA,18,534,4,556,1896
TABASCO,VILLAHERMOSA,17,460,2,479,1817
TABASCO,VILLAHERMOSA,17,515,4,536,1816
TABASCO,VILLAHERMOSA,14,473,6,493,1844
TABASCO,VILLAHERMOSA,17,411,3,431,1843
TABASCO,VILLAHERMOSA,12,556,5,573,1924
TABASCO,VILLAHERMOSA,8,535,2,545,1924
TABASCO,VILLAHERMOSA,16,497,6,519,1924
TABASCO,VILLAHERMOSA,11,526,3,540,1923
TABASCO,VILLAHERMOSA,10,344,1,355,1466
TABASCO,VILLAHERMOSA,15,323,3,341,1465
TABASCO,VILLAHERMOSA,11,539,3,553,1751
TABASCO,VILLAHERMOSA,6,500,1,507,1751
TABASCO,VILLAHERMOSA,10,608,0,618,1858
TABASCO,VILLAHERMOSA,11,562,2,575,1858
TABASCO,VILLAHERMOSA,29,461,3,493,1823
TABASCO,VILLAHERMOSA,18,478,3,499,1823
TABASCO,VILLAHERMOSA,16,416,2,434,1753
TABASCO,VILLAHERMOSA,12,434,6,452,1753
TABASCO,VILLAHERMOSA,12,432,6,450,1493
TABASCO,VILLAHERMOSA,6,475,3,484,1493
TABASCO,VILLAHERMOSA,9,438,7,454,1697
TABASCO,VILLAHERMOSA,12,424,9,445,1697
TABASCO,VILLAHERMOSA,13,456,8,477,1697
TABASCO,VILLAHERMOSA,9,325,2,336,1072
TABASCO,VILLAHERMOSA,13,339,3,355,1071
TABASCO,VILLAHERMOSA,12,478,5,495,1660
TABASCO,VILLAHERMOSA,11,395,5,411,1660
TABASCO,VILLAHERMOSA,9,413,3,425,1660
TABASCO,VILLAHERMOSA,20,513,3,536,1839
TABASCO,VILLAHERMOSA,11,522,2,535,1839
TABASCO,VILLAHERMOSA,16,426,4,446,1705
TABASCO,VILLAHERMOSA,8,389,6,403,1705
TABASCO,VILLAHERMOSA,6,441,5,452,1705
TABASCO,VILLAHERMOSA,8,405,4,417,1366
TABASCO,VILLAHERMOSA,7,375,7,389,1366
TABASCO,VILLAHERMOSA,14,353,4,371,1365
TABASCO,VILLAHERMOSA,0,336,4,340,1390
TABASCO,VILLAHERMOSA,10,420,6,436,1389
TABASCO,VILLAHERMOSA,14,342,0,356,1369
TABASCO,VILLAHERMOSA,5,374,2,381,1368
TABASCO,VILLAHERMOSA,8,378,4,390,1368
TABASCO,VILLAHERMOSA,9,440,1,450,1528
TABASCO,VILLAHERMOSA,7,422,3,432,1527
TABASCO,VILLAHERMOSA,8,386,3,397,1365
TABASCO,VILLAHERMOSA,9,416,5,430,1365
TABASCO,VILLAHERMOSA,6,381,0,387,1365
TABASCO,VILLAHERMOSA,18,416,0,434,1495
TABASCO,VILLAHERMOSA,27,364,2,393,1494
TABASCO,VILLAHERMOSA,10,266,35,311,1057
TABASCO,VILLAHERMOSA,9,304,1,314,1057
TABASCO,VILLAHERMOSA,11,484,3,498,1724
TABASCO,VILLAHERMOSA,9,452,5,466,1724
TABASCO,VILLAHERMOSA,11,470,6,487,1724
TABASCO,VILLAHERMOSA,0,471,0,471,1723
TABASCO,VILLAHERMOSA,4,659,4,667,1208
TABASCO,VILLAHERMOSA,4,616,3,623,1208
TABASCO,VILLAHERMOSA,5,885,4,894,1772
TABASCO,VILLAHERMOSA,2,866,4,872,1772
TABASCO,VILLAHERMOSA,3,885,4,892,1771
TABASCO,VILLAHERMOSA,5,809,8,822,1586
TABASCO,VILLAHERMOSA,9,891,0,900,1586
TABASCO,VILLAHERMOSA,8,637,7,652,1563
TABASCO,VILLAHERMOSA,3,685,10,698,1563
TABASCO,VILLAHERMOSA,9,586,2,597,1563
TABASCO,VILLAHERMOSA,9,573,3,585,1563
TABASCO,VILLAHERMOSA,6,655,0,661,1723
TABASCO,VILLAHERMOSA,6,591,3,600,1723
TABASCO,VILLAHERMOSA,14,613,3,630,1723
TABASCO,VILLAHERMOSA,9,363,3,375,1509
TABASCO,VILLAHERMOSA,3,384,1,388,1508
TABASCO,VILLAHERMOSA,8,364,2,374,1508
TABASCO,VILLAHERMOSA,7,580,5,592,1707
TABASCO,VILLAHERMOSA,10,587,5,602,1706
TABASCO,VILLAHERMOSA,9,513,2,524,1546
TABASCO,VILLAHERMOSA,6,522,3,531,1546
TABASCO,VILLAHERMOSA,8,528,4,540,1835
TABASCO,VILLAHERMOSA,9,503,4,516,1835
TABASCO,VILLAHERMOSA,12,538,0,550,1835
TABASCO,VILLAHERMOSA,3,660,4,667,1659
TABASCO,VILLAHERMOSA,3,693,4,700,1659
TABASCO,VILLAHERMOSA,9,663,8,680,1659
TABASCO,VILLAHERMOSA,11,449,2,462,1844
TABASCO,VILLAHERMOSA,6,490,2,498,1844
TABASCO,VILLAHERMOSA,6,458,7,471,1844
TABASCO,VILLAHERMOSA,9,440,9,458,1844
TABASCO,VILLAHERMOSA,7,498,0,505,1844
TABASCO,VILLAHERMOSA,13,460,2,475,1844
TABASCO,VILLAHERMOSA,0,438,5,443,1155
TABASCO,VILLAHERMOSA,8,327,17,352,1154
TABASCO,VILLAHERMOSA,6,381,2,389,1563
TABASCO,VILLAHERMOSA,8,370,0,378,1563
TABASCO,VILLAHERMOSA,4,396,5,405,1563
TABASCO,VILLAHERMOSA,9,365,7,381,1562
TABASCO,VILLAHERMOSA,11,373,3,387,1432
TABASCO,VILLAHERMOSA,7,381,6,394,1432
TABASCO,VILLAHERMOSA,4,347,15,366,1431
TABASCO,VILLAHERMOSA,8,345,17,370,1215
TABASCO,VILLAHERMOSA,4,318,6,328,1214
TABASCO,VILLAHERMOSA,12,431,12,455,1749
TABASCO,VILLAHERMOSA,8,386,10,404,1749
TABASCO,VILLAHERMOSA,8,301,13,322,1325
TABASCO,VILLAHERMOSA,4,313,15,332,1325
TABASCO,VILLAHERMOSA,3,335,6,344,1325
TABASCO,VILLAHERMOSA,6,323,6,335,1523
TABASCO,VILLAHERMOSA,4,355,5,364,1523
TABASCO,VILLAHERMOSA,8,318,6,332,1522
TABASCO,VILLAHERMOSA,3,431,6,440,1527
TABASCO,VILLAHERMOSA,2,383,4,389,1526
TABASCO,VILLAHERMOSA,6,396,3,405,1526
TABASCO,VILLAHERMOSA,4,374,6,384,1526
TABASCO,VILLAHERMOSA,13,311,36,360,1236
TABASCO,VILLAHERMOSA,8,358,27,393,1235
TABASCO,VILLAHERMOSA,6,440,25,471,1094
TABASCO,VILLAHERMOSA,1,415,8,424,1093
TABASCO,PARAISO,5,449,4,458,1243
TABASCO,PARAISO,5,435,0,440,1243
TABASCO,PARAISO,0,443,6,449,1543
TABASCO,PARAISO,6,477,3,486,1542
TABASCO,PARAISO,10,448,3,461,1542
TABASCO,PARAISO,9,614,6,629,1902
TABASCO,PARAISO,7,601,0,608,1901
TABASCO,PARAISO,6,571,5,582,1885
TABASCO,PARAISO,8,600,4,612,1884
TABASCO,PARAISO,6,618,1,625,1636
TABASCO,PARAISO,2,602,7,611,1635
TABASCO,PARAISO,8,511,2,521,1519
TABASCO,PARAISO,13,478,5,496,1519
TABASCO,PARAISO,1,446,8,455,1317
TABASCO,PARAISO,8,441,6,455,1317
TABASCO,PARAISO,6,510,6,522,1550
TABASCO,PARAISO,5,516,6,527,1550
TABASCO,PARAISO,6,590,7,603,1549
TABASCO,PARAISO,3,392,0,395,1433
TABASCO,PARAISO,4,377,5,386,1432
TABASCO,PARAISO,5,383,6,394,1432
TABASCO,PARAISO,4,396,4,404,1719
TABASCO,PARAISO,12,424,5,441,1718
TABASCO,PARAISO,10,384,3,397,1371
TABASCO,PARAISO,13,418,2,433,1371
TABASCO,PARAISO,13,356,4,373,1371
TABASCO,PARAISO,6,484,5,495,1542
TABASCO,PARAISO,2,550,6,558,1541
TABASCO,PARAISO,6,492,5,503,1541
TABASCO,PARAISO,7,526,2,535,1493
TABASCO,PARAISO,4,508,2,514,1492
TABASCO,PARAISO,6,542,7,555,1492
TABASCO,PARAISO,6,430,6,442,1162
TABASCO,PARAISO,7,448,9,464,1161
TABASCO,PARAISO,0,496,0,496,1390
TABASCO,PARAISO,8,524,8,540,1389
TABASCO,PARAISO,1,515,3,519,1389
TABASCO,PARAISO,3,443,7,453,1641
TABASCO,PARAISO,10,464,6,480,1641
TABASCO,PARAISO,6,530,6,542,1550
TABASCO,PARAISO,11,550,5,566,1550
TABASCO,PARAISO,14,670,10,694,1723
TABASCO,PARAISO,18,1576,8,1602,1722
TABASCO,PARAISO,6,1104,2,1112,1411
TABASCO,PARAISO,4,641,13,658,1462
TABASCO,PARAISO,4,595,5,604,1462
TABASCO,PARAISO,10,717,11,738,1822
TABASCO,PARAISO,12,733,5,750,1822
TABASCO,PARAISO,3,632,10,645,1591
TABASCO,PARAISO,8,595,5,608,1591
TABASCO,PARAISO,6,628,4,638,1582
TABASCO,PARAISO,8,564,4,576,1582
TABASCO,PARAISO,13,641,4,658,1806
TABASCO,PARAISO,10,689,4,703,1805
TABASCO,PARAISO,8,689,1,698,1952
TABASCO,PARAISO,15,741,5,761,1951
TABASCO,PARAISO,9,1010,1,1020,1801
TABASCO,PARAISO,19,624,6,649,1800
TABASCO,PARAISO,6,531,4,541,1394
TABASCO,PARAISO,0,536,1,537,1394
TABASCO,PARAISO,4,518,1,523,1393
TABASCO,PARAISO,11,749,8,768,1173
TABASCO,PARAISO,0,773,6,779,1173
TABASCO,PARAISO,6,793,10,809,1649
TABASCO,PARAISO,15,666,6,687,1649
TABASCO,PARAISO,8,524,5,537,1074
TABASCO,PARAISO,4,759,20,783,1074
TABASCO,PARAISO,20,437,8,465,1597
TABASCO,PARAISO,14,482,11,507,1597
TABASCO,PARAISO,2,678,2,682,1597
TABASCO,PARAISO,7,512,7,526,1163
TABASCO,PARAISO,5,489,4,498,1162
TABASCO,PARAISO,2,598,18,618,1247
TABASCO,PARAISO,2,547,5,554,1247
TABASCO,PARAISO,9,551,6,566,1470
TABASCO,PARAISO,11,572,1,584,1470
TABASCO,PARAISO,8,639,2,649,1658
TABASCO,PARAISO,3,602,7,612,1657
TABASCO,PARAISO,10,501,6,517,1470
TABASCO,PARAISO,13,498,2,513,1470
TABASCO,PARAISO,4,510,5,519,1470
TABASCO,PARAISO,0,621,13,634,1666
TABASCO,PARAISO,2,625,5,632,1665
TABASCO,PARAISO,10,662,4,676,1039
TABASCO,PARAISO,4,628,14,646,1039
TABASCO,PARAISO,24,619,0,643,1813
TABASCO,PARAISO,0,603,4,607,1813
TABASCO,PARAISO,7,776,14,797,1666
TABASCO,PARAISO,10,705,8,723,1665
TABASCO,PARAISO,9,720,7,736,1665
TABASCO,PARAISO,10,641,9,660,1971
TABASCO,PARAISO,14,680,11,705,1970
TABASCO,PARAISO,16,1048,6,1070,1717
TABASCO,PARAISO,15,456,1,472,1406
TABASCO,PARAISO,4,466,0,470,1405
TABASCO,PARAISO,10,527,6,543,1895
TABASCO,PARAISO,14,604,7,625,1895
TABASCO,PARAISO,7,467,5,479,1402
TABASCO,PARAISO,18,469,3,490,1402
TABASCO,PARAISO,10,589,12,611,1133
TABASCO,PARAISO,7,630,8,645,1132
TABASCO,PARAISO,8,663,3,674,1269
TABASCO,PARAISO,5,651,4,660,1268
TABASCO,PARAISO,8,426,9,443,1071
TABASCO,PARAISO,13,411,8,432,1070
TABASCO,PARAISO,8,419,11,438,1183
TABASCO,PARAISO,11,409,5,425,1182
TABASCO,PARAISO,7,578,6,591,1753
TABASCO,PARAISO,22,559,15,596,1752
TABASCO,PARAISO,13,764,3,780,1854
TABASCO,PARAISO,11,832,9,852,1853
TABASCO,PARAISO,7,635,10,652,1788
TABASCO,PARAISO,13,634,5,652,1787
TABASCO,PARAISO,10,508,10,528,1429
TABASCO,PARAISO,7,540,2,549,1429
TABASCO,PARAISO,11,560,3,574,1433
TABASCO,PARAISO,5,544,4,553,1433
TABASCO,PARAISO,10,574,10,594,1847
TABASCO,PARAISO,9,573,12,594,1847
TABASCO,PARAISO,3,595,8,606,1915
TABASCO,PARAISO,16,613,3,632,1915
TABASCO,PARAISO,8,544,0,552,1652
TABASCO,PARAISO,0,597,9,606,1652
TABASCO,PARAISO,14,532,4,550,1647
TABASCO,PARAISO,14,446,6,466,1646
TABASCO,PARAISO,12,703,10,725,1930
TABASCO,PARAISO,8,629,5,642,1929
TABASCO,PARAISO,4,296,5,305,1195
TABASCO,PARAISO,3,318,3,324,1195
TABASCO,PARAISO,14,325,3,342,1429
TABASCO,PARAISO,6,352,6,364,1429
TABASCO,PARAISO,5,336,3,344,1428
TABASCO,PARAISO,7,419,4,430,1853
TABASCO,PARAISO,11,386,8,405,1853
TABASCO,PARAISO,9,391,9,409,1853
TABASCO,PARAISO,11,365,12,388,1853
TABASCO,PARAISO,8,373,6,387,1853
TABASCO,PARAISO,9,374,11,394,1853
TABASCO,PARAISO,9,330,3,342,1172
TABASCO,PARAISO,11,287,1,299,1171
TABASCO,PARAISO,9,431,2,442,1437
TABASCO,PARAISO,12,412,1,425,1437
TABASCO,PARAISO,5,327,5,337,1251
TABASCO,PARAISO,6,296,5,307,1250
TABASCO,PARAISO,8,403,1,412,1464
TABASCO,PARAISO,5,414,1,420,1464
TABASCO,PARAISO,7,322,2,331,1209
TABASCO,PARAISO,4,272,1,277,1208
TABASCO,PARAISO,7,416,6,429,1537
TABASCO,PARAISO,6,442,2,450,1536
TABASCO,PARAISO,2,472,9,483,1536
TABASCO,PARAISO,15,497,3,515,1896
TABASCO,PARAISO,4,503,3,510,1896
TABASCO,PARAISO,11,413,3,427,1624
TABASCO,PARAISO,5,408,2,415,1624
TABASCO,PARAISO,3,314,5,322,1624
TABASCO,PARAISO,6,540,5,551,1653
TABASCO,PARAISO,4,509,5,518,1652
TABASCO,PARAISO,1,1988,5,1994,0
TABASCO,PARAISO,8,520,1,529,1632
TABASCO,PARAISO,7,490,2,499,1632
TABASCO,PARAISO,11,438,0,449,1632
TABASCO,PARAISO,2,497,2,501,1297
TABASCO,PARAISO,7,497,5,509,1297
TABASCO,PARAISO,7,709,11,727,1888
TABASCO,PARAISO,9,669,5,683,1887
TABASCO,PARAISO,7,667,10,684,1989
TABASCO,PARAISO,3,705,3,711,1989
TABASCO,PARAISO,8,595,10,613,1907
TABASCO,PARAISO,9,602,10,621,1907
TABASCO,PARAISO,8,649,8,665,2059
TABASCO,PARAISO,3,476,2,481,1173
TABASCO,PARAISO,5,479,7,491,1173
TABASCO,PARAISO,7,584,8,599,1933
TABASCO,PARAISO,11,564,2,577,1933
TABASCO,PARAISO,9,583,1,593,1798
TABASCO,PARAISO,4,530,9,543,1797
TABASCO,PARAISO,9,473,9,491,1300
TABASCO,PARAISO,4,451,8,463,1300
TABASCO,PARAISO,2,341,2,345,1302
TABASCO,PARAISO,2,356,0,358,1302
TABASCO,PARAISO,5,564,9,578,1777
TABASCO,PARAISO,8,620,14,642,1777
TABASCO,PARAISO,4,531,5,540,1840
TABASCO,PARAISO,4,571,5,580,1839
TABASCO,PARAISO,3,496,1,500,1032
TABASCO,PARAISO,6,443,5,454,1031
TABASCO,PARAISO,0,574,5,579,1443
TABASCO,PARAISO,2,639,6,647,1443
TABASCO,PARAISO,13,636,0,649,1443
TABASCO,PARAISO,7,279,3,289,1442
TABASCO,PARAISO,3,235,4,242,1441
TABASCO,PARAISO,9,279,0,288,1441
TABASCO,PARAISO,77,350,0,427,1636
TABASCO,PARAISO,14,369,1,384,1636
TABASCO,PARAISO,10,394,1,405,1739
TABASCO,PARAISO,10,390,1,401,1739
TABASCO,PARAISO,2,368,3,373,1947
TABASCO,PARAISO,6,374,4,384,1946
TABASCO,PARAISO,5,241,0,246,1372
TABASCO,PARAISO,5,252,0,257,1371
TABASCO,PARAISO,5,250,2,257,1371
TABASCO,PARAISO,2,516,1,519,1233
TABASCO,PARAISO,7,368,5,380,1232
TABASCO,VILLAHERMOSA,4,445,5,454,1927
TABASCO,VILLAHERMOSA,0,485,4,489,1927
TABASCO,VILLAHERMOSA,3,408,4,415,1927
TABASCO,VILLAHERMOSA,1,427,8,436,1926
TABASCO,VILLAHERMOSA,11,449,3,463,1589
TABASCO,VILLAHERMOSA,15,421,2,438,1589
TABASCO,VILLAHERMOSA,10,358,0,368,1424
TABASCO,VILLAHERMOSA,7,358,3,368,1423
TABASCO,VILLAHERMOSA,8,416,3,427,1562
TABASCO,VILLAHERMOSA,14,433,0,447,1562
TABASCO,VILLAHERMOSA,7,407,2,416,1562
TABASCO,VILLAHERMOSA,8,436,5,449,1783
TABASCO,VILLAHERMOSA,10,398,0,408,1783
TABASCO,VILLAHERMOSA,9,394,5,408,1783
TABASCO,VILLAHERMOSA,17,445,1,463,1813
TABASCO,VILLAHERMOSA,13,420,0,433,1813
TABASCO,VILLAHERMOSA,9,470,5,484,1774
TABASCO,VILLAHERMOSA,8,439,3,450,1773
TABASCO,VILLAHERMOSA,8,376,6,390,1487
TABASCO,VILLAHERMOSA,9,376,6,391,1487
TABASCO,VILLAHERMOSA,15,417,6,438,1457
TABASCO,VILLAHERMOSA,11,389,5,405,1456
TABASCO,VILLAHERMOSA,16,334,1,351,1430
TABASCO,VILLAHERMOSA,6,307,2,315,1430
TABASCO,VILLAHERMOSA,21,299,1,321,1429
TABASCO,VILLAHERMOSA,16,335,1,352,1500
TABASCO,VILLAHERMOSA,13,293,1,307,1499
TABASCO,VILLAHERMOSA,13,331,0,344,1499
TABASCO,VILLAHERMOSA,10,311,3,324,1499
TABASCO,VILLAHERMOSA,16,339,4,359,1378
TABASCO,VILLAHERMOSA,16,365,2,383,1377
TABASCO,VILLAHERMOSA,15,357,1,373,1377
TABASCO,VILLAHERMOSA,14,318,5,337,1917
TABASCO,VILLAHERMOSA,10,356,3,369,1917
TABASCO,VILLAHERMOSA,10,345,4,359,1917
TABASCO,VILLAHERMOSA,12,329,5,346,1916
TABASCO,VILLAHERMOSA,8,289,2,299,1020
TABASCO,VILLAHERMOSA,7,299,1,307,1019
TABASCO,VILLAHERMOSA,5,434,3,442,1395
TABASCO,VILLAHERMOSA,17,457,4,478,1394
TABASCO,VILLAHERMOSA,4,369,8,381,1216
TABASCO,VILLAHERMOSA,8,391,7,406,1216
TABASCO,VILLAHERMOSA,4,412,2,418,1292
TABASCO,VILLAHERMOSA,4,424,4,432,1291
TABASCO,VILLAHERMOSA,6,619,4,629,1775
TABASCO,VILLAHERMOSA,5,544,4,553,1775
TABASCO,VILLAHERMOSA,4,538,14,556,1851
TABASCO,VILLAHERMOSA,10,498,33,541,1851
TABASCO,VILLAHERMOSA,4,447,3,454,1582
TABASCO,VILLAHERMOSA,6,401,7,414,1582
TABASCO,VILLAHERMOSA,13,443,3,459,1873
TABASCO,VILLAHERMOSA,13,514,5,532,1873
TABASCO,VILLAHERMOSA,9,426,6,441,1872
TABASCO,VILLAHERMOSA,12,430,9,451,1872
TABASCO,VILLAHERMOSA,15,487,7,509,1872
TABASCO,VILLAHERMOSA,8,502,4,514,1349
TABASCO,VILLAHERMOSA,6,485,6,497,1348
TABASCO,VILLAHERMOSA,5,388,5,398,1107
TABASCO,VILLAHERMOSA,8,389,4,401,1106
TABASCO,VILLAHERMOSA,12,532,4,548,1945
TABASCO,VILLAHERMOSA,16,492,3,511,1944
TABASCO,VILLAHERMOSA,19,517,1,537,1944
TABASCO,VILLAHERMOSA,7,370,2,379,1205
TABASCO,VILLAHERMOSA,5,362,4,371,1204
TABASCO,VILLAHERMOSA,8,384,2,394,1557
TABASCO,VILLAHERMOSA,5,389,4,398,1556
TABASCO,VILLAHERMOSA,12,385,7,404,1556
TABASCO,VILLAHERMOSA,10,484,5,499,1782
TABASCO,VILLAHERMOSA,2,526,13,541,1782
TABASCO,VILLAHERMOSA,12,490,5,507,1620
TABASCO,VILLAHERMOSA,12,446,10,468,1619
TABASCO,VILLAHERMOSA,18,454,6,478,1896
TABASCO,VILLAHERMOSA,11,484,4,499,1896
TABASCO,VILLAHERMOSA,7,416,2,425,1896
TABASCO,VILLAHERMOSA,8,352,14,374,1476
TABASCO,VILLAHERMOSA,8,416,1,425,1476
TABASCO,VILLAHERMOSA,10,478,8,496,1475
TABASCO,VILLAHERMOSA,14,311,0,325,1034
TABASCO,VILLAHERMOSA,13,304,1,318,1033
TABASCO,VILLAHERMOSA,18,492,27,537,1803
TABASCO,VILLAHERMOSA,16,510,8,534,1803
TABASCO,VILLAHERMOSA,19,476,4,499,1803
TABASCO,VILLAHERMOSA,5,416,1,422,1566
TABASCO,VILLAHERMOSA,9,367,33,409,1565
TABASCO,VILLAHERMOSA,4,418,2,424,1565
TABASCO,VILLAHERMOSA,13,387,3,403,1565
TABASCO,VILLAHERMOSA,7,439,5,451,1580
TABASCO,VILLAHERMOSA,10,421,3,434,1579
TABASCO,VILLAHERMOSA,6,510,16,532,1500
TABASCO,VILLAHERMOSA,5,431,12,448,1500
TABASCO,VILLAHERMOSA,1,373,9,383,1022
TABASCO,VILLAHERMOSA,2,381,2,385,1022
TABASCO,VILLAHERMOSA,7,286,6,299,1153
TABASCO,VILLAHERMOSA,14,346,11,371,1153
TABASCO,VILLAHERMOSA,3,352,6,361,1783
TABASCO,VILLAHERMOSA,9,295,9,313,1783
TABASCO,VILLAHERMOSA,9,322,5,336,1437
TABASCO,VILLAHERMOSA,9,304,4,317,1436
TABASCO,VILLAHERMOSA,5,359,10,374,1436
TABASCO,VILLAHERMOSA,8,385,10,403,1512
TABASCO,VILLAHERMOSA,2,421,7,430,1511
TABASCO,VILLAHERMOSA,7,369,4,380,1147
TABASCO,VILLAHERMOSA,6,382,7,395,1146
TABASCO,VILLAHERMOSA,9,329,7,345,1209
TABASCO,VILLAHERMOSA,4,346,7,357,1208
TABASCO,VILLAHERMOSA,3,421,1,425,1927
TABASCO,VILLAHERMOSA,5,377,6,388,1927
TABASCO,VILLAHERMOSA,15,398,3,416,1927
TABASCO,VILLAHERMOSA,5,374,6,385,1927
TABASCO,VILLAHERMOSA,14,392,4,410,1927
TABASCO,VILLAHERMOSA,6,458,3,467,1500
TABASCO,VILLAHERMOSA,8,434,4,446,1499
TABASCO,VILLAHERMOSA,3,395,5,403,1741
TABASCO,VILLAHERMOSA,12,351,6,369,1741
TABASCO,VILLAHERMOSA,6,363,9,378,1741
TABASCO,VILLAHERMOSA,13,375,2,390,1741
TABASCO,VILLAHERMOSA,13,441,3,457,1741
TABASCO,VILLAHERMOSA,6,340,2,348,1741
TABASCO,VILLAHERMOSA,5,297,5,307,1379
TABASCO,VILLAHERMOSA,5,299,9,313,1379
TABASCO,VILLAHERMOSA,6,311,5,322,1378
TABASCO,VILLAHERMOSA,3,398,5,406,1613
TABASCO,VILLAHERMOSA,7,431,6,444,1612
TABASCO,VILLAHERMOSA,10,330,4,344,1923
TABASCO,VILLAHERMOSA,7,292,2,301,1922
TABASCO,VILLAHERMOSA,7,306,4,317,1922
TABASCO,VILLAHERMOSA,10,302,9,321,1922
TABASCO,VILLAHERMOSA,9,330,4,343,1124
TABASCO,VILLAHERMOSA,12,303,2,317,1123
TABASCO,VILLAHERMOSA,10,805,8,823,1962
TABASCO,VILLAHERMOSA,11,750,5,766,1961
TABASCO,VILLAHERMOSA,14,587,6,607,1864
TABASCO,VILLAHERMOSA,9,644,6,659,1864
TABASCO,VILLAHERMOSA,12,594,7,613,1585
TABASCO,VILLAHERMOSA,7,557,3,567,1585
TABASCO,VILLAHERMOSA,6,479,10,495,1585
TABASCO,VILLAHERMOSA,9,657,17,683,1969
TABASCO,VILLAHERMOSA,13,675,9,697,1968
TABASCO,VILLAHERMOSA,11,561,5,577,1479
TABASCO,VILLAHERMOSA,8,572,6,586,1478
TABASCO,VILLAHERMOSA,11,548,9,568,1478
TABASCO,VILLAHERMOSA,12,501,9,522,1604
TABASCO,VILLAHERMOSA,7,515,10,532,1604
TABASCO,VILLAHERMOSA,10,504,9,523,1429
TABASCO,VILLAHERMOSA,6,473,7,486,1429
TABASCO,VILLAHERMOSA,2,459,10,471,1429
TABASCO,VILLAHERMOSA,9,345,14,368,1910
TABASCO,VILLAHERMOSA,5,496,9,510,1909
TABASCO,VILLAHERMOSA,7,430,2,439,1393
TABASCO,VILLAHERMOSA,4,429,5,438,1392
TABASCO,VILLAHERMOSA,16,480,2,498,1392
TABASCO,VILLAHERMOSA,5,420,5,430,1086
TABASCO,VILLAHERMOSA,2,418,3,423,1086
TABASCO,VILLAHERMOSA,9,385,5,399,1426
TABASCO,VILLAHERMOSA,7,444,7,458,1425
TABASCO,VILLAHERMOSA,6,367,7,380,1425
TABASCO,VILLAHERMOSA,2,590,5,597,1485
TABASCO,VILLAHERMOSA,14,453,14,481,1485
TABASCO,VILLAHERMOSA,11,660,9,680,1890
TABASCO,VILLAHERMOSA,6,691,20,717,1889
TABASCO,VILLAHERMOSA,0,561,16,577,1470
TABASCO,VILLAHERMOSA,17,488,4,509,1470
TABASCO,VILLAHERMOSA,12,507,13,532,1469
TABASCO,VILLAHERMOSA,11,589,14,614,1513
TABASCO,VILLAHERMOSA,5,537,9,551,1513
TABASCO,VILLAHERMOSA,9,425,10,444,1149
TABASCO,VILLAHERMOSA,7,507,3,517,1149
TABASCO,VILLAHERMOSA,6,596,5,607,1656
TABASCO,VILLAHERMOSA,11,566,15,592,1656
TABASCO,VILLAHERMOSA,9,518,4,531,1961
TABASCO,VILLAHERMOSA,5,535,5,545,1960
TABASCO,VILLAHERMOSA,6,394,9,409,1519
TABASCO,VILLAHERMOSA,8,450,5,463,1519
TABASCO,VILLAHERMOSA,2,426,7,435,1519
TABASCO,VILLAHERMOSA,8,361,4,373,1519
TABASCO,VILLAHERMOSA,3,504,2,509,1839
TABASCO,VILLAHERMOSA,7,466,6,479,1838
TABASCO,VILLAHERMOSA,9,437,9,455,1790
TABASCO,VILLAHERMOSA,6,407,6,419,1789
TABASCO,VILLAHERMOSA,9,606,3,618,1897
TABASCO,VILLAHERMOSA,10,573,15,598,1897
TABASCO,VILLAHERMOSA,15,524,18,557,1825
TABASCO,VILLAHERMOSA,5,534,7,546,1824
TABASCO,VILLAHERMOSA,13,809,13,835,0
TABASCO,VILLAHERMOSA,7,588,12,607,1720
TABASCO,VILLAHERMOSA,7,603,7,617,1719
TABASCO,VILLAHERMOSA,10,669,11,690,1794
TABASCO,VILLAHERMOSA,5,495,11,511,1839
TABASCO,VILLAHERMOSA,9,408,18,435,1838
TABASCO,VILLAHERMOSA,4,679,11,694,1869
TABASCO,VILLAHERMOSA,5,648,7,660,1868
TABASCO,VILLAHERMOSA,13,624,19,656,1962
TABASCO,VILLAHERMOSA,13,606,10,629,1962
TAMAULIPAS,NUEVO LAREDO,18,300,6,324,2037
TAMAULIPAS,NUEVO LAREDO,22,290,10,322,2037
TAMAULIPAS,NUEVO LAREDO,18,268,5,291,2036
TAMAULIPAS,NUEVO LAREDO,13,239,6,258,2036
TAMAULIPAS,NUEVO LAREDO,19,264,4,287,2036
TAMAULIPAS,NUEVO LAREDO,20,267,4,291,1802
TAMAULIPAS,NUEVO LAREDO,16,265,3,284,1801
TAMAULIPAS,NUEVO LAREDO,17,269,7,293,1801
TAMAULIPAS,NUEVO LAREDO,11,252,3,266,1801
TAMAULIPAS,NUEVO LAREDO,31,247,6,284,1623
TAMAULIPAS,NUEVO LAREDO,26,274,10,310,1622
TAMAULIPAS,NUEVO LAREDO,23,259,5,287,1738
TAMAULIPAS,NUEVO LAREDO,24,247,6,277,1737
TAMAULIPAS,NUEVO LAREDO,25,223,7,255,1620
TAMAULIPAS,NUEVO LAREDO,24,221,4,249,1619
TAMAULIPAS,NUEVO LAREDO,19,209,7,235,1619
TAMAULIPAS,NUEVO LAREDO,26,197,3,226,1537
TAMAULIPAS,NUEVO LAREDO,17,213,4,234,1536
TAMAULIPAS,NUEVO LAREDO,22,183,5,210,1536
TAMAULIPAS,NUEVO LAREDO,26,276,7,309,1987
TAMAULIPAS,NUEVO LAREDO,18,280,3,301,1987
TAMAULIPAS,NUEVO LAREDO,18,248,1,267,1733
TAMAULIPAS,NUEVO LAREDO,21,183,5,209,1732
TAMAULIPAS,NUEVO LAREDO,26,207,5,238,1464
TAMAULIPAS,NUEVO LAREDO,33,204,6,243,1464
TAMAULIPAS,NUEVO LAREDO,13,270,8,291,1869
TAMAULIPAS,NUEVO LAREDO,15,242,8,265,1869
TAMAULIPAS,NUEVO LAREDO,17,323,4,344,1826
TAMAULIPAS,NUEVO LAREDO,23,344,11,378,1825
TAMAULIPAS,NUEVO LAREDO,24,319,6,349,1825
TAMAULIPAS,NUEVO LAREDO,23,343,4,370,1825
TAMAULIPAS,NUEVO LAREDO,14,171,0,185,1615
TAMAULIPAS,NUEVO LAREDO,17,170,0,187,1615
TAMAULIPAS,NUEVO LAREDO,12,192,4,208,1349
TAMAULIPAS,NUEVO LAREDO,20,198,8,226,1349
TAMAULIPAS,NUEVO LAREDO,10,180,1,191,1287
TAMAULIPAS,NUEVO LAREDO,11,179,2,192,1287
TAMAULIPAS,NUEVO LAREDO,29,133,1,163,1394
TAMAULIPAS,NUEVO LAREDO,22,138,1,161,1394
TAMAULIPAS,NUEVO LAREDO,22,135,2,159,1394
TAMAULIPAS,NUEVO LAREDO,11,149,0,160,1568
TAMAULIPAS,NUEVO LAREDO,22,174,0,196,1567
TAMAULIPAS,NUEVO LAREDO,33,225,6,264,1894
TAMAULIPAS,NUEVO LAREDO,22,191,7,220,1894
TAMAULIPAS,NUEVO LAREDO,25,208,4,237,1459
TAMAULIPAS,NUEVO LAREDO,24,214,3,241,1459
TAMAULIPAS,NUEVO LAREDO,19,200,3,222,1459
TAMAULIPAS,NUEVO LAREDO,22,237,2,261,1931
TAMAULIPAS,NUEVO LAREDO,17,239,4,260,1930
TAMAULIPAS,NUEVO LAREDO,20,247,4,271,1784
TAMAULIPAS,NUEVO LAREDO,21,237,5,263,1783
TAMAULIPAS,NUEVO LAREDO,13,263,3,279,1653
TAMAULIPAS,NUEVO LAREDO,16,249,3,268,1653
TAMAULIPAS,NUEVO LAREDO,18,250,11,279,1414
TAMAULIPAS,NUEVO LAREDO,14,270,6,290,1414
TAMAULIPAS,NUEVO LAREDO,23,353,19,395,1921
TAMAULIPAS,NUEVO LAREDO,20,343,4,367,1920
TAMAULIPAS,NUEVO LAREDO,20,232,9,261,1559
TAMAULIPAS,NUEVO LAREDO,16,255,10,281,1559
TAMAULIPAS,NUEVO LAREDO,15,264,4,283,1559
TAMAULIPAS,NUEVO LAREDO,21,254,1,276,1558
TAMAULIPAS,NUEVO LAREDO,18,216,4,238,1564
TAMAULIPAS,NUEVO LAREDO,11,214,6,231,1563
TAMAULIPAS,NUEVO LAREDO,35,312,4,351,1812
TAMAULIPAS,NUEVO LAREDO,19,303,4,326,1812
TAMAULIPAS,NUEVO LAREDO,19,199,1,219,1618
TAMAULIPAS,NUEVO LAREDO,17,171,5,193,1618
TAMAULIPAS,NUEVO LAREDO,16,177,7,200,1052
TAMAULIPAS,NUEVO LAREDO,16,159,4,179,1051
TAMAULIPAS,NUEVO LAREDO,30,213,3,246,1969
TAMAULIPAS,NUEVO LAREDO,46,208,2,256,1968
TAMAULIPAS,NUEVO LAREDO,25,165,6,196,1393
TAMAULIPAS,NUEVO LAREDO,28,167,6,201,1393
TAMAULIPAS,NUEVO LAREDO,16,174,1,191,1392
TAMAULIPAS,NUEVO LAREDO,23,158,4,185,1659
TAMAULIPAS,NUEVO LAREDO,22,168,3,193,1659
TAMAULIPAS,NUEVO LAREDO,35,151,2,188,1659
TAMAULIPAS,NUEVO LAREDO,28,210,2,240,1884
TAMAULIPAS,NUEVO LAREDO,33,192,1,226,1884
TAMAULIPAS,NUEVO LAREDO,18,223,2,243,1677
TAMAULIPAS,NUEVO LAREDO,23,216,1,240,1676
TAMAULIPAS,NUEVO LAREDO,27,250,2,279,1735
TAMAULIPAS,NUEVO LAREDO,37,245,3,285,1735
TAMAULIPAS,NUEVO LAREDO,31,264,5,300,1703
TAMAULIPAS,NUEVO LAREDO,20,271,6,297,1703
TAMAULIPAS,NUEVO LAREDO,45,217,1,263,1755
TAMAULIPAS,NUEVO LAREDO,29,194,3,226,1755
TAMAULIPAS,NUEVO LAREDO,51,246,3,300,1676
TAMAULIPAS,NUEVO LAREDO,31,246,1,278,1676
TAMAULIPAS,NUEVO LAREDO,29,232,5,266,1676
TAMAULIPAS,NUEVO LAREDO,27,108,2,137,1353
TAMAULIPAS,NUEVO LAREDO,26,119,1,146,1353
TAMAULIPAS,NUEVO LAREDO,29,124,1,154,1353
TAMAULIPAS,NUEVO LAREDO,13,151,1,165,997
TAMAULIPAS,NUEVO LAREDO,17,159,1,177,997
TAMAULIPAS,NUEVO LAREDO,15,180,1,196,1375
TAMAULIPAS,NUEVO LAREDO,22,184,2,208,1375
TAMAULIPAS,NUEVO LAREDO,29,160,3,192,1375
TAMAULIPAS,NUEVO LAREDO,18,183,4,205,1270
TAMAULIPAS,NUEVO LAREDO,18,205,7,230,1270
TAMAULIPAS,NUEVO LAREDO,18,270,6,294,1806
TAMAULIPAS,NUEVO LAREDO,25,244,9,278,1806
TAMAULIPAS,NUEVO LAREDO,15,247,7,269,1806
TAMAULIPAS,NUEVO LAREDO,22,279,4,305,1805
TAMAULIPAS,NUEVO LAREDO,17,258,4,279,1805
TAMAULIPAS,NUEVO LAREDO,18,249,6,273,1805
TAMAULIPAS,NUEVO LAREDO,12,283,5,300,1805
TAMAULIPAS,NUEVO LAREDO,23,236,6,265,1805
TAMAULIPAS,NUEVO LAREDO,13,234,5,252,1805
TAMAULIPAS,NUEVO LAREDO,17,210,5,232,1425
TAMAULIPAS,NUEVO LAREDO,14,249,9,272,1424
TAMAULIPAS,NUEVO LAREDO,40,215,3,258,1838
TAMAULIPAS,NUEVO LAREDO,40,198,2,240,1837
TAMAULIPAS,NUEVO LAREDO,41,188,5,234,1651
TAMAULIPAS,NUEVO LAREDO,35,176,3,214,1650
TAMAULIPAS,NUEVO LAREDO,13,220,1,234,1652
TAMAULIPAS,NUEVO LAREDO,15,250,4,269,1651
TAMAULIPAS,NUEVO LAREDO,11,232,2,245,1621
TAMAULIPAS,NUEVO LAREDO,22,200,6,228,1621
TAMAULIPAS,NUEVO LAREDO,26,22,7,55,1621
TAMAULIPAS,NUEVO LAREDO,29,303,7,339,1870
TAMAULIPAS,NUEVO LAREDO,30,295,2,327,1869
TAMAULIPAS,NUEVO LAREDO,34,334,4,372,1860
TAMAULIPAS,NUEVO LAREDO,17,305,5,327,1860
TAMAULIPAS,NUEVO LAREDO,19,266,4,289,1861
TAMAULIPAS,NUEVO LAREDO,19,232,1,252,1860
TAMAULIPAS,NUEVO LAREDO,19,234,3,256,1860
TAMAULIPAS,NUEVO LAREDO,28,271,2,301,1860
TAMAULIPAS,NUEVO LAREDO,33,244,3,280,1860
TAMAULIPAS,NUEVO LAREDO,22,231,2,255,1412
TAMAULIPAS,NUEVO LAREDO,37,175,5,217,1412
TAMAULIPAS,NUEVO LAREDO,16,200,2,218,1411
TAMAULIPAS,NUEVO LAREDO,23,238,4,265,1566
TAMAULIPAS,NUEVO LAREDO,36,233,3,272,1565
TAMAULIPAS,NUEVO LAREDO,42,240,0,282,1565
TAMAULIPAS,NUEVO LAREDO,104,998,15,1117,0
TAMAULIPAS,NUEVO LAREDO,37,209,2,248,1683
TAMAULIPAS,NUEVO LAREDO,24,243,1,268,1683
TAMAULIPAS,NUEVO LAREDO,25,204,1,230,1683
TAMAULIPAS,NUEVO LAREDO,26,223,3,252,1683
TAMAULIPAS,NUEVO LAREDO,27,274,3,304,1683
TAMAULIPAS,NUEVO LAREDO,27,248,2,277,1682
TAMAULIPAS,NUEVO LAREDO,29,302,3,334,1957
TAMAULIPAS,NUEVO LAREDO,38,283,3,324,1956
TAMAULIPAS,NUEVO LAREDO,34,289,6,329,1956
TAMAULIPAS,NUEVO LAREDO,32,341,3,376,1956
TAMAULIPAS,NUEVO LAREDO,38,310,2,350,1956
TAMAULIPAS,NUEVO LAREDO,32,200,1,233,1598
TAMAULIPAS,NUEVO LAREDO,44,199,0,243,1597
TAMAULIPAS,NUEVO LAREDO,45,195,6,246,1597
TAMAULIPAS,NUEVO LAREDO,23,219,1,243,1689
TAMAULIPAS,NUEVO LAREDO,25,219,4,248,1689
TAMAULIPAS,NUEVO LAREDO,23,244,3,270,1689
TAMAULIPAS,NUEVO LAREDO,29,196,4,229,1688
TAMAULIPAS,NUEVO LAREDO,26,204,1,231,1688
TAMAULIPAS,NUEVO LAREDO,25,241,3,269,1688
TAMAULIPAS,NUEVO LAREDO,23,252,2,277,1896
TAMAULIPAS,NUEVO LAREDO,28,224,5,257,1896
TAMAULIPAS,NUEVO LAREDO,24,220,8,252,1896
TAMAULIPAS,NUEVO LAREDO,17,184,11,212,1675
TAMAULIPAS,NUEVO LAREDO,20,234,6,260,1674
TAMAULIPAS,NUEVO LAREDO,20,249,3,272,1674
TAMAULIPAS,NUEVO LAREDO,20,130,4,154,1074
TAMAULIPAS,NUEVO LAREDO,8,118,2,128,1073
TAMAULIPAS,NUEVO LAREDO,11,268,1,280,1856
TAMAULIPAS,NUEVO LAREDO,16,285,3,304,1855
TAMAULIPAS,NUEVO LAREDO,10,276,2,288,1855
TAMAULIPAS,NUEVO LAREDO,10,249,4,263,1855
TAMAULIPAS,NUEVO LAREDO,13,258,2,273,1535
TAMAULIPAS,NUEVO LAREDO,18,276,0,294,1535
TAMAULIPAS,NUEVO LAREDO,6,284,1,291,1534
TAMAULIPAS,NUEVO LAREDO,21,275,6,302,1598
TAMAULIPAS,NUEVO LAREDO,13,214,1,228,1598
TAMAULIPAS,NUEVO LAREDO,17,263,8,288,1598
TAMAULIPAS,NUEVO LAREDO,9,180,1,190,1182
TAMAULIPAS,NUEVO LAREDO,5,185,0,190,1181
TAMAULIPAS,NUEVO LAREDO,13,220,4,237,1240
TAMAULIPAS,NUEVO LAREDO,19,243,5,267,1240
TAMAULIPAS,NUEVO LAREDO,14,273,3,290,1910
TAMAULIPAS,NUEVO LAREDO,15,250,1,266,1910
TAMAULIPAS,NUEVO LAREDO,14,221,5,240,1339
TAMAULIPAS,NUEVO LAREDO,18,222,0,240,1339
TAMAULIPAS,NUEVO LAREDO,10,203,4,217,1338
TAMAULIPAS,NUEVO LAREDO,16,363,5,384,1650
TAMAULIPAS,NUEVO LAREDO,20,340,4,364,1650
TAMAULIPAS,NUEVO LAREDO,22,268,4,294,1388
TAMAULIPAS,NUEVO LAREDO,16,256,5,277,1387
TAMAULIPAS,NUEVO LAREDO,18,214,3,235,1154
TAMAULIPAS,NUEVO LAREDO,19,220,4,243,1154
TAMAULIPAS,NUEVO LAREDO,29,314,4,347,1843
TAMAULIPAS,NUEVO LAREDO,24,354,2,380,1842
TAMAULIPAS,NUEVO LAREDO,23,359,4,386,1845
TAMAULIPAS,NUEVO LAREDO,20,348,4,372,1845
TAMAULIPAS,NUEVO LAREDO,11,216,2,229,1720
TAMAULIPAS,NUEVO LAREDO,8,204,0,212,1719
TAMAULIPAS,NUEVO LAREDO,7,207,1,215,1377
TAMAULIPAS,NUEVO LAREDO,8,189,2,199,1377
TAMAULIPAS,NUEVO LAREDO,5,159,6,170,1377
TAMAULIPAS,REYNOSA,8,129,5,142,1736
TAMAULIPAS,REYNOSA,10,134,1,145,1736
TAMAULIPAS,REYNOSA,8,182,1,191,1741
TAMAULIPAS,REYNOSA,10,184,5,199,1741
TAMAULIPAS,REYNOSA,6,155,2,163,1741
TAMAULIPAS,REYNOSA,5,140,1,146,1913
TAMAULIPAS,REYNOSA,7,133,3,143,1912
TAMAULIPAS,REYNOSA,5,146,2,153,1271
TAMAULIPAS,REYNOSA,13,132,2,147,1270
TAMAULIPAS,REYNOSA,20,230,7,257,1795
TAMAULIPAS,REYNOSA,16,194,1,211,1795
TAMAULIPAS,REYNOSA,18,245,1,264,1795
TAMAULIPAS,REYNOSA,11,200,1,212,1577
TAMAULIPAS,REYNOSA,10,195,1,206,1577
TAMAULIPAS,REYNOSA,18,201,5,224,1576
TAMAULIPAS,REYNOSA,10,218,9,237,1648
TAMAULIPAS,REYNOSA,30,201,11,242,1648
TAMAULIPAS,REYNOSA,10,210,6,226,2003
TAMAULIPAS,REYNOSA,15,215,2,232,2003
TAMAULIPAS,REYNOSA,9,118,0,127,1957
TAMAULIPAS,REYNOSA,11,112,0,123,1957
TAMAULIPAS,REYNOSA,9,116,0,125,1957
TAMAULIPAS,REYNOSA,9,122,1,132,1823
TAMAULIPAS,REYNOSA,7,132,2,141,1822
TAMAULIPAS,REYNOSA,11,142,2,155,1822
TAMAULIPAS,REYNOSA,11,132,3,146,1912
TAMAULIPAS,REYNOSA,8,136,1,145,1911
TAMAULIPAS,REYNOSA,13,125,0,138,1911
TAMAULIPAS,REYNOSA,10,113,0,123,1800
TAMAULIPAS,REYNOSA,7,122,4,133,1800
TAMAULIPAS,REYNOSA,2,144,4,150,1538
TAMAULIPAS,REYNOSA,2,186,1,189,1537
TAMAULIPAS,REYNOSA,8,206,3,217,1865
TAMAULIPAS,REYNOSA,4,229,1,234,1865
TAMAULIPAS,REYNOSA,20,227,3,250,1648
TAMAULIPAS,REYNOSA,10,219,1,230,1648
TAMAULIPAS,REYNOSA,9,233,1,243,1648
TAMAULIPAS,REYNOSA,11,206,0,217,1648
TAMAULIPAS,REYNOSA,15,194,2,211,1647
TAMAULIPAS,REYNOSA,12,220,4,236,1639
TAMAULIPAS,REYNOSA,6,229,8,243,1638
TAMAULIPAS,REYNOSA,19,210,3,232,1784
TAMAULIPAS,REYNOSA,16,218,3,237,1783
TAMAULIPAS,REYNOSA,11,217,4,232,2004
TAMAULIPAS,REYNOSA,12,224,4,240,2004
TAMAULIPAS,REYNOSA,11,275,5,291,1952
TAMAULIPAS,REYNOSA,11,224,5,240,1951
TAMAULIPAS,REYNOSA,15,196,2,213,1907
TAMAULIPAS,REYNOSA,20,216,5,241,1907
TAMAULIPAS,REYNOSA,16,129,0,145,1561
TAMAULIPAS,REYNOSA,11,121,1,133,1561
TAMAULIPAS,REYNOSA,9,139,1,149,1560
TAMAULIPAS,REYNOSA,98,1258,13,1369,0
TAMAULIPAS,REYNOSA,15,287,4,306,1855
TAMAULIPAS,REYNOSA,15,286,4,305,1855
TAMAULIPAS,REYNOSA,25,252,2,279,1855
TAMAULIPAS,REYNOSA,10,277,6,293,1740
TAMAULIPAS,REYNOSA,12,292,2,306,1740
TAMAULIPAS,REYNOSA,9,268,3,280,1740
TAMAULIPAS,REYNOSA,9,262,4,275,1740
TAMAULIPAS,REYNOSA,10,259,3,272,1740
TAMAULIPAS,REYNOSA,9,266,2,277,1740
TAMAULIPAS,REYNOSA,9,247,4,260,1740
TAMAULIPAS,REYNOSA,14,186,7,207,1709
TAMAULIPAS,REYNOSA,17,203,2,222,1709
TAMAULIPAS,REYNOSA,14,217,2,233,1809
TAMAULIPAS,REYNOSA,12,213,1,226,1808
TAMAULIPAS,REYNOSA,22,173,0,195,1907
TAMAULIPAS,REYNOSA,24,154,0,178,1907
TAMAULIPAS,REYNOSA,15,187,4,206,1446
TAMAULIPAS,REYNOSA,15,195,1,211,1446
TAMAULIPAS,REYNOSA,17,183,2,202,1446
TAMAULIPAS,REYNOSA,13,202,7,222,1477
TAMAULIPAS,REYNOSA,14,222,3,239,1476
TAMAULIPAS,REYNOSA,8,210,3,221,1476
TAMAULIPAS,REYNOSA,5,126,3,134,1042
TAMAULIPAS,REYNOSA,9,142,5,156,1042
TAMAULIPAS,REYNOSA,9,322,2,333,1555
TAMAULIPAS,REYNOSA,12,311,4,327,1554
TAMAULIPAS,REYNOSA,14,161,0,175,1344
TAMAULIPAS,REYNOSA,15,130,1,146,1344
TAMAULIPAS,REYNOSA,13,132,3,148,1344
TAMAULIPAS,REYNOSA,19,256,0,275,1896
TAMAULIPAS,REYNOSA,20,263,2,285,1895
TAMAULIPAS,REYNOSA,20,256,1,277,1954
TAMAULIPAS,REYNOSA,18,235,1,254,1954
TAMAULIPAS,REYNOSA,27,249,3,279,1954
TAMAULIPAS,REYNOSA,22,179,1,202,1678
TAMAULIPAS,REYNOSA,19,208,2,229,1677
TAMAULIPAS,REYNOSA,18,300,3,321,1852
TAMAULIPAS,REYNOSA,12,303,6,321,1851
TAMAULIPAS,REYNOSA,17,299,6,322,1769
TAMAULIPAS,REYNOSA,10,283,1,294,1769
TAMAULIPAS,REYNOSA,5,232,5,242,1966
TAMAULIPAS,REYNOSA,5,268,2,275,1966
TAMAULIPAS,REYNOSA,11,247,2,260,1965
TAMAULIPAS,REYNOSA,15,261,1,277,1965
TAMAULIPAS,REYNOSA,3,271,2,276,1965
TAMAULIPAS,REYNOSA,9,254,1,264,1965
TAMAULIPAS,REYNOSA,13,227,3,243,1965
TAMAULIPAS,REYNOSA,7,245,0,252,1965
TAMAULIPAS,REYNOSA,7,245,2,254,1640
TAMAULIPAS,REYNOSA,13,212,1,226,1640
TAMAULIPAS,REYNOSA,9,255,2,266,1640
TAMAULIPAS,REYNOSA,4,263,3,270,1640
TAMAULIPAS,REYNOSA,12,248,1,261,1639
TAMAULIPAS,REYNOSA,11,193,0,204,1594
TAMAULIPAS,REYNOSA,10,172,2,184,1593
TAMAULIPAS,REYNOSA,20,162,3,185,1593
TAMAULIPAS,REYNOSA,8,201,1,210,1462
TAMAULIPAS,REYNOSA,6,251,0,257,1461
TAMAULIPAS,REYNOSA,19,282,2,303,1597
TAMAULIPAS,REYNOSA,17,262,4,283,1597
TAMAULIPAS,REYNOSA,22,263,3,288,1597
TAMAULIPAS,REYNOSA,16,244,4,264,1890
TAMAULIPAS,REYNOSA,21,269,3,293,1890
TAMAULIPAS,REYNOSA,11,198,2,211,1347
TAMAULIPAS,REYNOSA,11,190,2,203,1346
TAMAULIPAS,REYNOSA,15,234,2,251,1346
TAMAULIPAS,REYNOSA,18,230,1,249,1433
TAMAULIPAS,REYNOSA,12,206,0,218,1432
TAMAULIPAS,REYNOSA,12,220,0,232,1432
TAMAULIPAS,REYNOSA,18,276,2,296,1664
TAMAULIPAS,REYNOSA,22,299,3,324,1664
TAMAULIPAS,REYNOSA,27,332,0,359,1834
TAMAULIPAS,REYNOSA,28,298,3,329,1834
TAMAULIPAS,REYNOSA,22,296,4,322,1774
TAMAULIPAS,REYNOSA,18,342,3,363,1774
TAMAULIPAS,REYNOSA,26,327,0,353,1969
TAMAULIPAS,REYNOSA,28,304,3,335,1968
TAMAULIPAS,REYNOSA,25,262,2,289,1914
TAMAULIPAS,REYNOSA,22,246,0,268,1914
TAMAULIPAS,REYNOSA,25,275,0,300,1914
TAMAULIPAS,REYNOSA,31,248,1,280,1914
TAMAULIPAS,REYNOSA,32,237,2,271,1913
TAMAULIPAS,REYNOSA,11,212,1,224,1432
TAMAULIPAS,REYNOSA,21,224,4,249,1431
TAMAULIPAS,REYNOSA,14,217,1,232,1431
TAMAULIPAS,REYNOSA,7,292,1,300,1750
TAMAULIPAS,REYNOSA,16,260,1,277,1750
TAMAULIPAS,REYNOSA,19,295,2,316,1749
TAMAULIPAS,REYNOSA,18,246,4,268,1670
TAMAULIPAS,REYNOSA,18,214,1,233,1670
TAMAULIPAS,REYNOSA,24,215,1,240,1669
TAMAULIPAS,REYNOSA,12,244,0,256,1669
TAMAULIPAS,REYNOSA,9,247,0,256,1836
TAMAULIPAS,REYNOSA,20,205,1,226,1836
TAMAULIPAS,REYNOSA,6,209,0,215,1835
TAMAULIPAS,REYNOSA,21,220,5,246,1835
TAMAULIPAS,REYNOSA,19,248,2,269,1922
TAMAULIPAS,REYNOSA,12,269,3,284,1921
TAMAULIPAS,REYNOSA,23,243,2,268,1908
TAMAULIPAS,REYNOSA,17,248,2,267,1908
TAMAULIPAS,REYNOSA,15,255,1,271,1907
TAMAULIPAS,REYNOSA,14,314,6,334,1891
TAMAULIPAS,REYNOSA,15,298,6,319,1890
TAMAULIPAS,REYNOSA,15,248,0,263,1823
TAMAULIPAS,REYNOSA,12,229,1,242,1823
TAMAULIPAS,REYNOSA,12,255,1,268,1561
TAMAULIPAS,REYNOSA,17,253,0,270,1561
TAMAULIPAS,REYNOSA,20,276,1,297,1560
TAMAULIPAS,REYNOSA,11,327,0,338,2017
TAMAULIPAS,REYNOSA,15,313,2,330,2017
TAMAULIPAS,REYNOSA,13,272,0,285,1898
TAMAULIPAS,REYNOSA,15,278,3,296,1897
TAMAULIPAS,REYNOSA,27,230,257,514,1897
TAMAULIPAS,REYNOSA,18,237,0,255,1897
TAMAULIPAS,RIO BRAVO,3,260,0,263,1579
TAMAULIPAS,RIO BRAVO,1,244,5,250,1579
TAMAULIPAS,RIO BRAVO,9,260,4,273,1578
TAMAULIPAS,RIO BRAVO,4,58,0,62,1135
TAMAULIPAS,RIO BRAVO,68,7,1,76,1135
TAMAULIPAS,RIO BRAVO,9,224,2,235,1636
TAMAULIPAS,RIO BRAVO,8,226,7,241,1635
TAMAULIPAS,RIO BRAVO,7,324,4,335,1556
TAMAULIPAS,RIO BRAVO,9,303,2,314,1555
TAMAULIPAS,RIO BRAVO,10,276,2,288,1269
TAMAULIPAS,RIO BRAVO,9,257,1,267,1269
TAMAULIPAS,RIO BRAVO,7,241,5,253,1682
TAMAULIPAS,RIO BRAVO,12,243,1,256,1682
TAMAULIPAS,RIO BRAVO,6,208,5,219,1682
TAMAULIPAS,RIO BRAVO,27,149,0,176,1485
TAMAULIPAS,RIO BRAVO,26,128,1,155,1484
TAMAULIPAS,RIO BRAVO,29,135,4,168,1484
TAMAULIPAS,RIO BRAVO,15,238,5,258,1329
TAMAULIPAS,RIO BRAVO,12,222,4,238,1329
TAMAULIPAS,RIO BRAVO,1,227,2,230,1328
TAMAULIPAS,RIO BRAVO,6,268,2,276,1703
TAMAULIPAS,RIO BRAVO,9,270,2,281,1703
TAMAULIPAS,RIO BRAVO,5,283,2,290,1702
TAMAULIPAS,RIO BRAVO,10,319,3,332,1800
TAMAULIPAS,RIO BRAVO,8,307,4,319,1800
TAMAULIPAS,RIO BRAVO,4,314,3,321,1800
TAMAULIPAS,RIO BRAVO,4,289,0,293,1799
TAMAULIPAS,RIO BRAVO,10,298,4,312,1799
TAMAULIPAS,RIO BRAVO,13,296,4,313,1799
TAMAULIPAS,RIO BRAVO,6,282,0,288,1799
TAMAULIPAS,RIO BRAVO,5,189,3,197,1564
TAMAULIPAS,RIO BRAVO,6,194,2,202,1564
TAMAULIPAS,RIO BRAVO,7,100,3,110,1319
TAMAULIPAS,RIO BRAVO,4,112,3,119,1319
TAMAULIPAS,RIO BRAVO,12,190,2,204,1984
TAMAULIPAS,RIO BRAVO,7,187,1,195,1983
TAMAULIPAS,RIO BRAVO,17,180,6,203,1517
TAMAULIPAS,RIO BRAVO,5,188,2,195,1517
TAMAULIPAS,RIO BRAVO,4,89,4,97,1072
TAMAULIPAS,RIO BRAVO,5,106,2,113,1071
TAMAULIPAS,RIO BRAVO,6,280,1,287,1985
TAMAULIPAS,RIO BRAVO,9,289,4,302,1985
TAMAULIPAS,RIO BRAVO,4,286,2,292,1985
TAMAULIPAS,RIO BRAVO,1,312,5,318,1984
TAMAULIPAS,RIO BRAVO,7,308,1,316,1984
TAMAULIPAS,RIO BRAVO,10,127,0,137,1497
TAMAULIPAS,RIO BRAVO,2,92,2,96,1497
TAMAULIPAS,RIO BRAVO,4,100,0,104,1497
TAMAULIPAS,RIO BRAVO,3,173,1,177,1738
TAMAULIPAS,RIO BRAVO,2,154,2,158,1738
TAMAULIPAS,RIO BRAVO,11,174,0,185,1738
TAMAULIPAS,RIO BRAVO,2,164,0,166,1738
TAMAULIPAS,RIO BRAVO,8,174,0,182,1738
TAMAULIPAS,RIO BRAVO,6,101,3,110,1340
TAMAULIPAS,RIO BRAVO,11,92,1,104,1339
TAMAULIPAS,RIO BRAVO,28,575,25,628,1594
TAMAULIPAS,RIO BRAVO,24,486,24,534,1593
TAMAULIPAS,RIO BRAVO,4,171,1,176,1958
TAMAULIPAS,RIO BRAVO,0,121,2,123,1957
TAMAULIPAS,RIO BRAVO,3,216,2,221,1706
TAMAULIPAS,RIO BRAVO,9,201,1,211,1706
TAMAULIPAS,RIO BRAVO,5,208,1,214,1706
TAMAULIPAS,RIO BRAVO,4,226,1,231,1706
TAMAULIPAS,RIO BRAVO,9,207,2,218,1705
TAMAULIPAS,RIO BRAVO,7,209,4,220,1705
TAMAULIPAS,RIO BRAVO,4,168,5,177,1427
TAMAULIPAS,RIO BRAVO,6,187,3,196,1426
TAMAULIPAS,RIO BRAVO,7,189,5,201,1426
TAMAULIPAS,RIO BRAVO,9,194,33,236,1431
TAMAULIPAS,RIO BRAVO,13,215,3,231,1431
TAMAULIPAS,RIO BRAVO,5,189,1,195,1820
TAMAULIPAS,RIO BRAVO,5,200,0,205,1819
TAMAULIPAS,RIO BRAVO,9,208,2,219,1819
TAMAULIPAS,RIO BRAVO,6,221,3,230,1819
TAMAULIPAS,RIO BRAVO,9,208,3,220,1819
TAMAULIPAS,RIO BRAVO,5,239,1,245,1819
TAMAULIPAS,RIO BRAVO,12,272,3,287,1914
TAMAULIPAS,RIO BRAVO,7,293,2,302,1914
TAMAULIPAS,RIO BRAVO,12,235,4,251,1422
TAMAULIPAS,RIO BRAVO,3,224,4,231,1421
TAMAULIPAS,RIO BRAVO,3,177,2,182,1581
TAMAULIPAS,RIO BRAVO,6,186,4,196,1581
TAMAULIPAS,RIO BRAVO,1,154,7,162,1580
TAMAULIPAS,RIO BRAVO,4,179,1,184,1580
TAMAULIPAS,RIO BRAVO,8,240,5,253,1963
TAMAULIPAS,RIO BRAVO,7,269,1,277,1963
TAMAULIPAS,RIO BRAVO,13,305,2,320,1858
TAMAULIPAS,RIO BRAVO,17,276,5,298,1858
TAMAULIPAS,RIO BRAVO,15,243,4,262,1815
TAMAULIPAS,RIO BRAVO,23,245,3,271,1814
TAMAULIPAS,RIO BRAVO,8,272,1,281,1686
TAMAULIPAS,RIO BRAVO,13,247,2,262,1686
TAMAULIPAS,RIO BRAVO,13,230,3,246,1685
TAMAULIPAS,RIO BRAVO,14,285,1,300,1933
TAMAULIPAS,RIO BRAVO,12,263,4,279,1932
TAMAULIPAS,RIO BRAVO,22,315,7,344,0
TAMAULIPAS,RIO BRAVO,27,237,1,265,1928
TAMAULIPAS,RIO BRAVO,26,272,4,302,1928
TAMAULIPAS,RIO BRAVO,19,215,1,235,1362
TAMAULIPAS,RIO BRAVO,18,230,2,250,1362
TAMAULIPAS,RIO BRAVO,13,249,2,264,1361
TAMAULIPAS,RIO BRAVO,15,280,1,296,1809
TAMAULIPAS,RIO BRAVO,12,246,5,263,1809
TAMAULIPAS,RIO BRAVO,6,268,5,279,1628
TAMAULIPAS,RIO BRAVO,5,246,3,254,1628
TAMAULIPAS,RIO BRAVO,9,224,1,234,1628
TAMAULIPAS,RIO BRAVO,16,231,3,250,1562
TAMAULIPAS,RIO BRAVO,14,237,0,251,1562
TAMAULIPAS,RIO BRAVO,21,300,4,325,1867
TAMAULIPAS,RIO BRAVO,17,304,5,326,1866
TAMAULIPAS,RIO BRAVO,11,176,4,191,1336
TAMAULIPAS,RIO BRAVO,7,189,6,202,1336
TAMAULIPAS,RIO BRAVO,3,162,1,166,1335
TAMAULIPAS,RIO BRAVO,9,170,2,181,1433
TAMAULIPAS,RIO BRAVO,8,131,1,140,1433
TAMAULIPAS,RIO BRAVO,4,119,3,126,1927
TAMAULIPAS,RIO BRAVO,6,126,3,135,1927
TAMAULIPAS,RIO BRAVO,6,130,1,137,1566
TAMAULIPAS,RIO BRAVO,7,160,2,169,1565
TAMAULIPAS,RIO BRAVO,5,75,1,81,1101
TAMAULIPAS,RIO BRAVO,8,66,1,75,1101
TAMAULIPAS,RIO BRAVO,24,240,16,280,1735
TAMAULIPAS,RIO BRAVO,15,213,8,236,1735
TAMAULIPAS,RIO BRAVO,16,225,6,247,1342
TAMAULIPAS,RIO BRAVO,11,243,3,257,1656
TAMAULIPAS,RIO BRAVO,7,219,3,229,1656
TAMAULIPAS,RIO BRAVO,8,205,2,215,1656
TAMAULIPAS,RIO BRAVO,5,226,3,234,2002
TAMAULIPAS,RIO BRAVO,7,245,4,256,2002
TAMAULIPAS,RIO BRAVO,9,216,0,225,1451
TAMAULIPAS,RIO BRAVO,12,207,4,223,1451
TAMAULIPAS,RIO BRAVO,13,196,3,212,1451
TAMAULIPAS,RIO BRAVO,10,178,2,190,1401
TAMAULIPAS,RIO BRAVO,14,185,7,206,1401
TAMAULIPAS,RIO BRAVO,9,234,5,248,1747
TAMAULIPAS,RIO BRAVO,11,255,4,270,1747
TAMAULIPAS,RIO BRAVO,3,194,4,201,1431
TAMAULIPAS,RIO BRAVO,9,155,2,166,1430
TAMAULIPAS,RIO BRAVO,9,164,1,174,1430
TAMAULIPAS,RIO BRAVO,21,194,3,218,1661
TAMAULIPAS,RIO BRAVO,11,241,7,259,1816
TAMAULIPAS,RIO BRAVO,8,230,2,240,1816
TAMAULIPAS,RIO BRAVO,5,217,3,225,1905
TAMAULIPAS,RIO BRAVO,9,220,5,234,1905
TAMAULIPAS,RIO BRAVO,6,222,4,232,1905
TAMAULIPAS,RIO BRAVO,12,396,9,417,1935
TAMAULIPAS,RIO BRAVO,12,395,16,423,1935
TAMAULIPAS,RIO BRAVO,26,221,5,252,1980
TAMAULIPAS,RIO BRAVO,25,215,4,244,1979
TAMAULIPAS,RIO BRAVO,6,185,10,201,1573
TAMAULIPAS,RIO BRAVO,9,186,2,197,1572
TAMAULIPAS,RIO BRAVO,18,259,4,281,1945
TAMAULIPAS,RIO BRAVO,14,199,7,220,1940
TAMAULIPAS,RIO BRAVO,14,200,5,219,1939
TAMAULIPAS,RIO BRAVO,13,262,3,278,1961
TAMAULIPAS,RIO BRAVO,18,267,8,293,1961
TAMAULIPAS,RIO BRAVO,9,185,1,195,1388
TAMAULIPAS,RIO BRAVO,4,170,2,176,1387
TAMAULIPAS,RIO BRAVO,19,197,4,220,1758
TAMAULIPAS,RIO BRAVO,7,183,4,194,1758
TAMAULIPAS,RIO BRAVO,18,150,1,169,1757
TAMAULIPAS,RIO BRAVO,21,224,2,247,1969
TAMAULIPAS,RIO BRAVO,20,214,0,234,1968
TAMAULIPAS,RIO BRAVO,10,149,0,159,1235
TAMAULIPAS,RIO BRAVO,8,151,20,179,1234
TAMAULIPAS,RIO BRAVO,9,235,4,248,1471
TAMAULIPAS,RIO BRAVO,10,226,2,238,1471
TAMAULIPAS,RIO BRAVO,6,132,0,138,1251
TAMAULIPAS,RIO BRAVO,3,128,1,132,1250
TAMAULIPAS,RIO BRAVO,15,165,1,181,1465
TAMAULIPAS,RIO BRAVO,8,147,3,158,1465
TAMAULIPAS,RIO BRAVO,11,114,1,126,1547
TAMAULIPAS,RIO BRAVO,14,144,1,159,1546
TAMAULIPAS,RIO BRAVO,7,156,1,164,1357
TAMAULIPAS,RIO BRAVO,5,137,2,144,1357
TAMAULIPAS,RIO BRAVO,3,151,2,156,1356
TAMAULIPAS,RIO BRAVO,5,177,0,182,1145
TAMAULIPAS,RIO BRAVO,3,208,0,211,1145
TAMAULIPAS,RIO BRAVO,11,290,1,302,1628
TAMAULIPAS,RIO BRAVO,11,282,3,296,1627
TAMAULIPAS,RIO BRAVO,9,266,0,275,1627
TAMAULIPAS,RIO BRAVO,7,300,1,308,1627
TAMAULIPAS,RIO BRAVO,4,220,4,228,1317
TAMAULIPAS,RIO BRAVO,14,236,1,251,1316
TAMAULIPAS,RIO BRAVO,4,293,3,300,2061
TAMAULIPAS,RIO BRAVO,2,262,2,266,2060
TAMAULIPAS,RIO BRAVO,10,274,1,285,2060
TAMAULIPAS,RIO BRAVO,10,315,2,327,2060
TAMAULIPAS,RIO BRAVO,9,298,2,309,2060
TAMAULIPAS,H. MATAMOROS,25,185,2,212,1893
TAMAULIPAS,H. MATAMOROS,22,209,1,232,1893
TAMAULIPAS,H. MATAMOROS,26,195,0,221,1892
TAMAULIPAS,H. MATAMOROS,6,234,3,243,1458
TAMAULIPAS,H. MATAMOROS,12,268,1,281,1457
TAMAULIPAS,H. MATAMOROS,13,344,2,359,1659
TAMAULIPAS,H. MATAMOROS,14,323,5,342,1658
TAMAULIPAS,H. MATAMOROS,10,317,1,328,1864
TAMAULIPAS,H. MATAMOROS,10,344,5,359,1864
TAMAULIPAS,H. MATAMOROS,6,301,1,308,1827
TAMAULIPAS,H. MATAMOROS,12,335,3,350,1827
TAMAULIPAS,H. MATAMOROS,10,343,3,356,1827
TAMAULIPAS,H. MATAMOROS,12,351,0,363,1827
TAMAULIPAS,H. MATAMOROS,18,325,1,344,1827
TAMAULIPAS,H. MATAMOROS,14,309,1,324,1827
TAMAULIPAS,H. MATAMOROS,33,172,1,206,1582
TAMAULIPAS,H. MATAMOROS,27,190,1,218,1582
TAMAULIPAS,H. MATAMOROS,27,163,0,190,1582
TAMAULIPAS,H. MATAMOROS,14,335,0,349,1780
TAMAULIPAS,H. MATAMOROS,17,349,6,372,1780
TAMAULIPAS,H. MATAMOROS,11,343,3,357,1780
TAMAULIPAS,H. MATAMOROS,16,316,5,337,1779
TAMAULIPAS,H. MATAMOROS,26,203,1,230,1592
TAMAULIPAS,H. MATAMOROS,5,248,1,254,1591
TAMAULIPAS,H. MATAMOROS,10,265,2,277,1591
TAMAULIPAS,H. MATAMOROS,10,159,1,170,1411
TAMAULIPAS,H. MATAMOROS,10,158,0,168,1411
TAMAULIPAS,H. MATAMOROS,17,171,2,190,1411
TAMAULIPAS,H. MATAMOROS,20,209,2,231,1911
TAMAULIPAS,H. MATAMOROS,26,191,1,218,1911
TAMAULIPAS,H. MATAMOROS,7,279,2,288,1547
TAMAULIPAS,H. MATAMOROS,14,261,2,277,1547
TAMAULIPAS,H. MATAMOROS,5,262,2,269,1546
TAMAULIPAS,H. MATAMOROS,5,226,3,234,1164
TAMAULIPAS,H. MATAMOROS,16,230,6,252,1163
TAMAULIPAS,H. MATAMOROS,4,248,1,253,1134
TAMAULIPAS,H. MATAMOROS,7,281,1,289,1133
TAMAULIPAS,H. MATAMOROS,12,190,2,204,1533
TAMAULIPAS,H. MATAMOROS,11,244,3,258,1532
TAMAULIPAS,H. MATAMOROS,18,199,2,219,1762
TAMAULIPAS,H. MATAMOROS,13,210,3,226,1761
TAMAULIPAS,H. MATAMOROS,9,220,1,230,1761
TAMAULIPAS,H. MATAMOROS,11,173,5,189,1466
TAMAULIPAS,H. MATAMOROS,12,216,2,230,1465
TAMAULIPAS,H. MATAMOROS,12,207,0,219,1465
TAMAULIPAS,H. MATAMOROS,18,355,1,374,1970
TAMAULIPAS,H. MATAMOROS,13,372,4,389,1970
TAMAULIPAS,H. MATAMOROS,11,344,0,355,1969
TAMAULIPAS,H. MATAMOROS,12,222,0,234,1457
TAMAULIPAS,H. MATAMOROS,12,197,3,212,1457
TAMAULIPAS,H. MATAMOROS,6,232,1,239,1457
TAMAULIPAS,H. MATAMOROS,10,313,7,330,1817
TAMAULIPAS,H. MATAMOROS,12,260,4,276,1817
TAMAULIPAS,H. MATAMOROS,17,318,2,337,1659
TAMAULIPAS,H. MATAMOROS,13,324,3,340,1659
TAMAULIPAS,H. MATAMOROS,15,312,3,330,1596
TAMAULIPAS,H. MATAMOROS,12,304,3,319,1596
TAMAULIPAS,H. MATAMOROS,10,283,3,296,1928
TAMAULIPAS,H. MATAMOROS,10,276,4,290,1927
TAMAULIPAS,H. MATAMOROS,25,253,6,284,1784
TAMAULIPAS,H. MATAMOROS,19,252,6,277,1783
TAMAULIPAS,H. MATAMOROS,16,262,1,279,1783
TAMAULIPAS,H. MATAMOROS,0,259,1,260,1796
TAMAULIPAS,H. MATAMOROS,15,231,0,246,1796
TAMAULIPAS,H. MATAMOROS,9,310,4,323,1793
TAMAULIPAS,H. MATAMOROS,8,276,1,285,1792
TAMAULIPAS,H. MATAMOROS,10,287,1,298,1792
TAMAULIPAS,H. MATAMOROS,4,296,5,305,1792
TAMAULIPAS,H. MATAMOROS,2,259,5,266,1381
TAMAULIPAS,H. MATAMOROS,9,233,6,248,1381
TAMAULIPAS,H. MATAMOROS,8,300,0,308,1381
TAMAULIPAS,H. MATAMOROS,10,277,1,288,1625
TAMAULIPAS,H. MATAMOROS,4,314,2,320,1625
TAMAULIPAS,H. MATAMOROS,9,315,10,334,1611
TAMAULIPAS,H. MATAMOROS,5,320,1,326,1610
TAMAULIPAS,H. MATAMOROS,12,331,4,347,1754
TAMAULIPAS,H. MATAMOROS,13,342,2,357,1754
TAMAULIPAS,H. MATAMOROS,19,331,5,355,1818
TAMAULIPAS,H. MATAMOROS,22,356,0,378,1817
TAMAULIPAS,H. MATAMOROS,42,243,2,287,2032
TAMAULIPAS,H. MATAMOROS,35,237,0,272,2031
TAMAULIPAS,H. MATAMOROS,7,324,5,336,1493
TAMAULIPAS,H. MATAMOROS,8,287,1,296,1492
TAMAULIPAS,H. MATAMOROS,9,282,1,292,1492
TAMAULIPAS,H. MATAMOROS,10,449,5,464,1960
TAMAULIPAS,H. MATAMOROS,9,445,2,456,1959
TAMAULIPAS,H. MATAMOROS,12,334,5,351,1755
TAMAULIPAS,H. MATAMOROS,16,309,11,336,1755
TAMAULIPAS,H. MATAMOROS,9,340,4,353,1738
TAMAULIPAS,H. MATAMOROS,5,342,5,352,1738
TAMAULIPAS,H. MATAMOROS,6,321,5,332,1737
TAMAULIPAS,H. MATAMOROS,6,361,6,373,1737
TAMAULIPAS,H. MATAMOROS,4,267,3,274,1402
TAMAULIPAS,H. MATAMOROS,3,271,1,275,1402
TAMAULIPAS,H. MATAMOROS,7,272,3,282,1402
TAMAULIPAS,H. MATAMOROS,13,327,1,341,1816
TAMAULIPAS,H. MATAMOROS,11,328,6,345,1816
TAMAULIPAS,H. MATAMOROS,10,331,4,345,1816
TAMAULIPAS,H. MATAMOROS,9,305,4,318,1816
TAMAULIPAS,H. MATAMOROS,13,313,4,330,1816
TAMAULIPAS,H. MATAMOROS,8,292,2,302,1816
TAMAULIPAS,H. MATAMOROS,10,356,1,367,1816
TAMAULIPAS,H. MATAMOROS,10,352,1,363,1968
TAMAULIPAS,H. MATAMOROS,12,349,4,365,1968
TAMAULIPAS,H. MATAMOROS,11,353,2,366,1968
TAMAULIPAS,H. MATAMOROS,6,349,3,358,1968
TAMAULIPAS,H. MATAMOROS,7,349,2,358,1968
TAMAULIPAS,H. MATAMOROS,4,330,6,340,1968
TAMAULIPAS,H. MATAMOROS,3,343,6,352,1968
TAMAULIPAS,H. MATAMOROS,2,379,5,386,1963
TAMAULIPAS,H. MATAMOROS,13,386,10,409,1962
TAMAULIPAS,H. MATAMOROS,11,355,4,370,1803
TAMAULIPAS,H. MATAMOROS,6,306,3,315,1803
TAMAULIPAS,H. MATAMOROS,7,381,2,390,1726
TAMAULIPAS,H. MATAMOROS,7,345,4,356,1726
TAMAULIPAS,H. MATAMOROS,5,349,1,355,1725
TAMAULIPAS,H. MATAMOROS,16,318,1,335,1725
TAMAULIPAS,H. MATAMOROS,2,325,1,328,1725
TAMAULIPAS,H. MATAMOROS,10,338,3,351,1725
TAMAULIPAS,H. MATAMOROS,4,346,3,353,1640
TAMAULIPAS,H. MATAMOROS,11,341,5,357,1639
TAMAULIPAS,H. MATAMOROS,7,277,5,289,1639
TAMAULIPAS,H. MATAMOROS,14,294,3,311,1639
TAMAULIPAS,H. MATAMOROS,6,284,4,294,1694
TAMAULIPAS,H. MATAMOROS,6,257,3,266,1693
TAMAULIPAS,H. MATAMOROS,4,311,1,316,1693
TAMAULIPAS,H. MATAMOROS,13,309,0,322,1859
TAMAULIPAS,H. MATAMOROS,12,271,1,284,1858
TAMAULIPAS,H. MATAMOROS,9,316,2,327,1692
TAMAULIPAS,H. MATAMOROS,6,297,2,305,1691
TAMAULIPAS,H. MATAMOROS,9,292,4,305,1691
TAMAULIPAS,H. MATAMOROS,15,266,2,283,1510
TAMAULIPAS,H. MATAMOROS,14,261,3,278,1510
TAMAULIPAS,H. MATAMOROS,16,306,2,324,1837
TAMAULIPAS,H. MATAMOROS,12,298,2,312,1837
TAMAULIPAS,H. MATAMOROS,5,314,3,322,1403
TAMAULIPAS,H. MATAMOROS,3,266,1,270,1403
TAMAULIPAS,H. MATAMOROS,8,249,3,260,1403
TAMAULIPAS,H. MATAMOROS,11,330,3,344,1483
TAMAULIPAS,H. MATAMOROS,10,289,2,301,1483
TAMAULIPAS,H. MATAMOROS,4,298,4,306,1783
TAMAULIPAS,H. MATAMOROS,1,327,0,328,1783
TAMAULIPAS,H. MATAMOROS,7,308,2,317,1783
TAMAULIPAS,H. MATAMOROS,3,328,4,335,1783
TAMAULIPAS,H. MATAMOROS,8,331,5,344,1783
TAMAULIPAS,H. MATAMOROS,2,298,2,302,1782
TAMAULIPAS,H. MATAMOROS,10,324,1,335,1787
TAMAULIPAS,H. MATAMOROS,12,344,2,358,1787
TAMAULIPAS,H. MATAMOROS,7,279,2,288,1833
TAMAULIPAS,H. MATAMOROS,8,263,4,275,1833
TAMAULIPAS,H. MATAMOROS,7,259,2,268,1832
TAMAULIPAS,H. MATAMOROS,60,1377,8,1445,0
TAMAULIPAS,H. MATAMOROS,9,286,1,296,1695
TAMAULIPAS,H. MATAMOROS,5,296,0,301,1695
TAMAULIPAS,H. MATAMOROS,8,302,5,315,1695
TAMAULIPAS,H. MATAMOROS,6,293,1,300,1694
TAMAULIPAS,H. MATAMOROS,16,288,2,306,1694
TAMAULIPAS,H. MATAMOROS,28,289,5,322,1989
TAMAULIPAS,H. MATAMOROS,8,254,5,267,1573
TAMAULIPAS,H. MATAMOROS,3,237,2,242,1573
TAMAULIPAS,H. MATAMOROS,10,258,4,272,1572
TAMAULIPAS,H. MATAMOROS,12,242,6,260,1751
TAMAULIPAS,H. MATAMOROS,4,256,8,268,1751
TAMAULIPAS,H. MATAMOROS,1,232,5,238,1751
TAMAULIPAS,H. MATAMOROS,6,227,4,237,1750
TAMAULIPAS,H. MATAMOROS,5,254,3,262,1762
TAMAULIPAS,H. MATAMOROS,9,230,6,245,1762
TAMAULIPAS,H. MATAMOROS,9,229,3,241,1299
TAMAULIPAS,H. MATAMOROS,14,204,1,219,1298
TAMAULIPAS,H. MATAMOROS,10,238,1,249,1738
TAMAULIPAS,H. MATAMOROS,11,331,6,348,1737
TAMAULIPAS,H. MATAMOROS,9,324,1,334,1575
TAMAULIPAS,H. MATAMOROS,4,332,2,338,1575
TAMAULIPAS,H. MATAMOROS,5,332,0,337,1575
TAMAULIPAS,H. MATAMOROS,7,337,0,344,1575
TAMAULIPAS,H. MATAMOROS,3,225,1,229,1630
TAMAULIPAS,H. MATAMOROS,5,234,2,241,1629
TAMAULIPAS,H. MATAMOROS,3,209,2,214,1629
TAMAULIPAS,H. MATAMOROS,9,349,4,362,2015
TAMAULIPAS,H. MATAMOROS,7,338,1,346,2015
TAMAULIPAS,H. MATAMOROS,6,263,1,270,1413
TAMAULIPAS,H. MATAMOROS,12,303,0,315,1413
TAMAULIPAS,H. MATAMOROS,26,303,4,333,1934
TAMAULIPAS,H. MATAMOROS,21,279,2,302,1933
TAMAULIPAS,H. MATAMOROS,19,346,1,366,2001
TAMAULIPAS,H. MATAMOROS,29,412,0,441,2000
TAMAULIPAS,CIUDAD VICTORIA,8,362,4,374,1912
TAMAULIPAS,CIUDAD VICTORIA,10,331,1,342,1912
TAMAULIPAS,CIUDAD VICTORIA,12,363,1,376,1911
TAMAULIPAS,CIUDAD VICTORIA,8,303,4,315,1959
TAMAULIPAS,CIUDAD VICTORIA,13,343,13,369,1958
TAMAULIPAS,CIUDAD VICTORIA,3,259,5,267,1748
TAMAULIPAS,CIUDAD VICTORIA,7,225,9,241,1747
TAMAULIPAS,CIUDAD VICTORIA,25,783,17,825,1841
TAMAULIPAS,CIUDAD VICTORIA,28,725,40,793,1840
TAMAULIPAS,CIUDAD VICTORIA,23,755,42,820,1840
TAMAULIPAS,CIUDAD VICTORIA,33,693,42,768,1840
TAMAULIPAS,CIUDAD VICTORIA,19,724,40,783,1738
TAMAULIPAS,CIUDAD VICTORIA,12,401,22,435,1716
TAMAULIPAS,CIUDAD VICTORIA,12,442,22,476,1716
TAMAULIPAS,CIUDAD VICTORIA,20,416,11,447,1715
TAMAULIPAS,CIUDAD VICTORIA,35,1072,9,1116,1964
TAMAULIPAS,CIUDAD VICTORIA,5,304,6,315,1611
TAMAULIPAS,CIUDAD VICTORIA,7,309,0,316,1610
TAMAULIPAS,CIUDAD VICTORIA,5,238,1,244,1280
TAMAULIPAS,CIUDAD VICTORIA,6,229,8,243,1279
TAMAULIPAS,CIUDAD VICTORIA,4,281,2,287,1583
TAMAULIPAS,CIUDAD VICTORIA,6,284,3,293,1582
TAMAULIPAS,CIUDAD VICTORIA,8,253,1,262,1323
TAMAULIPAS,CIUDAD VICTORIA,5,213,12,230,1323
TAMAULIPAS,CIUDAD VICTORIA,29,616,24,669,1944
TAMAULIPAS,CIUDAD VICTORIA,14,472,19,505,1943
TAMAULIPAS,CIUDAD VICTORIA,23,491,17,531,1514
TAMAULIPAS,CIUDAD VICTORIA,20,441,22,483,1514
TAMAULIPAS,CIUDAD VICTORIA,13,502,17,532,949
TAMAULIPAS,CIUDAD VICTORIA,8,252,4,264,1914
TAMAULIPAS,CIUDAD VICTORIA,9,261,4,274,1914
TAMAULIPAS,CIUDAD VICTORIA,8,250,5,263,1914
TAMAULIPAS,CIUDAD VICTORIA,17,246,3,266,1914
TAMAULIPAS,CIUDAD VICTORIA,10,243,1,254,1913
TAMAULIPAS,CIUDAD VICTORIA,10,260,1,271,1480
TAMAULIPAS,CIUDAD VICTORIA,7,209,2,218,1480
TAMAULIPAS,CIUDAD VICTORIA,10,237,5,252,1479
TAMAULIPAS,CIUDAD VICTORIA,16,359,8,383,1944
TAMAULIPAS,CIUDAD VICTORIA,16,350,5,371,1944
TAMAULIPAS,CIUDAD VICTORIA,24,335,0,359,1740
TAMAULIPAS,CIUDAD VICTORIA,25,272,3,300,1740
TAMAULIPAS,CIUDAD VICTORIA,17,283,3,303,1896
TAMAULIPAS,CIUDAD VICTORIA,30,295,4,329,1896
TAMAULIPAS,CIUDAD VICTORIA,18,267,4,289,1710
TAMAULIPAS,CIUDAD VICTORIA,16,281,0,297,1709
TAMAULIPAS,CIUDAD VICTORIA,33,175,0,208,1419
TAMAULIPAS,CIUDAD VICTORIA,36,187,2,225,1419
TAMAULIPAS,CIUDAD VICTORIA,36,167,2,205,1418
TAMAULIPAS,CIUDAD VICTORIA,25,233,1,259,1352
TAMAULIPAS,CIUDAD VICTORIA,22,242,0,264,1352
TAMAULIPAS,CIUDAD VICTORIA,18,225,2,245,1351
TAMAULIPAS,CIUDAD VICTORIA,10,264,2,276,1595
TAMAULIPAS,CIUDAD VICTORIA,15,246,0,261,1595
TAMAULIPAS,CIUDAD VICTORIA,14,252,1,267,1595
TAMAULIPAS,CIUDAD VICTORIA,21,279,1,301,1595
TAMAULIPAS,CIUDAD VICTORIA,14,318,2,334,1725
TAMAULIPAS,CIUDAD VICTORIA,20,300,5,325,1724
TAMAULIPAS,CIUDAD VICTORIA,23,307,3,333,1724
TAMAULIPAS,CIUDAD VICTORIA,34,309,1,344,1724
TAMAULIPAS,CIUDAD VICTORIA,16,351,2,369,1487
TAMAULIPAS,CIUDAD VICTORIA,16,340,7,363,1486
TAMAULIPAS,CIUDAD VICTORIA,23,335,9,367,1486
TAMAULIPAS,CIUDAD VICTORIA,55,296,3,354,1920
TAMAULIPAS,CIUDAD VICTORIA,53,284,3,340,1919
TAMAULIPAS,CIUDAD VICTORIA,28,303,2,333,1772
TAMAULIPAS,CIUDAD VICTORIA,29,295,2,326,1772
TAMAULIPAS,CIUDAD VICTORIA,24,288,0,312,1771
TAMAULIPAS,CIUDAD VICTORIA,7,240,2,249,1562
TAMAULIPAS,CIUDAD VICTORIA,5,229,4,238,1561
TAMAULIPAS,CIUDAD VICTORIA,19,339,1,359,1609
TAMAULIPAS,CIUDAD VICTORIA,14,351,5,370,1609
TAMAULIPAS,CIUDAD VICTORIA,13,346,0,359,1608
TAMAULIPAS,CIUDAD VICTORIA,54,215,1,270,1609
TAMAULIPAS,CIUDAD VICTORIA,55,208,1,264,1608
TAMAULIPAS,CIUDAD VICTORIA,36,247,1,284,1608
TAMAULIPAS,CIUDAD VICTORIA,19,333,1,353,1787
TAMAULIPAS,CIUDAD VICTORIA,14,356,14,384,1787
TAMAULIPAS,CIUDAD VICTORIA,23,300,4,327,1331
TAMAULIPAS,CIUDAD VICTORIA,13,293,1,307,1330
TAMAULIPAS,CIUDAD VICTORIA,26,346,3,375,1916
TAMAULIPAS,CIUDAD VICTORIA,26,347,4,377,1916
TAMAULIPAS,CIUDAD VICTORIA,31,282,3,316,1795
TAMAULIPAS,CIUDAD VICTORIA,22,249,5,276,1795
TAMAULIPAS,CIUDAD VICTORIA,23,250,3,276,1795
TAMAULIPAS,CIUDAD VICTORIA,20,272,2,294,1794
TAMAULIPAS,CIUDAD VICTORIA,4,229,2,235,1616
TAMAULIPAS,CIUDAD VICTORIA,7,238,4,249,1616
TAMAULIPAS,CIUDAD VICTORIA,12,243,7,262,1616
TAMAULIPAS,CIUDAD VICTORIA,9,207,1,217,1615
TAMAULIPAS,CIUDAD VICTORIA,7,231,10,248,1562
TAMAULIPAS,CIUDAD VICTORIA,15,226,6,247,1562
TAMAULIPAS,CIUDAD VICTORIA,13,254,5,272,1538
TAMAULIPAS,CIUDAD VICTORIA,4,240,0,244,1538
TAMAULIPAS,CIUDAD VICTORIA,10,266,5,281,1538
TAMAULIPAS,CIUDAD VICTORIA,10,211,2,223,1020
TAMAULIPAS,CIUDAD VICTORIA,10,207,4,221,1019
TAMAULIPAS,CIUDAD VICTORIA,23,308,3,334,1609
TAMAULIPAS,CIUDAD VICTORIA,28,268,4,300,1609
TAMAULIPAS,CIUDAD VICTORIA,34,314,5,353,1817
TAMAULIPAS,CIUDAD VICTORIA,25,320,2,347,1816
TAMAULIPAS,CIUDAD VICTORIA,17,305,2,324,1453
TAMAULIPAS,CIUDAD VICTORIA,19,274,6,299,1453
TAMAULIPAS,CIUDAD VICTORIA,18,286,2,306,1452
TAMAULIPAS,CIUDAD VICTORIA,34,326,4,364,1928
TAMAULIPAS,CIUDAD VICTORIA,25,310,0,335,1927
TAMAULIPAS,CIUDAD VICTORIA,22,322,4,348,1734
TAMAULIPAS,CIUDAD VICTORIA,14,368,2,384,1733
TAMAULIPAS,CIUDAD VICTORIA,55,1258,21,1334,0
TAMAULIPAS,CIUDAD VICTORIA,16,402,3,421,1889
TAMAULIPAS,CIUDAD VICTORIA,14,367,6,387,1889
TAMAULIPAS,CIUDAD VICTORIA,9,210,2,221,1478
TAMAULIPAS,CIUDAD VICTORIA,5,221,1,227,1478
TAMAULIPAS,CIUDAD VICTORIA,4,222,4,230,1478
TAMAULIPAS,CIUDAD VICTORIA,13,274,3,290,1836
TAMAULIPAS,CIUDAD VICTORIA,5,248,3,256,1836
TAMAULIPAS,CIUDAD VICTORIA,27,269,2,298,1691
TAMAULIPAS,CIUDAD VICTORIA,41,301,2,344,1690
TAMAULIPAS,CIUDAD VICTORIA,24,383,3,410,1840
TAMAULIPAS,CIUDAD VICTORIA,25,339,7,371,1840
TAMAULIPAS,CIUDAD VICTORIA,6,222,2,230,1586
TAMAULIPAS,CIUDAD VICTORIA,15,233,2,250,1586
TAMAULIPAS,CIUDAD VICTORIA,4,221,0,225,1586
TAMAULIPAS,CIUDAD VICTORIA,18,303,0,321,1699
TAMAULIPAS,CIUDAD VICTORIA,14,315,1,330,1698
TAMAULIPAS,CIUDAD VICTORIA,16,313,3,332,1486
TAMAULIPAS,CIUDAD VICTORIA,14,294,1,309,1486
TAMAULIPAS,CIUDAD VICTORIA,11,210,0,221,1115
TAMAULIPAS,CIUDAD VICTORIA,16,233,2,251,1114
TAMAULIPAS,CIUDAD VICTORIA,13,305,2,320,1558
TAMAULIPAS,CIUDAD VICTORIA,21,286,1,308,1557
TAMAULIPAS,CIUDAD VICTORIA,15,204,3,222,1133
TAMAULIPAS,CIUDAD VICTORIA,11,204,1,216,1133
TAMAULIPAS,CIUDAD VICTORIA,18,332,5,355,1588
TAMAULIPAS,CIUDAD VICTORIA,16,310,0,326,1588
TAMAULIPAS,CIUDAD VICTORIA,12,280,3,295,1614
TAMAULIPAS,CIUDAD VICTORIA,9,302,2,313,1613
TAMAULIPAS,CIUDAD VICTORIA,16,276,13,305,1889
TAMAULIPAS,CIUDAD VICTORIA,19,321,5,345,1888
TAMAULIPAS,CIUDAD VICTORIA,10,372,12,394,1701
TAMAULIPAS,CIUDAD VICTORIA,11,338,4,353,1700
TAMAULIPAS,CIUDAD VICTORIA,14,282,2,298,1938
TAMAULIPAS,CIUDAD VICTORIA,16,307,8,331,1938
TAMAULIPAS,CIUDAD VICTORIA,12,261,1,274,1843
TAMAULIPAS,CIUDAD VICTORIA,21,270,1,292,1842
TAMAULIPAS,CIUDAD VICTORIA,20,329,4,353,1776
TAMAULIPAS,CIUDAD VICTORIA,16,346,2,364,1776
TAMAULIPAS,CIUDAD VICTORIA,19,348,1,368,1775
TAMAULIPAS,CIUDAD VICTORIA,12,307,3,322,1862
TAMAULIPAS,CIUDAD VICTORIA,18,290,5,313,1862
TAMAULIPAS,CIUDAD VICTORIA,6,203,4,213,1635
TAMAULIPAS,CIUDAD VICTORIA,7,232,3,242,1635
TAMAULIPAS,CIUDAD VICTORIA,8,224,6,238,1635
TAMAULIPAS,CIUDAD VICTORIA,19,271,1,291,1996
TAMAULIPAS,CIUDAD VICTORIA,3,223,3,229,1996
TAMAULIPAS,CIUDAD VICTORIA,10,227,4,241,1996
TAMAULIPAS,CIUDAD VICTORIA,12,255,0,267,1996
TAMAULIPAS,CIUDAD VICTORIA,5,225,3,233,1995
TAMAULIPAS,CIUDAD VICTORIA,7,226,4,237,1995
TAMAULIPAS,CIUDAD VICTORIA,10,214,2,226,1995
TAMAULIPAS,CIUDAD VICTORIA,18,283,0,301,1542
TAMAULIPAS,CIUDAD VICTORIA,12,267,3,282,1541
TAMAULIPAS,CIUDAD VICTORIA,13,263,0,276,1541
TAMAULIPAS,CIUDAD VICTORIA,19,285,9,313,1814
TAMAULIPAS,CIUDAD VICTORIA,15,260,4,279,1814
TAMAULIPAS,CIUDAD VICTORIA,13,251,3,267,1666
TAMAULIPAS,CIUDAD VICTORIA,9,303,2,314,1665
TAMAULIPAS,CIUDAD VICTORIA,10,229,0,239,1055
TAMAULIPAS,CIUDAD VICTORIA,8,252,5,265,1055
TAMAULIPAS,CIUDAD VICTORIA,12,198,3,213,1242
TAMAULIPAS,CIUDAD VICTORIA,12,216,2,230,1242
TAMAULIPAS,CIUDAD VICTORIA,16,361,7,384,1856
TAMAULIPAS,CIUDAD VICTORIA,15,318,0,333,1856
TAMAULIPAS,CIUDAD VICTORIA,15,330,5,350,1889
TAMAULIPAS,CIUDAD VICTORIA,13,322,10,345,1889
TAMAULIPAS,CIUDAD VICTORIA,12,251,4,267,1531
TAMAULIPAS,CIUDAD VICTORIA,10,275,9,294,1530
TAMAULIPAS,CIUDAD VICTORIA,1,180,3,184,1234
TAMAULIPAS,CIUDAD VICTORIA,7,166,0,173,1234
TAMAULIPAS,CIUDAD VICTORIA,12,332,5,349,1799
TAMAULIPAS,CIUDAD VICTORIA,11,340,11,362,1799
TAMAULIPAS,CIUDAD VICTORIA,9,205,4,218,1738
TAMAULIPAS,CIUDAD VICTORIA,2,207,6,215,1738
TAMAULIPAS,CIUDAD VICTORIA,20,300,9,329,1856
TAMAULIPAS,CIUDAD VICTORIA,16,280,7,303,1856
TAMAULIPAS,CIUDAD VICTORIA,5,704,7,716,1504
TAMAULIPAS,CIUDAD VICTORIA,18,703,3,724,1504
TAMAULIPAS,CIUDAD VICTORIA,14,672,2,688,1503
TAMAULIPAS,CIUDAD MANTE,8,252,4,264,1430
TAMAULIPAS,CIUDAD MANTE,9,268,5,282,1429
TAMAULIPAS,CIUDAD MANTE,8,340,5,353,1469
TAMAULIPAS,CIUDAD MANTE,6,347,3,356,1468
TAMAULIPAS,CIUDAD MANTE,8,331,6,345,1725
TAMAULIPAS,CIUDAD MANTE,4,364,9,377,1725
TAMAULIPAS,CIUDAD MANTE,7,299,7,313,1608
TAMAULIPAS,CIUDAD MANTE,12,283,11,306,1608
TAMAULIPAS,CIUDAD MANTE,9,369,5,383,1680
TAMAULIPAS,CIUDAD MANTE,20,407,7,434,1680
TAMAULIPAS,CIUDAD MANTE,4,376,8,388,1679
TAMAULIPAS,CIUDAD MANTE,7,281,4,292,1733
TAMAULIPAS,CIUDAD MANTE,6,249,8,263,1732
TAMAULIPAS,CIUDAD MANTE,12,390,15,417,1858
TAMAULIPAS,CIUDAD MANTE,11,395,7,413,1858
TAMAULIPAS,CIUDAD MANTE,3,241,10,254,1426
TAMAULIPAS,CIUDAD MANTE,8,287,5,300,1426
TAMAULIPAS,CIUDAD MANTE,8,247,6,261,1533
TAMAULIPAS,CIUDAD MANTE,5,176,4,185,1533
TAMAULIPAS,CIUDAD MANTE,10,209,5,224,1082
TAMAULIPAS,CIUDAD MANTE,5,220,3,228,1081
TAMAULIPAS,CIUDAD MANTE,7,361,4,372,1812
TAMAULIPAS,CIUDAD MANTE,4,336,4,344,1811
TAMAULIPAS,CIUDAD MANTE,11,345,6,362,1885
TAMAULIPAS,CIUDAD MANTE,3,316,10,329,1884
TAMAULIPAS,CIUDAD MANTE,8,288,9,305,1381
TAMAULIPAS,CIUDAD MANTE,9,284,5,298,1381
TAMAULIPAS,CIUDAD MANTE,3,307,19,329,1528
TAMAULIPAS,CIUDAD MANTE,6,330,7,343,1528
TAMAULIPAS,CIUDAD MANTE,5,195,3,203,1271
TAMAULIPAS,CIUDAD MANTE,9,204,3,216,1271
TAMAULIPAS,CIUDAD MANTE,5,253,5,263,1731
TAMAULIPAS,CIUDAD MANTE,3,278,10,291,1876
TAMAULIPAS,CIUDAD MANTE,6,346,8,360,1875
TAMAULIPAS,CIUDAD MANTE,12,241,6,259,1356
TAMAULIPAS,CIUDAD MANTE,6,254,7,267,1356
TAMAULIPAS,CIUDAD MANTE,4,273,5,282,1356
TAMAULIPAS,CIUDAD MANTE,7,202,4,213,1442
TAMAULIPAS,CIUDAD MANTE,8,200,3,211,1442
TAMAULIPAS,CIUDAD MANTE,8,166,7,181,1441
TAMAULIPAS,CIUDAD MANTE,13,273,2,288,1756
TAMAULIPAS,CIUDAD MANTE,6,239,6,251,1756
TAMAULIPAS,CIUDAD MANTE,11,260,4,275,1755
TAMAULIPAS,CIUDAD MANTE,15,272,10,297,1755
TAMAULIPAS,CIUDAD MANTE,7,105,5,117,1272
TAMAULIPAS,CIUDAD MANTE,7,89,4,100,1271
TAMAULIPAS,CIUDAD MANTE,9,185,0,194,1382
TAMAULIPAS,CIUDAD MANTE,7,234,4,245,1608
TAMAULIPAS,CIUDAD MANTE,6,235,4,245,1607
TAMAULIPAS,CIUDAD MANTE,10,188,6,204,1541
TAMAULIPAS,CIUDAD MANTE,9,205,5,219,1541
TAMAULIPAS,CIUDAD MANTE,15,236,14,265,1517
TAMAULIPAS,CIUDAD MANTE,13,242,13,268,1517
TAMAULIPAS,CIUDAD MANTE,13,233,7,253,1517
TAMAULIPAS,CIUDAD MANTE,5,189,5,199,1229
TAMAULIPAS,CIUDAD MANTE,9,159,5,173,1229
TAMAULIPAS,CIUDAD MANTE,7,150,6,163,1455
TAMAULIPAS,CIUDAD MANTE,11,174,14,199,1455
TAMAULIPAS,CIUDAD MANTE,11,370,15,396,1771
TAMAULIPAS,CIUDAD MANTE,8,327,9,344,1770
TAMAULIPAS,CIUDAD MANTE,14,334,6,354,1770
TAMAULIPAS,CIUDAD MANTE,9,365,7,381,1791
TAMAULIPAS,CIUDAD MANTE,7,337,8,352,1790
TAMAULIPAS,CIUDAD MANTE,12,220,15,247,1687
TAMAULIPAS,CIUDAD MANTE,9,258,11,278,1687
TAMAULIPAS,CIUDAD MANTE,10,405,8,423,2013
TAMAULIPAS,CIUDAD MANTE,6,422,5,433,2013
TAMAULIPAS,CIUDAD MANTE,12,434,8,454,2012
TAMAULIPAS,CIUDAD MANTE,6,300,14,320,1833
TAMAULIPAS,CIUDAD MANTE,13,317,18,348,1832
TAMAULIPAS,CIUDAD MANTE,8,352,14,374,1954
TAMAULIPAS,CIUDAD MANTE,10,337,2,349,1954
TAMAULIPAS,CIUDAD MANTE,7,334,5,346,1954
TAMAULIPAS,CIUDAD MANTE,8,305,6,319,1703
TAMAULIPAS,CIUDAD MANTE,7,258,7,272,1702
TAMAULIPAS,CIUDAD MANTE,4,322,6,332,1716
TAMAULIPAS,CIUDAD MANTE,10,315,2,327,1715
TAMAULIPAS,CIUDAD MANTE,10,385,6,401,1550
TAMAULIPAS,CIUDAD MANTE,11,385,6,402,1550
TAMAULIPAS,CIUDAD MANTE,10,354,1,365,1550
TAMAULIPAS,CIUDAD MANTE,7,318,4,329,1642
TAMAULIPAS,CIUDAD MANTE,9,294,59,362,1641
TAMAULIPAS,CIUDAD MANTE,12,335,21,368,1641
TAMAULIPAS,CIUDAD MANTE,8,297,4,309,1558
TAMAULIPAS,CIUDAD MANTE,7,289,9,305,1557
TAMAULIPAS,CIUDAD MANTE,8,354,4,366,1724
TAMAULIPAS,CIUDAD MANTE,8,370,2,380,1723
TAMAULIPAS,CIUDAD MANTE,1,371,1,373,1750
TAMAULIPAS,CIUDAD MANTE,15,351,2,368,1749
TAMAULIPAS,CIUDAD MANTE,13,314,6,333,1577
TAMAULIPAS,CIUDAD MANTE,9,262,62,333,1577
TAMAULIPAS,CIUDAD MANTE,4,326,3,333,1577
TAMAULIPAS,CIUDAD MANTE,38,1008,9,1055,0
TAMAULIPAS,CIUDAD MANTE,13,268,1,282,1611
TAMAULIPAS,CIUDAD MANTE,6,314,1,321,1610
TAMAULIPAS,CIUDAD MANTE,11,301,0,312,1610
TAMAULIPAS,CIUDAD MANTE,13,315,3,331,1581
TAMAULIPAS,CIUDAD MANTE,15,320,1,336,1581
TAMAULIPAS,CIUDAD MANTE,9,271,2,282,1581
TAMAULIPAS,CIUDAD MANTE,9,342,2,353,1722
TAMAULIPAS,CIUDAD MANTE,11,377,3,391,1722
TAMAULIPAS,CIUDAD MANTE,13,352,6,371,1721
TAMAULIPAS,CIUDAD MANTE,10,416,4,430,1892
TAMAULIPAS,CIUDAD MANTE,10,441,1,452,1891
TAMAULIPAS,CIUDAD MANTE,3,289,5,297,1462
TAMAULIPAS,CIUDAD MANTE,6,320,9,335,1462
TAMAULIPAS,CIUDAD MANTE,11,307,0,318,1504
TAMAULIPAS,CIUDAD MANTE,10,307,1,318,1503
TAMAULIPAS,CIUDAD MANTE,11,303,1,315,1503
TAMAULIPAS,CIUDAD MANTE,12,395,3,410,1837
TAMAULIPAS,CIUDAD MANTE,17,373,2,392,1837
TAMAULIPAS,CIUDAD MANTE,16,242,4,262,1117
TAMAULIPAS,CIUDAD MANTE,12,240,0,252,1116
TAMAULIPAS,CIUDAD MANTE,9,294,4,307,1842
TAMAULIPAS,CIUDAD MANTE,9,328,4,341,1842
TAMAULIPAS,CIUDAD MANTE,4,371,6,381,1771
TAMAULIPAS,CIUDAD MANTE,6,360,2,368,1770
TAMAULIPAS,CIUDAD MANTE,12,326,4,342,1624
TAMAULIPAS,CIUDAD MANTE,2,315,6,323,1623
TAMAULIPAS,CIUDAD MANTE,6,248,1,255,1304
TAMAULIPAS,CIUDAD MANTE,3,290,0,293,1303
TAMAULIPAS,CIUDAD MANTE,9,336,4,349,1753
TAMAULIPAS,CIUDAD MANTE,19,355,10,384,1753
TAMAULIPAS,CIUDAD MANTE,8,199,2,209,1694
TAMAULIPAS,CIUDAD MANTE,6,190,7,203,1693
TAMAULIPAS,CIUDAD MANTE,6,189,5,200,1693
TAMAULIPAS,CIUDAD MANTE,8,232,2,242,1541
TAMAULIPAS,CIUDAD MANTE,13,194,5,212,1541
TAMAULIPAS,CIUDAD MANTE,8,243,4,255,1541
TAMAULIPAS,CIUDAD MANTE,21,298,10,329,1812
TAMAULIPAS,CIUDAD MANTE,4,357,12,373,1533
TAMAULIPAS,CIUDAD MANTE,9,333,9,351,1532
TAMAULIPAS,CIUDAD MANTE,10,378,8,396,1671
TAMAULIPAS,CIUDAD MANTE,14,380,4,398,1670
TAMAULIPAS,CIUDAD MANTE,11,272,6,289,1471
TAMAULIPAS,CIUDAD MANTE,5,233,6,244,1471
TAMAULIPAS,CIUDAD MANTE,8,234,9,251,1471
TAMAULIPAS,CIUDAD MANTE,5,231,7,243,1365
TAMAULIPAS,CIUDAD MANTE,9,225,1,235,1365
TAMAULIPAS,CIUDAD MANTE,376,10,9,395,1747
TAMAULIPAS,CIUDAD MANTE,3,436,6,445,1964
TAMAULIPAS,CIUDAD MANTE,6,215,2,223,1267
TAMAULIPAS,CIUDAD MANTE,7,263,13,283,1266
TAMAULIPAS,CIUDAD MANTE,9,278,3,290,1513
TAMAULIPAS,CIUDAD MANTE,6,270,2,278,1513
TAMAULIPAS,CIUDAD MANTE,6,278,4,288,1513
TAMAULIPAS,CIUDAD MANTE,10,238,2,250,1512
TAMAULIPAS,CIUDAD MANTE,11,349,7,367,1909
TAMAULIPAS,CIUDAD MANTE,12,377,5,394,1909
TAMAULIPAS,CIUDAD MANTE,1,257,2,260,1583
TAMAULIPAS,CIUDAD MANTE,4,254,24,282,1591
TAMAULIPAS,CIUDAD MANTE,6,232,3,241,1591
TAMAULIPAS,CIUDAD MANTE,5,239,6,250,1464
TAMAULIPAS,CIUDAD MANTE,8,264,4,276,1464
TAMAULIPAS,CIUDAD MANTE,4,241,5,250,1464
TAMAULIPAS,CIUDAD MANTE,7,298,16,321,1608
TAMAULIPAS,CIUDAD MANTE,5,280,9,294,1608
TAMAULIPAS,CIUDAD MANTE,6,296,8,310,1608
TAMAULIPAS,CIUDAD MANTE,6,221,14,241,1379
TAMAULIPAS,CIUDAD MANTE,6,222,6,234,1379
TAMAULIPAS,CIUDAD MANTE,4,220,10,234,1378
TAMAULIPAS,CIUDAD MANTE,3,220,4,227,1382
TAMAULIPAS,CIUDAD MANTE,13,225,10,248,1382
TAMAULIPAS,CIUDAD MANTE,10,249,7,266,1381
TAMAULIPAS,CIUDAD MANTE,12,255,10,277,1794
TAMAULIPAS,CIUDAD MANTE,7,276,17,300,1794
TAMAULIPAS,CIUDAD MANTE,11,231,6,248,1750
TAMAULIPAS,CIUDAD MANTE,7,251,6,264,1749
TAMAULIPAS,CIUDAD MANTE,9,246,4,259,1749
TAMAULIPAS,CIUDAD MANTE,0,123,0,123,1188
TAMAULIPAS,CIUDAD MANTE,2,139,3,144,1188
TAMAULIPAS,CIUDAD MANTE,6,208,4,218,1689
TAMAULIPAS,CIUDAD MANTE,5,208,24,237,1689
TAMAULIPAS,CIUDAD MANTE,4,201,2,207,1689
TAMAULIPAS,CIUDAD MANTE,5,300,3,308,1938
TAMAULIPAS,CIUDAD MANTE,5,299,4,308,1938
TAMAULIPAS,CIUDAD MANTE,4,261,5,270,1566
TAMAULIPAS,CIUDAD MANTE,5,250,3,258,1565
TAMAULIPAS,CIUDAD MANTE,7,194,3,204,1354
TAMAULIPAS,CIUDAD MANTE,1,184,7,192,1353
TAMAULIPAS,CIUDAD MADERO,9,253,4,266,1457
TAMAULIPAS,CIUDAD MADERO,5,262,1,268,1457
TAMAULIPAS,CIUDAD MADERO,16,281,4,301,1457
TAMAULIPAS,CIUDAD MADERO,19,481,2,502,1976
TAMAULIPAS,CIUDAD MADERO,27,466,0,493,1975
TAMAULIPAS,CIUDAD MADERO,19,305,5,329,1847
TAMAULIPAS,CIUDAD MADERO,9,333,3,345,1846
TAMAULIPAS,CIUDAD MADERO,12,322,4,338,1846
TAMAULIPAS,CIUDAD MADERO,14,373,28,415,1629
TAMAULIPAS,CIUDAD MADERO,12,442,2,456,1628
TAMAULIPAS,CIUDAD MADERO,17,397,5,419,1890
TAMAULIPAS,CIUDAD MADERO,22,397,3,422,1889
TAMAULIPAS,CIUDAD MADERO,19,332,5,356,1582
TAMAULIPAS,CIUDAD MADERO,8,319,7,334,1582
TAMAULIPAS,CIUDAD MADERO,13,288,5,306,1582
TAMAULIPAS,CIUDAD MADERO,6,326,8,340,1566
TAMAULIPAS,CIUDAD MADERO,12,299,7,318,1566
TAMAULIPAS,CIUDAD MADERO,17,344,8,369,1566
TAMAULIPAS,CIUDAD MADERO,21,476,7,504,1729
TAMAULIPAS,CIUDAD MADERO,15,365,2,382,1729
TAMAULIPAS,CIUDAD MADERO,18,364,4,386,1728
TAMAULIPAS,CIUDAD MADERO,42,870,4,916,0
TAMAULIPAS,CIUDAD MADERO,17,331,3,351,1734
TAMAULIPAS,CIUDAD MADERO,10,322,2,334,1734
TAMAULIPAS,CIUDAD MADERO,18,311,1,330,1734
TAMAULIPAS,CIUDAD MADERO,9,333,5,347,1734
TAMAULIPAS,CIUDAD MADERO,16,323,3,342,1734
TAMAULIPAS,CIUDAD MADERO,21,321,0,342,1733
TAMAULIPAS,CIUDAD MADERO,16,414,5,435,1759
TAMAULIPAS,CIUDAD MADERO,15,412,5,432,1759
TAMAULIPAS,CIUDAD MADERO,13,339,6,358,1250
TAMAULIPAS,CIUDAD MADERO,17,367,5,389,1250
TAMAULIPAS,CIUDAD MADERO,14,425,3,442,1790
TAMAULIPAS,CIUDAD MADERO,22,433,0,455,1790
TAMAULIPAS,CIUDAD MADERO,15,437,16,468,1860
TAMAULIPAS,CIUDAD MADERO,23,443,1,467,1860
TAMAULIPAS,CIUDAD MADERO,5,359,5,369,1413
TAMAULIPAS,CIUDAD MADERO,7,375,7,389,1412
TAMAULIPAS,CIUDAD MADERO,10,301,11,322,1457
TAMAULIPAS,CIUDAD MADERO,5,306,13,324,1457
TAMAULIPAS,CIUDAD MADERO,6,310,3,319,1456
TAMAULIPAS,CIUDAD MADERO,13,397,9,419,1793
TAMAULIPAS,CIUDAD MADERO,10,423,6,439,1793
TAMAULIPAS,CIUDAD MADERO,29,446,23,498,2068
TAMAULIPAS,CIUDAD MADERO,28,406,4,438,1803
TAMAULIPAS,CIUDAD MADERO,24,398,9,431,1802
TAMAULIPAS,CIUDAD MADERO,7,314,11,332,1424
TAMAULIPAS,CIUDAD MADERO,12,284,10,306,1424
TAMAULIPAS,CIUDAD MADERO,10,326,5,341,1423
TAMAULIPAS,CIUDAD MADERO,9,313,3,325,1689
TAMAULIPAS,CIUDAD MADERO,10,299,8,317,1689
TAMAULIPAS,CIUDAD MADERO,20,319,1,340,1688
TAMAULIPAS,CIUDAD MADERO,23,305,8,336,1475
TAMAULIPAS,CIUDAD MADERO,22,328,4,354,1474
TAMAULIPAS,CIUDAD MADERO,12,352,6,370,1704
TAMAULIPAS,CIUDAD MADERO,31,365,4,400,1703
TAMAULIPAS,CIUDAD MADERO,20,293,8,321,1450
TAMAULIPAS,CIUDAD MADERO,15,295,4,314,1449
TAMAULIPAS,CIUDAD MADERO,16,371,3,390,1927
TAMAULIPAS,CIUDAD MADERO,19,338,1,358,1926
TAMAULIPAS,CIUDAD MADERO,9,268,5,282,1806
TAMAULIPAS,CIUDAD MADERO,16,287,4,307,1805
TAMAULIPAS,CIUDAD MADERO,12,287,6,305,1805
TAMAULIPAS,CIUDAD MADERO,15,280,4,299,1805
TAMAULIPAS,CIUDAD MADERO,11,254,5,270,1805
TAMAULIPAS,CIUDAD MADERO,17,288,10,315,1805
TAMAULIPAS,CIUDAD MADERO,12,308,1,321,1423
TAMAULIPAS,CIUDAD MADERO,19,327,3,349,1422
TAMAULIPAS,CIUDAD MADERO,5,253,4,262,1672
TAMAULIPAS,CIUDAD MADERO,10,262,3,275,1671
TAMAULIPAS,CIUDAD MADERO,14,225,8,247,1671
TAMAULIPAS,CIUDAD MADERO,5,279,3,287,1671
TAMAULIPAS,CIUDAD MADERO,3,245,3,251,1671
TAMAULIPAS,CIUDAD MADERO,9,277,4,290,1488
TAMAULIPAS,CIUDAD MADERO,10,327,0,337,1488
TAMAULIPAS,CIUDAD MADERO,13,201,4,218,1060
TAMAULIPAS,CIUDAD MADERO,10,219,3,232,1060
TAMAULIPAS,CIUDAD MADERO,23,411,7,441,1688
TAMAULIPAS,CIUDAD MADERO,19,375,3,397,1687
TAMAULIPAS,CIUDAD MADERO,20,333,7,360,1464
TAMAULIPAS,CIUDAD MADERO,10,369,4,383,1464
TAMAULIPAS,CIUDAD MADERO,15,415,5,435,1635
TAMAULIPAS,CIUDAD MADERO,13,388,2,403,1634
TAMAULIPAS,CIUDAD MADERO,5,255,1,261,1397
TAMAULIPAS,CIUDAD MADERO,9,249,1,259,1396
TAMAULIPAS,CIUDAD MADERO,14,231,5,250,1396
TAMAULIPAS,CIUDAD MADERO,18,322,7,347,1399
TAMAULIPAS,CIUDAD MADERO,14,270,8,292,1399
TAMAULIPAS,CIUDAD MADERO,10,308,1,319,1444
TAMAULIPAS,CIUDAD MADERO,11,296,7,314,1444
TAMAULIPAS,CIUDAD MADERO,19,294,3,316,1539
TAMAULIPAS,CIUDAD MADERO,8,302,7,317,1538
TAMAULIPAS,CIUDAD MADERO,5,332,3,340,1538
TAMAULIPAS,CIUDAD MADERO,24,417,12,453,1829
TAMAULIPAS,CIUDAD MADERO,27,430,7,464,1828
TAMAULIPAS,CIUDAD MADERO,9,299,1,309,1117
TAMAULIPAS,CIUDAD MADERO,28,311,1,340,1117
TAMAULIPAS,CIUDAD MADERO,14,393,15,422,1969
TAMAULIPAS,CIUDAD MADERO,14,452,4,470,1968
TAMAULIPAS,CIUDAD MADERO,16,366,2,384,1857
TAMAULIPAS,CIUDAD MADERO,19,387,5,411,1856
TAMAULIPAS,CIUDAD MADERO,20,423,3,446,1986
TAMAULIPAS,CIUDAD MADERO,18,407,6,431,1985
TAMAULIPAS,CIUDAD MADERO,19,308,3,330,1759
TAMAULIPAS,CIUDAD MADERO,13,298,1,312,1759
TAMAULIPAS,CIUDAD MADERO,16,275,4,295,1758
TAMAULIPAS,CIUDAD MADERO,15,313,5,333,1758
TAMAULIPAS,CIUDAD MADERO,15,292,1,308,1758
TAMAULIPAS,CIUDAD MADERO,9,241,2,252,1224
TAMAULIPAS,CIUDAD MADERO,17,248,3,268,1223
TAMAULIPAS,CIUDAD MADERO,22,341,0,363,1898
TAMAULIPAS,CIUDAD MADERO,36,388,1,425,1898
TAMAULIPAS,CIUDAD MADERO,28,396,1,425,1897
TAMAULIPAS,CIUDAD MADERO,21,366,2,389,1695
TAMAULIPAS,CIUDAD MADERO,16,342,4,362,1695
TAMAULIPAS,CIUDAD MADERO,15,336,7,358,1398
TAMAULIPAS,CIUDAD MADERO,17,325,3,345,1398
TAMAULIPAS,CIUDAD MADERO,11,281,31,323,1761
TAMAULIPAS,CIUDAD MADERO,17,298,3,318,1761
TAMAULIPAS,CIUDAD MADERO,18,299,2,319,1761
TAMAULIPAS,CIUDAD MADERO,16,300,3,319,1760
TAMAULIPAS,CIUDAD MADERO,20,313,2,335,1760
TAMAULIPAS,CIUDAD MADERO,23,318,1,342,1760
TAMAULIPAS,CIUDAD MADERO,14,317,2,333,1760
TAMAULIPAS,CIUDAD MADERO,25,359,7,391,1609
TAMAULIPAS,CIUDAD MADERO,22,352,15,389,1608
TAMAULIPAS,CIUDAD MADERO,15,205,4,224,1377
TAMAULIPAS,CIUDAD MADERO,15,211,2,228,1376
TAMAULIPAS,CIUDAD MADERO,29,253,2,284,1536
TAMAULIPAS,CIUDAD MADERO,32,251,0,283,1535
TAMAULIPAS,CIUDAD MADERO,20,420,1,441,1942
TAMAULIPAS,CIUDAD MADERO,13,475,1,489,1942
TAMAULIPAS,CIUDAD MADERO,21,374,3,398,1789
TAMAULIPAS,CIUDAD MADERO,14,393,4,411,1788
TAMAULIPAS,CIUDAD MADERO,33,455,2,490,1997
TAMAULIPAS,CIUDAD MADERO,28,438,3,469,1997
TAMAULIPAS,CIUDAD MADERO,22,471,2,495,1995
TAMAULIPAS,CIUDAD MADERO,28,411,8,447,1994
TAMAULIPAS,CIUDAD MADERO,22,319,2,343,1549
TAMAULIPAS,CIUDAD MADERO,27,285,1,313,1548
TAMAULIPAS,CIUDAD MADERO,31,263,0,294,1548
TAMAULIPAS,CIUDAD MADERO,29,405,3,437,1803
TAMAULIPAS,CIUDAD MADERO,28,406,8,442,1802
TAMAULIPAS,CIUDAD MADERO,40,548,8,596,2017
TAMAULIPAS,CIUDAD MADERO,19,382,4,405,1631
TAMAULIPAS,CIUDAD MADERO,25,349,9,383,1631
TAMAULIPAS,CIUDAD MADERO,19,310,4,333,1793
TAMAULIPAS,CIUDAD MADERO,19,332,0,351,1793
TAMAULIPAS,CIUDAD MADERO,13,370,5,388,1793
TAMAULIPAS,CIUDAD MADERO,36,377,2,415,1877
TAMAULIPAS,CIUDAD MADERO,30,354,3,387,1877
TAMAULIPAS,CIUDAD MADERO,30,336,5,371,1877
TAMAULIPAS,CIUDAD MADERO,19,390,4,413,1576
TAMAULIPAS,CIUDAD MADERO,15,384,2,401,1575
TAMAULIPAS,CIUDAD MADERO,24,472,1,497,1865
TAMAULIPAS,CIUDAD MADERO,28,453,2,483,1865
TAMAULIPAS,CIUDAD MADERO,30,401,1,432,1872
TAMAULIPAS,CIUDAD MADERO,25,455,2,482,1871
TAMAULIPAS,CIUDAD MADERO,19,357,4,380,1521
TAMAULIPAS,CIUDAD MADERO,17,373,5,395,1520
TAMAULIPAS,CIUDAD MADERO,10,259,0,269,1138
TAMAULIPAS,CIUDAD MADERO,16,268,0,284,1137
TAMAULIPAS,CIUDAD MADERO,23,379,3,405,1820
TAMAULIPAS,CIUDAD MADERO,18,429,5,452,1820
TAMAULIPAS,CIUDAD MADERO,21,333,4,358,1452
TAMAULIPAS,CIUDAD MADERO,18,333,2,353,1451
TAMAULIPAS,CIUDAD MADERO,17,388,4,409,1613
TAMAULIPAS,CIUDAD MADERO,10,391,5,406,1613
TAMAULIPAS,CIUDAD MADERO,27,412,3,442,1612
TAMAULIPAS,CIUDAD MADERO,10,336,0,346,1668
TAMAULIPAS,CIUDAD MADERO,16,335,1,352,1667
TAMAULIPAS,CIUDAD MADERO,18,333,1,352,1667
TAMAULIPAS,CIUDAD MADERO,13,295,4,312,1904
TAMAULIPAS,CIUDAD MADERO,8,301,1,310,1903
TAMAULIPAS,CIUDAD MADERO,12,261,3,276,1429
TAMAULIPAS,CIUDAD MADERO,11,281,4,296,1429
TAMAULIPAS,CIUDAD MADERO,14,270,0,284,1428
TAMAULIPAS,CIUDAD MADERO,10,250,2,262,1456
TAMAULIPAS,CIUDAD MADERO,8,237,0,245,1455
TAMAULIPAS,CIUDAD MADERO,11,359,7,377,2056
TAMAULIPAS,CIUDAD MADERO,16,312,5,333,2056
TAMAULIPAS,CIUDAD MADERO,20,229,0,249,1178
TAMAULIPAS,CIUDAD MADERO,21,269,2,292,1178
TAMAULIPAS,TAMPICO,35,217,4,256,1587
TAMAULIPAS,TAMPICO,21,243,2,266,1587
TAMAULIPAS,TAMPICO,29,214,1,244,1587
TAMAULIPAS,TAMPICO,28,208,2,238,1526
TAMAULIPAS,TAMPICO,30,224,1,255,1526
TAMAULIPAS,TAMPICO,22,235,1,258,1526
TAMAULIPAS,TAMPICO,28,183,2,213,1176
TAMAULIPAS,TAMPICO,27,181,2,210,1176
TAMAULIPAS,TAMPICO,26,188,3,217,1194
TAMAULIPAS,TAMPICO,21,206,1,228,1194
TAMAULIPAS,TAMPICO,31,277,3,311,1620
TAMAULIPAS,TAMPICO,34,266,4,304,1620
TAMAULIPAS,TAMPICO,27,275,2,304,1620
TAMAULIPAS,TAMPICO,44,369,24,437,1934
TAMAULIPAS,TAMPICO,48,425,5,478,1934
TAMAULIPAS,TAMPICO,28,427,7,462,2028
TAMAULIPAS,TAMPICO,34,406,5,445,2028
TAMAULIPAS,TAMPICO,15,290,5,310,1402
TAMAULIPAS,TAMPICO,21,323,2,346,1401
TAMAULIPAS,TAMPICO,16,325,1,342,1705
TAMAULIPAS,TAMPICO,30,315,2,347,1705
TAMAULIPAS,TAMPICO,19,345,2,366,1705
TAMAULIPAS,TAMPICO,26,426,4,456,1714
TAMAULIPAS,TAMPICO,18,427,0,445,1713
TAMAULIPAS,TAMPICO,20,384,0,404,1757
TAMAULIPAS,TAMPICO,28,349,3,380,1757
TAMAULIPAS,TAMPICO,36,317,4,357,1378
TAMAULIPAS,TAMPICO,19,325,2,346,1377
TAMAULIPAS,TAMPICO,21,423,3,447,1847
TAMAULIPAS,TAMPICO,21,467,1,489,1846
TAMAULIPAS,TAMPICO,10,282,7,299,1675
TAMAULIPAS,TAMPICO,9,286,6,301,1675
TAMAULIPAS,TAMPICO,16,293,0,309,1675
TAMAULIPAS,TAMPICO,14,345,10,369,1690
TAMAULIPAS,TAMPICO,21,345,7,373,1690
TAMAULIPAS,TAMPICO,9,314,6,329,1827
TAMAULIPAS,TAMPICO,14,295,2,311,1827
TAMAULIPAS,TAMPICO,8,320,5,333,1570
TAMAULIPAS,TAMPICO,10,280,20,310,1569
TAMAULIPAS,TAMPICO,20,341,3,364,1976
TAMAULIPAS,TAMPICO,25,377,4,406,1976
TAMAULIPAS,TAMPICO,26,388,1,415,1976
TAMAULIPAS,TAMPICO,36,335,3,374,1976
TAMAULIPAS,TAMPICO,18,398,6,422,1830
TAMAULIPAS,TAMPICO,26,364,1,391,1829
TAMAULIPAS,TAMPICO,16,266,3,285,1423
TAMAULIPAS,TAMPICO,18,278,1,297,1422
TAMAULIPAS,TAMPICO,14,267,6,287,1422
TAMAULIPAS,TAMPICO,23,343,3,369,1761
TAMAULIPAS,TAMPICO,17,370,2,389,1761
TAMAULIPAS,TAMPICO,10,305,2,317,1506
TAMAULIPAS,TAMPICO,16,265,31,312,1505
TAMAULIPAS,TAMPICO,8,317,6,331,1994
TAMAULIPAS,TAMPICO,13,327,4,344,1994
TAMAULIPAS,TAMPICO,27,377,1,405,1894
TAMAULIPAS,TAMPICO,10,370,3,383,1894
TAMAULIPAS,TAMPICO,20,382,3,405,1941
TAMAULIPAS,TAMPICO,23,376,2,401,1940
TAMAULIPAS,TAMPICO,15,351,6,372,1904
TAMAULIPAS,TAMPICO,16,301,3,320,1903
TAMAULIPAS,TAMPICO,22,393,6,421,1929
TAMAULIPAS,TAMPICO,9,417,2,428,1928
TAMAULIPAS,TAMPICO,0,355,0,355,1848
TAMAULIPAS,TAMPICO,5,407,1,413,1847
TAMAULIPAS,TAMPICO,17,353,0,370,1750
TAMAULIPAS,TAMPICO,14,305,4,323,1749
TAMAULIPAS,TAMPICO,19,460,2,481,2014
TAMAULIPAS,TAMPICO,28,471,9,508,2013
TAMAULIPAS,TAMPICO,25,333,4,362,1884
TAMAULIPAS,TAMPICO,28,330,6,364,1883
TAMAULIPAS,TAMPICO,9,313,2,324,1486
TAMAULIPAS,TAMPICO,30,308,0,338,1486
TAMAULIPAS,TAMPICO,29,278,2,309,1513
TAMAULIPAS,TAMPICO,17,307,1,325,1513
TAMAULIPAS,TAMPICO,19,332,1,352,1758
TAMAULIPAS,TAMPICO,18,364,1,383,1758
TAMAULIPAS,TAMPICO,25,312,3,340,1969
TAMAULIPAS,TAMPICO,25,290,3,318,1968
TAMAULIPAS,TAMPICO,26,346,3,375,1968
TAMAULIPAS,TAMPICO,20,340,0,360,1456
TAMAULIPAS,TAMPICO,6,374,6,386,1456
TAMAULIPAS,TAMPICO,10,376,4,390,1455
TAMAULIPAS,TAMPICO,15,277,4,296,1227
TAMAULIPAS,TAMPICO,10,242,2,254,1227
TAMAULIPAS,TAMPICO,33,366,3,402,2072
TAMAULIPAS,TAMPICO,28,412,3,443,2072
TAMAULIPAS,TAMPICO,18,399,0,417,2072
TAMAULIPAS,TAMPICO,25,264,1,290,1825
TAMAULIPAS,TAMPICO,19,245,2,266,1824
TAMAULIPAS,TAMPICO,20,264,0,284,1824
TAMAULIPAS,TAMPICO,17,262,4,283,1824
TAMAULIPAS,TAMPICO,18,263,1,282,1526
TAMAULIPAS,TAMPICO,30,296,0,326,1526
TAMAULIPAS,TAMPICO,30,241,1,272,1525
TAMAULIPAS,TAMPICO,21,361,0,382,1902
TAMAULIPAS,TAMPICO,23,381,2,406,1901
TAMAULIPAS,TAMPICO,19,373,5,397,1824
TAMAULIPAS,TAMPICO,13,375,2,390,1823
TAMAULIPAS,TAMPICO,16,331,5,352,1755
TAMAULIPAS,TAMPICO,20,320,2,342,1755
TAMAULIPAS,TAMPICO,29,394,2,425,1914
TAMAULIPAS,TAMPICO,24,348,0,372,1914
TAMAULIPAS,TAMPICO,50,138,0,188,1929
TAMAULIPAS,TAMPICO,46,132,1,179,1929
TAMAULIPAS,TAMPICO,15,280,4,299,1569
TAMAULIPAS,TAMPICO,16,327,2,345,1568
TAMAULIPAS,TAMPICO,12,303,2,317,1568
TAMAULIPAS,TAMPICO,13,307,2,322,1726
TAMAULIPAS,TAMPICO,14,316,4,334,1726
TAMAULIPAS,TAMPICO,17,362,3,382,1628
TAMAULIPAS,TAMPICO,16,362,2,380,1628
TAMAULIPAS,TAMPICO,58,231,2,291,1990
TAMAULIPAS,TAMPICO,49,246,0,295,1989
TAMAULIPAS,TAMPICO,50,168,0,218,1701
TAMAULIPAS,TAMPICO,42,153,0,195,1700
TAMAULIPAS,TAMPICO,33,247,4,284,1761
TAMAULIPAS,TAMPICO,25,246,0,271,1760
TAMAULIPAS,TAMPICO,40,92,3,135,1523
TAMAULIPAS,TAMPICO,37,99,0,136,1522
TAMAULIPAS,TAMPICO,31,109,1,141,1522
TAMAULIPAS,TAMPICO,101,1718,8,1827,0
TAMAULIPAS,TAMPICO,46,310,7,363,1952
TAMAULIPAS,TAMPICO,42,323,0,365,1952
TAMAULIPAS,TAMPICO,29,349,5,383,2038
TAMAULIPAS,TAMPICO,30,309,4,343,1937
TAMAULIPAS,TAMPICO,30,312,2,344,1936
TAMAULIPAS,TAMPICO,22,269,0,291,1470
TAMAULIPAS,TAMPICO,7,275,2,284,1470
TAMAULIPAS,TAMPICO,9,285,2,296,1470
TAMAULIPAS,TAMPICO,20,355,3,378,1594
TAMAULIPAS,TAMPICO,15,362,2,379,1593
TAMAULIPAS,TAMPICO,16,150,1,167,1216
TAMAULIPAS,TAMPICO,27,130,2,159,1215
TAMAULIPAS,TAMPICO,26,273,2,301,1429
TAMAULIPAS,TAMPICO,13,323,1,337,1429
TAMAULIPAS,TAMPICO,18,273,0,291,1428
TAMAULIPAS,TAMPICO,22,327,6,355,1749
TAMAULIPAS,TAMPICO,21,308,3,332,1749
TAMAULIPAS,TAMPICO,19,276,3,298,1748
TAMAULIPAS,TAMPICO,8,221,6,235,1267
TAMAULIPAS,TAMPICO,0,248,3,251,1267
TAMAULIPAS,TAMPICO,27,346,1,374,1925
TAMAULIPAS,TAMPICO,17,357,6,380,1925
TAMAULIPAS,TAMPICO,23,356,4,383,1794
TAMAULIPAS,TAMPICO,21,380,4,405,1793
TAMAULIPAS,TAMPICO,22,332,4,358,1452
TAMAULIPAS,TAMPICO,25,307,1,333,1452
TAMAULIPAS,TAMPICO,24,330,7,361,1540
TAMAULIPAS,TAMPICO,20,277,3,300,1539
TAMAULIPAS,TAMPICO,8,259,3,270,1244
TAMAULIPAS,TAMPICO,10,292,2,304,1244
TAMAULIPAS,TAMPICO,15,271,1,287,1264
TAMAULIPAS,TAMPICO,9,231,0,240,1264
TAMAULIPAS,TAMPICO,25,329,3,357,1901
TAMAULIPAS,TAMPICO,25,339,3,367,1901
TAMAULIPAS,TAMPICO,11,289,1,301,1624
TAMAULIPAS,TAMPICO,13,295,13,321,1624
TAMAULIPAS,TAMPICO,14,301,6,321,1546
TAMAULIPAS,TAMPICO,18,306,5,329,1545
TAMAULIPAS,TAMPICO,18,283,5,306,1545
TAMAULIPAS,TAMPICO,14,246,15,275,1536
TAMAULIPAS,TAMPICO,18,224,3,245,1535
TAMAULIPAS,TAMPICO,9,259,9,277,1535
TAMAULIPAS,TAMPICO,25,419,5,449,1891
TAMAULIPAS,TAMPICO,24,405,1,430,1891
TAMAULIPAS,TAMPICO,31,343,1,375,1699
TAMAULIPAS,TAMPICO,26,341,2,369,1699
TAMAULIPAS,TAMPICO,16,344,4,364,1950
TAMAULIPAS,TAMPICO,15,335,1,351,1949
TAMAULIPAS,TAMPICO,26,330,5,361,1949
TAMAULIPAS,TAMPICO,12,394,2,408,1972
TAMAULIPAS,TAMPICO,19,411,4,434,1971
TAMAULIPAS,TAMPICO,15,346,2,363,1888
TAMAULIPAS,TAMPICO,6,306,4,316,1887
TAMAULIPAS,TAMPICO,35,359,1,395,1933
TAMAULIPAS,TAMPICO,29,383,3,415,1933
TAMAULIPAS,TAMPICO,29,370,2,401,1933
TAMAULIPAS,REYNOSA,11,199,1,211,1650
TAMAULIPAS,REYNOSA,9,196,3,208,1649
TAMAULIPAS,REYNOSA,11,296,5,312,1937
TAMAULIPAS,REYNOSA,19,296,0,315,1936
TAMAULIPAS,REYNOSA,7,319,8,334,1936
TAMAULIPAS,REYNOSA,36,779,3,818,0
TAMAULIPAS,REYNOSA,10,242,3,255,1403
TAMAULIPAS,REYNOSA,7,228,6,241,1402
TAMAULIPAS,REYNOSA,13,211,5,229,1402
TAMAULIPAS,REYNOSA,6,227,1,234,1487
TAMAULIPAS,REYNOSA,3,250,1,254,1486
TAMAULIPAS,REYNOSA,12,190,1,203,1240
TAMAULIPAS,REYNOSA,10,200,3,213,1240
TAMAULIPAS,REYNOSA,10,340,1,351,1857
TAMAULIPAS,REYNOSA,11,326,4,341,1856
TAMAULIPAS,REYNOSA,13,303,6,322,1950
TAMAULIPAS,REYNOSA,14,303,8,325,1950
TAMAULIPAS,REYNOSA,13,264,3,280,1705
TAMAULIPAS,REYNOSA,12,271,3,286,1705
TAMAULIPAS,REYNOSA,10,192,5,207,1151
TAMAULIPAS,REYNOSA,18,201,4,223,1151
TAMAULIPAS,REYNOSA,13,314,2,329,1986
TAMAULIPAS,REYNOSA,12,275,1,288,1986
TAMAULIPAS,REYNOSA,7,326,3,336,1985
TAMAULIPAS,REYNOSA,8,293,3,304,1985
TAMAULIPAS,REYNOSA,7,283,4,294,1839
TAMAULIPAS,REYNOSA,19,291,8,318,1839
TAMAULIPAS,REYNOSA,12,279,2,293,1839
TAMAULIPAS,REYNOSA,7,341,7,355,1665
TAMAULIPAS,REYNOSA,8,278,8,294,1665
TAMAULIPAS,REYNOSA,5,286,2,293,1665
TAMAULIPAS,REYNOSA,11,376,3,390,1972
TAMAULIPAS,REYNOSA,9,360,3,372,1972
TAMAULIPAS,REYNOSA,8,368,3,379,1972
TAMAULIPAS,REYNOSA,8,231,2,241,1850
TAMAULIPAS,REYNOSA,8,254,13,275,1849
TAMAULIPAS,REYNOSA,4,205,6,215,1564
TAMAULIPAS,REYNOSA,7,209,6,222,1564
TAMAULIPAS,REYNOSA,6,155,4,165,1301
TAMAULIPAS,REYNOSA,9,188,2,199,1301
TAMAULIPAS,REYNOSA,2,205,7,214,1501
TAMAULIPAS,REYNOSA,9,230,1,240,1500
TAMAULIPAS,REYNOSA,4,248,2,254,2014
TAMAULIPAS,REYNOSA,13,249,5,267,2014
TAMAULIPAS,REYNOSA,0,250,8,258,2014
TAMAULIPAS,REYNOSA,6,254,6,266,2014
TAMAULIPAS,REYNOSA,7,245,2,254,2014
TAMAULIPAS,REYNOSA,8,271,3,282,2014
TAMAULIPAS,REYNOSA,11,245,1,257,2013
TAMAULIPAS,REYNOSA,6,202,1,209,1502
TAMAULIPAS,REYNOSA,8,227,2,237,1501
TAMAULIPAS,REYNOSA,8,245,6,259,1625
TAMAULIPAS,REYNOSA,15,244,5,264,1625
TAMAULIPAS,REYNOSA,9,273,4,286,2014
TAMAULIPAS,REYNOSA,9,287,0,296,2014
TAMAULIPAS,REYNOSA,13,274,5,292,2013
TAMAULIPAS,REYNOSA,8,268,7,283,1981
TAMAULIPAS,REYNOSA,9,248,3,260,1980
TAMAULIPAS,REYNOSA,12,229,3,244,1747
TAMAULIPAS,REYNOSA,11,229,4,244,1747
TAMAULIPAS,REYNOSA,9,214,1,224,1116
TAMAULIPAS,REYNOSA,6,181,4,191,1116
TAMAULIPAS,REYNOSA,11,243,2,256,1827
TAMAULIPAS,REYNOSA,7,276,5,288,1827
TAMAULIPAS,REYNOSA,9,253,3,265,1826
TAMAULIPAS,REYNOSA,8,214,6,228,1458
TAMAULIPAS,REYNOSA,10,213,4,227,1458
TAMAULIPAS,REYNOSA,8,198,4,210,1457
TAMAULIPAS,REYNOSA,4,233,2,239,1495
TAMAULIPAS,REYNOSA,12,255,1,268,1495
TAMAULIPAS,REYNOSA,9,245,0,254,1495
TAMAULIPAS,REYNOSA,4,233,1,238,2068
TAMAULIPAS,REYNOSA,2,267,1,270,2067
TAMAULIPAS,REYNOSA,1,231,1,233,2067
TAMAULIPAS,REYNOSA,9,231,4,244,2067
TAMAULIPAS,REYNOSA,5,209,1,215,2067
TAMAULIPAS,REYNOSA,9,232,2,243,2067
TAMAULIPAS,REYNOSA,3,224,1,228,2067
TAMAULIPAS,REYNOSA,8,241,1,250,2067
TAMAULIPAS,REYNOSA,8,174,4,186,1821
TAMAULIPAS,REYNOSA,11,271,12,294,1518
TAMAULIPAS,REYNOSA,6,277,6,289,1517
TAMAULIPAS,REYNOSA,12,330,1,343,1954
TAMAULIPAS,REYNOSA,7,329,3,339,1953
TAMAULIPAS,REYNOSA,287,21,1,309,1790
TAMAULIPAS,REYNOSA,14,265,2,281,1790
TAMAULIPAS,REYNOSA,18,259,0,277,1790
TAMAULIPAS,REYNOSA,14,277,2,293,1671
TAMAULIPAS,REYNOSA,13,319,1,333,1671
TAMAULIPAS,REYNOSA,16,256,3,275,1671
TAMAULIPAS,REYNOSA,12,330,1,343,1706
TAMAULIPAS,REYNOSA,10,314,1,325,1706
TAMAULIPAS,REYNOSA,3,250,2,255,1130
TAMAULIPAS,REYNOSA,6,215,1,222,1130
TAMAULIPAS,REYNOSA,15,305,2,322,1600
TAMAULIPAS,REYNOSA,11,305,1,317,1600
TAMAULIPAS,REYNOSA,21,297,1,319,1599
TAMAULIPAS,REYNOSA,10,262,1,273,1529
TAMAULIPAS,REYNOSA,10,223,1,234,1528
TAMAULIPAS,REYNOSA,14,237,2,253,1528
TAMAULIPAS,REYNOSA,9,233,4,246,1752
TAMAULIPAS,REYNOSA,4,246,2,252,1751
TAMAULIPAS,REYNOSA,3,252,0,255,1508
TAMAULIPAS,REYNOSA,6,208,0,214,1507
TAMAULIPAS,REYNOSA,1,222,0,223,1507
TAMAULIPAS,REYNOSA,6,278,3,287,1407
TAMAULIPAS,REYNOSA,10,255,2,267,1406
TAMAULIPAS,REYNOSA,14,233,2,249,1406
TAMAULIPAS,REYNOSA,8,350,4,362,1856
TAMAULIPAS,REYNOSA,16,317,4,337,1855
TAMAULIPAS,REYNOSA,10,319,3,332,1496
TAMAULIPAS,REYNOSA,10,310,0,320,1495
TAMAULIPAS,REYNOSA,9,313,3,325,1495
TAMAULIPAS,REYNOSA,6,294,0,300,1730
TAMAULIPAS,REYNOSA,5,292,2,299,1729
TAMAULIPAS,REYNOSA,7,261,0,268,1729
TAMAULIPAS,REYNOSA,9,290,2,301,1860
TAMAULIPAS,REYNOSA,5,338,1,344,1860
TAMAULIPAS,REYNOSA,13,312,0,325,1860
TAMAULIPAS,REYNOSA,3,310,2,315,1520
TAMAULIPAS,REYNOSA,2,315,1,318,1520
TAMAULIPAS,REYNOSA,9,392,2,403,1994
TAMAULIPAS,REYNOSA,12,362,6,380,1994
TAMAULIPAS,REYNOSA,10,370,5,385,1732
TAMAULIPAS,REYNOSA,16,329,1,346,1732
TAMAULIPAS,REYNOSA,9,345,4,358,1946
TAMAULIPAS,REYNOSA,15,335,2,352,1946
TAMAULIPAS,REYNOSA,6,268,3,277,1536
TAMAULIPAS,REYNOSA,5,247,1,253,1536
TAMAULIPAS,REYNOSA,5,263,0,268,1535
TAMAULIPAS,REYNOSA,11,403,6,420,1891
TAMAULIPAS,REYNOSA,8,377,4,389,1890
TAMAULIPAS,REYNOSA,9,431,2,442,2082
TAMAULIPAS,REYNOSA,8,379,5,392,2082
TAMAULIPAS,REYNOSA,9,223,2,234,1337
TAMAULIPAS,REYNOSA,4,266,3,273,1336
TAMAULIPAS,REYNOSA,2,247,0,249,1638
TAMAULIPAS,REYNOSA,2,264,0,266,1638
TAMAULIPAS,REYNOSA,5,268,0,273,1637
TAMAULIPAS,REYNOSA,7,229,2,238,1482
TAMAULIPAS,REYNOSA,0,240,2,242,1481
TAMAULIPAS,REYNOSA,4,230,1,235,1481
TAMAULIPAS,REYNOSA,9,283,4,296,1769
TAMAULIPAS,REYNOSA,15,279,0,294,1769
TAMAULIPAS,REYNOSA,7,349,1,357,1585
TAMAULIPAS,REYNOSA,8,313,4,325,1585
TAMAULIPAS,REYNOSA,1,250,0,251,1774
TAMAULIPAS,REYNOSA,7,267,2,276,1774
TAMAULIPAS,REYNOSA,4,243,1,248,1774
TAMAULIPAS,REYNOSA,5,301,0,306,1826
TAMAULIPAS,REYNOSA,9,284,2,295,1826
TAMAULIPAS,REYNOSA,9,260,5,274,1825
TAMAULIPAS,REYNOSA,8,271,3,282,1825
TAMAULIPAS,REYNOSA,9,264,0,273,1666
TAMAULIPAS,REYNOSA,9,262,0,271,1665
TAMAULIPAS,REYNOSA,2,289,0,291,1665
TAMAULIPAS,REYNOSA,5,259,3,267,1840
TAMAULIPAS,REYNOSA,3,257,4,264,1840
TAMAULIPAS,REYNOSA,11,354,2,367,1891
TAMAULIPAS,REYNOSA,15,339,6,360,1890
TAMAULIPAS,REYNOSA,5,299,0,304,1768
TAMAULIPAS,REYNOSA,2,241,0,243,1767
TAMAULIPAS,REYNOSA,9,204,1,214,1168
TAMAULIPAS,REYNOSA,4,184,2,190,1167
TAMAULIPAS,REYNOSA,12,178,6,196,1132
TAMAULIPAS,REYNOSA,10,212,1,223,1131
TAMAULIPAS,REYNOSA,13,324,0,337,1721
TAMAULIPAS,REYNOSA,9,315,1,325,1720
TAMAULIPAS,REYNOSA,9,316,8,333,1720
TAMAULIPAS,REYNOSA,15,293,3,311,1801
TAMAULIPAS,REYNOSA,7,293,3,303,1801
TAMAULIPAS,REYNOSA,3,159,1,163,1224
TAMAULIPAS,REYNOSA,4,133,3,140,1224
TAMAULIPAS,REYNOSA,6,322,1,329,1792
TAMAULIPAS,REYNOSA,7,347,0,354,1792
TAMAULIPAS,REYNOSA,7,209,2,218,1221
TAMAULIPAS,REYNOSA,3,195,6,204,1220
TAMAULIPAS,REYNOSA,3,267,1,271,1388
TAMAULIPAS,REYNOSA,2,325,0,327,1387
TAMAULIPAS,REYNOSA,3,307,3,313,1525
TAMAULIPAS,REYNOSA,5,298,2,305,1525
TAMAULIPAS,REYNOSA,5,150,2,157,1407
TAMAULIPAS,REYNOSA,8,166,0,174,1406
TAMAULIPAS,REYNOSA,9,217,1,227,1728
TAMAULIPAS,REYNOSA,5,236,5,246,1728
TAMAULIPAS,REYNOSA,9,212,1,222,1728
TLAXCALA,APIZACO,24,356,5,385,1953
TLAXCALA,APIZACO,21,380,8,409,1953
TLAXCALA,APIZACO,21,275,6,302,1596
TLAXCALA,APIZACO,18,285,4,307,1595
TLAXCALA,APIZACO,17,285,4,306,1595
TLAXCALA,APIZACO,34,376,4,414,1950
TLAXCALA,APIZACO,36,335,6,377,1788
TLAXCALA,APIZACO,29,318,7,354,1787
TLAXCALA,APIZACO,33,308,11,352,1875
TLAXCALA,APIZACO,29,346,6,381,1875
TLAXCALA,APIZACO,30,276,3,309,1723
TLAXCALA,APIZACO,35,292,21,348,1722
TLAXCALA,APIZACO,27,181,3,211,1021
TLAXCALA,APIZACO,16,181,0,197,1020
TLAXCALA,APIZACO,28,332,0,360,1898
TLAXCALA,APIZACO,37,333,10,380,1898
TLAXCALA,APIZACO,72,719,8,799,0
TLAXCALA,APIZACO,24,305,2,331,1525
TLAXCALA,APIZACO,22,292,5,319,1525
TLAXCALA,APIZACO,32,260,8,300,1525
TLAXCALA,APIZACO,37,289,3,329,1525
TLAXCALA,APIZACO,25,251,5,281,1472
TLAXCALA,APIZACO,15,267,3,285,1471
TLAXCALA,APIZACO,20,303,5,328,1792
TLAXCALA,APIZACO,34,327,4,365,1791
TLAXCALA,APIZACO,33,307,14,354,1762
TLAXCALA,APIZACO,31,347,9,387,1761
TLAXCALA,APIZACO,38,253,5,296,1586
TLAXCALA,APIZACO,26,274,8,308,1585
TLAXCALA,APIZACO,12,177,3,192,1015
TLAXCALA,APIZACO,12,170,5,187,1014
TLAXCALA,APIZACO,14,383,9,406,1972
TLAXCALA,APIZACO,16,398,6,420,1972
TLAXCALA,APIZACO,27,400,4,431,1594
TLAXCALA,APIZACO,20,358,5,383,1593
TLAXCALA,APIZACO,28,339,2,369,1896
TLAXCALA,APIZACO,22,331,4,357,1896
TLAXCALA,APIZACO,11,254,5,270,1407
TLAXCALA,APIZACO,9,282,0,291,1407
TLAXCALA,APIZACO,12,321,2,335,1604
TLAXCALA,APIZACO,15,292,4,311,1603
TLAXCALA,APIZACO,14,302,9,325,1672
TLAXCALA,APIZACO,14,349,8,371,1672
TLAXCALA,APIZACO,11,361,13,385,1671
TLAXCALA,APIZACO,30,458,10,498,1851
TLAXCALA,APIZACO,28,541,11,580,1850
TLAXCALA,APIZACO,39,511,10,560,1921
TLAXCALA,APIZACO,35,554,8,597,1920
TLAXCALA,APIZACO,37,408,21,466,1672
TLAXCALA,APIZACO,26,433,7,466,1671
TLAXCALA,APIZACO,20,360,5,385,1141
TLAXCALA,APIZACO,19,407,22,448,1955
TLAXCALA,APIZACO,20,425,5,450,1955
TLAXCALA,APIZACO,30,365,20,415,1955
TLAXCALA,APIZACO,22,367,11,400,1954
TLAXCALA,APIZACO,37,371,12,420,1954
TLAXCALA,APIZACO,14,403,20,437,1954
TLAXCALA,APIZACO,35,491,8,534,1701
TLAXCALA,APIZACO,41,489,13,543,1701
TLAXCALA,APIZACO,25,425,7,457,1392
TLAXCALA,APIZACO,28,378,10,416,1391
TLAXCALA,APIZACO,29,386,12,427,1391
TLAXCALA,APIZACO,25,393,7,425,1613
TLAXCALA,APIZACO,25,464,8,497,1612
TLAXCALA,APIZACO,40,527,9,576,1603
TLAXCALA,APIZACO,24,328,6,358,1875
TLAXCALA,APIZACO,14,311,2,327,1874
TLAXCALA,APIZACO,26,330,5,361,1611
TLAXCALA,APIZACO,16,323,5,344,1611
TLAXCALA,APIZACO,27,321,10,358,1610
TLAXCALA,APIZACO,17,205,8,230,1442
TLAXCALA,APIZACO,13,232,1,246,1441
TLAXCALA,APIZACO,16,219,13,248,1441
TLAXCALA,APIZACO,27,358,8,393,1932
TLAXCALA,APIZACO,23,306,1,330,1931
TLAXCALA,APIZACO,32,346,8,386,1700
TLAXCALA,APIZACO,19,324,11,354,1700
TLAXCALA,APIZACO,16,287,4,307,1475
TLAXCALA,APIZACO,29,277,7,313,1474
TLAXCALA,APIZACO,24,377,9,410,1827
TLAXCALA,APIZACO,22,398,6,426,1827
TLAXCALA,APIZACO,33,248,6,287,1560
TLAXCALA,APIZACO,20,240,10,270,1560
TLAXCALA,APIZACO,16,242,4,262,1559
TLAXCALA,APIZACO,27,359,9,395,1970
TLAXCALA,APIZACO,24,327,6,357,1885
TLAXCALA,APIZACO,18,300,5,323,1884
TLAXCALA,APIZACO,22,302,6,330,1884
TLAXCALA,APIZACO,12,183,5,200,1002
TLAXCALA,APIZACO,45,345,14,404,1911
TLAXCALA,APIZACO,28,364,5,397,1911
TLAXCALA,APIZACO,32,298,3,333,1912
TLAXCALA,APIZACO,13,262,6,281,1911
TLAXCALA,APIZACO,22,370,6,398,1884
TLAXCALA,APIZACO,28,279,7,314,1884
TLAXCALA,APIZACO,24,332,8,364,1782
TLAXCALA,APIZACO,34,380,12,426,1782
TLAXCALA,APIZACO,24,364,14,402,1781
TLAXCALA,APIZACO,21,335,4,360,1881
TLAXCALA,APIZACO,36,333,8,377,1881
TLAXCALA,APIZACO,16,181,9,206,1045
TLAXCALA,APIZACO,12,228,7,247,1045
TLAXCALA,APIZACO,8,200,3,211,1296
TLAXCALA,APIZACO,11,206,6,223,1295
TLAXCALA,APIZACO,11,240,5,256,1534
TLAXCALA,APIZACO,8,237,9,254,1534
TLAXCALA,APIZACO,15,366,9,390,1923
TLAXCALA,APIZACO,9,373,8,390,1922
TLAXCALA,APIZACO,30,577,16,623,1787
TLAXCALA,APIZACO,19,520,10,549,1786
TLAXCALA,APIZACO,15,216,2,233,1283
TLAXCALA,APIZACO,12,183,1,196,1283
TLAXCALA,APIZACO,21,274,6,301,1162
TLAXCALA,APIZACO,28,257,3,288,1161
TLAXCALA,APIZACO,25,313,5,343,1081
TLAXCALA,APIZACO,31,348,5,384,1081
TLAXCALA,APIZACO,33,250,6,289,1014
TLAXCALA,APIZACO,28,269,4,301,1013
TLAXCALA,APIZACO,18,286,4,308,1146
TLAXCALA,APIZACO,24,237,5,266,1145
TLAXCALA,APIZACO,19,391,5,415,1364
TLAXCALA,APIZACO,18,387,7,412,1364
TLAXCALA,APIZACO,24,378,16,418,1655
TLAXCALA,APIZACO,17,403,8,428,1654
TLAXCALA,APIZACO,17,532,8,557,1863
TLAXCALA,APIZACO,25,538,10,573,1862
TLAXCALA,APIZACO,22,385,5,412,1917
TLAXCALA,APIZACO,32,449,7,488,1917
TLAXCALA,APIZACO,10,250,2,262,1376
TLAXCALA,APIZACO,11,263,3,277,1376
TLAXCALA,APIZACO,23,298,2,323,1574
TLAXCALA,APIZACO,21,360,3,384,1574
TLAXCALA,APIZACO,15,335,0,350,1574
TLAXCALA,APIZACO,20,310,1,331,1611
TLAXCALA,APIZACO,27,372,4,403,1611
TLAXCALA,APIZACO,16,364,12,392,1843
TLAXCALA,APIZACO,13,255,3,271,1396
TLAXCALA,APIZACO,12,281,3,296,1395
TLAXCALA,APIZACO,21,261,1,283,1207
TLAXCALA,APIZACO,26,243,7,276,1206
TLAXCALA,APIZACO,24,305,4,333,1944
TLAXCALA,APIZACO,15,278,3,296,1944
TLAXCALA,APIZACO,16,218,3,237,1825
TLAXCALA,APIZACO,26,222,7,255,1824
TLAXCALA,APIZACO,14,277,9,300,1856
TLAXCALA,APIZACO,23,287,7,317,1855
TLAXCALA,APIZACO,13,209,1,223,1588
TLAXCALA,APIZACO,19,221,1,241,1588
TLAXCALA,APIZACO,21,230,2,253,1587
TLAXCALA,APIZACO,14,333,9,356,1949
TLAXCALA,APIZACO,12,293,2,307,1948
TLAXCALA,APIZACO,20,445,6,471,1951
TLAXCALA,APIZACO,31,401,5,437,1950
TLAXCALA,APIZACO,12,355,6,373,1435
TLAXCALA,APIZACO,14,341,8,363,1434
TLAXCALA,APIZACO,13,369,5,387,1434
TLAXCALA,APIZACO,35,419,9,463,1978
TLAXCALA,APIZACO,28,486,10,524,1977
TLAXCALA,APIZACO,15,443,19,477,1753
TLAXCALA,APIZACO,30,492,9,531,1843
TLAXCALA,APIZACO,46,513,14,573,1962
TLAXCALA,APIZACO,23,467,7,497,1961
TLAXCALA,APIZACO,18,262,6,286,1858
TLAXCALA,APIZACO,21,241,9,271,1857
TLAXCALA,APIZACO,36,330,7,373,1378
TLAXCALA,APIZACO,27,332,11,370,1377
TLAXCALA,APIZACO,33,371,15,419,1500
TLAXCALA,APIZACO,26,386,7,419,1500
TLAXCALA,APIZACO,27,349,14,390,1499
TLAXCALA,APIZACO,40,424,10,474,1738
TLAXCALA,APIZACO,44,443,9,496,1738
TLAXCALA,APIZACO,44,544,17,605,1737
TLAXCALA,APIZACO,11,272,6,289,1579
TLAXCALA,APIZACO,9,279,3,291,1579
TLAXCALA,APIZACO,7,294,5,306,1579
TLAXCALA,APIZACO,13,287,7,307,1179
TLAXCALA,APIZACO,7,278,4,289,1179
TLAXCALA,APIZACO,17,330,1,348,1069
TLAXCALA,APIZACO,14,334,6,354,1068
TLAXCALA,APIZACO,23,441,7,471,1731
TLAXCALA,APIZACO,14,520,7,541,1730
TLAXCALA,APIZACO,10,364,5,379,1405
TLAXCALA,APIZACO,12,388,5,405,1405
TLAXCALA,APIZACO,24,344,8,376,1294
TLAXCALA,APIZACO,14,296,8,318,1294
TLAXCALA,APIZACO,11,278,4,293,1098
TLAXCALA,APIZACO,10,308,2,320,1098
TLAXCALA,APIZACO,28,570,10,608,1819
TLAXCALA,APIZACO,30,462,15,507,1819
TLAXCALA,APIZACO,28,493,12,533,1835
TLAXCALA,APIZACO,24,515,13,552,1835
TLAXCALA,APIZACO,19,193,6,218,1108
TLAXCALA,APIZACO,20,220,3,243,1107
TLAXCALA,APIZACO,49,449,12,510,1964
TLAXCALA,APIZACO,53,503,12,568,1963
TLAXCALA,APIZACO,23,396,12,431,1970
TLAXCALA,APIZACO,16,331,6,353,1969
TLAXCALA,TLAXCALA DE XICOHTENCATL,39,406,11,456,1717
TLAXCALA,TLAXCALA DE XICOHTENCATL,28,444,9,481,1716
TLAXCALA,TLAXCALA DE XICOHTENCATL,38,379,5,422,1710
TLAXCALA,TLAXCALA DE XICOHTENCATL,53,423,9,485,1709
TLAXCALA,TLAXCALA DE XICOHTENCATL,28,418,2,448,1765
TLAXCALA,TLAXCALA DE XICOHTENCATL,39,410,3,452,1765
TLAXCALA,TLAXCALA DE XICOHTENCATL,34,450,6,490,1764
TLAXCALA,TLAXCALA DE XICOHTENCATL,27,399,8,434,1406
TLAXCALA,TLAXCALA DE XICOHTENCATL,37,375,9,421,1405
TLAXCALA,TLAXCALA DE XICOHTENCATL,25,459,5,489,2012
TLAXCALA,TLAXCALA DE XICOHTENCATL,17,476,5,498,2012
TLAXCALA,TLAXCALA DE XICOHTENCATL,32,466,9,507,2012
TLAXCALA,TLAXCALA DE XICOHTENCATL,14,452,14,480,1828
TLAXCALA,TLAXCALA DE XICOHTENCATL,28,421,6,455,1828
TLAXCALA,TLAXCALA DE XICOHTENCATL,33,467,9,509,1827
TLAXCALA,TLAXCALA DE XICOHTENCATL,28,400,7,435,1411
TLAXCALA,TLAXCALA DE XICOHTENCATL,45,389,7,441,1411
TLAXCALA,TLAXCALA DE XICOHTENCATL,22,369,8,399,1410
TLAXCALA,TLAXCALA DE XICOHTENCATL,26,341,17,384,1417
TLAXCALA,TLAXCALA DE XICOHTENCATL,33,337,5,375,1416
TLAXCALA,TLAXCALA DE XICOHTENCATL,12,359,10,381,1178
TLAXCALA,TLAXCALA DE XICOHTENCATL,25,367,8,400,1177
TLAXCALA,TLAXCALA DE XICOHTENCATL,33,352,6,391,1599
TLAXCALA,TLAXCALA DE XICOHTENCATL,25,402,2,429,1599
TLAXCALA,TLAXCALA DE XICOHTENCATL,13,310,5,328,1709
TLAXCALA,TLAXCALA DE XICOHTENCATL,24,342,5,371,1709
TLAXCALA,TLAXCALA DE XICOHTENCATL,24,369,24,417,1709
TLAXCALA,TLAXCALA DE XICOHTENCATL,29,359,14,402,1709
TLAXCALA,TLAXCALA DE XICOHTENCATL,26,406,1,433,1530
TLAXCALA,TLAXCALA DE XICOHTENCATL,39,384,13,436,1529
TLAXCALA,TLAXCALA DE XICOHTENCATL,24,349,5,378,1580
TLAXCALA,TLAXCALA DE XICOHTENCATL,42,375,3,420,1580
TLAXCALA,TLAXCALA DE XICOHTENCATL,24,319,4,347,1579
TLAXCALA,TLAXCALA DE XICOHTENCATL,6,473,9,488,1805
TLAXCALA,TLAXCALA DE XICOHTENCATL,28,422,7,457,1805
TLAXCALA,TLAXCALA DE XICOHTENCATL,31,362,3,396,1563
TLAXCALA,TLAXCALA DE XICOHTENCATL,17,356,3,376,1562
TLAXCALA,TLAXCALA DE XICOHTENCATL,13,364,1,378,1447
TLAXCALA,TLAXCALA DE XICOHTENCATL,19,341,5,365,1446
TLAXCALA,TLAXCALA DE XICOHTENCATL,19,391,4,414,1691
TLAXCALA,TLAXCALA DE XICOHTENCATL,22,402,3,427,1690
TLAXCALA,TLAXCALA DE XICOHTENCATL,26,454,9,489,1690
TLAXCALA,TLAXCALA DE XICOHTENCATL,18,334,5,357,1566
TLAXCALA,TLAXCALA DE XICOHTENCATL,16,403,5,424,1566
TLAXCALA,TLAXCALA DE XICOHTENCATL,28,444,10,482,1791
TLAXCALA,TLAXCALA DE XICOHTENCATL,24,425,7,456,1791
TLAXCALA,TLAXCALA DE XICOHTENCATL,34,492,11,537,1791
TLAXCALA,TLAXCALA DE XICOHTENCATL,10,358,1,369,1389
TLAXCALA,TLAXCALA DE XICOHTENCATL,15,337,8,360,1389
TLAXCALA,TLAXCALA DE XICOHTENCATL,20,389,10,419,1599
TLAXCALA,TLAXCALA DE XICOHTENCATL,14,339,4,357,1599
TLAXCALA,TLAXCALA DE XICOHTENCATL,20,277,5,302,1456
TLAXCALA,TLAXCALA DE XICOHTENCATL,11,274,6,291,1456
TLAXCALA,TLAXCALA DE XICOHTENCATL,10,313,11,334,1456
TLAXCALA,TLAXCALA DE XICOHTENCATL,23,392,11,426,1399
TLAXCALA,TLAXCALA DE XICOHTENCATL,28,356,9,393,1399
TLAXCALA,TLAXCALA DE XICOHTENCATL,15,323,2,340,1439
TLAXCALA,TLAXCALA DE XICOHTENCATL,8,373,4,385,1438
TLAXCALA,TLAXCALA DE XICOHTENCATL,7,325,7,339,1438
TLAXCALA,TLAXCALA DE XICOHTENCATL,5,453,3,461,1843
TLAXCALA,TLAXCALA DE XICOHTENCATL,6,490,3,499,1843
TLAXCALA,TLAXCALA DE XICOHTENCATL,14,359,4,377,1464
TLAXCALA,TLAXCALA DE XICOHTENCATL,16,410,4,430,1463
TLAXCALA,TLAXCALA DE XICOHTENCATL,13,404,5,422,1463
TLAXCALA,TLAXCALA DE XICOHTENCATL,18,493,10,521,1917
TLAXCALA,TLAXCALA DE XICOHTENCATL,27,479,5,511,1917
TLAXCALA,TLAXCALA DE XICOHTENCATL,22,443,8,473,1626
TLAXCALA,TLAXCALA DE XICOHTENCATL,33,468,4,505,1625
TLAXCALA,TLAXCALA DE XICOHTENCATL,25,426,6,457,1348
TLAXCALA,TLAXCALA DE XICOHTENCATL,14,468,1,483,1347
TLAXCALA,TLAXCALA DE XICOHTENCATL,28,376,7,411,1347
TLAXCALA,TLAXCALA DE XICOHTENCATL,21,476,8,505,1903
TLAXCALA,TLAXCALA DE XICOHTENCATL,14,494,3,511,1903
TLAXCALA,TLAXCALA DE XICOHTENCATL,15,532,10,557,1431
TLAXCALA,TLAXCALA DE XICOHTENCATL,8,449,6,463,1431
TLAXCALA,TLAXCALA DE XICOHTENCATL,12,399,7,418,1290
TLAXCALA,TLAXCALA DE XICOHTENCATL,5,388,2,395,1290
TLAXCALA,TLAXCALA DE XICOHTENCATL,43,401,1,445,1437
TLAXCALA,TLAXCALA DE XICOHTENCATL,19,405,2,426,1436
TLAXCALA,TLAXCALA DE XICOHTENCATL,14,591,0,605,1617
TLAXCALA,TLAXCALA DE XICOHTENCATL,19,456,1,476,1617
TLAXCALA,TLAXCALA DE XICOHTENCATL,20,445,4,469,1617
TLAXCALA,TLAXCALA DE XICOHTENCATL,17,351,3,371,1790
TLAXCALA,TLAXCALA DE XICOHTENCATL,32,347,8,387,1790
TLAXCALA,TLAXCALA DE XICOHTENCATL,15,352,6,373,1829
TLAXCALA,TLAXCALA DE XICOHTENCATL,14,347,2,363,1828
TLAXCALA,TLAXCALA DE XICOHTENCATL,14,306,4,324,1578
TLAXCALA,TLAXCALA DE XICOHTENCATL,11,275,5,291,1578
TLAXCALA,TLAXCALA DE XICOHTENCATL,11,287,3,301,1577
TLAXCALA,TLAXCALA DE XICOHTENCATL,12,304,5,321,1673
TLAXCALA,TLAXCALA DE XICOHTENCATL,8,291,1,300,1673
TLAXCALA,TLAXCALA DE XICOHTENCATL,10,274,6,290,1672
TLAXCALA,TLAXCALA DE XICOHTENCATL,6,307,4,317,1672
TLAXCALA,TLAXCALA DE XICOHTENCATL,41,332,0,373,1714
TLAXCALA,TLAXCALA DE XICOHTENCATL,12,360,3,375,1713
TLAXCALA,TLAXCALA DE XICOHTENCATL,10,287,3,300,1657
TLAXCALA,TLAXCALA DE XICOHTENCATL,13,336,0,349,1657
TLAXCALA,TLAXCALA DE XICOHTENCATL,16,280,4,300,1348
TLAXCALA,TLAXCALA DE XICOHTENCATL,22,282,12,316,1347
TLAXCALA,TLAXCALA DE XICOHTENCATL,21,408,8,437,1908
TLAXCALA,TLAXCALA DE XICOHTENCATL,27,420,1,448,1908
TLAXCALA,TLAXCALA DE XICOHTENCATL,11,344,2,357,1406
TLAXCALA,TLAXCALA DE XICOHTENCATL,14,302,1,317,1406
TLAXCALA,TLAXCALA DE XICOHTENCATL,13,312,4,329,1724
TLAXCALA,TLAXCALA DE XICOHTENCATL,7,360,1,368,1723
TLAXCALA,TLAXCALA DE XICOHTENCATL,9,234,3,246,1247
TLAXCALA,TLAXCALA DE XICOHTENCATL,8,185,4,197,1246
TLAXCALA,TLAXCALA DE XICOHTENCATL,11,192,1,204,1167
TLAXCALA,TLAXCALA DE XICOHTENCATL,5,184,0,189,1166
TLAXCALA,TLAXCALA DE XICOHTENCATL,24,276,1,301,1850
TLAXCALA,TLAXCALA DE XICOHTENCATL,11,238,4,253,1850
TLAXCALA,TLAXCALA DE XICOHTENCATL,13,277,1,291,1849
TLAXCALA,TLAXCALA DE XICOHTENCATL,14,240,2,256,1849
TLAXCALA,TLAXCALA DE XICOHTENCATL,16,255,11,282,1817
TLAXCALA,TLAXCALA DE XICOHTENCATL,15,245,5,265,1817
TLAXCALA,TLAXCALA DE XICOHTENCATL,17,264,8,289,1816
TLAXCALA,TLAXCALA DE XICOHTENCATL,15,253,6,274,1816
TLAXCALA,TLAXCALA DE XICOHTENCATL,12,368,5,385,1551
TLAXCALA,TLAXCALA DE XICOHTENCATL,11,400,7,418,1551
TLAXCALA,TLAXCALA DE XICOHTENCATL,9,387,5,401,1551
TLAXCALA,TLAXCALA DE XICOHTENCATL,10,324,2,336,1469
TLAXCALA,TLAXCALA DE XICOHTENCATL,11,313,0,324,1469
TLAXCALA,TLAXCALA DE XICOHTENCATL,8,347,7,362,1469
TLAXCALA,TLAXCALA DE XICOHTENCATL,22,293,6,321,1214
TLAXCALA,TLAXCALA DE XICOHTENCATL,20,304,7,331,1213
TLAXCALA,TLAXCALA DE XICOHTENCATL,34,306,8,348,1375
TLAXCALA,TLAXCALA DE XICOHTENCATL,23,352,2,377,1375
TLAXCALA,TLAXCALA DE XICOHTENCATL,31,301,8,340,1374
TLAXCALA,TLAXCALA DE XICOHTENCATL,31,576,7,614,1786
TLAXCALA,TLAXCALA DE XICOHTENCATL,27,518,6,551,1785
TLAXCALA,TLAXCALA DE XICOHTENCATL,31,520,10,561,1788
TLAXCALA,TLAXCALA DE XICOHTENCATL,22,453,2,477,1788
TLAXCALA,TLAXCALA DE XICOHTENCATL,14,313,4,331,1061
TLAXCALA,TLAXCALA DE XICOHTENCATL,12,343,2,357,1060
TLAXCALA,TLAXCALA DE XICOHTENCATL,29,444,10,483,1819
TLAXCALA,TLAXCALA DE XICOHTENCATL,25,544,5,574,1819
TLAXCALA,TLAXCALA DE XICOHTENCATL,43,496,6,545,1819
TLAXCALA,TLAXCALA DE XICOHTENCATL,15,354,3,372,1692
TLAXCALA,TLAXCALA DE XICOHTENCATL,18,330,7,355,1691
TLAXCALA,TLAXCALA DE XICOHTENCATL,24,504,7,535,1921
TLAXCALA,TLAXCALA DE XICOHTENCATL,47,530,5,582,1920
TLAXCALA,TLAXCALA DE XICOHTENCATL,37,452,18,507,1926
TLAXCALA,TLAXCALA DE XICOHTENCATL,23,506,8,537,1925
TLAXCALA,TLAXCALA DE XICOHTENCATL,21,321,4,346,1346
TLAXCALA,TLAXCALA DE XICOHTENCATL,27,300,4,331,1346
TLAXCALA,TLAXCALA DE XICOHTENCATL,24,322,4,350,1345
TLAXCALA,TLAXCALA DE XICOHTENCATL,61,355,16,432,1855
TLAXCALA,TLAXCALA DE XICOHTENCATL,52,395,7,454,1855
TLAXCALA,TLAXCALA DE XICOHTENCATL,27,304,9,340,1357
TLAXCALA,TLAXCALA DE XICOHTENCATL,25,286,13,324,1357
TLAXCALA,TLAXCALA DE XICOHTENCATL,41,292,7,340,1357
TLAXCALA,TLAXCALA DE XICOHTENCATL,21,340,2,363,1510
TLAXCALA,TLAXCALA DE XICOHTENCATL,24,332,5,361,1509
TLAXCALA,TLAXCALA DE XICOHTENCATL,26,383,8,417,1657
TLAXCALA,TLAXCALA DE XICOHTENCATL,39,372,7,418,1657
TLAXCALA,TLAXCALA DE XICOHTENCATL,36,390,8,434,1657
TLAXCALA,TLAXCALA DE XICOHTENCATL,49,358,5,412,1829
TLAXCALA,TLAXCALA DE XICOHTENCATL,50,427,14,491,1829
TLAXCALA,TLAXCALA DE XICOHTENCATL,113,961,16,1090,0
TLAXCALA,TLAXCALA DE XICOHTENCATL,32,406,10,448,1718
TLAXCALA,TLAXCALA DE XICOHTENCATL,53,464,8,525,1717
TLAXCALA,TLAXCALA DE XICOHTENCATL,41,387,7,435,1821
TLAXCALA,TLAXCALA DE XICOHTENCATL,39,415,9,463,1820
TLAXCALA,TLAXCALA DE XICOHTENCATL,38,378,17,433,1820
TLAXCALA,TLAXCALA DE XICOHTENCATL,35,400,6,441,1820
TLAXCALA,TLAXCALA DE XICOHTENCATL,53,397,10,460,1812
TLAXCALA,TLAXCALA DE XICOHTENCATL,50,449,12,511,1812
TLAXCALA,TLAXCALA DE XICOHTENCATL,35,429,7,471,1923
TLAXCALA,TLAXCALA DE XICOHTENCATL,32,446,6,484,1923
TLAXCALA,TLAXCALA DE XICOHTENCATL,20,429,6,455,1923
TLAXCALA,TLAXCALA DE XICOHTENCATL,31,354,3,388,1698
TLAXCALA,TLAXCALA DE XICOHTENCATL,24,404,7,435,1697
TLAXCALA,TLAXCALA DE XICOHTENCATL,47,488,11,546,1972
TLAXCALA,TLAXCALA DE XICOHTENCATL,42,495,9,546,1971
TLAXCALA,TLAXCALA DE XICOHTENCATL,23,404,9,436,1798
TLAXCALA,TLAXCALA DE XICOHTENCATL,24,415,1,440,1798
TLAXCALA,TLAXCALA DE XICOHTENCATL,31,341,4,376,1580
TLAXCALA,TLAXCALA DE XICOHTENCATL,32,313,9,354,1580
TLAXCALA,TLAXCALA DE XICOHTENCATL,23,322,8,353,1579
TLAXCALA,TLAXCALA DE XICOHTENCATL,36,429,7,472,1640
TLAXCALA,TLAXCALA DE XICOHTENCATL,39,364,5,408,1639
TLAXCALA,TLAXCALA DE XICOHTENCATL,30,382,8,420,1639
TLAXCALA,TLAXCALA DE XICOHTENCATL,11,409,0,420,1505
TLAXCALA,TLAXCALA DE XICOHTENCATL,12,403,5,420,1505
TLAXCALA,TLAXCALA DE XICOHTENCATL,21,431,2,454,1505
TLAXCALA,TLAXCALA DE XICOHTENCATL,12,438,4,454,1420
TLAXCALA,TLAXCALA DE XICOHTENCATL,6,406,3,415,1419
TLAXCALA,TLAXCALA DE XICOHTENCATL,15,407,8,430,1419
TLAXCALA,TLAXCALA DE XICOHTENCATL,15,332,3,350,1212
TLAXCALA,TLAXCALA DE XICOHTENCATL,18,371,4,393,1212
TLAXCALA,TLAXCALA DE XICOHTENCATL,15,332,5,352,1497
TLAXCALA,TLAXCALA DE XICOHTENCATL,10,344,1,355,1496
TLAXCALA,TLAXCALA DE XICOHTENCATL,15,320,7,342,1496
TLAXCALA,TLAXCALA DE XICOHTENCATL,25,388,3,416,1779
TLAXCALA,TLAXCALA DE XICOHTENCATL,13,415,5,433,1779
TLAXCALA,TLAXCALA DE XICOHTENCATL,16,411,2,429,1865
TLAXCALA,TLAXCALA DE XICOHTENCATL,17,473,4,494,1865
TLAXCALA,TLAXCALA DE XICOHTENCATL,11,274,3,288,1042
TLAXCALA,TLAXCALA DE XICOHTENCATL,15,273,3,291,1042
TLAXCALA,TLAXCALA DE XICOHTENCATL,12,378,1,391,1756
TLAXCALA,TLAXCALA DE XICOHTENCATL,22,370,9,401,1755
TLAXCALA,TLAXCALA DE XICOHTENCATL,14,381,1,396,1443
TLAXCALA,TLAXCALA DE XICOHTENCATL,11,389,1,401,1443
TLAXCALA,TLAXCALA DE XICOHTENCATL,14,399,1,414,1443
TLAXCALA,ZACATELCO,38,524,9,571,1790
TLAXCALA,ZACATELCO,36,500,3,539,1789
TLAXCALA,ZACATELCO,24,499,6,529,1881
TLAXCALA,ZACATELCO,39,413,10,462,1880
TLAXCALA,ZACATELCO,10,213,5,228,1502
TLAXCALA,ZACATELCO,10,245,3,258,1502
TLAXCALA,ZACATELCO,15,238,4,257,1502
TLAXCALA,ZACATELCO,27,289,13,329,1812
TLAXCALA,ZACATELCO,22,315,5,342,1811
TLAXCALA,ZACATELCO,14,195,7,216,1373
TLAXCALA,ZACATELCO,13,219,2,234,1373
TLAXCALA,ZACATELCO,18,292,2,312,1426
TLAXCALA,ZACATELCO,20,244,12,276,1426
TLAXCALA,ZACATELCO,16,299,3,318,1425
TLAXCALA,ZACATELCO,21,307,2,330,1820
TLAXCALA,ZACATELCO,28,342,2,372,1820
TLAXCALA,ZACATELCO,21,365,2,388,1916
TLAXCALA,ZACATELCO,15,322,5,342,1915
TLAXCALA,ZACATELCO,25,393,4,422,1783
TLAXCALA,ZACATELCO,31,383,4,418,1783
TLAXCALA,ZACATELCO,17,243,1,261,1541
TLAXCALA,ZACATELCO,12,243,8,263,1540
TLAXCALA,ZACATELCO,13,276,1,290,1683
TLAXCALA,ZACATELCO,21,258,5,284,1682
TLAXCALA,ZACATELCO,25,177,6,208,1653
TLAXCALA,ZACATELCO,25,175,4,204,1653
TLAXCALA,ZACATELCO,27,534,9,570,1874
TLAXCALA,ZACATELCO,24,624,11,659,1873
TLAXCALA,ZACATELCO,17,316,9,342,1754
TLAXCALA,ZACATELCO,18,376,8,402,1754
TLAXCALA,ZACATELCO,18,339,9,366,1557
TLAXCALA,ZACATELCO,22,357,4,383,1557
TLAXCALA,ZACATELCO,14,274,1,289,1214
TLAXCALA,ZACATELCO,16,308,4,328,1213
TLAXCALA,ZACATELCO,30,432,11,473,1873
TLAXCALA,ZACATELCO,24,478,11,513,1872
TLAXCALA,ZACATELCO,24,473,4,501,1917
TLAXCALA,ZACATELCO,20,500,8,528,1916
TLAXCALA,ZACATELCO,32,448,6,486,1629
TLAXCALA,ZACATELCO,25,437,7,469,1629
TLAXCALA,ZACATELCO,14,398,10,422,1858
TLAXCALA,ZACATELCO,9,356,4,369,1858
TLAXCALA,ZACATELCO,10,295,7,312,1552
TLAXCALA,ZACATELCO,10,264,3,277,1552
TLAXCALA,ZACATELCO,6,297,7,310,1551
TLAXCALA,ZACATELCO,30,582,8,620,1955
TLAXCALA,ZACATELCO,31,501,3,535,1954
TLAXCALA,ZACATELCO,24,550,11,585,1973
TLAXCALA,ZACATELCO,39,500,8,547,1973
TLAXCALA,ZACATELCO,18,589,2,609,1891
TLAXCALA,ZACATELCO,32,495,5,532,1891
TLAXCALA,ZACATELCO,24,475,2,501,1846
TLAXCALA,ZACATELCO,27,451,4,482,1846
TLAXCALA,ZACATELCO,18,501,9,528,1478
TLAXCALA,ZACATELCO,16,510,1,527,1478
TLAXCALA,ZACATELCO,21,470,7,498,1463
TLAXCALA,ZACATELCO,20,495,14,529,1462
TLAXCALA,ZACATELCO,14,368,8,390,1506
TLAXCALA,ZACATELCO,18,425,11,454,1506
TLAXCALA,ZACATELCO,15,451,9,475,1506
TLAXCALA,ZACATELCO,22,445,5,472,1831
TLAXCALA,ZACATELCO,24,430,5,459,1830
TLAXCALA,ZACATELCO,16,338,1,355,1668
TLAXCALA,ZACATELCO,18,356,7,381,1667
TLAXCALA,ZACATELCO,14,319,2,335,1528
TLAXCALA,ZACATELCO,16,353,0,369,1528
TLAXCALA,ZACATELCO,9,329,3,341,1528
TLAXCALA,ZACATELCO,38,330,10,378,1442
TLAXCALA,ZACATELCO,38,282,12,332,1442
TLAXCALA,ZACATELCO,36,352,6,394,1412
TLAXCALA,ZACATELCO,24,401,4,429,1412
TLAXCALA,ZACATELCO,15,281,7,303,1539
TLAXCALA,ZACATELCO,11,236,9,256,1538
TLAXCALA,ZACATELCO,15,262,3,280,1538
TLAXCALA,ZACATELCO,31,331,7,369,1649
TLAXCALA,ZACATELCO,30,339,8,377,1649
TLAXCALA,ZACATELCO,30,331,7,368,1649
TLAXCALA,ZACATELCO,26,320,14,360,1425
TLAXCALA,ZACATELCO,31,377,6,414,1425
TLAXCALA,ZACATELCO,30,351,4,385,1637
TLAXCALA,ZACATELCO,24,303,5,332,1637
TLAXCALA,ZACATELCO,26,319,3,348,1319
TLAXCALA,ZACATELCO,15,308,3,326,1318
TLAXCALA,ZACATELCO,28,321,6,355,1318
TLAXCALA,ZACATELCO,15,272,4,291,1056
TLAXCALA,ZACATELCO,14,260,5,279,1056
TLAXCALA,ZACATELCO,6,642,16,664,1857
TLAXCALA,ZACATELCO,16,621,10,647,1856
TLAXCALA,ZACATELCO,16,684,5,705,1858
TLAXCALA,ZACATELCO,12,833,7,852,1858
TLAXCALA,ZACATELCO,16,463,2,481,1895
TLAXCALA,ZACATELCO,18,442,5,465,1894
TLAXCALA,ZACATELCO,20,478,3,501,1989
TLAXCALA,ZACATELCO,13,441,6,460,1988
TLAXCALA,ZACATELCO,22,462,9,493,1862
TLAXCALA,ZACATELCO,27,531,6,564,1862
TLAXCALA,ZACATELCO,18,421,9,448,1560
TLAXCALA,ZACATELCO,17,384,4,405,1560
TLAXCALA,ZACATELCO,9,269,5,283,1494
TLAXCALA,ZACATELCO,21,274,5,300,1493
TLAXCALA,ZACATELCO,23,429,3,455,1449
TLAXCALA,ZACATELCO,16,477,7,500,1448
TLAXCALA,ZACATELCO,42,568,14,624,1797
TLAXCALA,ZACATELCO,42,563,8,613,1796
TLAXCALA,ZACATELCO,24,473,6,503,1972
TLAXCALA,ZACATELCO,21,459,11,491,1971
TLAXCALA,ZACATELCO,20,305,10,335,1284
TLAXCALA,ZACATELCO,16,270,8,294,1284
TLAXCALA,ZACATELCO,22,310,8,340,1719
TLAXCALA,ZACATELCO,20,426,1,447,1719
TLAXCALA,ZACATELCO,21,409,4,434,1457
TLAXCALA,ZACATELCO,29,449,8,486,1457
TLAXCALA,ZACATELCO,20,416,5,441,1457
TLAXCALA,ZACATELCO,13,331,6,350,1509
TLAXCALA,ZACATELCO,16,292,2,310,1508
TLAXCALA,ZACATELCO,30,452,1,483,1945
TLAXCALA,ZACATELCO,19,544,11,574,1945
TLAXCALA,ZACATELCO,23,507,3,533,1557
TLAXCALA,ZACATELCO,18,435,4,457,1557
TLAXCALA,ZACATELCO,18,435,8,461,1556
TLAXCALA,ZACATELCO,11,552,2,565,1852
TLAXCALA,ZACATELCO,9,530,5,544,1851
TLAXCALA,ZACATELCO,14,410,3,427,1511
TLAXCALA,ZACATELCO,15,453,4,472,1510
TLAXCALA,ZACATELCO,39,436,5,480,1965
TLAXCALA,ZACATELCO,29,452,12,493,1964
TLAXCALA,ZACATELCO,25,451,4,480,1794
TLAXCALA,ZACATELCO,22,474,2,498,1793
TLAXCALA,ZACATELCO,17,446,12,475,1977
TLAXCALA,ZACATELCO,29,409,12,450,1976
TLAXCALA,ZACATELCO,27,463,12,502,1785
TLAXCALA,ZACATELCO,20,508,3,531,1785
TLAXCALA,ZACATELCO,18,415,2,435,1633
TLAXCALA,ZACATELCO,27,420,5,452,1633
TLAXCALA,ZACATELCO,13,417,3,433,1633
TLAXCALA,ZACATELCO,25,466,3,494,1728
TLAXCALA,ZACATELCO,16,458,1,475,1728
TLAXCALA,ZACATELCO,18,423,6,447,1673
TLAXCALA,ZACATELCO,18,393,4,415,1672
TLAXCALA,ZACATELCO,37,421,12,470,1935
TLAXCALA,ZACATELCO,38,428,8,474,1934
TLAXCALA,ZACATELCO,36,328,8,372,1202
TLAXCALA,ZACATELCO,17,311,3,331,1201
TLAXCALA,ZACATELCO,33,454,10,497,1427
TLAXCALA,ZACATELCO,42,442,15,499,1427
TLAXCALA,ZACATELCO,23,474,5,502,1807
TLAXCALA,ZACATELCO,22,464,4,490,1807
TLAXCALA,ZACATELCO,21,529,9,559,1807
TLAXCALA,ZACATELCO,14,459,0,473,1934
TLAXCALA,ZACATELCO,32,436,3,471,1934
TLAXCALA,ZACATELCO,24,439,6,469,1933
TLAXCALA,ZACATELCO,13,350,7,370,1798
TLAXCALA,ZACATELCO,22,386,3,411,1798
TLAXCALA,ZACATELCO,15,246,3,264,1244
TLAXCALA,ZACATELCO,22,244,6,272,1244
TLAXCALA,ZACATELCO,22,216,3,241,1472
TLAXCALA,ZACATELCO,10,205,4,219,1472
TLAXCALA,ZACATELCO,22,210,4,236,1471
TLAXCALA,ZACATELCO,30,321,4,355,1903
TLAXCALA,ZACATELCO,28,274,3,305,1903
TLAXCALA,ZACATELCO,20,310,6,336,1653
TLAXCALA,ZACATELCO,16,311,4,331,1652
TLAXCALA,ZACATELCO,22,306,2,330,1652
TLAXCALA,ZACATELCO,21,278,6,305,1584
TLAXCALA,ZACATELCO,19,319,2,340,1583
TLAXCALA,ZACATELCO,9,246,2,257,1322
TLAXCALA,ZACATELCO,8,234,2,244,1321
TLAXCALA,ZACATELCO,22,286,3,311,1375
TLAXCALA,ZACATELCO,22,304,3,329,1375
TLAXCALA,ZACATELCO,9,337,4,350,1375
TLAXCALA,ZACATELCO,24,790,12,826,1970
TLAXCALA,ZACATELCO,35,776,9,820,1969
TLAXCALA,ZACATELCO,25,429,3,457,1753
TLAXCALA,ZACATELCO,20,476,6,502,1753
TLAXCALA,ZACATELCO,27,458,6,491,1780
TLAXCALA,ZACATELCO,27,511,6,544,1780
TLAXCALA,ZACATELCO,16,478,6,500,1660
TLAXCALA,ZACATELCO,16,461,1,478,1660
TLAXCALA,ZACATELCO,22,396,0,418,1659
TLAXCALA,ZACATELCO,39,533,6,578,0
TLAXCALA,ZACATELCO,17,493,4,514,1881
TLAXCALA,ZACATELCO,26,507,5,538,1881
TLAXCALA,ZACATELCO,11,283,1,295,1142
TLAXCALA,ZACATELCO,15,259,5,279,1141
TLAXCALA,ZACATELCO,17,347,0,364,1126
TLAXCALA,ZACATELCO,8,315,30,353,1126
TLAXCALA,ZACATELCO,10,467,11,488,1550
TLAXCALA,ZACATELCO,21,422,2,445,1550
TLAXCALA,ZACATELCO,12,282,4,298,1078
TLAXCALA,ZACATELCO,5,319,3,327,1078
TLAXCALA,ZACATELCO,11,431,3,445,1415
TLAXCALA,ZACATELCO,8,341,1,350,1414
TLAXCALA,ZACATELCO,20,483,3,506,1686
TLAXCALA,ZACATELCO,16,500,7,523,1685
TLAXCALA,ZACATELCO,14,381,3,398,1371
TLAXCALA,ZACATELCO,13,358,5,376,1371
TLAXCALA,ZACATELCO,27,593,11,631,1614
TLAXCALA,ZACATELCO,44,559,13,616,1613
TLAXCALA,ZACATELCO,37,681,9,727,1911
TLAXCALA,ZACATELCO,39,650,19,708,1910
VERACRUZ,PANUCO,30,501,3,534,1630
VERACRUZ,PANUCO,11,536,8,555,1629
VERACRUZ,PANUCO,19,469,11,499,1965
VERACRUZ,PANUCO,17,484,9,510,1964
VERACRUZ,PANUCO,13,565,8,586,1816
VERACRUZ,PANUCO,14,567,14,595,1815
VERACRUZ,PANUCO,38,716,7,761,0
VERACRUZ,PANUCO,19,511,3,533,1671
VERACRUZ,PANUCO,22,551,10,583,1671
VERACRUZ,PANUCO,15,315,6,336,1059
VERACRUZ,PANUCO,21,298,3,322,1058
VERACRUZ,PANUCO,9,363,11,383,1505
VERACRUZ,PANUCO,24,360,15,399,1504
VERACRUZ,PANUCO,22,506,16,544,1977
VERACRUZ,PANUCO,17,287,16,320,1594
VERACRUZ,PANUCO,7,297,17,321,1594
VERACRUZ,PANUCO,30,596,22,648,1970
VERACRUZ,PANUCO,27,620,20,667,1970
VERACRUZ,PANUCO,13,420,15,448,1526
VERACRUZ,PANUCO,15,428,12,455,1526
VERACRUZ,PANUCO,15,428,12,455,1525
VERACRUZ,PANUCO,30,296,10,336,1248
VERACRUZ,PANUCO,39,270,8,317,1248
VERACRUZ,PANUCO,41,430,18,489,1680
VERACRUZ,PANUCO,38,425,21,484,1680
VERACRUZ,PANUCO,33,425,16,474,1680
VERACRUZ,PANUCO,39,527,15,581,1288
VERACRUZ,PANUCO,25,365,15,405,1087
VERACRUZ,PANUCO,11,385,8,404,1086
VERACRUZ,PANUCO,22,417,10,449,1417
VERACRUZ,PANUCO,23,299,11,333,1417
VERACRUZ,PANUCO,16,393,14,423,1417
VERACRUZ,PANUCO,25,606,18,649,1930
VERACRUZ,PANUCO,16,647,5,668,1930
VERACRUZ,PANUCO,18,528,14,560,1714
VERACRUZ,PANUCO,21,516,11,548,1714
VERACRUZ,PANUCO,23,542,10,575,1682
VERACRUZ,PANUCO,20,575,10,605,1682
VERACRUZ,PANUCO,20,540,7,567,1903
VERACRUZ,PANUCO,24,527,13,564,1903
VERACRUZ,PANUCO,28,546,17,591,1771
VERACRUZ,PANUCO,40,582,9,631,1770
VERACRUZ,PANUCO,26,636,11,673,2048
VERACRUZ,PANUCO,29,693,10,732,2048
VERACRUZ,PANUCO,20,444,5,469,1414
VERACRUZ,PANUCO,23,431,5,459,1413
VERACRUZ,PANUCO,17,513,7,537,1413
VERACRUZ,PANUCO,18,373,6,397,1214
VERACRUZ,PANUCO,25,364,10,399,1213
VERACRUZ,PANUCO,15,426,6,447,1187
VERACRUZ,PANUCO,12,397,7,416,1187
VERACRUZ,PANUCO,9,421,5,435,1187
VERACRUZ,PANUCO,19,377,9,405,1187
VERACRUZ,PANUCO,17,501,13,531,1280
VERACRUZ,PANUCO,17,426,15,458,1280
VERACRUZ,PANUCO,13,398,12,423,1237
VERACRUZ,PANUCO,18,409,13,440,1236
VERACRUZ,PANUCO,10,996,6,1012,1605
VERACRUZ,PANUCO,16,1008,12,1036,1604
VERACRUZ,PANUCO,49,984,6,1039,1604
VERACRUZ,PANUCO,15,1346,5,1366,1836
VERACRUZ,PANUCO,13,1580,10,1603,1835
VERACRUZ,PANUCO,17,1497,2,1516,1835
VERACRUZ,PANUCO,28,1329,6,1363,1798
VERACRUZ,PANUCO,15,1306,29,1350,1797
VERACRUZ,PANUCO,21,1364,35,1420,1797
VERACRUZ,PANUCO,13,810,9,832,1571
VERACRUZ,PANUCO,24,450,13,487,1571
VERACRUZ,PANUCO,11,545,0,556,1570
VERACRUZ,PANUCO,48,396,18,462,1234
VERACRUZ,PANUCO,38,528,13,579,1233
VERACRUZ,PANUCO,44,630,39,713,1944
VERACRUZ,PANUCO,21,534,24,579,1640
VERACRUZ,PANUCO,24,513,24,561,1639
VERACRUZ,PANUCO,22,1264,8,1294,1280
VERACRUZ,PANUCO,28,700,8,736,1280
VERACRUZ,PANUCO,14,468,8,490,1733
VERACRUZ,PANUCO,10,512,10,532,1732
VERACRUZ,PANUCO,25,452,9,486,1922
VERACRUZ,PANUCO,23,433,6,462,1921
VERACRUZ,PANUCO,26,506,5,537,2023
VERACRUZ,PANUCO,17,431,9,457,2022
VERACRUZ,PANUCO,22,415,19,456,1828
VERACRUZ,PANUCO,14,362,3,379,1827
VERACRUZ,PANUCO,18,514,4,536,1838
VERACRUZ,PANUCO,16,466,6,488,1838
VERACRUZ,PANUCO,20,477,12,509,1838
VERACRUZ,PANUCO,16,384,9,409,1611
VERACRUZ,PANUCO,14,365,2,381,1611
VERACRUZ,PANUCO,13,308,71,392,1611
VERACRUZ,PANUCO,19,511,12,542,1860
VERACRUZ,PANUCO,23,490,11,524,1860
VERACRUZ,PANUCO,27,560,5,592,1859
VERACRUZ,PANUCO,18,461,11,490,1910
VERACRUZ,PANUCO,20,497,12,529,1909
VERACRUZ,PANUCO,22,467,4,493,1695
VERACRUZ,PANUCO,20,450,5,475,1695
VERACRUZ,PANUCO,10,468,11,489,1694
VERACRUZ,PANUCO,27,519,24,570,1791
VERACRUZ,PANUCO,24,539,27,590,1791
VERACRUZ,PANUCO,14,337,5,356,1061
VERACRUZ,PANUCO,16,335,6,357,1060
VERACRUZ,PANUCO,13,415,13,441,1330
VERACRUZ,PANUCO,23,365,12,400,1330
VERACRUZ,PANUCO,22,379,7,408,1330
VERACRUZ,PANUCO,18,614,7,639,1734
VERACRUZ,PANUCO,7,488,23,518,1644
VERACRUZ,PANUCO,16,470,33,519,1643
VERACRUZ,PANUCO,30,526,32,588,1914
VERACRUZ,PANUCO,23,511,9,543,1914
VERACRUZ,PANUCO,13,419,11,443,1946
VERACRUZ,PANUCO,23,409,4,436,1946
VERACRUZ,PANUCO,16,347,19,382,1511
VERACRUZ,PANUCO,19,385,13,417,1510
VERACRUZ,PANUCO,24,484,11,519,1612
VERACRUZ,PANUCO,18,505,18,541,1611
VERACRUZ,PANUCO,12,666,20,698,1628
VERACRUZ,PANUCO,24,714,28,766,1628
VERACRUZ,PANUCO,27,533,30,590,1865
VERACRUZ,PANUCO,20,570,27,617,1865
VERACRUZ,PANUCO,19,539,16,574,1860
VERACRUZ,PANUCO,29,559,20,608,1859
VERACRUZ,PANUCO,28,463,27,518,1581
VERACRUZ,PANUCO,27,428,19,474,1580
VERACRUZ,PANUCO,26,436,13,475,1580
VERACRUZ,PANUCO,21,688,25,734,1962
VERACRUZ,PANUCO,26,630,22,678,1961
VERACRUZ,PANUCO,18,345,21,384,1755
VERACRUZ,PANUCO,15,417,30,462,1754
VERACRUZ,PANUCO,23,380,20,423,1754
VERACRUZ,PANUCO,12,343,12,367,1359
VERACRUZ,PANUCO,13,354,9,376,1358
VERACRUZ,PANUCO,16,312,8,336,1545
VERACRUZ,PANUCO,21,370,10,401,1544
VERACRUZ,PANUCO,13,329,9,351,1409
VERACRUZ,PANUCO,7,272,9,288,1409
VERACRUZ,PANUCO,12,297,12,321,1408
VERACRUZ,PANUCO,17,415,22,454,1581
VERACRUZ,PANUCO,28,434,22,484,1580
VERACRUZ,PANUCO,13,251,19,283,1449
VERACRUZ,PANUCO,23,246,30,299,1448
VERACRUZ,PANUCO,19,467,18,504,1174
VERACRUZ,PANUCO,19,493,20,532,1174
VERACRUZ,PANUCO,19,673,2,694,1825
VERACRUZ,PANUCO,20,612,11,643,1824
VERACRUZ,PANUCO,17,454,9,480,1260
VERACRUZ,PANUCO,9,441,8,458,1260
VERACRUZ,PANUCO,13,611,17,641,1609
VERACRUZ,PANUCO,15,612,24,651,1609
VERACRUZ,PANUCO,1,648,5,654,1407
VERACRUZ,PANUCO,10,619,10,639,1406
VERACRUZ,PANUCO,8,619,5,632,1361
VERACRUZ,PANUCO,7,530,24,561,1361
VERACRUZ,PANUCO,12,583,10,605,1361
VERACRUZ,TANTOYUCA,40,683,38,761,1922
VERACRUZ,TANTOYUCA,47,679,63,789,1921
VERACRUZ,TANTOYUCA,30,534,26,590,1885
VERACRUZ,TANTOYUCA,52,556,62,670,1884
VERACRUZ,TANTOYUCA,39,562,28,629,1884
VERACRUZ,TANTOYUCA,47,406,61,514,1524
VERACRUZ,TANTOYUCA,46,358,50,454,1524
VERACRUZ,TANTOYUCA,60,536,46,642,1457
VERACRUZ,TANTOYUCA,47,543,22,612,1456
VERACRUZ,TANTOYUCA,74,505,39,618,1456
VERACRUZ,TANTOYUCA,9,849,24,882,1927
VERACRUZ,TANTOYUCA,12,794,45,851,1926
VERACRUZ,TANTOYUCA,8,524,12,544,1536
VERACRUZ,TANTOYUCA,12,500,7,519,1536
VERACRUZ,TANTOYUCA,18,580,10,608,1536
VERACRUZ,TANTOYUCA,30,442,11,483,1358
VERACRUZ,TANTOYUCA,31,365,29,425,1358
VERACRUZ,TANTOYUCA,39,405,18,462,1357
VERACRUZ,TANTOYUCA,20,631,10,661,1946
VERACRUZ,TANTOYUCA,11,609,14,634,1946
VERACRUZ,TANTOYUCA,15,528,20,563,1852
VERACRUZ,TANTOYUCA,19,535,13,567,1851
VERACRUZ,TANTOYUCA,22,564,19,605,1534
VERACRUZ,TANTOYUCA,13,529,16,558,1534
VERACRUZ,TANTOYUCA,22,577,24,623,1534
VERACRUZ,TANTOYUCA,27,773,29,829,1644
VERACRUZ,TANTOYUCA,39,726,14,779,1643
VERACRUZ,TANTOYUCA,18,638,22,678,1836
VERACRUZ,TANTOYUCA,17,623,18,658,1836
VERACRUZ,TANTOYUCA,25,567,32,624,1631
VERACRUZ,TANTOYUCA,28,563,8,599,1631
VERACRUZ,TANTOYUCA,8,284,8,300,1041
VERACRUZ,TANTOYUCA,13,249,9,271,1041
VERACRUZ,TANTOYUCA,23,641,30,694,1625
VERACRUZ,TANTOYUCA,24,643,23,690,1625
VERACRUZ,TANTOYUCA,41,695,24,760,1961
VERACRUZ,TANTOYUCA,25,736,25,786,1961
VERACRUZ,TANTOYUCA,19,405,16,440,1636
VERACRUZ,TANTOYUCA,15,383,33,431,1636
VERACRUZ,TANTOYUCA,14,406,29,449,1636
VERACRUZ,TANTOYUCA,14,426,24,464,1636
VERACRUZ,TANTOYUCA,50,493,16,559,1776
VERACRUZ,TANTOYUCA,46,492,33,571,1775
VERACRUZ,TANTOYUCA,40,480,21,541,1431
VERACRUZ,TANTOYUCA,44,543,7,594,1431
VERACRUZ,TANTOYUCA,49,573,36,658,1952
VERACRUZ,TANTOYUCA,50,528,45,623,1951
VERACRUZ,TANTOYUCA,87,612,43,742,1919
VERACRUZ,TANTOYUCA,57,588,28,673,1919
VERACRUZ,TANTOYUCA,30,519,29,578,1803
VERACRUZ,TANTOYUCA,32,564,28,624,1803
VERACRUZ,TANTOYUCA,41,565,32,638,1803
VERACRUZ,TANTOYUCA,33,399,49,481,1682
VERACRUZ,TANTOYUCA,34,413,13,460,1682
VERACRUZ,TANTOYUCA,45,379,47,471,1682
VERACRUZ,TANTOYUCA,36,552,34,622,1900
VERACRUZ,TANTOYUCA,50,601,30,681,1900
VERACRUZ,TANTOYUCA,45,479,16,540,1717
VERACRUZ,TANTOYUCA,18,422,15,455,1717
VERACRUZ,TANTOYUCA,39,482,28,549,1716
VERACRUZ,TANTOYUCA,18,677,30,725,1592
VERACRUZ,TANTOYUCA,29,682,25,736,1591
VERACRUZ,TANTOYUCA,18,535,25,578,1968
VERACRUZ,TANTOYUCA,12,504,23,539,1967
VERACRUZ,TANTOYUCA,44,515,59,618,1662
VERACRUZ,TANTOYUCA,538,34,41,613,1661
VERACRUZ,TANTOYUCA,20,617,16,653,1625
VERACRUZ,TANTOYUCA,33,656,15,704,1625
VERACRUZ,TANTOYUCA,46,468,13,527,1440
VERACRUZ,TANTOYUCA,55,374,23,452,1440
VERACRUZ,TANTOYUCA,38,402,32,472,1439
VERACRUZ,TANTOYUCA,22,450,6,478,1323
VERACRUZ,TANTOYUCA,25,416,10,451,1323
VERACRUZ,TANTOYUCA,14,408,16,438,1323
VERACRUZ,TANTOYUCA,46,529,31,606,1431
VERACRUZ,TANTOYUCA,28,513,19,560,1431
VERACRUZ,TANTOYUCA,27,508,9,544,1430
VERACRUZ,TANTOYUCA,36,490,13,539,1844
VERACRUZ,TANTOYUCA,24,408,10,442,1844
VERACRUZ,TANTOYUCA,30,555,22,607,1594
VERACRUZ,TANTOYUCA,34,525,8,567,1594
VERACRUZ,TANTOYUCA,56,569,13,638,1594
VERACRUZ,TANTOYUCA,33,644,19,696,1618
VERACRUZ,TANTOYUCA,29,610,16,655,1617
VERACRUZ,TANTOYUCA,27,606,25,658,1617
VERACRUZ,TANTOYUCA,82,124,46,252,1104
VERACRUZ,TANTOYUCA,58,117,58,233,1103
VERACRUZ,TANTOYUCA,20,411,21,452,1645
VERACRUZ,TANTOYUCA,36,507,8,551,1644
VERACRUZ,TANTOYUCA,9,413,14,436,1644
VERACRUZ,TANTOYUCA,13,490,10,513,1722
VERACRUZ,TANTOYUCA,20,459,22,501,1722
VERACRUZ,TANTOYUCA,10,494,9,513,1721
VERACRUZ,TANTOYUCA,29,390,15,434,1379
VERACRUZ,TANTOYUCA,34,440,35,509,1378
VERACRUZ,TANTOYUCA,21,376,17,414,1378
VERACRUZ,TANTOYUCA,18,417,5,440,1941
VERACRUZ,TANTOYUCA,23,409,7,439,1941
VERACRUZ,TANTOYUCA,0,231,4,235,1029
VERACRUZ,TANTOYUCA,13,251,1,265,1028
VERACRUZ,TANTOYUCA,18,258,7,283,1673
VERACRUZ,TANTOYUCA,17,281,12,310,1673
VERACRUZ,TANTOYUCA,17,390,7,414,1716
VERACRUZ,TANTOYUCA,16,378,3,397,1716
VERACRUZ,TANTOYUCA,27,349,3,379,1697
VERACRUZ,TANTOYUCA,18,291,8,317,1697
VERACRUZ,TANTOYUCA,12,290,1,303,1401
VERACRUZ,TANTOYUCA,18,276,3,297,1401
VERACRUZ,TANTOYUCA,71,1041,22,1134,0
VERACRUZ,TANTOYUCA,14,311,3,328,1542
VERACRUZ,TANTOYUCA,10,324,11,345,1541
VERACRUZ,TANTOYUCA,16,213,17,246,1162
VERACRUZ,TANTOYUCA,5,237,9,251,1161
VERACRUZ,TANTOYUCA,23,281,17,321,1374
VERACRUZ,TANTOYUCA,19,328,16,363,1373
VERACRUZ,TANTOYUCA,22,304,19,345,1373
VERACRUZ,TANTOYUCA,86,273,69,428,1695
VERACRUZ,TANTOYUCA,48,347,55,450,1695
VERACRUZ,TANTOYUCA,32,144,32,208,1430
VERACRUZ,TANTOYUCA,41,148,31,220,1430
VERACRUZ,TANTOYUCA,39,162,23,224,1429
VERACRUZ,TANTOYUCA,92,265,24,381,1910
VERACRUZ,TANTOYUCA,63,285,33,381,1909
VERACRUZ,TANTOYUCA,36,321,36,393,1856
VERACRUZ,TANTOYUCA,33,285,43,361,1855
VERACRUZ,TANTOYUCA,16,242,34,292,1899
VERACRUZ,TANTOYUCA,38,302,35,375,1899
VERACRUZ,TANTOYUCA,41,294,33,368,1811
VERACRUZ,TANTOYUCA,29,303,21,353,1810
VERACRUZ,TANTOYUCA,26,185,21,232,1600
VERACRUZ,TANTOYUCA,14,198,12,224,1600
VERACRUZ,TANTOYUCA,18,224,3,245,1599
VERACRUZ,TANTOYUCA,63,322,31,416,1154
VERACRUZ,TANTOYUCA,49,316,13,378,1154
VERACRUZ,TANTOYUCA,27,490,29,546,1950
VERACRUZ,TANTOYUCA,21,527,27,575,1950
VERACRUZ,TANTOYUCA,20,417,20,457,1692
VERACRUZ,TANTOYUCA,24,456,26,506,1691
VERACRUZ,TANTOYUCA,29,627,32,688,1750
VERACRUZ,TANTOYUCA,28,627,24,679,1750
VERACRUZ,TANTOYUCA,15,577,19,611,1750
VERACRUZ,TANTOYUCA,99,552,69,720,2025
VERACRUZ,TANTOYUCA,79,457,58,594,1722
VERACRUZ,TANTOYUCA,77,484,49,610,1722
VERACRUZ,TANTOYUCA,48,448,42,538,1495
VERACRUZ,TANTOYUCA,43,410,40,493,1494
VERACRUZ,TANTOYUCA,54,493,38,585,1710
VERACRUZ,TANTOYUCA,53,526,30,609,1709
VERACRUZ,TANTOYUCA,59,800,16,875,1589
VERACRUZ,TANTOYUCA,62,635,33,730,1588
VERACRUZ,TANTOYUCA,36,372,11,419,1169
VERACRUZ,TANTOYUCA,17,360,28,405,1169
VERACRUZ,TANTOYUCA,49,508,23,580,1630
VERACRUZ,TANTOYUCA,35,479,44,558,1629
VERACRUZ,TANTOYUCA,35,499,16,550,1629
VERACRUZ,TANTOYUCA,78,384,37,499,1934
VERACRUZ,TANTOYUCA,30,270,28,328,1933
VERACRUZ,TANTOYUCA,74,428,46,548,1933
VERACRUZ,TUXPAN DE RODRIGUEZ CANO,19,357,3,379,2034
VERACRUZ,TUXPAN DE RODRIGUEZ CANO,14,396,5,415,2034
VERACRUZ,TUXPAN DE RODRIGUEZ CANO,16,404,10,430,1910
VERACRUZ,TUXPAN DE RODRIGUEZ CANO,28,353,4,385,1909
VERACRUZ,TUXPAN DE RODRIGUEZ CANO,21,354,3,378,1824
VERACRUZ,TUXPAN DE RODRIGUEZ CANO,9,340,1,350,1824
VERACRUZ,TUXPAN DE RODRIGUEZ CANO,15,351,8,374,1928
VERACRUZ,TUXPAN DE RODRIGUEZ CANO,14,319,4,337,1927
VERACRUZ,TUXPAN DE RODRIGUEZ CANO,13,400,8,421,1861
VERACRUZ,TUXPAN DE RODRIGUEZ CANO,11,382,6,399,1861
VERACRUZ,TUXPAN DE RODRIGUEZ CANO,12,413,2,427,1860
VERACRUZ,TUXPAN DE RODRIGUEZ CANO,21,411,20,452,1609
VERACRUZ,TUXPAN DE RODRIGUEZ CANO,14,466,24,504,1609
VERACRUZ,TUXPAN DE RODRIGUEZ CANO,17,370,12,399,1652
VERACRUZ,TUXPAN DE RODRIGUEZ CANO,17,391,14,422,1651
VERACRUZ,TUXPAN DE RODRIGUEZ CANO,11,401,13,425,1651
VERACRUZ,TUXPAN DE RODRIGUEZ CANO,16,331,8,355,1788
VERACRUZ,TUXPAN DE RODRIGUEZ CANO,11,351,18,380,1787
VERACRUZ,TUXPAN DE RODRIGUEZ CANO,14,306,4,324,1780
VERACRUZ,TUXPAN DE RODRIGUEZ CANO,14,283,8,305,1779
VERACRUZ,TUXPAN DE RODRIGUEZ CANO,25,440,20,485,1805
VERACRUZ,TUXPAN DE RODRIGUEZ CANO,16,465,11,492,1805
VERACRUZ,TUXPAN DE RODRIGUEZ CANO,19,386,19,424,1961
VERACRUZ,TUXPAN DE RODRIGUEZ CANO,12,356,19,387,1960
VERACRUZ,TUXPAN DE RODRIGUEZ CANO,11,271,5,287,1497
VERACRUZ,TUXPAN DE RODRIGUEZ CANO,11,225,7,243,1497
VERACRUZ,TUXPAN DE RODRIGUEZ CANO,13,367,2,382,1496
VERACRUZ,TUXPAN DE RODRIGUEZ CANO,12,402,18,432,1395
VERACRUZ,TUXPAN DE RODRIGUEZ CANO,20,500,12,532,1395
VERACRUZ,TUXPAN DE RODRIGUEZ CANO,40,352,14,406,1395
VERACRUZ,TUXPAN DE RODRIGUEZ CANO,18,489,26,533,1931
VERACRUZ,TUXPAN DE RODRIGUEZ CANO,17,247,8,272,1538
VERACRUZ,TUXPAN DE RODRIGUEZ CANO,16,219,12,247,1538
VERACRUZ,TUXPAN DE RODRIGUEZ CANO,17,184,8,209,1538
VERACRUZ,TUXPAN DE RODRIGUEZ CANO,9,157,10,176,1181
VERACRUZ,TUXPAN DE RODRIGUEZ CANO,7,177,5,189,1180
VERACRUZ,TUXPAN DE RODRIGUEZ CANO,14,242,15,271,1300
VERACRUZ,TUXPAN DE RODRIGUEZ CANO,9,255,17,281,1300
VERACRUZ,TUXPAN DE RODRIGUEZ CANO,12,302,12,326,1524
VERACRUZ,TUXPAN DE RODRIGUEZ CANO,7,253,5,265,1524
VERACRUZ,TUXPAN DE RODRIGUEZ CANO,12,274,6,292,1524
VERACRUZ,TUXPAN DE RODRIGUEZ CANO,8,170,7,185,1333
VERACRUZ,TUXPAN DE RODRIGUEZ CANO,4,203,1,208,1333
VERACRUZ,TUXPAN DE RODRIGUEZ CANO,11,519,28,558,1920
VERACRUZ,TUXPAN DE RODRIGUEZ CANO,13,514,34,561,1919
VERACRUZ,TUXPAN DE RODRIGUEZ CANO,11,305,13,329,1384
VERACRUZ,TUXPAN DE RODRIGUEZ CANO,16,272,23,311,1383
VERACRUZ,TUXPAN DE RODRIGUEZ CANO,14,251,20,285,1383
VERACRUZ,TUXPAN DE RODRIGUEZ CANO,11,394,6,411,1224
VERACRUZ,TUXPAN DE RODRIGUEZ CANO,9,386,18,413,1223
VERACRUZ,TUXPAN DE RODRIGUEZ CANO,11,435,16,462,1774
VERACRUZ,TUXPAN DE RODRIGUEZ CANO,20,404,13,437,1774
VERACRUZ,TUXPAN DE RODRIGUEZ CANO,11,432,19,462,1587
VERACRUZ,TUXPAN DE RODRIGUEZ CANO,11,455,20,486,1587
VERACRUZ,TUXPAN DE RODRIGUEZ CANO,6,341,8,355,1587
VERACRUZ,TUXPAN DE RODRIGUEZ CANO,15,484,20,519,1348
VERACRUZ,TUXPAN DE RODRIGUEZ CANO,19,465,25,509,1347
VERACRUZ,TUXPAN DE RODRIGUEZ CANO,16,571,15,602,1464
VERACRUZ,TUXPAN DE RODRIGUEZ CANO,10,575,12,597,1464
VERACRUZ,TUXPAN DE RODRIGUEZ CANO,10,565,11,586,1463
VERACRUZ,TUXPAN DE RODRIGUEZ CANO,22,592,26,640,1587
VERACRUZ,TUXPAN DE RODRIGUEZ CANO,20,618,44,682,1587
VERACRUZ,TUXPAN DE RODRIGUEZ CANO,25,603,25,653,1604
VERACRUZ,TUXPAN DE RODRIGUEZ CANO,13,571,20,604,1604
VERACRUZ,TUXPAN DE RODRIGUEZ CANO,19,601,14,634,1603
VERACRUZ,TUXPAN DE RODRIGUEZ CANO,12,475,17,504,1629
VERACRUZ,TUXPAN DE RODRIGUEZ CANO,9,426,24,459,1628
VERACRUZ,TUXPAN DE RODRIGUEZ CANO,11,473,15,499,1628
VERACRUZ,TUXPAN DE RODRIGUEZ CANO,15,435,7,457,1577
VERACRUZ,TUXPAN DE RODRIGUEZ CANO,16,446,10,472,1577
VERACRUZ,TUXPAN DE RODRIGUEZ CANO,17,556,7,580,1883
VERACRUZ,TUXPAN DE RODRIGUEZ CANO,19,556,12,587,1882
VERACRUZ,TUXPAN DE RODRIGUEZ CANO,15,360,8,383,1538
VERACRUZ,TUXPAN DE RODRIGUEZ CANO,10,352,9,371,1537
VERACRUZ,TUXPAN DE RODRIGUEZ CANO,3,357,3,363,1604
VERACRUZ,TUXPAN DE RODRIGUEZ CANO,7,421,5,433,1604
VERACRUZ,TUXPAN DE RODRIGUEZ CANO,8,432,4,444,1603
VERACRUZ,TUXPAN DE RODRIGUEZ CANO,10,339,12,361,1636
VERACRUZ,TUXPAN DE RODRIGUEZ CANO,16,290,5,311,1636
VERACRUZ,TUXPAN DE RODRIGUEZ CANO,7,358,8,373,1635
VERACRUZ,TUXPAN DE RODRIGUEZ CANO,19,515,10,544,1573
VERACRUZ,TUXPAN DE RODRIGUEZ CANO,7,487,16,510,1573
VERACRUZ,TUXPAN DE RODRIGUEZ CANO,9,486,16,511,1573
VERACRUZ,TUXPAN DE RODRIGUEZ CANO,38,372,23,433,1521
VERACRUZ,TUXPAN DE RODRIGUEZ CANO,41,341,21,403,1521
VERACRUZ,TUXPAN DE RODRIGUEZ CANO,18,437,22,477,1430
VERACRUZ,TUXPAN DE RODRIGUEZ CANO,17,412,17,446,1430
VERACRUZ,TUXPAN DE RODRIGUEZ CANO,18,378,4,400,1645
VERACRUZ,TUXPAN DE RODRIGUEZ CANO,22,372,4,398,1645
VERACRUZ,TUXPAN DE RODRIGUEZ CANO,16,313,9,338,1645
VERACRUZ,TUXPAN DE RODRIGUEZ CANO,12,379,5,396,1700
VERACRUZ,TUXPAN DE RODRIGUEZ CANO,12,334,3,349,1700
VERACRUZ,TUXPAN DE RODRIGUEZ CANO,13,315,6,334,1700
VERACRUZ,TUXPAN DE RODRIGUEZ CANO,15,330,3,348,1699
VERACRUZ,TUXPAN DE RODRIGUEZ CANO,14,324,4,342,1699
VERACRUZ,TUXPAN DE RODRIGUEZ CANO,17,379,12,408,1518
VERACRUZ,TUXPAN DE RODRIGUEZ CANO,7,380,12,399,1517
VERACRUZ,TUXPAN DE RODRIGUEZ CANO,18,484,7,509,2022
VERACRUZ,TUXPAN DE RODRIGUEZ CANO,14,485,11,510,1896
VERACRUZ,TUXPAN DE RODRIGUEZ CANO,7,455,6,468,1896
VERACRUZ,TUXPAN DE RODRIGUEZ CANO,19,453,4,476,1562
VERACRUZ,TUXPAN DE RODRIGUEZ CANO,7,411,6,424,1561
VERACRUZ,TUXPAN DE RODRIGUEZ CANO,28,387,8,423,1965
VERACRUZ,TUXPAN DE RODRIGUEZ CANO,20,401,3,424,1964
VERACRUZ,TUXPAN DE RODRIGUEZ CANO,12,358,4,374,1655
VERACRUZ,TUXPAN DE RODRIGUEZ CANO,16,366,6,388,1655
VERACRUZ,TUXPAN DE RODRIGUEZ CANO,4,338,9,351,1827
VERACRUZ,TUXPAN DE RODRIGUEZ CANO,9,344,6,359,1827
VERACRUZ,TUXPAN DE RODRIGUEZ CANO,21,464,19,504,2049
VERACRUZ,TUXPAN DE RODRIGUEZ CANO,12,311,4,327,1329
VERACRUZ,TUXPAN DE RODRIGUEZ CANO,16,294,2,312,1328
VERACRUZ,TUXPAN DE RODRIGUEZ CANO,12,278,9,299,1328
VERACRUZ,TUXPAN DE RODRIGUEZ CANO,17,324,6,347,1597
VERACRUZ,TUXPAN DE RODRIGUEZ CANO,18,315,4,337,1597
VERACRUZ,TUXPAN DE RODRIGUEZ CANO,121,1592,27,1740,0
VERACRUZ,TUXPAN DE RODRIGUEZ CANO,15,349,4,368,1575
VERACRUZ,TUXPAN DE RODRIGUEZ CANO,25,326,3,354,1575
VERACRUZ,TUXPAN DE RODRIGUEZ CANO,20,339,6,365,1632
VERACRUZ,TUXPAN DE RODRIGUEZ CANO,31,354,1,386,1632
VERACRUZ,TUXPAN DE RODRIGUEZ CANO,21,328,2,351,1632
VERACRUZ,TUXPAN DE RODRIGUEZ CANO,16,363,6,385,1550
VERACRUZ,TUXPAN DE RODRIGUEZ CANO,20,377,4,401,1549
VERACRUZ,TUXPAN DE RODRIGUEZ CANO,14,371,6,391,1549
VERACRUZ,TUXPAN DE RODRIGUEZ CANO,17,382,5,404,1568
VERACRUZ,TUXPAN DE RODRIGUEZ CANO,22,375,2,399,1567
VERACRUZ,TUXPAN DE RODRIGUEZ CANO,29,403,4,436,1567
VERACRUZ,TUXPAN DE RODRIGUEZ CANO,14,432,5,451,1909
VERACRUZ,TUXPAN DE RODRIGUEZ CANO,13,430,7,450,1909
VERACRUZ,TUXPAN DE RODRIGUEZ CANO,28,443,8,479,1908
VERACRUZ,TUXPAN DE RODRIGUEZ CANO,14,320,11,345,1571
VERACRUZ,TUXPAN DE RODRIGUEZ CANO,19,349,4,372,1571
VERACRUZ,TUXPAN DE RODRIGUEZ CANO,19,447,5,471,1677
VERACRUZ,TUXPAN DE RODRIGUEZ CANO,19,447,4,470,1677
VERACRUZ,TUXPAN DE RODRIGUEZ CANO,20,422,2,444,1629
VERACRUZ,TUXPAN DE RODRIGUEZ CANO,23,411,8,442,1628
VERACRUZ,TUXPAN DE RODRIGUEZ CANO,26,414,3,443,1628
VERACRUZ,TUXPAN DE RODRIGUEZ CANO,23,363,14,400,1790
VERACRUZ,TUXPAN DE RODRIGUEZ CANO,28,387,8,423,1790
VERACRUZ,TUXPAN DE RODRIGUEZ CANO,14,385,18,417,1997
VERACRUZ,TUXPAN DE RODRIGUEZ CANO,26,419,17,462,1997
VERACRUZ,TUXPAN DE RODRIGUEZ CANO,12,410,9,431,2082
VERACRUZ,TUXPAN DE RODRIGUEZ CANO,7,434,8,449,2081
VERACRUZ,TUXPAN DE RODRIGUEZ CANO,11,443,2,456,2046
VERACRUZ,TUXPAN DE RODRIGUEZ CANO,12,448,9,469,2046
VERACRUZ,TUXPAN DE RODRIGUEZ CANO,10,235,5,250,1128
VERACRUZ,TUXPAN DE RODRIGUEZ CANO,12,216,3,231,1127
VERACRUZ,TUXPAN DE RODRIGUEZ CANO,7,330,11,348,1505
VERACRUZ,TUXPAN DE RODRIGUEZ CANO,4,342,7,353,1505
VERACRUZ,TUXPAN DE RODRIGUEZ CANO,16,323,15,354,1505
VERACRUZ,TUXPAN DE RODRIGUEZ CANO,26,533,28,587,1917
VERACRUZ,TUXPAN DE RODRIGUEZ CANO,0,521,24,545,1916
VERACRUZ,TUXPAN DE RODRIGUEZ CANO,9,323,8,340,1834
VERACRUZ,TUXPAN DE RODRIGUEZ CANO,6,376,7,389,1833
VERACRUZ,TUXPAN DE RODRIGUEZ CANO,12,555,26,593,1718
VERACRUZ,TUXPAN DE RODRIGUEZ CANO,13,472,19,504,1718
VERACRUZ,TUXPAN DE RODRIGUEZ CANO,24,390,22,436,1072
VERACRUZ,TUXPAN DE RODRIGUEZ CANO,19,394,21,434,1071
VERACRUZ,VERACRUZ,23,295,3,321,1770
VERACRUZ,VERACRUZ,17,300,5,322,1770
VERACRUZ,VERACRUZ,18,269,6,293,1770
VERACRUZ,VERACRUZ,27,183,2,212,1391
VERACRUZ,VERACRUZ,28,188,1,217,1391
VERACRUZ,VERACRUZ,15,194,1,210,1391
VERACRUZ,VERACRUZ,109,1475,15,1599,0
VERACRUZ,VERACRUZ,0,299,4,303,1718
VERACRUZ,VERACRUZ,21,305,2,328,1717
VERACRUZ,VERACRUZ,22,286,4,312,1717
VERACRUZ,VERACRUZ,19,245,3,267,1645
VERACRUZ,VERACRUZ,22,262,0,284,1645
VERACRUZ,VERACRUZ,14,241,0,255,1645
VERACRUZ,VERACRUZ,18,220,1,239,1644
VERACRUZ,VERACRUZ,28,275,10,313,1839
VERACRUZ,VERACRUZ,24,317,0,341,1839
VERACRUZ,VERACRUZ,18,318,5,341,1839
VERACRUZ,VERACRUZ,15,304,5,324,1839
VERACRUZ,VERACRUZ,25,253,5,283,1621
VERACRUZ,VERACRUZ,16,288,4,308,1620
VERACRUZ,VERACRUZ,20,247,4,271,1620
VERACRUZ,VERACRUZ,32,372,9,413,1815
VERACRUZ,VERACRUZ,29,364,2,395,1815
VERACRUZ,VERACRUZ,9,346,2,357,1935
VERACRUZ,VERACRUZ,22,349,2,373,1934
VERACRUZ,VERACRUZ,9,297,1,307,1692
VERACRUZ,VERACRUZ,17,247,1,265,1691
VERACRUZ,VERACRUZ,12,282,6,300,1691
VERACRUZ,VERACRUZ,18,279,3,300,1691
VERACRUZ,VERACRUZ,21,275,3,299,1538
VERACRUZ,VERACRUZ,13,274,4,291,1538
VERACRUZ,VERACRUZ,15,275,6,296,1537
VERACRUZ,VERACRUZ,17,338,2,357,1584
VERACRUZ,VERACRUZ,18,304,3,325,1583
VERACRUZ,VERACRUZ,8,328,5,341,1583
VERACRUZ,VERACRUZ,29,314,2,345,1583
VERACRUZ,VERACRUZ,19,326,4,349,1481
VERACRUZ,VERACRUZ,14,319,3,336,1481
VERACRUZ,VERACRUZ,15,232,3,250,1369
VERACRUZ,VERACRUZ,3,209,3,215,1369
VERACRUZ,VERACRUZ,11,254,3,268,1368
VERACRUZ,VERACRUZ,14,255,3,272,1546
VERACRUZ,VERACRUZ,11,248,4,263,1546
VERACRUZ,VERACRUZ,20,220,5,245,1546
VERACRUZ,VERACRUZ,15,253,1,269,1546
VERACRUZ,VERACRUZ,13,288,6,307,1545
VERACRUZ,VERACRUZ,13,261,6,280,1545
VERACRUZ,VERACRUZ,21,336,5,362,1917
VERACRUZ,VERACRUZ,12,329,7,348,1917
VERACRUZ,VERACRUZ,29,297,3,329,1704
VERACRUZ,VERACRUZ,23,306,7,336,1704
VERACRUZ,VERACRUZ,17,352,6,375,1766
VERACRUZ,VERACRUZ,13,331,3,347,1766
VERACRUZ,VERACRUZ,9,259,5,273,1243
VERACRUZ,VERACRUZ,16,208,2,226,1242
VERACRUZ,VERACRUZ,12,254,5,271,1430
VERACRUZ,VERACRUZ,12,257,3,272,1430
VERACRUZ,VERACRUZ,17,255,3,275,1232
VERACRUZ,VERACRUZ,19,215,1,235,1232
VERACRUZ,VERACRUZ,12,236,6,254,1800
VERACRUZ,VERACRUZ,14,230,8,252,1800
VERACRUZ,VERACRUZ,4,261,1,266,1800
VERACRUZ,VERACRUZ,10,225,4,239,1799
VERACRUZ,VERACRUZ,8,249,2,259,1799
VERACRUZ,VERACRUZ,8,276,6,290,1799
VERACRUZ,VERACRUZ,9,243,5,257,1799
VERACRUZ,VERACRUZ,43,298,4,345,1764
VERACRUZ,VERACRUZ,23,290,4,317,1763
VERACRUZ,VERACRUZ,12,209,4,225,1107
VERACRUZ,VERACRUZ,12,192,3,207,1107
VERACRUZ,VERACRUZ,18,265,6,289,1796
VERACRUZ,VERACRUZ,23,336,3,362,1796
VERACRUZ,VERACRUZ,37,236,0,273,1651
VERACRUZ,VERACRUZ,24,236,0,260,1651
VERACRUZ,VERACRUZ,24,235,1,260,1651
VERACRUZ,VERACRUZ,21,223,1,245,1737
VERACRUZ,VERACRUZ,40,242,4,286,1737
VERACRUZ,VERACRUZ,21,221,3,245,1737
VERACRUZ,VERACRUZ,26,220,1,247,1737
VERACRUZ,VERACRUZ,35,231,0,266,1736
VERACRUZ,VERACRUZ,21,389,5,415,1827
VERACRUZ,VERACRUZ,16,333,4,353,1826
VERACRUZ,VERACRUZ,16,289,3,308,1797
VERACRUZ,VERACRUZ,18,223,2,243,1797
VERACRUZ,VERACRUZ,21,438,7,466,2089
VERACRUZ,VERACRUZ,12,230,4,246,1562
VERACRUZ,VERACRUZ,16,249,5,270,1562
VERACRUZ,VERACRUZ,16,259,4,279,1562
VERACRUZ,VERACRUZ,8,229,3,240,1832
VERACRUZ,VERACRUZ,14,230,0,244,1831
VERACRUZ,VERACRUZ,15,202,3,220,1831
VERACRUZ,VERACRUZ,13,219,2,234,1831
VERACRUZ,VERACRUZ,10,192,7,209,1831
VERACRUZ,VERACRUZ,8,226,6,240,1831
VERACRUZ,VERACRUZ,23,268,2,293,1880
VERACRUZ,VERACRUZ,11,295,9,315,1879
VERACRUZ,VERACRUZ,18,271,6,295,1879
VERACRUZ,VERACRUZ,12,259,8,279,1879
VERACRUZ,VERACRUZ,14,266,4,284,1879
VERACRUZ,VERACRUZ,11,292,6,309,1879
VERACRUZ,VERACRUZ,14,257,5,276,1879
VERACRUZ,VERACRUZ,10,211,5,226,1368
VERACRUZ,VERACRUZ,7,205,2,214,1367
VERACRUZ,VERACRUZ,6,230,2,238,1367
VERACRUZ,VERACRUZ,11,257,9,277,1001
VERACRUZ,VERACRUZ,5,202,2,209,1974
VERACRUZ,VERACRUZ,14,196,2,212,1974
VERACRUZ,VERACRUZ,5,199,0,204,1974
VERACRUZ,VERACRUZ,5,199,2,206,1974
VERACRUZ,VERACRUZ,13,180,0,193,1409
VERACRUZ,VERACRUZ,14,201,2,217,1409
VERACRUZ,VERACRUZ,10,215,1,226,1408
VERACRUZ,VERACRUZ,14,374,5,393,1907
VERACRUZ,VERACRUZ,18,341,0,359,1907
VERACRUZ,VERACRUZ,17,284,5,306,1745
VERACRUZ,VERACRUZ,14,267,7,288,1745
VERACRUZ,VERACRUZ,24,266,2,292,1745
VERACRUZ,VERACRUZ,9,245,3,257,1166
VERACRUZ,VERACRUZ,12,245,4,261,1165
VERACRUZ,VERACRUZ,21,247,1,269,1169
VERACRUZ,VERACRUZ,18,234,3,255,1168
VERACRUZ,VERACRUZ,16,214,6,236,1477
VERACRUZ,VERACRUZ,10,225,3,238,1477
VERACRUZ,VERACRUZ,19,234,4,257,1476
VERACRUZ,VERACRUZ,9,194,7,210,1811
VERACRUZ,VERACRUZ,9,245,5,259,1811
VERACRUZ,VERACRUZ,14,207,11,232,1810
VERACRUZ,VERACRUZ,12,224,20,256,1810
VERACRUZ,VERACRUZ,6,250,2,258,1810
VERACRUZ,VERACRUZ,14,227,7,248,1810
VERACRUZ,VERACRUZ,6,185,5,196,1758
VERACRUZ,VERACRUZ,12,184,2,198,1758
VERACRUZ,VERACRUZ,15,243,0,258,1758
VERACRUZ,VERACRUZ,12,215,3,230,1758
VERACRUZ,VERACRUZ,7,197,8,212,1758
VERACRUZ,VERACRUZ,224,9,1,234,1757
VERACRUZ,VERACRUZ,5,188,2,195,1757
VERACRUZ,VERACRUZ,3,186,9,198,1757
VERACRUZ,VERACRUZ,15,203,2,220,1935
VERACRUZ,VERACRUZ,14,218,3,235,1935
VERACRUZ,VERACRUZ,7,199,5,211,1934
VERACRUZ,VERACRUZ,8,222,1,231,1934
VERACRUZ,VERACRUZ,18,230,9,257,1934
VERACRUZ,VERACRUZ,14,242,4,260,1934
VERACRUZ,VERACRUZ,27,368,5,400,1936
VERACRUZ,VERACRUZ,19,392,2,413,1936
VERACRUZ,VERACRUZ,35,338,1,374,1874
VERACRUZ,VERACRUZ,27,318,0,345,1873
VERACRUZ,VERACRUZ,22,240,2,264,1280
VERACRUZ,VERACRUZ,13,221,8,242,1279
VERACRUZ,VERACRUZ,20,238,6,264,1224
VERACRUZ,VERACRUZ,12,240,0,252,1223
VERACRUZ,VERACRUZ,15,295,5,315,1792
VERACRUZ,VERACRUZ,20,282,2,304,1792
VERACRUZ,VERACRUZ,31,283,3,317,1791
VERACRUZ,VERACRUZ,17,215,2,234,1416
VERACRUZ,VERACRUZ,18,220,2,240,1415
VERACRUZ,VERACRUZ,21,228,1,250,1671
VERACRUZ,VERACRUZ,23,237,2,262,1671
VERACRUZ,VERACRUZ,18,202,1,221,1671
VERACRUZ,VERACRUZ,14,136,1,151,1117
VERACRUZ,VERACRUZ,9,172,1,182,1117
VERACRUZ,VERACRUZ,32,299,3,334,1879
VERACRUZ,VERACRUZ,24,295,1,320,1878
VERACRUZ,VERACRUZ,25,312,3,340,1878
VERACRUZ,VERACRUZ,23,327,4,354,1878
VERACRUZ,VERACRUZ,16,234,2,252,1119
VERACRUZ,VERACRUZ,21,218,1,240,1118
VERACRUZ,VERACRUZ,17,241,2,260,1878
VERACRUZ,VERACRUZ,17,256,1,274,1878
VERACRUZ,VERACRUZ,4,107,2,113,1241
VERACRUZ,VERACRUZ,7,97,1,105,1240
VERACRUZ,VERACRUZ,10,166,0,176,1445
VERACRUZ,VERACRUZ,12,204,1,217,1444
VERACRUZ,VERACRUZ,9,183,1,193,1444
VERACRUZ,VERACRUZ,18,255,1,274,1657
VERACRUZ,VERACRUZ,19,248,0,267,1657
VERACRUZ,VERACRUZ,16,199,1,216,1893
VERACRUZ,VERACRUZ,10,221,0,231,1892
VERACRUZ,VERACRUZ,20,214,6,240,1892
VERACRUZ,VERACRUZ,7,175,0,182,1405
VERACRUZ,VERACRUZ,12,197,2,211,1404
VERACRUZ,VERACRUZ,9,183,1,193,1404
VERACRUZ,VERACRUZ,15,225,0,240,1632
VERACRUZ,VERACRUZ,18,244,0,262,1632
VERACRUZ,VERACRUZ,14,214,2,230,1632
VERACRUZ,VERACRUZ,11,134,0,145,1298
VERACRUZ,VERACRUZ,7,139,0,146,1298
VERACRUZ,VERACRUZ,6,151,0,157,1392
VERACRUZ,VERACRUZ,17,158,0,175,1391
VERACRUZ,VERACRUZ,6,173,2,181,1391
VERACRUZ,VERACRUZ,7,130,1,138,1153
VERACRUZ,VERACRUZ,10,134,0,144,1153
VERACRUZ,VERACRUZ,50,258,0,308,2088
VERACRUZ,VERACRUZ,38,180,1,219,1626
VERACRUZ,VERACRUZ,39,196,3,238,1626
VERACRUZ,VERACRUZ,26,213,0,239,1567
VERACRUZ,VERACRUZ,40,181,3,224,1567
VERACRUZ,VERACRUZ,28,160,1,189,1863
VERACRUZ,VERACRUZ,33,203,1,237,1862
VERACRUZ,VERACRUZ,24,166,1,191,1668
VERACRUZ,VERACRUZ,26,170,1,197,1668
VERACRUZ,VERACRUZ,29,189,2,220,1984
VERACRUZ,VERACRUZ,25,176,3,204,1983
VERACRUZ,VERACRUZ,9,104,1,114,1117
VERACRUZ,VERACRUZ,7,117,1,125,1116
VERACRUZ,POZA RICA DE HIDALGO,20,458,3,481,1609
VERACRUZ,POZA RICA DE HIDALGO,21,443,9,473,1609
VERACRUZ,POZA RICA DE HIDALGO,26,418,3,447,1609
VERACRUZ,POZA RICA DE HIDALGO,14,383,7,404,1608
VERACRUZ,POZA RICA DE HIDALGO,17,426,17,460,1608
VERACRUZ,POZA RICA DE HIDALGO,10,314,9,333,1207
VERACRUZ,POZA RICA DE HIDALGO,10,327,5,342,1206
VERACRUZ,POZA RICA DE HIDALGO,11,506,6,523,1842
VERACRUZ,POZA RICA DE HIDALGO,17,544,5,566,1842
VERACRUZ,POZA RICA DE HIDALGO,15,387,21,423,1413
VERACRUZ,POZA RICA DE HIDALGO,8,411,10,429,1413
VERACRUZ,POZA RICA DE HIDALGO,7,388,7,402,1412
VERACRUZ,POZA RICA DE HIDALGO,13,434,13,460,1682
VERACRUZ,POZA RICA DE HIDALGO,16,404,7,427,1681
VERACRUZ,POZA RICA DE HIDALGO,12,456,3,471,1567
VERACRUZ,POZA RICA DE HIDALGO,19,447,6,472,1567
VERACRUZ,POZA RICA DE HIDALGO,10,436,6,452,1566
VERACRUZ,POZA RICA DE HIDALGO,9,372,11,392,1073
VERACRUZ,POZA RICA DE HIDALGO,8,351,10,369,1073
VERACRUZ,POZA RICA DE HIDALGO,10,368,9,387,1522
VERACRUZ,POZA RICA DE HIDALGO,5,377,2,384,1522
VERACRUZ,POZA RICA DE HIDALGO,22,697,26,745,1880
VERACRUZ,POZA RICA DE HIDALGO,25,616,33,674,1880
VERACRUZ,POZA RICA DE HIDALGO,9,428,10,447,1174
VERACRUZ,POZA RICA DE HIDALGO,12,433,10,455,1174
VERACRUZ,POZA RICA DE HIDALGO,10,534,32,576,1081
VERACRUZ,POZA RICA DE HIDALGO,7,269,0,276,1024
VERACRUZ,POZA RICA DE HIDALGO,14,316,4,334,1023
VERACRUZ,POZA RICA DE HIDALGO,14,451,6,471,1747
VERACRUZ,POZA RICA DE HIDALGO,16,471,5,492,1746
VERACRUZ,POZA RICA DE HIDALGO,14,337,3,354,1175
VERACRUZ,POZA RICA DE HIDALGO,12,321,3,336,1175
VERACRUZ,POZA RICA DE HIDALGO,20,452,6,478,1448
VERACRUZ,POZA RICA DE HIDALGO,26,459,6,491,1448
VERACRUZ,POZA RICA DE HIDALGO,14,535,7,556,1787
VERACRUZ,POZA RICA DE HIDALGO,30,473,7,510,1787
VERACRUZ,POZA RICA DE HIDALGO,23,498,16,537,1806
VERACRUZ,POZA RICA DE HIDALGO,14,506,8,528,1805
VERACRUZ,POZA RICA DE HIDALGO,7,351,8,366,1275
VERACRUZ,POZA RICA DE HIDALGO,10,351,8,369,1275
VERACRUZ,POZA RICA DE HIDALGO,9,431,13,453,1362
VERACRUZ,POZA RICA DE HIDALGO,12,391,9,412,1361
VERACRUZ,POZA RICA DE HIDALGO,9,415,9,433,1361
VERACRUZ,POZA RICA DE HIDALGO,13,619,7,639,1851
VERACRUZ,POZA RICA DE HIDALGO,21,472,5,498,1850
VERACRUZ,POZA RICA DE HIDALGO,18,527,5,550,1731
VERACRUZ,POZA RICA DE HIDALGO,14,464,4,482,1730
VERACRUZ,POZA RICA DE HIDALGO,31,490,3,524,1995
VERACRUZ,POZA RICA DE HIDALGO,25,473,2,500,1994
VERACRUZ,POZA RICA DE HIDALGO,22,433,2,457,1752
VERACRUZ,POZA RICA DE HIDALGO,19,455,8,482,1752
VERACRUZ,POZA RICA DE HIDALGO,19,402,6,427,1518
VERACRUZ,POZA RICA DE HIDALGO,19,419,5,443,1518
VERACRUZ,POZA RICA DE HIDALGO,11,401,14,426,1518
VERACRUZ,POZA RICA DE HIDALGO,21,393,5,419,1628
VERACRUZ,POZA RICA DE HIDALGO,28,379,4,411,1627
VERACRUZ,POZA RICA DE HIDALGO,19,467,7,493,1830
VERACRUZ,POZA RICA DE HIDALGO,17,442,4,463,1830
VERACRUZ,POZA RICA DE HIDALGO,98,1892,13,2003,0
VERACRUZ,POZA RICA DE HIDALGO,16,523,4,543,1739
VERACRUZ,POZA RICA DE HIDALGO,12,553,7,572,1738
VERACRUZ,POZA RICA DE HIDALGO,21,413,4,438,1642
VERACRUZ,POZA RICA DE HIDALGO,18,428,2,448,1642
VERACRUZ,POZA RICA DE HIDALGO,16,502,3,521,1925
VERACRUZ,POZA RICA DE HIDALGO,22,544,6,572,1925
VERACRUZ,POZA RICA DE HIDALGO,14,510,7,531,1924
VERACRUZ,POZA RICA DE HIDALGO,23,527,9,559,1924
VERACRUZ,POZA RICA DE HIDALGO,29,288,3,320,1051
VERACRUZ,POZA RICA DE HIDALGO,16,279,1,296,1050
VERACRUZ,POZA RICA DE HIDALGO,15,542,8,565,1815
VERACRUZ,POZA RICA DE HIDALGO,15,498,3,516,1814
VERACRUZ,POZA RICA DE HIDALGO,23,492,7,522,1814
VERACRUZ,POZA RICA DE HIDALGO,20,470,4,494,1797
VERACRUZ,POZA RICA DE HIDALGO,17,483,5,505,1796
VERACRUZ,POZA RICA DE HIDALGO,21,464,6,491,1761
VERACRUZ,POZA RICA DE HIDALGO,29,458,7,494,1760
VERACRUZ,POZA RICA DE HIDALGO,15,447,5,467,1918
VERACRUZ,POZA RICA DE HIDALGO,18,493,7,518,1917
VERACRUZ,POZA RICA DE HIDALGO,14,437,0,451,1482
VERACRUZ,POZA RICA DE HIDALGO,21,381,7,409,1482
VERACRUZ,POZA RICA DE HIDALGO,13,426,3,442,1481
VERACRUZ,POZA RICA DE HIDALGO,12,328,0,340,1346
VERACRUZ,POZA RICA DE HIDALGO,11,331,1,343,1345
VERACRUZ,POZA RICA DE HIDALGO,18,342,5,365,1345
VERACRUZ,POZA RICA DE HIDALGO,24,570,6,600,1958
VERACRUZ,POZA RICA DE HIDALGO,27,498,0,525,1958
VERACRUZ,POZA RICA DE HIDALGO,30,439,5,474,1778
VERACRUZ,POZA RICA DE HIDALGO,0,422,8,430,1778
VERACRUZ,POZA RICA DE HIDALGO,6,449,8,463,1506
VERACRUZ,POZA RICA DE HIDALGO,14,442,6,462,1505
VERACRUZ,POZA RICA DE HIDALGO,23,405,5,433,1649
VERACRUZ,POZA RICA DE HIDALGO,23,419,8,450,1649
VERACRUZ,POZA RICA DE HIDALGO,7,416,9,432,1368
VERACRUZ,POZA RICA DE HIDALGO,13,378,9,400,1368
VERACRUZ,POZA RICA DE HIDALGO,17,514,4,535,1790
VERACRUZ,POZA RICA DE HIDALGO,14,500,8,522,1790
VERACRUZ,POZA RICA DE HIDALGO,22,494,6,522,1766
VERACRUZ,POZA RICA DE HIDALGO,21,500,4,525,1766
VERACRUZ,POZA RICA DE HIDALGO,16,451,2,469,1765
VERACRUZ,POZA RICA DE HIDALGO,12,380,3,395,1478
VERACRUZ,POZA RICA DE HIDALGO,7,377,2,386,1477
VERACRUZ,POZA RICA DE HIDALGO,20,365,4,389,1477
VERACRUZ,POZA RICA DE HIDALGO,8,444,12,464,1651
VERACRUZ,POZA RICA DE HIDALGO,10,420,18,448,1650
VERACRUZ,POZA RICA DE HIDALGO,18,489,6,513,1522
VERACRUZ,POZA RICA DE HIDALGO,14,391,2,407,1521
VERACRUZ,POZA RICA DE HIDALGO,14,425,9,448,1467
VERACRUZ,POZA RICA DE HIDALGO,20,422,5,447,1467
VERACRUZ,POZA RICA DE HIDALGO,21,478,12,511,1800
VERACRUZ,POZA RICA DE HIDALGO,16,464,11,491,1799
VERACRUZ,POZA RICA DE HIDALGO,14,407,16,437,1799
VERACRUZ,POZA RICA DE HIDALGO,16,482,3,501,1599
VERACRUZ,POZA RICA DE HIDALGO,15,464,7,486,1598
VERACRUZ,POZA RICA DE HIDALGO,15,408,2,425,1395
VERACRUZ,POZA RICA DE HIDALGO,4,404,3,411,1395
VERACRUZ,POZA RICA DE HIDALGO,18,425,5,448,1516
VERACRUZ,POZA RICA DE HIDALGO,13,463,10,486,1516
VERACRUZ,POZA RICA DE HIDALGO,18,422,12,452,1750
VERACRUZ,POZA RICA DE HIDALGO,17,436,19,472,1749
VERACRUZ,POZA RICA DE HIDALGO,14,424,18,456,1749
VERACRUZ,POZA RICA DE HIDALGO,11,549,16,576,1836
VERACRUZ,POZA RICA DE HIDALGO,12,507,5,524,1619
VERACRUZ,POZA RICA DE HIDALGO,18,479,8,505,1618
VERACRUZ,POZA RICA DE HIDALGO,19,557,15,591,1828
VERACRUZ,POZA RICA DE HIDALGO,17,527,6,550,1828
VERACRUZ,POZA RICA DE HIDALGO,28,393,16,437,1749
VERACRUZ,POZA RICA DE HIDALGO,5,385,9,399,2046
VERACRUZ,POZA RICA DE HIDALGO,21,560,10,591,1234
VERACRUZ,POZA RICA DE HIDALGO,15,525,24,564,1351
VERACRUZ,POZA RICA DE HIDALGO,15,576,14,605,1351
VERACRUZ,POZA RICA DE HIDALGO,11,412,24,447,1717
VERACRUZ,POZA RICA DE HIDALGO,15,424,25,464,1717
VERACRUZ,POZA RICA DE HIDALGO,24,480,33,537,1644
VERACRUZ,POZA RICA DE HIDALGO,27,614,15,656,1876
VERACRUZ,POZA RICA DE HIDALGO,12,441,11,464,1582
VERACRUZ,POZA RICA DE HIDALGO,12,453,16,481,1582
VERACRUZ,POZA RICA DE HIDALGO,8,479,20,507,1582
VERACRUZ,POZA RICA DE HIDALGO,23,566,33,622,1890
VERACRUZ,POZA RICA DE HIDALGO,24,592,35,651,1890
VERACRUZ,POZA RICA DE HIDALGO,7,407,16,430,1580
VERACRUZ,POZA RICA DE HIDALGO,9,361,5,375,1579
VERACRUZ,POZA RICA DE HIDALGO,42,549,51,642,1624
VERACRUZ,POZA RICA DE HIDALGO,17,444,14,475,1476
VERACRUZ,POZA RICA DE HIDALGO,11,420,12,443,1476
VERACRUZ,POZA RICA DE HIDALGO,12,441,0,453,1478
VERACRUZ,POZA RICA DE HIDALGO,0,416,14,430,1477
VERACRUZ,POZA RICA DE HIDALGO,11,396,6,413,1477
VERACRUZ,POZA RICA DE HIDALGO,9,446,4,459,1524
VERACRUZ,POZA RICA DE HIDALGO,12,418,7,437,1524
VERACRUZ,POZA RICA DE HIDALGO,15,435,11,461,1607
VERACRUZ,POZA RICA DE HIDALGO,22,456,11,489,1606
VERACRUZ,POZA RICA DE HIDALGO,10,410,12,432,1606
VERACRUZ,POZA RICA DE HIDALGO,13,308,4,325,1082
VERACRUZ,POZA RICA DE HIDALGO,9,302,10,321,1082
VERACRUZ,POZA RICA DE HIDALGO,8,484,9,501,1754
VERACRUZ,POZA RICA DE HIDALGO,16,450,15,481,1753
VERACRUZ,POZA RICA DE HIDALGO,10,540,6,556,1847
VERACRUZ,POZA RICA DE HIDALGO,15,481,22,518,1846
VERACRUZ,PAPANTLA DE OLARTE,25,918,14,957,1879
VERACRUZ,PAPANTLA DE OLARTE,27,862,17,906,1879
VERACRUZ,PAPANTLA DE OLARTE,13,487,3,503,1051
VERACRUZ,PAPANTLA DE OLARTE,9,469,2,480,1050
VERACRUZ,PAPANTLA DE OLARTE,13,490,6,509,1516
VERACRUZ,PAPANTLA DE OLARTE,6,462,8,476,1516
VERACRUZ,PAPANTLA DE OLARTE,6,460,2,468,1515
VERACRUZ,PAPANTLA DE OLARTE,1,431,9,441,1515
VERACRUZ,PAPANTLA DE OLARTE,26,766,25,817,1792
VERACRUZ,PAPANTLA DE OLARTE,36,734,38,808,1792
VERACRUZ,PAPANTLA DE OLARTE,7,737,17,761,1665
VERACRUZ,PAPANTLA DE OLARTE,12,706,6,724,1665
VERACRUZ,PAPANTLA DE OLARTE,16,579,42,637,1838
VERACRUZ,PAPANTLA DE OLARTE,27,631,34,692,1838
VERACRUZ,PAPANTLA DE OLARTE,12,660,10,682,1326
VERACRUZ,PAPANTLA DE OLARTE,17,669,5,691,1326
VERACRUZ,PAPANTLA DE OLARTE,19,818,10,847,1552
VERACRUZ,PAPANTLA DE OLARTE,13,790,3,806,1551
VERACRUZ,PAPANTLA DE OLARTE,16,606,46,668,1943
VERACRUZ,PAPANTLA DE OLARTE,28,748,23,799,1943
VERACRUZ,PAPANTLA DE OLARTE,14,887,7,908,1886
VERACRUZ,PAPANTLA DE OLARTE,14,842,4,860,1886
VERACRUZ,PAPANTLA DE OLARTE,21,611,17,649,1481
VERACRUZ,PAPANTLA DE OLARTE,8,604,7,619,1480
VERACRUZ,PAPANTLA DE OLARTE,17,567,22,606,1480
VERACRUZ,PAPANTLA DE OLARTE,26,1000,22,1048,1622
VERACRUZ,PAPANTLA DE OLARTE,29,591,27,647,1621
VERACRUZ,PAPANTLA DE OLARTE,30,516,23,569,1721
VERACRUZ,PAPANTLA DE OLARTE,20,570,22,612,1720
VERACRUZ,PAPANTLA DE OLARTE,14,402,6,422,1247
VERACRUZ,PAPANTLA DE OLARTE,12,425,8,445,1247
VERACRUZ,PAPANTLA DE OLARTE,32,514,20,566,1677
VERACRUZ,PAPANTLA DE OLARTE,37,569,36,642,1676
VERACRUZ,PAPANTLA DE OLARTE,14,516,12,542,1407
VERACRUZ,PAPANTLA DE OLARTE,21,526,15,562,1407
VERACRUZ,PAPANTLA DE OLARTE,27,542,16,585,1407
VERACRUZ,PAPANTLA DE OLARTE,13,471,14,498,1551
VERACRUZ,PAPANTLA DE OLARTE,12,509,9,530,1551
VERACRUZ,PAPANTLA DE OLARTE,28,370,30,428,1253
VERACRUZ,PAPANTLA DE OLARTE,15,356,21,392,1252
VERACRUZ,PAPANTLA DE OLARTE,16,205,7,228,1070
VERACRUZ,PAPANTLA DE OLARTE,11,240,6,257,1069
VERACRUZ,PAPANTLA DE OLARTE,21,264,22,307,1080
VERACRUZ,PAPANTLA DE OLARTE,16,253,19,288,1079
VERACRUZ,PAPANTLA DE OLARTE,16,284,6,306,1241
VERACRUZ,PAPANTLA DE OLARTE,21,273,7,301,1240
VERACRUZ,PAPANTLA DE OLARTE,32,514,33,579,1815
VERACRUZ,PAPANTLA DE OLARTE,2,591,29,622,1815
VERACRUZ,PAPANTLA DE OLARTE,23,209,17,249,1309
VERACRUZ,PAPANTLA DE OLARTE,23,174,10,207,1308
VERACRUZ,PAPANTLA DE OLARTE,9,277,8,294,1321
VERACRUZ,PAPANTLA DE OLARTE,12,249,6,267,1320
VERACRUZ,PAPANTLA DE OLARTE,15,293,7,315,1320
VERACRUZ,PAPANTLA DE OLARTE,20,467,7,494,1892
VERACRUZ,PAPANTLA DE OLARTE,17,435,9,461,1891
VERACRUZ,PAPANTLA DE OLARTE,15,468,10,493,1696
VERACRUZ,PAPANTLA DE OLARTE,12,467,10,489,1695
VERACRUZ,PAPANTLA DE OLARTE,11,373,9,393,1443
VERACRUZ,PAPANTLA DE OLARTE,8,405,8,421,1443
VERACRUZ,PAPANTLA DE OLARTE,14,297,8,319,1382
VERACRUZ,PAPANTLA DE OLARTE,8,315,3,326,1381
VERACRUZ,PAPANTLA DE OLARTE,13,305,0,318,1381
VERACRUZ,PAPANTLA DE OLARTE,3,393,1,397,1693
VERACRUZ,PAPANTLA DE OLARTE,6,342,1,349,1692
VERACRUZ,PAPANTLA DE OLARTE,7,278,1,286,1496
VERACRUZ,PAPANTLA DE OLARTE,6,240,6,252,1495
VERACRUZ,PAPANTLA DE OLARTE,8,269,3,280,1495
VERACRUZ,PAPANTLA DE OLARTE,9,181,2,192,1109
VERACRUZ,PAPANTLA DE OLARTE,4,157,2,163,1109
VERACRUZ,PAPANTLA DE OLARTE,6,462,6,474,1844
VERACRUZ,PAPANTLA DE OLARTE,12,480,5,497,1844
VERACRUZ,PAPANTLA DE OLARTE,6,406,6,418,1967
VERACRUZ,PAPANTLA DE OLARTE,14,347,4,365,1967
VERACRUZ,PAPANTLA DE OLARTE,63,556,35,654,1846
VERACRUZ,PAPANTLA DE OLARTE,52,528,20,600,1846
VERACRUZ,PAPANTLA DE OLARTE,14,434,37,485,1914
VERACRUZ,PAPANTLA DE OLARTE,15,502,25,542,1914
VERACRUZ,PAPANTLA DE OLARTE,6,356,2,364,1768
VERACRUZ,PAPANTLA DE OLARTE,10,390,7,407,1767
VERACRUZ,PAPANTLA DE OLARTE,9,365,11,385,1423
VERACRUZ,PAPANTLA DE OLARTE,3,367,6,376,1422
VERACRUZ,PAPANTLA DE OLARTE,12,332,14,358,1422
VERACRUZ,PAPANTLA DE OLARTE,9,433,18,460,1947
VERACRUZ,PAPANTLA DE OLARTE,10,453,17,480,1946
VERACRUZ,PAPANTLA DE OLARTE,8,496,10,514,1942
VERACRUZ,PAPANTLA DE OLARTE,25,481,4,510,1941
VERACRUZ,PAPANTLA DE OLARTE,6,449,7,462,1901
VERACRUZ,PAPANTLA DE OLARTE,15,440,8,463,1901
VERACRUZ,PAPANTLA DE OLARTE,10,425,11,446,1440
VERACRUZ,PAPANTLA DE OLARTE,13,417,5,435,1439
VERACRUZ,PAPANTLA DE OLARTE,22,401,11,434,1463
VERACRUZ,PAPANTLA DE OLARTE,6,402,5,413,1462
VERACRUZ,PAPANTLA DE OLARTE,16,382,1,399,1404
VERACRUZ,PAPANTLA DE OLARTE,17,354,5,376,1404
VERACRUZ,PAPANTLA DE OLARTE,13,361,59,433,1662
VERACRUZ,PAPANTLA DE OLARTE,12,331,4,347,1661
VERACRUZ,PAPANTLA DE OLARTE,64,1666,49,1779,0
VERACRUZ,PAPANTLA DE OLARTE,20,470,5,495,1772
VERACRUZ,PAPANTLA DE OLARTE,19,445,7,471,1771
VERACRUZ,PAPANTLA DE OLARTE,15,414,9,438,1652
VERACRUZ,PAPANTLA DE OLARTE,14,464,11,489,1652
VERACRUZ,PAPANTLA DE OLARTE,14,409,5,428,1616
VERACRUZ,PAPANTLA DE OLARTE,16,396,4,416,1615
VERACRUZ,PAPANTLA DE OLARTE,8,456,3,467,1911
VERACRUZ,PAPANTLA DE OLARTE,13,453,16,482,1911
VERACRUZ,PAPANTLA DE OLARTE,17,394,13,424,1671
VERACRUZ,PAPANTLA DE OLARTE,13,415,5,433,1671
VERACRUZ,PAPANTLA DE OLARTE,10,294,6,310,1267
VERACRUZ,PAPANTLA DE OLARTE,11,393,6,410,1267
VERACRUZ,PAPANTLA DE OLARTE,6,296,6,308,989
VERACRUZ,PAPANTLA DE OLARTE,5,277,5,287,988
VERACRUZ,PAPANTLA DE OLARTE,9,522,10,541,1555
VERACRUZ,PAPANTLA DE OLARTE,12,510,16,538,1555
VERACRUZ,PAPANTLA DE OLARTE,8,452,13,473,1555
VERACRUZ,PAPANTLA DE OLARTE,24,702,22,748,1978
VERACRUZ,PAPANTLA DE OLARTE,14,686,8,708,1978
VERACRUZ,PAPANTLA DE OLARTE,23,519,25,567,1621
VERACRUZ,PAPANTLA DE OLARTE,29,453,25,507,1620
VERACRUZ,PAPANTLA DE OLARTE,26,500,14,540,1897
VERACRUZ,PAPANTLA DE OLARTE,16,523,10,549,1897
VERACRUZ,PAPANTLA DE OLARTE,7,409,14,430,1665
VERACRUZ,PAPANTLA DE OLARTE,11,427,16,454,1665
VERACRUZ,PAPANTLA DE OLARTE,22,439,21,482,1788
VERACRUZ,PAPANTLA DE OLARTE,21,395,34,450,1788
VERACRUZ,PAPANTLA DE OLARTE,23,382,15,420,1788
VERACRUZ,PAPANTLA DE OLARTE,12,557,19,588,1959
VERACRUZ,PAPANTLA DE OLARTE,10,550,24,584,1959
VERACRUZ,PAPANTLA DE OLARTE,13,290,7,310,1824
VERACRUZ,PAPANTLA DE OLARTE,13,337,12,362,1824
VERACRUZ,PAPANTLA DE OLARTE,15,446,14,475,1857
VERACRUZ,PAPANTLA DE OLARTE,11,515,9,535,1857
VERACRUZ,PAPANTLA DE OLARTE,17,476,9,502,1856
VERACRUZ,PAPANTLA DE OLARTE,8,404,10,422,1522
VERACRUZ,PAPANTLA DE OLARTE,4,375,8,387,1522
VERACRUZ,PAPANTLA DE OLARTE,13,406,5,424,1522
VERACRUZ,PAPANTLA DE OLARTE,20,460,27,507,1641
VERACRUZ,PAPANTLA DE OLARTE,8,403,12,423,1641
VERACRUZ,PAPANTLA DE OLARTE,12,390,8,410,1971
VERACRUZ,PAPANTLA DE OLARTE,9,323,13,345,1970
VERACRUZ,PAPANTLA DE OLARTE,8,429,14,451,1585
VERACRUZ,PAPANTLA DE OLARTE,13,304,63,380,1585
VERACRUZ,PAPANTLA DE OLARTE,16,331,7,354,1359
VERACRUZ,PAPANTLA DE OLARTE,15,366,8,389,1359
VERACRUZ,PAPANTLA DE OLARTE,6,512,17,535,1550
VERACRUZ,PAPANTLA DE OLARTE,13,562,7,582,1549
VERACRUZ,PAPANTLA DE OLARTE,21,285,11,317,1421
VERACRUZ,PAPANTLA DE OLARTE,7,306,7,320,1421
VERACRUZ,PAPANTLA DE OLARTE,15,326,13,354,1420
VERACRUZ,PAPANTLA DE OLARTE,18,490,21,529,1873
VERACRUZ,PAPANTLA DE OLARTE,20,495,14,529,1872
VERACRUZ,PAPANTLA DE OLARTE,18,520,9,547,1756
VERACRUZ,PAPANTLA DE OLARTE,14,537,18,569,1756
VERACRUZ,PAPANTLA DE OLARTE,24,567,7,598,1415
VERACRUZ,PAPANTLA DE OLARTE,30,515,12,557,1415
VERACRUZ,PAPANTLA DE OLARTE,25,455,25,505,1663
VERACRUZ,PAPANTLA DE OLARTE,23,453,8,484,1663
VERACRUZ,PAPANTLA DE OLARTE,17,282,6,305,1587
VERACRUZ,PAPANTLA DE OLARTE,10,302,1,313,1587
VERACRUZ,PAPANTLA DE OLARTE,11,302,6,319,1586
VERACRUZ,PAPANTLA DE OLARTE,6,408,9,423,1845
VERACRUZ,PAPANTLA DE OLARTE,12,434,9,455,1844
VERACRUZ,PAPANTLA DE OLARTE,12,418,8,438,1844
VERACRUZ,PAPANTLA DE OLARTE,8,396,11,415,1735
VERACRUZ,PAPANTLA DE OLARTE,12,455,22,489,1735
VERACRUZ,PAPANTLA DE OLARTE,9,297,5,311,1453
VERACRUZ,PAPANTLA DE OLARTE,7,326,7,340,1453
VERACRUZ,PAPANTLA DE OLARTE,16,431,11,458,1576
VERACRUZ,PAPANTLA DE OLARTE,22,395,11,428,1576
VERACRUZ,PAPANTLA DE OLARTE,16,529,12,557,1826
VERACRUZ,PAPANTLA DE OLARTE,9,528,9,546,1826
VERACRUZ,PAPANTLA DE OLARTE,12,539,10,561,1826
VERACRUZ,PAPANTLA DE OLARTE,23,401,9,433,1210
VERACRUZ,PAPANTLA DE OLARTE,30,429,5,464,1210
VERACRUZ,PAPANTLA DE OLARTE,9,569,5,583,1830
VERACRUZ,PAPANTLA DE OLARTE,17,613,10,640,1830
VERACRUZ,PAPANTLA DE OLARTE,11,567,5,583,1830
VERACRUZ,PAPANTLA DE OLARTE,20,459,9,488,1308
VERACRUZ,PAPANTLA DE OLARTE,4,460,3,467,1308
VERACRUZ,PAPANTLA DE OLARTE,24,351,13,388,1316
VERACRUZ,PAPANTLA DE OLARTE,25,371,16,412,1316
VERACRUZ,PAPANTLA DE OLARTE,28,422,25,475,1801
VERACRUZ,PAPANTLA DE OLARTE,20,440,7,467,1801
VERACRUZ,PAPANTLA DE OLARTE,12,341,3,356,1771
VERACRUZ,PAPANTLA DE OLARTE,11,358,3,372,1770
VERACRUZ,MARTINEZ DE LA TORRE,22,422,11,455,1910
VERACRUZ,MARTINEZ DE LA TORRE,14,385,6,405,1910
VERACRUZ,MARTINEZ DE LA TORRE,18,322,10,350,1724
VERACRUZ,MARTINEZ DE LA TORRE,19,295,6,320,1723
VERACRUZ,MARTINEZ DE LA TORRE,18,443,10,471,1894
VERACRUZ,MARTINEZ DE LA TORRE,14,404,3,421,1893
VERACRUZ,MARTINEZ DE LA TORRE,13,362,24,399,2002
VERACRUZ,MARTINEZ DE LA TORRE,17,371,14,402,2001
VERACRUZ,MARTINEZ DE LA TORRE,9,318,12,339,1644
VERACRUZ,MARTINEZ DE LA TORRE,8,317,7,332,1644
VERACRUZ,MARTINEZ DE LA TORRE,28,208,12,248,1098
VERACRUZ,MARTINEZ DE LA TORRE,17,194,2,213,1098
VERACRUZ,MARTINEZ DE LA TORRE,13,178,10,201,1334
VERACRUZ,MARTINEZ DE LA TORRE,19,151,7,177,1334
VERACRUZ,MARTINEZ DE LA TORRE,35,184,25,244,1737
VERACRUZ,MARTINEZ DE LA TORRE,22,202,18,242,1737
VERACRUZ,MARTINEZ DE LA TORRE,31,228,21,280,1606
VERACRUZ,MARTINEZ DE LA TORRE,24,180,9,213,1605
VERACRUZ,MARTINEZ DE LA TORRE,50,173,15,238,1697
VERACRUZ,MARTINEZ DE LA TORRE,30,188,13,231,1696
VERACRUZ,MARTINEZ DE LA TORRE,15,202,2,219,1894
VERACRUZ,MARTINEZ DE LA TORRE,9,199,17,225,1893
VERACRUZ,MARTINEZ DE LA TORRE,17,410,12,439,1899
VERACRUZ,MARTINEZ DE LA TORRE,8,438,8,454,1899
VERACRUZ,MARTINEZ DE LA TORRE,20,425,12,457,1898
VERACRUZ,MARTINEZ DE LA TORRE,12,304,23,339,1874
VERACRUZ,MARTINEZ DE LA TORRE,11,310,19,340,1874
VERACRUZ,MARTINEZ DE LA TORRE,6,209,1,216,1410
VERACRUZ,MARTINEZ DE LA TORRE,16,198,3,217,1410
VERACRUZ,MARTINEZ DE LA TORRE,21,166,4,191,1409
VERACRUZ,MARTINEZ DE LA TORRE,26,402,29,457,2121
VERACRUZ,MARTINEZ DE LA TORRE,26,397,20,443,2120
VERACRUZ,MARTINEZ DE LA TORRE,14,379,19,412,2120
VERACRUZ,MARTINEZ DE LA TORRE,18,188,9,215,1143
VERACRUZ,MARTINEZ DE LA TORRE,8,197,13,218,1142
VERACRUZ,MARTINEZ DE LA TORRE,31,368,5,404,1512
VERACRUZ,MARTINEZ DE LA TORRE,19,386,16,421,1611
VERACRUZ,MARTINEZ DE LA TORRE,22,389,11,422,1611
VERACRUZ,MARTINEZ DE LA TORRE,17,293,11,321,1525
VERACRUZ,MARTINEZ DE LA TORRE,18,284,10,312,1524
VERACRUZ,MARTINEZ DE LA TORRE,15,361,18,394,1734
VERACRUZ,MARTINEZ DE LA TORRE,9,306,21,336,1734
VERACRUZ,MARTINEZ DE LA TORRE,18,307,24,349,1528
VERACRUZ,MARTINEZ DE LA TORRE,8,325,18,351,1528
VERACRUZ,MARTINEZ DE LA TORRE,13,267,10,290,1668
VERACRUZ,MARTINEZ DE LA TORRE,25,223,13,261,1668
VERACRUZ,MARTINEZ DE LA TORRE,44,229,5,278,1794
VERACRUZ,MARTINEZ DE LA TORRE,50,232,3,285,1794
VERACRUZ,MARTINEZ DE LA TORRE,27,237,1,265,1374
VERACRUZ,MARTINEZ DE LA TORRE,29,228,2,259,1373
VERACRUZ,MARTINEZ DE LA TORRE,23,307,12,342,2027
VERACRUZ,MARTINEZ DE LA TORRE,18,274,9,301,2026
VERACRUZ,MARTINEZ DE LA TORRE,30,278,18,326,1398
VERACRUZ,MARTINEZ DE LA TORRE,35,346,19,400,1398
VERACRUZ,MARTINEZ DE LA TORRE,32,283,23,338,1398
VERACRUZ,MARTINEZ DE LA TORRE,23,121,11,155,1349
VERACRUZ,MARTINEZ DE LA TORRE,33,118,16,167,1348
VERACRUZ,MARTINEZ DE LA TORRE,36,110,6,152,1200
VERACRUZ,MARTINEZ DE LA TORRE,27,105,13,145,1199
VERACRUZ,MARTINEZ DE LA TORRE,27,297,8,332,1655
VERACRUZ,MARTINEZ DE LA TORRE,38,342,9,389,1654
VERACRUZ,MARTINEZ DE LA TORRE,58,467,18,543,2097
VERACRUZ,MARTINEZ DE LA TORRE,13,371,2,386,1696
VERACRUZ,MARTINEZ DE LA TORRE,19,356,5,380,1695
VERACRUZ,MARTINEZ DE LA TORRE,6,399,8,413,1745
VERACRUZ,MARTINEZ DE LA TORRE,15,396,4,415,1744
VERACRUZ,MARTINEZ DE LA TORRE,11,308,7,326,1756
VERACRUZ,MARTINEZ DE LA TORRE,8,345,0,353,1756
VERACRUZ,MARTINEZ DE LA TORRE,9,295,6,310,1628
VERACRUZ,MARTINEZ DE LA TORRE,14,363,7,384,1628
VERACRUZ,MARTINEZ DE LA TORRE,9,338,10,357,1802
VERACRUZ,MARTINEZ DE LA TORRE,7,320,10,337,1801
VERACRUZ,MARTINEZ DE LA TORRE,11,309,15,335,1801
VERACRUZ,MARTINEZ DE LA TORRE,8,336,6,350,1801
VERACRUZ,MARTINEZ DE LA TORRE,8,336,12,356,1801
VERACRUZ,MARTINEZ DE LA TORRE,12,326,9,347,1801
VERACRUZ,MARTINEZ DE LA TORRE,11,311,6,328,1801
VERACRUZ,MARTINEZ DE LA TORRE,16,454,16,486,1957
VERACRUZ,MARTINEZ DE LA TORRE,16,457,12,485,1957
VERACRUZ,MARTINEZ DE LA TORRE,10,344,0,354,1521
VERACRUZ,MARTINEZ DE LA TORRE,6,339,0,345,1520
VERACRUZ,MARTINEZ DE LA TORRE,13,329,6,348,1445
VERACRUZ,MARTINEZ DE LA TORRE,12,343,6,361,1444
VERACRUZ,MARTINEZ DE LA TORRE,24,400,5,429,1744
VERACRUZ,MARTINEZ DE LA TORRE,14,428,1,443,1743
VERACRUZ,MARTINEZ DE LA TORRE,8,393,5,406,1604
VERACRUZ,MARTINEZ DE LA TORRE,17,391,4,412,1603
VERACRUZ,MARTINEZ DE LA TORRE,20,437,6,463,2075
VERACRUZ,MARTINEZ DE LA TORRE,74,1466,23,1563,0
VERACRUZ,MARTINEZ DE LA TORRE,10,411,7,428,1415
VERACRUZ,MARTINEZ DE LA TORRE,9,453,4,466,1415
VERACRUZ,MARTINEZ DE LA TORRE,10,430,3,443,1414
VERACRUZ,MARTINEZ DE LA TORRE,10,345,9,364,1247
VERACRUZ,MARTINEZ DE LA TORRE,16,318,4,338,1246
VERACRUZ,MARTINEZ DE LA TORRE,16,417,4,437,1493
VERACRUZ,MARTINEZ DE LA TORRE,7,431,3,441,1492
VERACRUZ,MARTINEZ DE LA TORRE,15,387,4,406,1461
VERACRUZ,MARTINEZ DE LA TORRE,17,391,3,411,1461
VERACRUZ,MARTINEZ DE LA TORRE,21,403,4,428,1514
VERACRUZ,MARTINEZ DE LA TORRE,21,458,6,485,1513
VERACRUZ,MARTINEZ DE LA TORRE,15,388,4,407,1341
VERACRUZ,MARTINEZ DE LA TORRE,7,411,9,427,1340
VERACRUZ,MARTINEZ DE LA TORRE,14,477,12,503,1821
VERACRUZ,MARTINEZ DE LA TORRE,0,470,17,487,1820
VERACRUZ,MARTINEZ DE LA TORRE,12,413,9,434,1707
VERACRUZ,MARTINEZ DE LA TORRE,14,404,10,428,1707
VERACRUZ,MARTINEZ DE LA TORRE,18,400,9,427,1707
VERACRUZ,MARTINEZ DE LA TORRE,5,307,10,322,1372
VERACRUZ,MARTINEZ DE LA TORRE,16,279,8,303,1371
VERACRUZ,MARTINEZ DE LA TORRE,6,335,5,346,1371
VERACRUZ,MARTINEZ DE LA TORRE,36,313,17,366,1213
VERACRUZ,MARTINEZ DE LA TORRE,37,332,9,378,1212
VERACRUZ,MARTINEZ DE LA TORRE,7,555,8,570,1895
VERACRUZ,MARTINEZ DE LA TORRE,17,547,13,577,1895
VERACRUZ,MARTINEZ DE LA TORRE,13,419,8,440,1364
VERACRUZ,MARTINEZ DE LA TORRE,17,388,7,412,1364
VERACRUZ,MARTINEZ DE LA TORRE,10,425,10,445,1363
VERACRUZ,MARTINEZ DE LA TORRE,7,466,8,481,1800
VERACRUZ,MARTINEZ DE LA TORRE,12,472,8,492,1800
VERACRUZ,MARTINEZ DE LA TORRE,14,339,12,365,1235
VERACRUZ,MARTINEZ DE LA TORRE,7,339,13,359,1234
VERACRUZ,MARTINEZ DE LA TORRE,13,435,10,458,1535
VERACRUZ,MARTINEZ DE LA TORRE,14,428,5,447,1535
VERACRUZ,MARTINEZ DE LA TORRE,10,428,5,443,1535
VERACRUZ,MARTINEZ DE LA TORRE,10,578,9,597,1840
VERACRUZ,MARTINEZ DE LA TORRE,21,533,9,563,1840
VERACRUZ,MARTINEZ DE LA TORRE,5,465,11,481,1538
VERACRUZ,MARTINEZ DE LA TORRE,3,421,4,428,1538
VERACRUZ,MARTINEZ DE LA TORRE,16,515,15,546,1661
VERACRUZ,MARTINEZ DE LA TORRE,12,473,18,503,1660
VERACRUZ,MARTINEZ DE LA TORRE,9,509,8,526,1660
VERACRUZ,MARTINEZ DE LA TORRE,23,623,6,652,1643
VERACRUZ,MARTINEZ DE LA TORRE,14,598,3,615,1643
VERACRUZ,MARTINEZ DE LA TORRE,14,543,10,567,1473
VERACRUZ,MARTINEZ DE LA TORRE,11,529,8,548,1473
VERACRUZ,MARTINEZ DE LA TORRE,20,521,17,558,1424
VERACRUZ,MARTINEZ DE LA TORRE,27,505,12,544,1423
VERACRUZ,MARTINEZ DE LA TORRE,52,686,13,751,1963
VERACRUZ,MARTINEZ DE LA TORRE,56,679,8,743,1963
VERACRUZ,MARTINEZ DE LA TORRE,22,403,7,432,1337
VERACRUZ,MARTINEZ DE LA TORRE,15,381,1,397,1337
VERACRUZ,MARTINEZ DE LA TORRE,18,402,14,434,1423
VERACRUZ,MARTINEZ DE LA TORRE,14,430,22,466,1423
VERACRUZ,MARTINEZ DE LA TORRE,6,254,3,263,1392
VERACRUZ,MARTINEZ DE LA TORRE,7,254,9,270,1391
VERACRUZ,MARTINEZ DE LA TORRE,8,382,7,397,1904
VERACRUZ,MARTINEZ DE LA TORRE,9,405,7,421,1903
VERACRUZ,MARTINEZ DE LA TORRE,9,425,2,436,1469
VERACRUZ,MARTINEZ DE LA TORRE,14,444,33,491,1468
VERACRUZ,MARTINEZ DE LA TORRE,4,318,3,325,1468
VERACRUZ,MARTINEZ DE LA TORRE,10,237,5,252,1250
VERACRUZ,MARTINEZ DE LA TORRE,6,296,6,308,1249
VERACRUZ,MARTINEZ DE LA TORRE,15,314,2,331,1373
VERACRUZ,MARTINEZ DE LA TORRE,6,294,6,306,1372
VERACRUZ,MARTINEZ DE LA TORRE,11,304,7,322,1688
VERACRUZ,MARTINEZ DE LA TORRE,12,349,11,372,1687
VERACRUZ,MARTINEZ DE LA TORRE,7,349,4,360,1332
VERACRUZ,MARTINEZ DE LA TORRE,12,307,10,329,1332
VERACRUZ,MARTINEZ DE LA TORRE,11,590,4,605,2002
VERACRUZ,MARTINEZ DE LA TORRE,12,250,10,272,1544
VERACRUZ,MARTINEZ DE LA TORRE,16,293,10,319,1544
VERACRUZ,MARTINEZ DE LA TORRE,17,229,9,255,1544
VERACRUZ,MARTINEZ DE LA TORRE,15,291,8,314,1618
VERACRUZ,MARTINEZ DE LA TORRE,11,275,10,296,1618
VERACRUZ,MARTINEZ DE LA TORRE,5,338,10,353,1900
VERACRUZ,MARTINEZ DE LA TORRE,10,398,14,422,1900
VERACRUZ,MARTINEZ DE LA TORRE,24,384,10,418,1718
VERACRUZ,MARTINEZ DE LA TORRE,26,391,24,441,1717
VERACRUZ,MARTINEZ DE LA TORRE,13,391,5,409,1984
VERACRUZ,MARTINEZ DE LA TORRE,13,364,10,387,1983
VERACRUZ,MARTINEZ DE LA TORRE,21,391,3,415,1983
VERACRUZ,MARTINEZ DE LA TORRE,19,217,12,248,1848
VERACRUZ,MARTINEZ DE LA TORRE,15,245,12,272,1848
VERACRUZ,MARTINEZ DE LA TORRE,32,321,8,361,1794
VERACRUZ,MARTINEZ DE LA TORRE,30,256,8,294,1793
VERACRUZ,MARTINEZ DE LA TORRE,20,454,15,489,1705
VERACRUZ,MARTINEZ DE LA TORRE,18,453,14,485,1705
VERACRUZ,MARTINEZ DE LA TORRE,22,327,14,363,1785
VERACRUZ,MARTINEZ DE LA TORRE,7,331,13,351,1785
VERACRUZ,MARTINEZ DE LA TORRE,22,301,12,335,1796
VERACRUZ,MARTINEZ DE LA TORRE,11,359,11,381,1796
VERACRUZ,XALAPA,11,406,8,425,1242
VERACRUZ,XALAPA,29,410,3,442,1241
VERACRUZ,XALAPA,15,402,3,420,1603
VERACRUZ,XALAPA,14,375,6,395,1603
VERACRUZ,XALAPA,11,238,2,251,1500
VERACRUZ,XALAPA,10,247,3,260,1500
VERACRUZ,XALAPA,19,366,10,395,1553
VERACRUZ,XALAPA,18,408,11,437,1973
VERACRUZ,XALAPA,9,403,6,418,1973
VERACRUZ,XALAPA,21,780,23,824,2165
VERACRUZ,XALAPA,33,289,12,334,1784
VERACRUZ,XALAPA,6,183,0,189,1071
VERACRUZ,XALAPA,14,428,10,452,1482
VERACRUZ,XALAPA,11,395,15,421,1481
VERACRUZ,XALAPA,0,386,1,387,1481
VERACRUZ,XALAPA,10,404,6,420,1381
VERACRUZ,XALAPA,6,412,3,421,1380
VERACRUZ,XALAPA,14,760,8,782,2096
VERACRUZ,XALAPA,14,622,4,640,2095
VERACRUZ,XALAPA,10,444,15,469,2018
VERACRUZ,XALAPA,19,344,4,367,1212
VERACRUZ,XALAPA,15,322,6,343,1211
VERACRUZ,XALAPA,11,334,5,350,1435
VERACRUZ,XALAPA,15,358,2,375,1435
VERACRUZ,XALAPA,20,423,7,450,1380
VERACRUZ,XALAPA,16,394,2,412,1379
VERACRUZ,XALAPA,0,369,6,375,1135
VERACRUZ,XALAPA,23,341,0,364,1134
VERACRUZ,XALAPA,5,458,1,464,2093
VERACRUZ,XALAPA,3,504,0,507,2092
VERACRUZ,XALAPA,7,265,8,280,1443
VERACRUZ,XALAPA,15,266,12,293,1442
VERACRUZ,XALAPA,7,412,18,437,1339
VERACRUZ,XALAPA,24,253,3,280,1127
VERACRUZ,XALAPA,14,608,1,623,1723
VERACRUZ,XALAPA,19,296,0,315,1257
VERACRUZ,XALAPA,16,333,6,355,1256
VERACRUZ,XALAPA,6,298,0,304,1500
VERACRUZ,XALAPA,17,296,1,314,1500
VERACRUZ,XALAPA,61,1075,19,1155,0
VERACRUZ,XALAPA,11,312,2,325,1652
VERACRUZ,XALAPA,14,314,5,333,1652
VERACRUZ,XALAPA,18,340,1,359,1707
VERACRUZ,XALAPA,15,342,2,359,1706
VERACRUZ,XALAPA,4,211,3,218,1160
VERACRUZ,XALAPA,6,247,0,253,1159
VERACRUZ,XALAPA,12,314,7,333,1590
VERACRUZ,XALAPA,10,344,2,356,1590
VERACRUZ,XALAPA,9,321,3,333,1589
VERACRUZ,XALAPA,14,368,5,387,1611
VERACRUZ,XALAPA,10,329,9,348,1611
VERACRUZ,XALAPA,6,384,5,395,1610
VERACRUZ,XALAPA,14,308,13,335,1106
VERACRUZ,XALAPA,9,284,15,308,1106
VERACRUZ,XALAPA,9,475,17,501,1221
VERACRUZ,XALAPA,13,359,11,383,1475
VERACRUZ,XALAPA,14,460,8,482,1475
VERACRUZ,XALAPA,12,445,26,483,1474
VERACRUZ,XALAPA,13,331,17,361,1550
VERACRUZ,XALAPA,33,336,24,393,1739
VERACRUZ,XALAPA,54,213,15,282,1453
VERACRUZ,XALAPA,58,222,23,303,1452
VERACRUZ,XALAPA,29,575,20,624,1950
VERACRUZ,XALAPA,51,551,24,626,1950
VERACRUZ,XALAPA,41,545,26,612,1950
VERACRUZ,XALAPA,39,443,33,515,1428
VERACRUZ,XALAPA,46,478,66,590,1871
VERACRUZ,XALAPA,20,186,4,210,1140
VERACRUZ,XALAPA,10,328,13,351,1555
VERACRUZ,XALAPA,18,303,11,332,1554
VERACRUZ,XALAPA,23,197,5,225,1113
VERACRUZ,XALAPA,15,173,1,189,1113
VERACRUZ,XALAPA,47,324,8,379,2139
VERACRUZ,XALAPA,44,310,6,360,2139
VERACRUZ,XALAPA,38,343,8,389,2139
VERACRUZ,XALAPA,47,326,3,376,2139
VERACRUZ,XALAPA,41,370,4,415,2138
VERACRUZ,XALAPA,43,316,9,368,2138
VERACRUZ,XALAPA,43,330,6,379,2138
VERACRUZ,XALAPA,26,219,5,250,1247
VERACRUZ,XALAPA,14,256,5,275,1247
VERACRUZ,XALAPA,21,267,4,292,1351
VERACRUZ,XALAPA,13,256,3,272,1351
VERACRUZ,XALAPA,26,242,0,268,1215
VERACRUZ,XALAPA,22,211,6,239,1215
VERACRUZ,XALAPA,21,287,14,322,1402
VERACRUZ,XALAPA,20,320,7,347,1402
VERACRUZ,XALAPA,21,289,5,315,1242
VERACRUZ,XALAPA,30,249,3,282,1242
VERACRUZ,XALAPA,24,490,13,527,1905
VERACRUZ,XALAPA,20,569,13,602,2027
VERACRUZ,XALAPA,17,551,7,575,2036
VERACRUZ,XALAPA,11,422,4,437,1952
VERACRUZ,XALAPA,20,392,7,419,1952
VERACRUZ,XALAPA,23,363,15,401,1257
VERACRUZ,XALAPA,9,392,6,407,1507
VERACRUZ,XALAPA,6,373,5,384,1507
VERACRUZ,XALAPA,10,403,0,413,1625
VERACRUZ,XALAPA,8,365,5,378,1625
VERACRUZ,XALAPA,4,374,9,387,1624
VERACRUZ,XALAPA,7,532,6,545,2125
VERACRUZ,XALAPA,14,472,5,491,2125
VERACRUZ,XALAPA,26,346,0,372,2069
VERACRUZ,XALAPA,32,308,7,347,2068
VERACRUZ,XALAPA,27,318,11,356,2068
VERACRUZ,XALAPA,26,308,4,338,1524
VERACRUZ,XALAPA,20,326,7,353,1523
VERACRUZ,XALAPA,24,312,6,342,1523
VERACRUZ,XALAPA,39,302,4,345,1717
VERACRUZ,XALAPA,25,330,0,355,1716
VERACRUZ,XALAPA,30,332,5,367,1716
VERACRUZ,XALAPA,39,278,7,324,1876
VERACRUZ,XALAPA,49,267,4,320,1875
VERACRUZ,XALAPA,46,271,0,317,1766
VERACRUZ,XALAPA,276,49,2,327,1765
VERACRUZ,XALAPA,52,294,4,350,1765
VERACRUZ,XALAPA,43,181,6,230,1674
VERACRUZ,XALAPA,35,213,5,253,1673
VERACRUZ,XALAPA,43,214,0,257,1888
VERACRUZ,XALAPA,47,231,6,284,1887
VERACRUZ,XALAPA,37,229,4,270,1748
VERACRUZ,XALAPA,38,195,7,240,1748
VERACRUZ,XALAPA,36,262,5,303,1748
VERACRUZ,XALAPA,26,275,7,308,2052
VERACRUZ,XALAPA,24,246,8,278,2052
VERACRUZ,XALAPA,15,291,7,313,2052
VERACRUZ,XALAPA,31,278,10,319,2051
VERACRUZ,XALAPA,12,559,27,598,1638
VERACRUZ,XALAPA,21,304,0,325,1526
VERACRUZ,XALAPA,23,323,8,354,1525
VERACRUZ,XALAPA,27,330,1,358,1525
VERACRUZ,XALAPA,13,209,10,232,1242
VERACRUZ,XALAPA,13,208,9,230,1242
VERACRUZ,XALAPA,16,407,13,436,1286
VERACRUZ,XALAPA,5,407,10,422,1285
VERACRUZ,XALAPA,5,367,8,380,1518
VERACRUZ,XALAPA,8,634,7,649,1726
VERACRUZ,XALAPA,13,573,12,598,1726
VERACRUZ,XALAPA,16,466,17,499,1298
VERACRUZ,XALAPA,7,468,5,480,1297
VERACRUZ,XALAPA,12,521,17,550,1919
VERACRUZ,XALAPA,17,539,15,571,1347
VERACRUZ,XALAPA,12,537,6,555,1346
VERACRUZ,XALAPA,21,679,25,725,1839
VERACRUZ,XALAPA,19,610,8,637,1839
VERACRUZ,XALAPA,9,479,7,495,1409
VERACRUZ,XALAPA,13,476,5,494,1556
VERACRUZ,XALAPA,8,393,5,406,1556
VERACRUZ,XALAPA,10,468,6,484,1555
VERACRUZ,XALAPA,13,383,6,402,2049
VERACRUZ,XALAPA,23,347,6,376,2049
VERACRUZ,XALAPA,16,386,10,412,1764
VERACRUZ,XALAPA,15,363,9,387,1764
VERACRUZ,XALAPA,16,402,8,426,1618
VERACRUZ,XALAPA,25,438,9,472,1617
VERACRUZ,XALAPA,13,396,11,420,1337
VERACRUZ,XALAPA,16,303,7,326,1290
VERACRUZ,XALAPA,12,269,6,287,1289
VERACRUZ,XALAPA,7,447,6,460,1427
VERACRUZ,XALAPA,27,353,3,383,1784
VERACRUZ,XALAPA,24,348,2,374,1784
VERACRUZ,XALAPA,6,361,5,372,1739
VERACRUZ,XALAPA,3,373,5,381,1739
VERACRUZ,XALAPA,8,353,4,365,1739
VERACRUZ,XALAPA,6,295,2,303,1195
VERACRUZ,XALAPA,6,317,2,325,1195
VERACRUZ,XALAPA,10,546,4,560,1398
VERACRUZ,XALAPA,9,376,2,387,1130
VERACRUZ,XALAPA,11,386,9,406,1129
VERACRUZ,XALAPA,11,371,20,402,1141
VERACRUZ,XALAPA,10,381,15,406,1141
VERACRUZ,XALAPA,7,596,6,609,1407
VERACRUZ,XALAPA,11,546,9,566,1406
VERACRUZ,XALAPA,21,462,20,503,2138
VERACRUZ,XALAPA,23,442,27,492,2137
VERACRUZ,XALAPA,11,432,7,450,1240
VERACRUZ,XALAPA,9,357,3,369,1239
VERACRUZ,XALAPA,20,661,22,703,1612
VERACRUZ,XALAPA,12,707,18,737,1612
VERACRUZ,XALAPA,11,200,6,217,1220
VERACRUZ,XALAPA,19,234,5,258,1220
VERACRUZ,XALAPA,36,263,11,310,1797
VERACRUZ,XALAPA,15,344,9,368,1883
VERACRUZ,XALAPA,15,315,6,336,1883
VERACRUZ,XALAPA,21,315,24,360,1848
VERACRUZ,XALAPA,16,385,10,411,1847
VERACRUZ,XALAPA,37,471,13,521,2007
VERACRUZ,XALAPA,18,473,11,502,1623
VERACRUZ,XALAPA,22,487,8,517,1623
VERACRUZ,XALAPA,10,378,1,389,1721
VERACRUZ,XALAPA,14,442,3,459,1720
VERACRUZ,XALAPA,9,393,5,407,1720
VERACRUZ,XALAPA,13,673,0,686,1666
VERACRUZ,XALAPA,9,535,0,544,1666
VERACRUZ,XALAPA,10,417,5,432,1456
VERACRUZ,XALAPA,10,474,2,486,1456
VERACRUZ,XALAPA,8,474,6,488,1455
VERACRUZ,XALAPA,18,498,9,525,1852
VERACRUZ,XALAPA,18,466,4,488,1852
VERACRUZ,XALAPA,4,311,3,318,1327
VERACRUZ,XALAPA,9,312,2,323,1326
VERACRUZ,XALAPA,15,433,4,452,1311
VERACRUZ,XALAPA,8,460,1,469,1311
VERACRUZ,XALAPA,15,525,0,540,1724
VERACRUZ,XALAPA,13,767,5,785,1932
VERACRUZ,XALAPA,14,754,12,780,1932
VERACRUZ,XALAPA,14,493,16,523,1661
VERACRUZ,XALAPA,7,563,2,572,1660
VERACRUZ,COATEPEC,18,276,11,305,1438
VERACRUZ,COATEPEC,12,230,6,248,1438
VERACRUZ,COATEPEC,25,394,8,427,1827
VERACRUZ,COATEPEC,30,386,8,424,1827
VERACRUZ,COATEPEC,11,168,16,195,1139
VERACRUZ,COATEPEC,14,162,9,185,1138
VERACRUZ,COATEPEC,35,267,11,313,1669
VERACRUZ,COATEPEC,34,230,8,272,1669
VERACRUZ,COATEPEC,32,213,17,262,1669
VERACRUZ,COATEPEC,19,264,11,294,1235
VERACRUZ,COATEPEC,12,273,8,293,1235
VERACRUZ,COATEPEC,33,180,7,220,2038
VERACRUZ,COATEPEC,31,243,6,280,2037
VERACRUZ,COATEPEC,33,123,11,167,1183
VERACRUZ,COATEPEC,26,98,8,132,1182
VERACRUZ,COATEPEC,36,122,27,185,1136
VERACRUZ,COATEPEC,79,126,7,212,1135
VERACRUZ,COATEPEC,48,396,10,454,1900
VERACRUZ,COATEPEC,45,450,6,501,1900
VERACRUZ,COATEPEC,33,384,8,425,1648
VERACRUZ,COATEPEC,36,326,6,368,1648
VERACRUZ,COATEPEC,37,328,14,379,1648
VERACRUZ,COATEPEC,29,393,10,432,1731
VERACRUZ,COATEPEC,32,366,15,413,1731
VERACRUZ,COATEPEC,34,394,9,437,1731
VERACRUZ,COATEPEC,43,393,6,442,1955
VERACRUZ,COATEPEC,31,398,6,435,1955
VERACRUZ,COATEPEC,43,331,6,380,1455
VERACRUZ,COATEPEC,28,316,7,351,1455
VERACRUZ,COATEPEC,24,381,18,423,1970
VERACRUZ,COATEPEC,22,402,20,444,1969
VERACRUZ,COATEPEC,15,420,7,442,1912
VERACRUZ,COATEPEC,23,409,14,446,1911
VERACRUZ,COATEPEC,25,365,5,395,1765
VERACRUZ,COATEPEC,21,371,11,403,1764
VERACRUZ,COATEPEC,30,376,6,412,1909
VERACRUZ,COATEPEC,37,386,9,432,1909
VERACRUZ,COATEPEC,41,389,9,439,1771
VERACRUZ,COATEPEC,29,385,7,421,1771
VERACRUZ,COATEPEC,15,246,10,271,1406
VERACRUZ,COATEPEC,22,239,7,268,1405
VERACRUZ,COATEPEC,22,404,9,435,1847
VERACRUZ,COATEPEC,26,424,11,461,1847
VERACRUZ,COATEPEC,32,364,12,408,1759
VERACRUZ,COATEPEC,42,335,6,383,1758
VERACRUZ,COATEPEC,29,348,6,383,1718
VERACRUZ,COATEPEC,39,363,4,406,1717
VERACRUZ,COATEPEC,116,1162,22,1300,0
VERACRUZ,COATEPEC,28,344,8,380,1692
VERACRUZ,COATEPEC,25,327,7,359,1692
VERACRUZ,COATEPEC,28,334,11,373,1692
VERACRUZ,COATEPEC,29,397,12,438,1761
VERACRUZ,COATEPEC,17,382,8,407,1760
VERACRUZ,COATEPEC,29,318,7,354,1469
VERACRUZ,COATEPEC,20,300,4,324,1469
VERACRUZ,COATEPEC,21,298,6,325,1469
VERACRUZ,COATEPEC,13,223,5,241,1143
VERACRUZ,COATEPEC,15,224,7,246,1143
VERACRUZ,COATEPEC,33,332,12,377,1876
VERACRUZ,COATEPEC,17,349,3,369,1875
VERACRUZ,COATEPEC,29,346,15,390,1738
VERACRUZ,COATEPEC,29,375,13,417,1737
VERACRUZ,COATEPEC,27,519,12,558,2024
VERACRUZ,COATEPEC,26,553,14,593,2023
VERACRUZ,COATEPEC,17,443,11,471,1655
VERACRUZ,COATEPEC,22,363,9,394,1654
VERACRUZ,COATEPEC,10,309,7,326,1308
VERACRUZ,COATEPEC,15,241,7,263,1307
VERACRUZ,COATEPEC,16,556,20,592,2101
VERACRUZ,COATEPEC,25,525,17,567,2101
VERACRUZ,COATEPEC,6,403,14,423,1298
VERACRUZ,COATEPEC,6,325,15,346,1298
VERACRUZ,COATEPEC,21,610,12,643,2050
VERACRUZ,COATEPEC,17,585,16,618,2050
VERACRUZ,COATEPEC,25,386,17,428,1606
VERACRUZ,COATEPEC,18,378,20,416,1606
VERACRUZ,COATEPEC,18,349,12,379,1606
VERACRUZ,COATEPEC,26,455,19,500,1836
VERACRUZ,COATEPEC,19,495,27,541,1835
VERACRUZ,COATEPEC,19,439,28,486,1835
VERACRUZ,COATEPEC,31,279,12,322,1740
VERACRUZ,COATEPEC,29,298,17,344,1739
VERACRUZ,COATEPEC,39,176,4,219,1945
VERACRUZ,COATEPEC,22,244,21,287,1306
VERACRUZ,COATEPEC,23,266,22,311,1306
VERACRUZ,COATEPEC,29,459,12,500,1612
VERACRUZ,COATEPEC,21,422,6,449,1612
VERACRUZ,COATEPEC,30,601,16,647,2002
VERACRUZ,COATEPEC,27,609,15,651,2002
VERACRUZ,COATEPEC,23,461,16,500,1544
VERACRUZ,COATEPEC,29,444,17,490,1544
VERACRUZ,COATEPEC,18,249,9,276,1472
VERACRUZ,COATEPEC,13,235,5,253,1472
VERACRUZ,COATEPEC,9,155,1,165,1134
VERACRUZ,COATEPEC,15,128,4,147,1134
VERACRUZ,COATEPEC,21,255,6,282,1486
VERACRUZ,COATEPEC,27,248,3,278,1486
VERACRUZ,COATEPEC,19,260,4,283,1279
VERACRUZ,COATEPEC,8,239,6,253,1279
VERACRUZ,COATEPEC,11,241,3,255,1668
VERACRUZ,COATEPEC,14,282,6,302,1668
VERACRUZ,COATEPEC,15,261,1,277,2041
VERACRUZ,COATEPEC,8,240,8,256,2041
VERACRUZ,COATEPEC,12,265,4,281,2040
VERACRUZ,COATEPEC,20,225,6,251,1549
VERACRUZ,COATEPEC,16,229,2,247,1549
VERACRUZ,COATEPEC,13,252,3,268,1549
VERACRUZ,COATEPEC,11,254,3,268,1943
VERACRUZ,COATEPEC,10,288,5,303,1942
VERACRUZ,COATEPEC,18,334,9,361,1529
VERACRUZ,COATEPEC,15,326,4,345,1528
VERACRUZ,COATEPEC,6,208,8,222,1522
VERACRUZ,COATEPEC,14,235,2,251,1521
VERACRUZ,COATEPEC,14,283,4,301,1521
VERACRUZ,COATEPEC,28,169,19,216,1225
VERACRUZ,COATEPEC,23,180,6,209,1225
VERACRUZ,COATEPEC,13,335,7,355,1557
VERACRUZ,COATEPEC,20,316,10,346,1556
VERACRUZ,COATEPEC,34,307,6,347,1623
VERACRUZ,COATEPEC,15,372,3,390,1622
VERACRUZ,COATEPEC,26,309,14,349,1674
VERACRUZ,COATEPEC,20,313,8,341,1673
VERACRUZ,COATEPEC,30,487,13,530,1395
VERACRUZ,COATEPEC,22,584,14,620,1893
VERACRUZ,COATEPEC,28,604,14,646,2077
VERACRUZ,COATEPEC,44,603,10,657,2076
VERACRUZ,COATEPEC,42,414,12,468,1974
VERACRUZ,COATEPEC,21,319,8,348,1658
VERACRUZ,COATEPEC,20,332,5,357,1657
VERACRUZ,COATEPEC,19,435,13,467,1560
VERACRUZ,COATEPEC,20,384,10,414,1560
VERACRUZ,COATEPEC,13,379,6,398,1560
VERACRUZ,COATEPEC,14,368,6,388,1520
VERACRUZ,COATEPEC,16,343,11,370,1519
VERACRUZ,COATEPEC,17,369,8,394,1519
VERACRUZ,COATEPEC,38,432,19,489,1732
VERACRUZ,COATEPEC,40,388,19,447,1731
VERACRUZ,COATEPEC,20,505,9,534,1535
VERACRUZ,COATEPEC,21,486,6,513,1535
VERACRUZ,COATEPEC,31,611,10,652,1924
VERACRUZ,COATEPEC,44,629,16,689,1924
VERACRUZ,COATEPEC,36,653,13,702,2088
VERACRUZ,COATEPEC,10,500,23,533,2111
VERACRUZ,COATEPEC,15,504,15,534,1267
VERACRUZ,COATEPEC,18,467,15,500,1267
VERACRUZ,COATEPEC,136,586,27,749,1666
VERACRUZ,COATEPEC,100,754,20,874,1665
VERACRUZ,COATEPEC,130,582,40,752,1665
VERACRUZ,COATEPEC,131,612,57,800,1379
VERACRUZ,COATEPEC,113,627,44,784,1378
VERACRUZ,COATEPEC,21,212,6,239,1219
VERACRUZ,COATEPEC,12,224,10,246,1219
VERACRUZ,COATEPEC,29,204,6,239,1177
VERACRUZ,COATEPEC,28,219,8,255,1177
VERACRUZ,COATEPEC,32,315,6,353,1889
VERACRUZ,COATEPEC,26,317,14,357,1889
VERACRUZ,COATEPEC,16,370,11,397,1889
VERACRUZ,COATEPEC,12,187,20,219,1087
VERACRUZ,COATEPEC,23,220,16,259,1086
VERACRUZ,COATEPEC,22,304,14,340,1227
VERACRUZ,COATEPEC,9,520,10,539,1957
VERACRUZ,COATEPEC,19,506,16,541,1957
VERACRUZ,COATEPEC,13,461,9,483,2074
VERACRUZ,COATEPEC,9,563,15,587,2073
VERACRUZ,COATEPEC,14,457,6,477,2011
VERACRUZ,COATEPEC,13,500,11,524,2010
VERACRUZ,COATEPEC,15,404,11,430,1775
VERACRUZ,COATEPEC,15,447,7,469,1775
VERACRUZ,COATEPEC,27,110,0,137,986
VERACRUZ,COATEPEC,59,400,7,466,1856
VERACRUZ,COATEPEC,135,98,19,252,905
VERACRUZ,COATEPEC,30,144,4,178,983
VERACRUZ,COATEPEC,27,392,11,430,1409
VERACRUZ,COATEPEC,11,263,15,289,1095
VERACRUZ,COATEPEC,13,230,5,248,1094
VERACRUZ,COATEPEC,20,386,14,420,1609
VERACRUZ,COATEPEC,23,393,16,432,1609
VERACRUZ,COATEPEC,19,393,26,438,1608
VERACRUZ,XALAPA,37,345,5,387,1726
VERACRUZ,XALAPA,33,344,6,383,1726
VERACRUZ,XALAPA,22,325,10,357,1725
VERACRUZ,XALAPA,33,273,4,310,1341
VERACRUZ,XALAPA,31,258,5,294,1341
VERACRUZ,XALAPA,26,285,6,317,1341
VERACRUZ,XALAPA,19,277,3,299,1500
VERACRUZ,XALAPA,22,303,6,331,1500
VERACRUZ,XALAPA,25,376,7,408,1499
VERACRUZ,XALAPA,10,268,7,285,1528
VERACRUZ,XALAPA,16,269,4,289,1528
VERACRUZ,XALAPA,15,302,7,324,1527
VERACRUZ,XALAPA,21,342,6,369,1802
VERACRUZ,XALAPA,19,357,6,382,1802
VERACRUZ,XALAPA,29,298,7,334,1485
VERACRUZ,XALAPA,24,304,7,335,1485
VERACRUZ,XALAPA,31,352,3,386,1917
VERACRUZ,XALAPA,31,366,11,408,1916
VERACRUZ,XALAPA,22,243,1,266,1444
VERACRUZ,XALAPA,31,239,5,275,1443
VERACRUZ,XALAPA,26,282,6,314,1533
VERACRUZ,XALAPA,20,316,4,340,1532
VERACRUZ,XALAPA,20,339,6,365,1952
VERACRUZ,XALAPA,22,342,10,374,1952
VERACRUZ,XALAPA,22,228,1,251,1254
VERACRUZ,XALAPA,17,200,3,220,1254
VERACRUZ,XALAPA,23,272,5,300,1705
VERACRUZ,XALAPA,21,287,6,314,1705
VERACRUZ,XALAPA,21,261,4,286,1704
VERACRUZ,XALAPA,15,197,2,214,1373
VERACRUZ,XALAPA,18,220,3,241,1372
VERACRUZ,XALAPA,21,251,2,274,1372
VERACRUZ,XALAPA,13,266,6,285,1411
VERACRUZ,XALAPA,26,255,7,288,1411
VERACRUZ,XALAPA,17,247,2,266,1410
VERACRUZ,XALAPA,22,253,11,286,1401
VERACRUZ,XALAPA,14,270,16,300,1401
VERACRUZ,XALAPA,22,266,13,301,1401
VERACRUZ,XALAPA,26,322,6,354,1945
VERACRUZ,XALAPA,16,280,12,308,1944
VERACRUZ,XALAPA,22,367,9,398,1919
VERACRUZ,XALAPA,28,351,8,387,1918
VERACRUZ,XALAPA,27,281,5,313,1443
VERACRUZ,XALAPA,20,286,6,312,1443
VERACRUZ,XALAPA,24,287,7,318,1442
VERACRUZ,XALAPA,17,359,8,384,1843
VERACRUZ,XALAPA,18,348,13,379,1842
VERACRUZ,XALAPA,22,317,4,343,1490
VERACRUZ,XALAPA,20,323,5,348,1490
VERACRUZ,XALAPA,21,288,11,320,1490
VERACRUZ,XALAPA,13,280,6,299,1373
VERACRUZ,XALAPA,19,289,7,315,1373
VERACRUZ,XALAPA,21,302,5,328,1372
VERACRUZ,XALAPA,28,363,5,396,1642
VERACRUZ,XALAPA,27,339,3,369,1641
VERACRUZ,XALAPA,28,368,8,404,1793
VERACRUZ,XALAPA,34,360,8,402,1792
VERACRUZ,XALAPA,23,252,2,277,1426
VERACRUZ,XALAPA,32,273,6,311,1426
VERACRUZ,XALAPA,19,233,9,261,1425
VERACRUZ,XALAPA,25,369,11,405,1968
VERACRUZ,XALAPA,18,338,8,364,1968
VERACRUZ,XALAPA,22,327,8,357,1968
VERACRUZ,XALAPA,42,372,10,424,1886
VERACRUZ,XALAPA,34,358,7,399,1886
VERACRUZ,XALAPA,35,345,2,382,1886
VERACRUZ,XALAPA,42,363,1,406,1886
VERACRUZ,XALAPA,32,247,2,281,1311
VERACRUZ,XALAPA,21,250,5,276,1310
VERACRUZ,XALAPA,13,274,3,290,1677
VERACRUZ,XALAPA,19,273,5,297,1677
VERACRUZ,XALAPA,26,269,0,295,1676
VERACRUZ,XALAPA,18,285,2,305,1676
VERACRUZ,XALAPA,20,279,1,300,1676
VERACRUZ,XALAPA,28,272,3,303,1676
VERACRUZ,XALAPA,17,246,8,271,1676
VERACRUZ,XALAPA,21,249,7,277,1676
VERACRUZ,XALAPA,16,246,3,265,1676
VERACRUZ,XALAPA,37,345,4,386,1933
VERACRUZ,XALAPA,30,349,8,387,1933
VERACRUZ,XALAPA,32,246,4,282,1527
VERACRUZ,XALAPA,26,281,3,310,1527
VERACRUZ,XALAPA,21,261,1,283,1527
VERACRUZ,XALAPA,53,410,7,470,1779
VERACRUZ,XALAPA,23,374,7,404,1779
VERACRUZ,XALAPA,22,324,3,349,1623
VERACRUZ,XALAPA,37,315,3,355,1623
VERACRUZ,XALAPA,30,321,4,355,1538
VERACRUZ,XALAPA,23,299,8,330,1538
VERACRUZ,XALAPA,22,320,8,350,1537
VERACRUZ,XALAPA,35,380,6,421,1927
VERACRUZ,XALAPA,34,346,8,388,1926
VERACRUZ,XALAPA,30,286,4,320,1541
VERACRUZ,XALAPA,24,282,6,312,1541
VERACRUZ,XALAPA,23,316,5,344,1541
VERACRUZ,XALAPA,29,323,2,354,1540
VERACRUZ,XALAPA,37,386,4,427,1924
VERACRUZ,XALAPA,31,382,5,418,1924
VERACRUZ,XALAPA,20,277,6,303,1516
VERACRUZ,XALAPA,25,224,7,256,1516
VERACRUZ,XALAPA,24,239,0,263,1124
VERACRUZ,XALAPA,27,219,1,247,1123
VERACRUZ,XALAPA,32,297,4,333,1509
VERACRUZ,XALAPA,37,278,2,317,1509
VERACRUZ,XALAPA,45,270,1,316,1508
VERACRUZ,XALAPA,26,382,7,415,1914
VERACRUZ,XALAPA,35,348,9,392,1913
VERACRUZ,XALAPA,24,291,5,320,1484
VERACRUZ,XALAPA,26,305,2,333,1484
VERACRUZ,XALAPA,24,285,4,313,1675
VERACRUZ,XALAPA,30,270,2,302,1675
VERACRUZ,XALAPA,24,257,6,287,1674
VERACRUZ,XALAPA,12,172,3,187,1079
VERACRUZ,XALAPA,16,194,0,210,1079
VERACRUZ,XALAPA,41,354,12,407,1857
VERACRUZ,XALAPA,45,353,3,401,1857
VERACRUZ,XALAPA,47,300,4,351,1691
VERACRUZ,XALAPA,46,334,8,388,1691
VERACRUZ,XALAPA,37,301,7,345,1690
VERACRUZ,XALAPA,30,251,2,283,1311
VERACRUZ,XALAPA,24,275,5,304,1311
VERACRUZ,XALAPA,25,210,2,237,1310
VERACRUZ,XALAPA,27,284,5,316,1554
VERACRUZ,XALAPA,29,282,3,314,1553
VERACRUZ,XALAPA,26,290,3,319,1553
VERACRUZ,XALAPA,39,349,2,390,1596
VERACRUZ,XALAPA,37,308,2,347,1595
VERACRUZ,XALAPA,22,253,3,278,1383
VERACRUZ,XALAPA,37,292,6,335,1382
VERACRUZ,XALAPA,24,267,4,295,1382
VERACRUZ,XALAPA,27,318,7,352,1678
VERACRUZ,XALAPA,30,312,9,351,1678
VERACRUZ,XALAPA,41,269,9,319,1485
VERACRUZ,XALAPA,28,225,6,259,1484
VERACRUZ,XALAPA,23,168,5,196,1035
VERACRUZ,XALAPA,18,169,4,191,1034
VERACRUZ,XALAPA,36,306,6,348,1615
VERACRUZ,XALAPA,31,267,3,301,1614
VERACRUZ,XALAPA,23,277,1,301,1614
VERACRUZ,XALAPA,39,336,6,381,1728
VERACRUZ,XALAPA,31,338,4,373,1727
VERACRUZ,XALAPA,39,261,5,305,1502
VERACRUZ,XALAPA,25,256,7,288,1501
VERACRUZ,XALAPA,34,358,4,396,1857
VERACRUZ,XALAPA,35,354,9,398,1856
VERACRUZ,XALAPA,26,222,3,251,1323
VERACRUZ,XALAPA,25,235,1,261,1323
VERACRUZ,XALAPA,44,299,8,351,1764
VERACRUZ,XALAPA,45,235,3,283,1764
VERACRUZ,XALAPA,56,320,10,386,1911
VERACRUZ,XALAPA,60,325,4,389,1911
VERACRUZ,XALAPA,56,348,8,412,1825
VERACRUZ,XALAPA,52,356,3,411,1825
VERACRUZ,XALAPA,37,309,4,350,1801
VERACRUZ,XALAPA,25,344,8,377,1801
VERACRUZ,XALAPA,35,341,6,382,1800
VERACRUZ,XALAPA,112,1871,17,2000,0
VERACRUZ,XALAPA,35,301,3,339,1906
VERACRUZ,XALAPA,41,251,5,297,1905
VERACRUZ,XALAPA,38,417,5,460,1883
VERACRUZ,XALAPA,48,395,7,450,1882
VERACRUZ,XALAPA,26,296,9,331,1445
VERACRUZ,XALAPA,36,324,6,366,1445
VERACRUZ,XALAPA,31,327,4,362,1444
VERACRUZ,XALAPA,49,321,2,372,1769
VERACRUZ,XALAPA,39,331,11,381,1768
VERACRUZ,XALAPA,39,237,3,279,1675
VERACRUZ,XALAPA,33,295,5,333,1674
VERACRUZ,XALAPA,25,273,4,302,1345
VERACRUZ,XALAPA,34,279,5,318,1345
VERACRUZ,XALAPA,33,236,10,279,1345
VERACRUZ,XALAPA,40,404,3,447,1971
VERACRUZ,XALAPA,37,390,9,436,1971
VERACRUZ,XALAPA,44,303,1,348,1811
VERACRUZ,XALAPA,41,297,7,345,1810
VERACRUZ,XALAPA,51,262,1,314,1810
VERACRUZ,XALAPA,48,292,6,346,1810
VERACRUZ,XALAPA,35,403,5,443,1919
VERACRUZ,XALAPA,51,406,7,464,1919
VERACRUZ,XALAPA,13,210,3,226,1080
VERACRUZ,XALAPA,19,214,7,240,1079
VERACRUZ,XALAPA,30,298,2,330,1356
VERACRUZ,XALAPA,33,250,6,289,1355
VERACRUZ,XALAPA,31,366,8,405,1966
VERACRUZ,XALAPA,43,342,6,391,1965
VERACRUZ,XALAPA,36,343,6,385,1690
VERACRUZ,XALAPA,32,322,6,360,1690
VERACRUZ,XALAPA,40,274,4,318,1708
VERACRUZ,XALAPA,38,261,7,306,1708
VERACRUZ,XALAPA,38,280,7,325,1707
VERACRUZ,XALAPA,16,178,3,197,1060
VERACRUZ,XALAPA,23,181,7,211,1059
VERACRUZ,XALAPA,34,275,6,315,1754
VERACRUZ,XALAPA,25,232,3,260,1754
VERACRUZ,XALAPA,14,250,8,272,1754
VERACRUZ,XALAPA,32,273,6,311,1753
VERACRUZ,XALAPA,34,276,4,314,1753
VERACRUZ,XALAPA,26,265,8,299,1753
VERACRUZ,XALAPA,29,259,4,292,1753
VERACRUZ,XALAPA,40,271,6,317,1643
VERACRUZ,XALAPA,21,248,6,275,1643
VERACRUZ,XALAPA,39,242,0,281,1642
VERACRUZ,COATZACOALCOS,33,466,2,501,1945
VERACRUZ,COATZACOALCOS,28,498,0,526,1944
VERACRUZ,COATZACOALCOS,21,439,2,462,1793
VERACRUZ,COATZACOALCOS,12,499,8,519,1792
VERACRUZ,COATZACOALCOS,9,392,0,401,1598
VERACRUZ,COATZACOALCOS,15,391,8,414,1598
VERACRUZ,COATZACOALCOS,16,346,5,367,1253
VERACRUZ,COATZACOALCOS,11,334,5,350,1252
VERACRUZ,COATZACOALCOS,21,391,2,414,1632
VERACRUZ,COATZACOALCOS,14,410,2,426,1631
VERACRUZ,COATZACOALCOS,13,339,4,356,1397
VERACRUZ,COATZACOALCOS,18,308,1,327,1397
VERACRUZ,COATZACOALCOS,19,343,2,364,1396
VERACRUZ,COATZACOALCOS,17,293,3,313,1588
VERACRUZ,COATZACOALCOS,13,311,7,331,1587
VERACRUZ,COATZACOALCOS,16,530,3,549,1686
VERACRUZ,COATZACOALCOS,20,503,4,527,1685
VERACRUZ,COATZACOALCOS,15,340,4,359,1547
VERACRUZ,COATZACOALCOS,14,374,5,393,1547
VERACRUZ,COATZACOALCOS,14,336,5,355,1449
VERACRUZ,COATZACOALCOS,12,359,4,375,1449
VERACRUZ,COATZACOALCOS,9,371,3,383,1448
VERACRUZ,COATZACOALCOS,15,452,4,471,1773
VERACRUZ,COATZACOALCOS,16,462,2,480,1772
VERACRUZ,COATZACOALCOS,20,415,4,439,1687
VERACRUZ,COATZACOALCOS,24,402,1,427,1687
VERACRUZ,COATZACOALCOS,12,363,1,376,1366
VERACRUZ,COATZACOALCOS,5,374,5,384,1366
VERACRUZ,COATZACOALCOS,12,312,2,326,1001
VERACRUZ,COATZACOALCOS,13,295,4,312,1000
VERACRUZ,COATZACOALCOS,17,468,3,488,1558
VERACRUZ,COATZACOALCOS,14,457,0,471,1558
VERACRUZ,COATZACOALCOS,9,298,0,307,1075
VERACRUZ,COATZACOALCOS,4,312,2,318,1075
VERACRUZ,COATZACOALCOS,24,510,9,543,1685
VERACRUZ,COATZACOALCOS,18,563,0,581,1684
VERACRUZ,COATZACOALCOS,19,494,4,517,1626
VERACRUZ,COATZACOALCOS,15,476,4,495,1625
VERACRUZ,COATZACOALCOS,18,465,2,485,1625
VERACRUZ,COATZACOALCOS,5,421,3,429,1445
VERACRUZ,COATZACOALCOS,13,425,5,443,1444
VERACRUZ,COATZACOALCOS,9,429,2,440,1444
VERACRUZ,COATZACOALCOS,5,512,9,526,1712
VERACRUZ,COATZACOALCOS,13,525,8,546,1712
VERACRUZ,COATZACOALCOS,5,340,8,353,1316
VERACRUZ,COATZACOALCOS,7,339,7,353,1315
VERACRUZ,COATZACOALCOS,6,340,5,351,1141
VERACRUZ,COATZACOALCOS,3,318,2,323,1141
VERACRUZ,COATZACOALCOS,7,490,2,499,1682
VERACRUZ,COATZACOALCOS,8,430,12,450,1681
VERACRUZ,COATZACOALCOS,10,416,3,429,1460
VERACRUZ,COATZACOALCOS,10,391,8,409,1460
VERACRUZ,COATZACOALCOS,11,375,5,391,1437
VERACRUZ,COATZACOALCOS,13,403,3,419,1436
VERACRUZ,COATZACOALCOS,13,427,5,445,1436
VERACRUZ,COATZACOALCOS,11,548,7,566,1854
VERACRUZ,COATZACOALCOS,22,545,2,569,1854
VERACRUZ,COATZACOALCOS,11,464,7,482,1569
VERACRUZ,COATZACOALCOS,12,432,8,452,1569
VERACRUZ,COATZACOALCOS,14,425,10,449,1596
VERACRUZ,COATZACOALCOS,10,485,3,498,1596
VERACRUZ,COATZACOALCOS,9,493,7,509,1593
VERACRUZ,COATZACOALCOS,7,463,7,477,1593
VERACRUZ,COATZACOALCOS,10,532,4,546,1875
VERACRUZ,COATZACOALCOS,5,561,3,569,1874
VERACRUZ,COATZACOALCOS,5,350,4,359,1131
VERACRUZ,COATZACOALCOS,6,329,6,341,1131
VERACRUZ,COATZACOALCOS,5,424,5,434,1493
VERACRUZ,COATZACOALCOS,9,491,4,504,1492
VERACRUZ,COATZACOALCOS,7,492,9,508,1851
VERACRUZ,COATZACOALCOS,10,555,7,572,1851
VERACRUZ,COATZACOALCOS,10,459,12,481,1933
VERACRUZ,COATZACOALCOS,14,479,11,504,1932
VERACRUZ,COATZACOALCOS,10,537,9,556,1897
VERACRUZ,COATZACOALCOS,17,542,5,564,1897
VERACRUZ,COATZACOALCOS,11,343,7,361,1166
VERACRUZ,COATZACOALCOS,15,352,4,371,1166
VERACRUZ,COATZACOALCOS,54,1837,18,1909,0
VERACRUZ,COATZACOALCOS,8,480,14,502,1809
VERACRUZ,COATZACOALCOS,8,526,6,540,1808
VERACRUZ,COATZACOALCOS,3,527,9,539,1646
VERACRUZ,COATZACOALCOS,12,552,7,571,1646
VERACRUZ,COATZACOALCOS,6,441,11,458,1809
VERACRUZ,COATZACOALCOS,14,471,6,491,1808
VERACRUZ,COATZACOALCOS,14,646,7,667,1739
VERACRUZ,COATZACOALCOS,9,625,6,640,1738
VERACRUZ,COATZACOALCOS,6,554,7,567,1676
VERACRUZ,COATZACOALCOS,5,513,9,527,1676
VERACRUZ,COATZACOALCOS,4,522,10,536,1675
VERACRUZ,COATZACOALCOS,16,588,4,608,2052
VERACRUZ,COATZACOALCOS,14,1499,5,1518,2052
VERACRUZ,COATZACOALCOS,7,609,4,620,1730
VERACRUZ,COATZACOALCOS,6,614,6,626,1730
VERACRUZ,COATZACOALCOS,8,486,5,499,1470
VERACRUZ,COATZACOALCOS,5,508,8,521,1470
VERACRUZ,COATZACOALCOS,12,576,4,592,1536
VERACRUZ,COATZACOALCOS,9,601,6,616,1536
VERACRUZ,COATZACOALCOS,9,546,8,563,1764
VERACRUZ,COATZACOALCOS,8,505,8,521,1764
VERACRUZ,COATZACOALCOS,12,564,5,581,1764
VERACRUZ,COATZACOALCOS,3,544,9,556,1652
VERACRUZ,COATZACOALCOS,7,518,9,534,1652
VERACRUZ,COATZACOALCOS,16,539,5,560,1652
VERACRUZ,COATZACOALCOS,10,516,13,539,1572
VERACRUZ,COATZACOALCOS,10,599,4,613,1823
VERACRUZ,COATZACOALCOS,3,576,6,585,1822
VERACRUZ,COATZACOALCOS,12,505,11,528,1533
VERACRUZ,COATZACOALCOS,11,441,8,460,1532
VERACRUZ,COATZACOALCOS,7,389,6,402,1357
VERACRUZ,COATZACOALCOS,9,337,3,349,1357
VERACRUZ,COATZACOALCOS,4,358,3,365,1356
VERACRUZ,COATZACOALCOS,3,291,4,298,1077
VERACRUZ,COATZACOALCOS,1,320,4,325,1077
VERACRUZ,COATZACOALCOS,9,568,4,581,1624
VERACRUZ,COATZACOALCOS,14,508,6,528,1623
VERACRUZ,COATZACOALCOS,17,600,10,627,1763
VERACRUZ,COATZACOALCOS,12,622,6,640,1762
VERACRUZ,COATZACOALCOS,10,588,5,603,1888
VERACRUZ,COATZACOALCOS,12,675,7,694,1888
VERACRUZ,COATZACOALCOS,6,436,3,445,1381
VERACRUZ,COATZACOALCOS,1,458,7,466,1380
VERACRUZ,COATZACOALCOS,8,439,3,450,1380
VERACRUZ,COATZACOALCOS,6,286,9,301,1029
VERACRUZ,COATZACOALCOS,6,304,6,316,1029
VERACRUZ,COATZACOALCOS,13,482,14,509,1693
VERACRUZ,COATZACOALCOS,7,520,2,529,1693
VERACRUZ,COATZACOALCOS,12,534,11,557,1805
VERACRUZ,COATZACOALCOS,9,568,9,586,1804
VERACRUZ,COATZACOALCOS,6,500,12,518,1631
VERACRUZ,COATZACOALCOS,6,475,2,483,1630
VERACRUZ,COATZACOALCOS,9,394,5,408,1438
VERACRUZ,COATZACOALCOS,8,438,7,453,1438
VERACRUZ,COATZACOALCOS,6,413,8,427,1273
VERACRUZ,COATZACOALCOS,15,421,13,449,1273
VERACRUZ,COATZACOALCOS,7,425,14,446,1564
VERACRUZ,COATZACOALCOS,8,442,3,453,1564
VERACRUZ,COATZACOALCOS,3,359,4,366,1656
VERACRUZ,COATZACOALCOS,1,470,10,481,1656
VERACRUZ,COATZACOALCOS,4,364,1,369,1655
VERACRUZ,COATZACOALCOS,4,456,3,463,1650
VERACRUZ,COATZACOALCOS,8,411,8,427,1650
VERACRUZ,COATZACOALCOS,9,454,6,469,1865
VERACRUZ,COATZACOALCOS,12,448,7,467,1864
VERACRUZ,COATZACOALCOS,11,392,8,411,1318
VERACRUZ,COATZACOALCOS,12,401,3,416,1317
VERACRUZ,COATZACOALCOS,6,319,0,325,1457
VERACRUZ,COATZACOALCOS,3,308,0,311,1456
VERACRUZ,COATZACOALCOS,5,283,0,288,1558
VERACRUZ,COATZACOALCOS,5,296,3,304,1557
VERACRUZ,COATZACOALCOS,7,312,3,322,1486
VERACRUZ,COATZACOALCOS,4,305,1,310,1485
VERACRUZ,COATZACOALCOS,7,228,0,235,1076
VERACRUZ,COATZACOALCOS,6,257,1,264,1075
VERACRUZ,COATZACOALCOS,13,328,6,347,1541
VERACRUZ,COATZACOALCOS,13,290,2,305,1541
VERACRUZ,COATZACOALCOS,7,280,2,289,1101
VERACRUZ,COATZACOALCOS,10,260,0,270,1101
VERACRUZ,COATZACOALCOS,4,256,4,264,1140
VERACRUZ,COATZACOALCOS,1,220,4,225,1140
VERACRUZ,COATZACOALCOS,6,348,3,357,1745
VERACRUZ,COATZACOALCOS,13,347,1,361,1744
VERACRUZ,COATZACOALCOS,12,346,2,360,1744
VERACRUZ,COATZACOALCOS,18,432,1,451,1837
VERACRUZ,COATZACOALCOS,9,414,5,428,1837
VERACRUZ,COATZACOALCOS,18,501,0,519,1928
VERACRUZ,COATZACOALCOS,15,464,4,483,1928
VERACRUZ,COATZACOALCOS,10,531,11,552,1602
VERACRUZ,COATZACOALCOS,6,441,15,462,1601
VERACRUZ,COATZACOALCOS,22,483,1,506,1896
VERACRUZ,COATZACOALCOS,14,515,0,529,1896
VERACRUZ,COATZACOALCOS,9,366,5,380,1208
VERACRUZ,COATZACOALCOS,13,301,4,318,1208
VERACRUZ,COATZACOALCOS,7,487,12,506,1904
VERACRUZ,COATZACOALCOS,13,475,7,495,1903
VERACRUZ,COATZACOALCOS,8,408,4,420,1665
VERACRUZ,COATZACOALCOS,7,426,4,437,1664
VERACRUZ,COATZACOALCOS,8,382,3,393,1664
VERACRUZ,COATZACOALCOS,6,434,6,446,1626
VERACRUZ,COATZACOALCOS,11,449,5,465,1625
VERACRUZ,COATZACOALCOS,6,460,6,472,1625
VERACRUZ,COATZACOALCOS,12,555,10,577,1810
VERACRUZ,COATZACOALCOS,10,582,2,594,1809
VERACRUZ,COATZACOALCOS,14,467,2,483,1985
VERACRUZ,COATZACOALCOS,20,464,4,488,1984
VERACRUZ,COATZACOALCOS,5,474,10,489,1794
VERACRUZ,COATZACOALCOS,9,494,8,511,1794
VERACRUZ,COATZACOALCOS,12,505,6,523,1793
VERACRUZ,VERACRUZ,40,210,1,251,1895
VERACRUZ,VERACRUZ,25,233,4,262,1895
VERACRUZ,VERACRUZ,24,186,1,211,1788
VERACRUZ,VERACRUZ,31,170,1,202,1788
VERACRUZ,VERACRUZ,25,284,5,314,1851
VERACRUZ,VERACRUZ,22,297,2,321,1851
VERACRUZ,VERACRUZ,29,154,2,185,1826
VERACRUZ,VERACRUZ,28,145,1,174,1826
VERACRUZ,VERACRUZ,29,144,0,173,1826
VERACRUZ,VERACRUZ,34,134,0,168,1826
VERACRUZ,VERACRUZ,39,133,0,172,1877
VERACRUZ,VERACRUZ,36,131,0,167,1877
VERACRUZ,VERACRUZ,18,188,4,210,1130
VERACRUZ,VERACRUZ,23,203,1,227,1129
VERACRUZ,VERACRUZ,27,261,0,288,1724
VERACRUZ,VERACRUZ,18,254,4,276,1724
VERACRUZ,VERACRUZ,33,242,2,277,1453
VERACRUZ,VERACRUZ,33,242,2,277,1453
VERACRUZ,VERACRUZ,22,242,1,265,1452
VERACRUZ,VERACRUZ,25,181,3,209,1943
VERACRUZ,VERACRUZ,28,168,3,199,1942
VERACRUZ,VERACRUZ,43,262,6,311,1750
VERACRUZ,VERACRUZ,31,273,7,311,1750
VERACRUZ,VERACRUZ,26,259,3,288,1750
VERACRUZ,VERACRUZ,16,200,8,224,1488
VERACRUZ,VERACRUZ,15,234,5,254,1487
VERACRUZ,VERACRUZ,22,74,1,97,1039
VERACRUZ,VERACRUZ,15,89,2,106,1038
VERACRUZ,VERACRUZ,26,225,3,254,1617
VERACRUZ,VERACRUZ,17,231,3,251,1616
VERACRUZ,VERACRUZ,16,256,5,277,1520
VERACRUZ,VERACRUZ,26,244,7,277,1520
VERACRUZ,VERACRUZ,16,240,4,260,1402
VERACRUZ,VERACRUZ,23,256,5,284,1402
VERACRUZ,VERACRUZ,16,163,0,179,1333
VERACRUZ,VERACRUZ,14,155,2,171,1333
VERACRUZ,VERACRUZ,18,184,0,202,1332
VERACRUZ,VERACRUZ,31,301,2,334,1958
VERACRUZ,VERACRUZ,15,339,4,358,1957
VERACRUZ,VERACRUZ,26,293,0,319,1943
VERACRUZ,VERACRUZ,30,262,1,293,1942
VERACRUZ,VERACRUZ,10,272,2,284,1715
VERACRUZ,VERACRUZ,21,280,6,307,1714
VERACRUZ,VERACRUZ,11,187,5,203,1388
VERACRUZ,VERACRUZ,15,182,4,201,1387
VERACRUZ,VERACRUZ,25,289,6,320,1844
VERACRUZ,VERACRUZ,14,319,4,337,1844
VERACRUZ,VERACRUZ,19,280,5,304,1543
VERACRUZ,VERACRUZ,20,242,6,268,1542
VERACRUZ,VERACRUZ,9,201,4,214,1346
VERACRUZ,VERACRUZ,12,210,5,227,1346
VERACRUZ,VERACRUZ,14,226,6,246,1346
VERACRUZ,VERACRUZ,6,79,0,85,1166
VERACRUZ,VERACRUZ,7,183,2,192,1165
VERACRUZ,VERACRUZ,11,207,2,220,1400
VERACRUZ,VERACRUZ,11,214,1,226,1400
VERACRUZ,VERACRUZ,9,225,6,240,1399
VERACRUZ,VERACRUZ,17,204,4,225,1615
VERACRUZ,VERACRUZ,15,242,7,264,1614
VERACRUZ,VERACRUZ,14,253,2,269,1951
VERACRUZ,VERACRUZ,19,250,4,273,1950
VERACRUZ,VERACRUZ,26,207,4,237,1769
VERACRUZ,VERACRUZ,31,198,3,232,1768
VERACRUZ,VERACRUZ,11,111,3,125,1703
VERACRUZ,VERACRUZ,10,151,5,166,1702
VERACRUZ,VERACRUZ,10,167,1,178,1702
VERACRUZ,VERACRUZ,23,138,3,164,1612
VERACRUZ,VERACRUZ,12,129,1,142,1611
VERACRUZ,VERACRUZ,18,206,5,229,1803
VERACRUZ,VERACRUZ,9,180,7,196,1803
VERACRUZ,VERACRUZ,12,165,1,178,1938
VERACRUZ,VERACRUZ,9,117,2,128,1937
VERACRUZ,VERACRUZ,23,145,1,169,1460
VERACRUZ,VERACRUZ,17,138,2,157,1460
VERACRUZ,VERACRUZ,12,123,0,135,1459
VERACRUZ,VERACRUZ,1,377,5,383,1846
VERACRUZ,VERACRUZ,14,346,10,370,1846
VERACRUZ,VERACRUZ,21,392,7,420,1892
VERACRUZ,VERACRUZ,12,381,1,394,1892
VERACRUZ,VERACRUZ,16,233,9,258,829
VERACRUZ,VERACRUZ,18,103,7,128,1451
VERACRUZ,VERACRUZ,24,406,8,438,1450
VERACRUZ,VERACRUZ,13,439,5,457,1450
VERACRUZ,VERACRUZ,11,379,10,400,1358
VERACRUZ,VERACRUZ,5,358,4,367,1358
VERACRUZ,VERACRUZ,4,368,16,388,1357
VERACRUZ,VERACRUZ,10,464,15,489,1924
VERACRUZ,VERACRUZ,23,482,4,509,1923
VERACRUZ,VERACRUZ,10,566,2,578,1762
VERACRUZ,VERACRUZ,26,603,6,635,1762
VERACRUZ,VERACRUZ,19,484,7,510,1430
VERACRUZ,VERACRUZ,16,511,11,538,1429
VERACRUZ,VERACRUZ,12,217,6,235,1378
VERACRUZ,VERACRUZ,14,244,5,263,1378
VERACRUZ,VERACRUZ,14,335,3,352,1769
VERACRUZ,VERACRUZ,13,337,2,352,1769
VERACRUZ,VERACRUZ,19,213,3,235,1262
VERACRUZ,VERACRUZ,16,198,2,216,1261
VERACRUZ,VERACRUZ,11,229,3,243,1259
VERACRUZ,VERACRUZ,9,221,3,233,1259
VERACRUZ,VERACRUZ,18,175,1,194,1344
VERACRUZ,VERACRUZ,23,165,3,191,1344
VERACRUZ,VERACRUZ,152,11,1,164,1343
VERACRUZ,VERACRUZ,8,286,5,299,1180
VERACRUZ,VERACRUZ,13,280,8,301,1179
VERACRUZ,VERACRUZ,7,275,3,285,1339
VERACRUZ,VERACRUZ,12,239,5,256,1339
VERACRUZ,VERACRUZ,13,218,3,234,1338
VERACRUZ,VERACRUZ,16,338,9,363,1835
VERACRUZ,VERACRUZ,9,345,8,362,1834
VERACRUZ,VERACRUZ,11,342,4,357,1834
VERACRUZ,VERACRUZ,20,278,3,301,1455
VERACRUZ,VERACRUZ,12,288,4,304,1455
VERACRUZ,VERACRUZ,15,270,4,289,1455
VERACRUZ,VERACRUZ,24,240,6,270,1493
VERACRUZ,VERACRUZ,15,258,1,274,1493
VERACRUZ,VERACRUZ,20,260,2,282,1392
VERACRUZ,VERACRUZ,17,272,5,294,1392
VERACRUZ,VERACRUZ,25,243,1,269,1391
VERACRUZ,VERACRUZ,25,281,5,311,1627
VERACRUZ,VERACRUZ,20,262,1,283,1626
VERACRUZ,VERACRUZ,32,335,3,370,1836
VERACRUZ,VERACRUZ,20,336,2,358,1836
VERACRUZ,VERACRUZ,17,313,6,336,1506
VERACRUZ,VERACRUZ,15,290,2,307,1506
VERACRUZ,VERACRUZ,98,1533,19,1650,0
VERACRUZ,VERACRUZ,26,351,2,379,1888
VERACRUZ,VERACRUZ,42,375,0,417,1888
VERACRUZ,VERACRUZ,29,265,7,301,1935
VERACRUZ,VERACRUZ,26,257,4,287,1935
VERACRUZ,VERACRUZ,13,295,6,314,1337
VERACRUZ,VERACRUZ,11,282,2,295,1337
VERACRUZ,VERACRUZ,18,284,1,303,1337
VERACRUZ,VERACRUZ,15,334,2,351,1717
VERACRUZ,VERACRUZ,29,350,1,380,1717
VERACRUZ,VERACRUZ,30,334,3,367,1811
VERACRUZ,VERACRUZ,16,321,3,340,1811
VERACRUZ,VERACRUZ,22,267,4,293,1760
VERACRUZ,VERACRUZ,29,238,3,270,1759
VERACRUZ,VERACRUZ,33,219,1,253,1953
VERACRUZ,VERACRUZ,27,229,4,260,1952
VERACRUZ,VERACRUZ,24,212,2,238,1411
VERACRUZ,VERACRUZ,21,211,2,234,1410
VERACRUZ,VERACRUZ,23,225,4,252,1410
VERACRUZ,VERACRUZ,27,239,1,267,1372
VERACRUZ,VERACRUZ,20,225,1,246,1372
VERACRUZ,VERACRUZ,24,257,2,283,1371
VERACRUZ,VERACRUZ,32,382,5,419,1847
VERACRUZ,VERACRUZ,24,362,5,391,1846
VERACRUZ,VERACRUZ,13,244,1,258,1580
VERACRUZ,VERACRUZ,14,253,0,267,1579
VERACRUZ,VERACRUZ,12,255,2,269,1579
VERACRUZ,VERACRUZ,14,234,3,251,1577
VERACRUZ,VERACRUZ,15,239,0,254,1576
VERACRUZ,VERACRUZ,30,212,3,245,1771
VERACRUZ,VERACRUZ,17,187,2,206,1770
VERACRUZ,VERACRUZ,14,250,2,266,1547
VERACRUZ,VERACRUZ,23,292,2,317,1547
VERACRUZ,VERACRUZ,23,215,5,243,1254
VERACRUZ,VERACRUZ,14,219,3,236,1253
VERACRUZ,VERACRUZ,23,262,0,285,1611
VERACRUZ,VERACRUZ,18,298,2,318,1611
VERACRUZ,VERACRUZ,20,191,5,216,1013
VERACRUZ,VERACRUZ,15,170,4,189,1012
VERACRUZ,VERACRUZ,14,148,4,166,1012
VERACRUZ,VERACRUZ,17,124,2,143,1011
VERACRUZ,VERACRUZ,27,162,2,191,1553
VERACRUZ,VERACRUZ,29,177,0,206,1553
VERACRUZ,VERACRUZ,22,292,5,319,1832
VERACRUZ,VERACRUZ,15,301,6,322,1831
VERACRUZ,VERACRUZ,16,138,1,155,1258
VERACRUZ,VERACRUZ,16,145,4,165,1258
VERACRUZ,VERACRUZ,26,124,2,152,1548
VERACRUZ,VERACRUZ,23,144,1,168,1548
VERACRUZ,VERACRUZ,27,126,1,154,1547
VERACRUZ,VERACRUZ,39,175,5,219,1701
VERACRUZ,VERACRUZ,38,194,2,234,1700
VERACRUZ,VERACRUZ,18,233,4,255,1509
VERACRUZ,VERACRUZ,18,233,2,253,1509
VERACRUZ,VERACRUZ,21,235,6,262,1333
VERACRUZ,VERACRUZ,20,248,0,268,1333
VERACRUZ,VERACRUZ,15,231,2,248,1333
VERACRUZ,VERACRUZ,39,168,7,214,1516
VERACRUZ,VERACRUZ,45,203,1,249,1515
VERACRUZ,VERACRUZ,13,154,0,167,1055
VERACRUZ,VERACRUZ,8,168,3,179,1054
VERACRUZ,VERACRUZ,25,211,3,239,1680
VERACRUZ,VERACRUZ,24,189,0,213,1679
VERACRUZ,VERACRUZ,34,202,4,240,1679
VERACRUZ,VERACRUZ,22,205,1,228,1554
VERACRUZ,VERACRUZ,19,205,5,229,1554
VERACRUZ,VERACRUZ,32,205,2,239,1621
VERACRUZ,VERACRUZ,36,210,2,248,1621
VERACRUZ,VERACRUZ,19,344,8,371,1514
VERACRUZ,VERACRUZ,7,359,5,371,1514
VERACRUZ,VERACRUZ,16,381,7,404,1513
VERACRUZ,VERACRUZ,14,508,10,532,1713
VERACRUZ,VERACRUZ,26,540,7,573,1712
VERACRUZ,VERACRUZ,21,146,0,167,1567
VERACRUZ,VERACRUZ,17,181,1,199,1567
VERACRUZ,VERACRUZ,24,180,0,204,1566
VERACRUZ,VERACRUZ,12,201,5,218,1704
VERACRUZ,VERACRUZ,16,167,0,183,1704
VERACRUZ,VERACRUZ,17,129,1,147,1345
VERACRUZ,VERACRUZ,14,154,2,170,1344
VERACRUZ,VERACRUZ,9,143,0,152,1543
VERACRUZ,VERACRUZ,13,177,0,190,1543
VERACRUZ,VERACRUZ,6,228,2,236,1863
VERACRUZ,VERACRUZ,12,196,3,211,1862
VERACRUZ,VERACRUZ,19,175,2,196,1135
VERACRUZ,VERACRUZ,8,164,0,172,1134
VERACRUZ,VERACRUZ,7,123,3,133,1180
VERACRUZ,VERACRUZ,7,129,1,137,1179
VERACRUZ,HUATUSCO,19,671,18,708,1688
VERACRUZ,HUATUSCO,25,785,12,822,1687
VERACRUZ,HUATUSCO,31,715,19,765,1687
VERACRUZ,HUATUSCO,16,431,18,465,1702
VERACRUZ,HUATUSCO,8,402,17,427,1701
VERACRUZ,HUATUSCO,19,428,20,467,1701
VERACRUZ,HUATUSCO,15,614,12,641,2034
VERACRUZ,HUATUSCO,8,844,11,863,1981
VERACRUZ,HUATUSCO,11,338,12,361,1417
VERACRUZ,HUATUSCO,8,298,5,311,1417
VERACRUZ,HUATUSCO,13,410,8,431,1416
VERACRUZ,HUATUSCO,17,423,21,461,1525
VERACRUZ,HUATUSCO,21,376,8,405,1525
VERACRUZ,HUATUSCO,20,362,16,398,1808
VERACRUZ,HUATUSCO,13,471,23,507,1808
VERACRUZ,HUATUSCO,24,405,16,445,1807
VERACRUZ,HUATUSCO,13,392,9,414,1169
VERACRUZ,HUATUSCO,14,435,3,452,1169
VERACRUZ,HUATUSCO,25,724,34,783,1996
VERACRUZ,HUATUSCO,22,662,53,737,1996
VERACRUZ,HUATUSCO,14,394,9,417,1523
VERACRUZ,HUATUSCO,7,363,15,385,1522
VERACRUZ,HUATUSCO,12,486,7,505,1959
VERACRUZ,HUATUSCO,7,521,1,529,1959
VERACRUZ,HUATUSCO,17,602,11,630,1912
VERACRUZ,HUATUSCO,7,565,8,580,1911
VERACRUZ,HUATUSCO,10,557,10,577,1911
VERACRUZ,HUATUSCO,6,454,13,473,1910
VERACRUZ,HUATUSCO,13,404,21,438,1910
VERACRUZ,HUATUSCO,7,430,8,445,1898
VERACRUZ,HUATUSCO,11,466,9,486,1897
VERACRUZ,HUATUSCO,10,417,9,436,1897
VERACRUZ,HUATUSCO,17,396,10,423,1981
VERACRUZ,HUATUSCO,13,406,3,422,1981
VERACRUZ,HUATUSCO,25,370,10,405,1981
VERACRUZ,HUATUSCO,5,461,3,469,1895
VERACRUZ,HUATUSCO,7,390,12,409,1895
VERACRUZ,HUATUSCO,7,416,10,433,1895
VERACRUZ,HUATUSCO,15,476,14,505,1636
VERACRUZ,HUATUSCO,23,426,6,455,1636
VERACRUZ,HUATUSCO,35,360,7,402,1963
VERACRUZ,HUATUSCO,18,343,11,372,1963
VERACRUZ,HUATUSCO,32,328,3,363,1962
VERACRUZ,HUATUSCO,34,383,8,425,2039
VERACRUZ,HUATUSCO,28,398,10,436,2039
VERACRUZ,HUATUSCO,31,351,8,390,1641
VERACRUZ,HUATUSCO,21,302,13,336,1641
VERACRUZ,HUATUSCO,27,326,5,358,1641
VERACRUZ,HUATUSCO,34,291,11,336,1894
VERACRUZ,HUATUSCO,31,327,6,364,1894
VERACRUZ,HUATUSCO,25,279,8,312,1893
VERACRUZ,HUATUSCO,34,330,7,371,1966
VERACRUZ,HUATUSCO,29,346,10,385,1965
VERACRUZ,HUATUSCO,33,310,18,361,1965
VERACRUZ,HUATUSCO,75,498,13,586,0
VERACRUZ,HUATUSCO,47,186,40,273,1074
VERACRUZ,HUATUSCO,68,190,28,286,1074
VERACRUZ,HUATUSCO,36,307,12,355,1461
VERACRUZ,HUATUSCO,35,241,17,293,1460
VERACRUZ,HUATUSCO,49,214,15,278,1498
VERACRUZ,HUATUSCO,36,211,10,257,1497
VERACRUZ,HUATUSCO,22,155,9,186,1717
VERACRUZ,HUATUSCO,42,187,18,247,1717
VERACRUZ,HUATUSCO,44,316,14,374,1440
VERACRUZ,HUATUSCO,38,297,20,355,1619
VERACRUZ,HUATUSCO,44,252,10,306,1619
VERACRUZ,HUATUSCO,11,270,9,290,1682
VERACRUZ,HUATUSCO,11,266,10,287,1682
VERACRUZ,HUATUSCO,23,293,12,328,1747
VERACRUZ,HUATUSCO,10,294,18,322,1747
VERACRUZ,HUATUSCO,11,315,10,336,1812
VERACRUZ,HUATUSCO,12,331,10,353,1812
VERACRUZ,HUATUSCO,12,216,13,241,1330
VERACRUZ,HUATUSCO,3,252,19,274,1329
VERACRUZ,HUATUSCO,19,409,6,434,1837
VERACRUZ,HUATUSCO,16,392,10,418,1836
VERACRUZ,HUATUSCO,21,538,14,573,1866
VERACRUZ,HUATUSCO,14,558,20,592,1865
VERACRUZ,HUATUSCO,11,556,26,593,1865
VERACRUZ,HUATUSCO,24,415,11,450,1828
VERACRUZ,HUATUSCO,18,434,8,460,1828
VERACRUZ,HUATUSCO,13,500,18,531,1709
VERACRUZ,HUATUSCO,17,523,14,554,1708
VERACRUZ,HUATUSCO,6,487,12,505,1708
VERACRUZ,HUATUSCO,16,401,14,431,1533
VERACRUZ,HUATUSCO,14,450,17,481,1532
VERACRUZ,HUATUSCO,23,797,15,835,2023
VERACRUZ,HUATUSCO,2,362,4,368,1485
VERACRUZ,HUATUSCO,13,330,9,352,1485
VERACRUZ,HUATUSCO,11,386,7,404,1484
VERACRUZ,HUATUSCO,16,297,4,317,1307
VERACRUZ,HUATUSCO,11,337,8,356,1307
VERACRUZ,HUATUSCO,12,451,8,471,1516
VERACRUZ,HUATUSCO,8,481,11,500,1516
VERACRUZ,HUATUSCO,24,422,8,454,2029
VERACRUZ,HUATUSCO,19,507,6,532,2029
VERACRUZ,HUATUSCO,6,311,5,322,1072
VERACRUZ,HUATUSCO,9,306,9,324,1072
VERACRUZ,HUATUSCO,15,388,11,414,1909
VERACRUZ,HUATUSCO,9,414,7,430,1908
VERACRUZ,HUATUSCO,9,362,6,377,1081
VERACRUZ,HUATUSCO,12,378,6,396,1081
VERACRUZ,HUATUSCO,6,247,0,253,1058
VERACRUZ,HUATUSCO,6,271,5,282,1057
VERACRUZ,HUATUSCO,29,469,17,515,1432
VERACRUZ,HUATUSCO,27,469,13,509,1432
VERACRUZ,HUATUSCO,13,446,3,462,1744
VERACRUZ,HUATUSCO,14,454,14,482,1744
VERACRUZ,HUATUSCO,8,432,9,449,1743
VERACRUZ,HUATUSCO,12,458,2,472,1520
VERACRUZ,HUATUSCO,3,427,3,433,1520
VERACRUZ,HUATUSCO,1,465,6,472,1520
VERACRUZ,HUATUSCO,16,273,13,302,1437
VERACRUZ,HUATUSCO,13,298,7,318,1437
VERACRUZ,HUATUSCO,11,256,8,275,1436
VERACRUZ,HUATUSCO,10,365,13,388,1206
VERACRUZ,HUATUSCO,10,326,4,340,1205
VERACRUZ,HUATUSCO,7,337,14,358,1240
VERACRUZ,HUATUSCO,9,359,11,379,1240
VERACRUZ,HUATUSCO,22,456,17,495,1614
VERACRUZ,HUATUSCO,23,414,16,453,1613
VERACRUZ,HUATUSCO,10,344,4,358,1450
VERACRUZ,HUATUSCO,15,312,2,329,1450
VERACRUZ,HUATUSCO,14,373,8,395,1940
VERACRUZ,HUATUSCO,21,395,4,420,1939
VERACRUZ,HUATUSCO,4,412,4,420,1939
VERACRUZ,HUATUSCO,15,375,4,394,1886
VERACRUZ,HUATUSCO,13,356,5,374,1886
VERACRUZ,HUATUSCO,10,402,5,417,1885
VERACRUZ,HUATUSCO,18,307,1,326,1668
VERACRUZ,HUATUSCO,9,303,4,316,1668
VERACRUZ,HUATUSCO,17,255,6,278,1533
VERACRUZ,HUATUSCO,12,279,10,301,1533
VERACRUZ,HUATUSCO,9,393,3,405,1680
VERACRUZ,HUATUSCO,4,351,3,358,1680
VERACRUZ,HUATUSCO,11,357,0,368,1680
VERACRUZ,HUATUSCO,12,448,6,466,1968
VERACRUZ,HUATUSCO,17,438,3,458,1968
VERACRUZ,HUATUSCO,16,363,17,396,2011
VERACRUZ,HUATUSCO,11,363,3,377,2011
VERACRUZ,HUATUSCO,9,329,7,345,1694
VERACRUZ,HUATUSCO,10,293,2,305,1693
VERACRUZ,HUATUSCO,14,333,3,350,1693
VERACRUZ,HUATUSCO,21,375,8,404,1713
VERACRUZ,HUATUSCO,15,384,10,409,1712
VERACRUZ,HUATUSCO,26,600,9,635,2088
VERACRUZ,HUATUSCO,10,586,13,609,2005
VERACRUZ,HUATUSCO,14,365,7,386,1931
VERACRUZ,HUATUSCO,7,341,9,357,1930
VERACRUZ,HUATUSCO,7,253,2,262,1670
VERACRUZ,HUATUSCO,11,279,7,297,1670
VERACRUZ,HUATUSCO,23,253,11,287,1644
VERACRUZ,HUATUSCO,15,283,10,308,1644
VERACRUZ,HUATUSCO,10,201,0,211,1453
VERACRUZ,HUATUSCO,17,214,2,233,1453
VERACRUZ,HUATUSCO,8,221,5,234,1359
VERACRUZ,HUATUSCO,16,258,12,286,1358
VERACRUZ,HUATUSCO,24,436,20,480,2067
VERACRUZ,HUATUSCO,23,202,6,231,1070
VERACRUZ,HUATUSCO,19,198,4,221,1069
VERACRUZ,HUATUSCO,6,224,18,248,1326
VERACRUZ,HUATUSCO,16,244,2,262,1326
VERACRUZ,HUATUSCO,7,396,2,405,1663
VERACRUZ,HUATUSCO,15,365,6,386,1662
VERACRUZ,HUATUSCO,14,350,13,377,1551
VERACRUZ,HUATUSCO,14,370,4,388,1550
VERACRUZ,HUATUSCO,5,252,12,269,1657
VERACRUZ,HUATUSCO,3,265,9,277,1656
VERACRUZ,HUATUSCO,11,183,5,199,1039
VERACRUZ,HUATUSCO,9,200,5,214,1039
VERACRUZ,HUATUSCO,7,240,5,252,1122
VERACRUZ,HUATUSCO,6,247,4,257,1121
VERACRUZ,HUATUSCO,10,303,4,317,1315
VERACRUZ,HUATUSCO,11,297,6,314,1315
VERACRUZ,HUATUSCO,7,200,4,211,1421
VERACRUZ,HUATUSCO,6,246,5,257,1420
VERACRUZ,HUATUSCO,9,302,5,316,1426
VERACRUZ,HUATUSCO,14,284,8,306,1426
VERACRUZ,HUATUSCO,4,152,5,161,1069
VERACRUZ,HUATUSCO,6,164,7,177,1069
VERACRUZ,HUATUSCO,10,401,27,438,2100
VERACRUZ,HUATUSCO,20,241,16,277,1235
VERACRUZ,HUATUSCO,14,273,12,299,1235
VERACRUZ,HUATUSCO,10,193,11,214,1199
VERACRUZ,HUATUSCO,7,243,8,258,1199
VERACRUZ,HUATUSCO,20,247,15,282,1746
VERACRUZ,HUATUSCO,29,285,13,327,1746
VERACRUZ,HUATUSCO,21,410,21,452,1577
VERACRUZ,HUATUSCO,29,405,12,446,1577
VERACRUZ,HUATUSCO,34,272,6,312,1562
VERACRUZ,HUATUSCO,38,254,11,303,1561
VERACRUZ,MINATITLAN,6,392,4,402,1485
VERACRUZ,MINATITLAN,15,410,8,433,1484
VERACRUZ,MINATITLAN,7,400,5,412,1484
VERACRUZ,MINATITLAN,9,563,15,587,1820
VERACRUZ,MINATITLAN,11,527,5,543,1819
VERACRUZ,MINATITLAN,5,458,7,470,1456
VERACRUZ,MINATITLAN,13,444,9,466,1455
VERACRUZ,MINATITLAN,9,463,4,476,1455
VERACRUZ,MINATITLAN,6,446,0,452,1898
VERACRUZ,MINATITLAN,5,360,19,384,1727
VERACRUZ,MINATITLAN,8,354,9,371,1726
VERACRUZ,MINATITLAN,11,470,4,485,1549
VERACRUZ,MINATITLAN,14,487,5,506,1548
VERACRUZ,MINATITLAN,8,470,9,487,1726
VERACRUZ,MINATITLAN,7,494,13,514,1725
VERACRUZ,MINATITLAN,8,374,7,389,1668
VERACRUZ,MINATITLAN,9,360,9,378,1668
VERACRUZ,MINATITLAN,11,456,10,477,1720
VERACRUZ,MINATITLAN,3,448,10,461,1720
VERACRUZ,MINATITLAN,10,415,4,429,1719
VERACRUZ,MINATITLAN,12,137,10,159,1083
VERACRUZ,MINATITLAN,5,173,2,180,1083
VERACRUZ,MINATITLAN,12,198,2,212,1144
VERACRUZ,MINATITLAN,8,191,7,206,1144
VERACRUZ,MINATITLAN,11,365,20,396,1831
VERACRUZ,MINATITLAN,6,381,9,396,1830
VERACRUZ,MINATITLAN,18,732,14,764,1793
VERACRUZ,MINATITLAN,17,634,4,655,1792
VERACRUZ,MINATITLAN,4,435,2,441,1369
VERACRUZ,MINATITLAN,6,429,182,617,1369
VERACRUZ,MINATITLAN,7,248,3,258,1369
VERACRUZ,MINATITLAN,11,237,9,257,1456
VERACRUZ,MINATITLAN,3,238,10,251,1455
VERACRUZ,MINATITLAN,10,303,15,328,1557
VERACRUZ,MINATITLAN,21,291,10,322,1557
VERACRUZ,MINATITLAN,17,320,14,351,1556
VERACRUZ,MINATITLAN,14,551,19,584,1944
VERACRUZ,MINATITLAN,12,452,3,467,1359
VERACRUZ,MINATITLAN,14,517,4,535,1358
VERACRUZ,MINATITLAN,7,511,4,522,1358
VERACRUZ,MINATITLAN,4,434,0,438,1473
VERACRUZ,MINATITLAN,6,442,13,461,1473
VERACRUZ,MINATITLAN,2,389,2,393,1473
VERACRUZ,MINATITLAN,4,653,23,680,1599
VERACRUZ,MINATITLAN,8,596,17,621,1599
VERACRUZ,MINATITLAN,12,492,7,511,1005
VERACRUZ,MINATITLAN,13,632,18,663,1922
VERACRUZ,MINATITLAN,18,596,9,623,1921
VERACRUZ,MINATITLAN,10,515,19,544,1522
VERACRUZ,MINATITLAN,11,546,12,569,1522
VERACRUZ,MINATITLAN,8,508,13,529,1822
VERACRUZ,MINATITLAN,4,909,11,924,1822
VERACRUZ,MINATITLAN,16,736,15,767,1822
VERACRUZ,MINATITLAN,3,1179,20,1202,1317
VERACRUZ,MINATITLAN,5,1022,12,1039,1317
VERACRUZ,MINATITLAN,4,1464,2,1470,1543
VERACRUZ,MINATITLAN,6,1492,3,1501,1542
VERACRUZ,MINATITLAN,12,475,59,546,1856
VERACRUZ,MINATITLAN,8,707,9,724,1856
VERACRUZ,MINATITLAN,8,1407,4,1419,1905
VERACRUZ,MINATITLAN,13,1080,3,1096,1904
VERACRUZ,MINATITLAN,8,647,14,669,1794
VERACRUZ,MINATITLAN,21,625,8,654,1794
VERACRUZ,MINATITLAN,4,481,5,490,1712
VERACRUZ,MINATITLAN,6,464,14,484,1712
VERACRUZ,MINATITLAN,9,563,8,580,1725
VERACRUZ,MINATITLAN,8,549,5,562,1725
VERACRUZ,MINATITLAN,7,573,10,590,1725
VERACRUZ,MINATITLAN,7,611,2,620,1905
VERACRUZ,MINATITLAN,8,612,4,624,1905
VERACRUZ,MINATITLAN,6,385,1,392,1172
VERACRUZ,MINATITLAN,7,358,3,368,1172
VERACRUZ,MINATITLAN,22,460,2,484,1677
VERACRUZ,MINATITLAN,21,469,5,495,1676
VERACRUZ,MINATITLAN,16,504,7,527,1676
VERACRUZ,MINATITLAN,11,533,2,546,1873
VERACRUZ,MINATITLAN,12,486,5,503,1873
VERACRUZ,MINATITLAN,10,545,5,560,1832
VERACRUZ,MINATITLAN,14,613,7,634,1832
VERACRUZ,MINATITLAN,13,620,6,639,1899
VERACRUZ,MINATITLAN,16,609,6,631,1899
VERACRUZ,MINATITLAN,6,539,5,550,1649
VERACRUZ,MINATITLAN,13,542,6,561,1648
VERACRUZ,MINATITLAN,24,634,2,660,1860
VERACRUZ,MINATITLAN,9,621,4,634,1859
VERACRUZ,MINATITLAN,18,608,3,629,1859
VERACRUZ,MINATITLAN,7,531,2,540,1489
VERACRUZ,MINATITLAN,10,473,5,488,1489
VERACRUZ,MINATITLAN,16,528,1,545,1489
VERACRUZ,MINATITLAN,20,560,13,593,1851
VERACRUZ,MINATITLAN,15,582,2,599,1850
VERACRUZ,MINATITLAN,14,330,3,347,1054
VERACRUZ,MINATITLAN,15,370,2,387,1054
VERACRUZ,MINATITLAN,12,510,2,524,1490
VERACRUZ,MINATITLAN,7,505,3,515,1489
VERACRUZ,MINATITLAN,45,1322,10,1377,0
VERACRUZ,MINATITLAN,21,459,3,483,1478
VERACRUZ,MINATITLAN,15,416,5,436,1478
VERACRUZ,MINATITLAN,16,642,2,660,1911
VERACRUZ,MINATITLAN,13,624,6,643,1910
VERACRUZ,MINATITLAN,12,500,5,517,1629
VERACRUZ,MINATITLAN,12,491,9,512,1628
VERACRUZ,MINATITLAN,10,475,3,488,1628
VERACRUZ,MINATITLAN,18,541,7,566,1649
VERACRUZ,MINATITLAN,11,535,3,549,1649
VERACRUZ,MINATITLAN,12,388,4,404,1334
VERACRUZ,MINATITLAN,6,385,3,394,1334
VERACRUZ,MINATITLAN,6,402,3,411,1334
VERACRUZ,MINATITLAN,13,486,3,502,1384
VERACRUZ,MINATITLAN,17,480,4,501,1383
VERACRUZ,MINATITLAN,6,298,0,304,1148
VERACRUZ,MINATITLAN,7,261,1,269,1148
VERACRUZ,MINATITLAN,10,268,8,286,1869
VERACRUZ,MINATITLAN,15,326,6,347,1869
VERACRUZ,MINATITLAN,9,315,7,331,1868
VERACRUZ,MINATITLAN,8,317,3,328,1393
VERACRUZ,MINATITLAN,7,336,5,348,1393
VERACRUZ,MINATITLAN,11,292,9,312,1411
VERACRUZ,MINATITLAN,3,343,9,355,1411
VERACRUZ,MINATITLAN,12,464,13,489,1652
VERACRUZ,MINATITLAN,17,373,15,405,1652
VERACRUZ,MINATITLAN,4,242,4,250,1445
VERACRUZ,MINATITLAN,5,301,2,308,1445
VERACRUZ,MINATITLAN,7,270,7,284,1444
VERACRUZ,MINATITLAN,10,355,4,369,1627
VERACRUZ,MINATITLAN,5,301,3,309,1627
VERACRUZ,MINATITLAN,28,445,17,490,1315
VERACRUZ,MINATITLAN,20,583,11,614,1455
VERACRUZ,MINATITLAN,16,582,19,617,1454
VERACRUZ,MINATITLAN,15,589,12,616,1454
VERACRUZ,MINATITLAN,24,569,16,609,1721
VERACRUZ,MINATITLAN,13,502,25,540,1720
VERACRUZ,MINATITLAN,33,607,26,666,1720
VERACRUZ,MINATITLAN,23,502,8,533,1887
VERACRUZ,MINATITLAN,13,573,12,598,1886
VERACRUZ,MINATITLAN,4,392,5,401,1814
VERACRUZ,MINATITLAN,11,357,4,372,1813
VERACRUZ,MINATITLAN,8,296,7,311,1813
VERACRUZ,MINATITLAN,7,295,8,310,1413
VERACRUZ,MINATITLAN,12,368,10,390,1976
VERACRUZ,MINATITLAN,5,392,5,402,1976
VERACRUZ,MINATITLAN,7,512,11,530,1704
VERACRUZ,MINATITLAN,6,547,11,564,1703
VERACRUZ,MINATITLAN,6,492,11,509,1703
VERACRUZ,MINATITLAN,17,509,5,531,1703
VERACRUZ,MINATITLAN,8,422,4,434,1624
VERACRUZ,MINATITLAN,13,396,15,424,1623
VERACRUZ,MINATITLAN,7,376,1,384,1239
VERACRUZ,MINATITLAN,9,424,8,441,1238
VERACRUZ,MINATITLAN,9,592,11,612,1794
VERACRUZ,MINATITLAN,10,573,17,600,1794
VERACRUZ,MINATITLAN,16,554,9,579,1592
VERACRUZ,MINATITLAN,8,557,15,580,1592
VERACRUZ,MINATITLAN,5,344,3,352,1094
VERACRUZ,MINATITLAN,6,337,14,357,1094
VERACRUZ,MINATITLAN,17,719,5,741,1707
VERACRUZ,MINATITLAN,3,437,6,446,1424
VERACRUZ,MINATITLAN,6,498,8,512,1424
VERACRUZ,MINATITLAN,11,468,4,483,1423
VERACRUZ,MINATITLAN,6,540,5,551,1367
VERACRUZ,MINATITLAN,14,480,3,497,1367
VERACRUZ,MINATITLAN,6,405,13,424,1372
VERACRUZ,MINATITLAN,6,445,6,457,1372
VERACRUZ,MINATITLAN,22,492,4,518,1780
VERACRUZ,MINATITLAN,14,498,2,514,1780
VERACRUZ,MINATITLAN,18,545,4,567,1779
VERACRUZ,MINATITLAN,5,524,3,532,1701
VERACRUZ,MINATITLAN,16,515,2,533,1701
VERACRUZ,MINATITLAN,5,488,8,501,1560
VERACRUZ,MINATITLAN,9,485,2,496,1560
VERACRUZ,MINATITLAN,7,470,6,483,1741
VERACRUZ,MINATITLAN,13,345,78,436,1740
VERACRUZ,MINATITLAN,7,442,5,454,1740
VERACRUZ,ORIZABA,20,331,4,355,1435
VERACRUZ,ORIZABA,25,288,20,333,1435
VERACRUZ,ORIZABA,41,269,34,344,1970
VERACRUZ,ORIZABA,40,297,24,361,1969
VERACRUZ,ORIZABA,20,588,12,620,1842
VERACRUZ,ORIZABA,19,586,25,630,1841
VERACRUZ,ORIZABA,24,442,13,479,1374
VERACRUZ,ORIZABA,24,423,14,461,1373
VERACRUZ,ORIZABA,19,415,14,448,1373
VERACRUZ,ORIZABA,22,525,8,555,1390
VERACRUZ,ORIZABA,9,580,7,596,1390
VERACRUZ,ORIZABA,36,321,43,400,1712
VERACRUZ,ORIZABA,60,301,35,396,1711
VERACRUZ,ORIZABA,17,360,10,387,1847
VERACRUZ,ORIZABA,18,337,10,365,1846
VERACRUZ,ORIZABA,24,270,8,302,1583
VERACRUZ,ORIZABA,78,387,3,468,1583
VERACRUZ,ORIZABA,50,205,17,272,1106
VERACRUZ,ORIZABA,44,212,16,272,1106
VERACRUZ,ORIZABA,12,286,6,304,1879
VERACRUZ,ORIZABA,14,291,3,308,1878
VERACRUZ,ORIZABA,13,299,5,317,1729
VERACRUZ,ORIZABA,10,297,15,322,1728
VERACRUZ,ORIZABA,14,377,6,397,1912
VERACRUZ,ORIZABA,18,408,6,432,1911
VERACRUZ,ORIZABA,5,221,10,236,1670
VERACRUZ,ORIZABA,4,226,5,235,1669
VERACRUZ,ORIZABA,16,225,11,252,1620
VERACRUZ,ORIZABA,11,178,8,197,1619
VERACRUZ,ORIZABA,13,215,6,234,1619
VERACRUZ,ORIZABA,17,167,12,196,1554
VERACRUZ,ORIZABA,10,256,11,277,1857
VERACRUZ,ORIZABA,14,218,4,236,1856
VERACRUZ,ORIZABA,11,260,7,278,1515
VERACRUZ,ORIZABA,21,237,3,261,1515
VERACRUZ,ORIZABA,26,245,16,287,1515
VERACRUZ,ORIZABA,70,214,4,288,1729
VERACRUZ,ORIZABA,51,209,11,271,1729
VERACRUZ,ORIZABA,25,43,3,71,1089
VERACRUZ,ORIZABA,15,32,8,55,1089
VERACRUZ,ORIZABA,23,103,4,130,1887
VERACRUZ,ORIZABA,15,96,6,117,1886
VERACRUZ,ORIZABA,24,180,22,226,1342
VERACRUZ,ORIZABA,16,180,16,212,1342
VERACRUZ,ORIZABA,16,180,17,213,1341
VERACRUZ,ORIZABA,19,289,9,317,1961
VERACRUZ,ORIZABA,15,314,14,343,1961
VERACRUZ,ORIZABA,17,315,8,340,1960
VERACRUZ,ORIZABA,19,377,4,400,1903
VERACRUZ,ORIZABA,13,386,3,402,1903
VERACRUZ,ORIZABA,13,368,9,390,1903
VERACRUZ,ORIZABA,16,444,6,466,1718
VERACRUZ,ORIZABA,19,418,8,445,1717
VERACRUZ,ORIZABA,26,479,3,508,1717
VERACRUZ,ORIZABA,15,461,13,489,1680
VERACRUZ,ORIZABA,14,453,14,481,1680
VERACRUZ,ORIZABA,21,324,7,352,1084
VERACRUZ,ORIZABA,22,305,22,349,1084
VERACRUZ,ORIZABA,17,533,8,558,1659
VERACRUZ,ORIZABA,21,497,11,529,1659
VERACRUZ,ORIZABA,19,384,10,413,1396
VERACRUZ,ORIZABA,13,397,13,423,1395
VERACRUZ,ORIZABA,26,428,11,465,1395
VERACRUZ,ORIZABA,9,329,6,344,1374
VERACRUZ,ORIZABA,19,272,5,296,1374
VERACRUZ,ORIZABA,4,342,5,351,1373
VERACRUZ,ORIZABA,4,289,4,297,1048
VERACRUZ,ORIZABA,10,237,5,252,1047
VERACRUZ,ORIZABA,11,449,5,465,1923
VERACRUZ,ORIZABA,14,435,4,453,1923
VERACRUZ,ORIZABA,26,411,13,450,1922
VERACRUZ,ORIZABA,14,428,9,451,1876
VERACRUZ,ORIZABA,14,458,5,477,1876
VERACRUZ,ORIZABA,21,365,7,393,1441
VERACRUZ,ORIZABA,25,345,10,380,1441
VERACRUZ,ORIZABA,14,374,3,391,1441
VERACRUZ,ORIZABA,16,371,18,405,1326
VERACRUZ,ORIZABA,20,405,15,440,1325
VERACRUZ,ORIZABA,20,420,17,457,1325
VERACRUZ,ORIZABA,29,621,21,671,2014
VERACRUZ,ORIZABA,30,561,19,610,2014
VERACRUZ,ORIZABA,38,384,11,433,1229
VERACRUZ,ORIZABA,29,398,13,440,1229
VERACRUZ,ORIZABA,28,415,10,453,1419
VERACRUZ,ORIZABA,22,439,11,472,1418
VERACRUZ,ORIZABA,28,446,15,489,1418
VERACRUZ,ORIZABA,9,208,9,226,1498
VERACRUZ,ORIZABA,9,191,9,209,1497
VERACRUZ,ORIZABA,12,115,15,142,1399
VERACRUZ,ORIZABA,13,98,7,118,1398
VERACRUZ,ORIZABA,16,229,12,257,1848
VERACRUZ,ORIZABA,25,374,13,412,1847
VERACRUZ,ORIZABA,8,243,5,256,1541
VERACRUZ,ORIZABA,8,241,6,255,1540
VERACRUZ,ORIZABA,13,318,8,339,1782
VERACRUZ,ORIZABA,15,338,7,360,1782
VERACRUZ,ORIZABA,14,356,0,370,1508
VERACRUZ,ORIZABA,16,367,0,383,1507
VERACRUZ,ORIZABA,12,379,3,394,1507
VERACRUZ,ORIZABA,19,423,0,442,1790
VERACRUZ,ORIZABA,23,420,8,451,1790
VERACRUZ,ORIZABA,30,414,3,447,1789
VERACRUZ,ORIZABA,21,376,2,399,1917
VERACRUZ,ORIZABA,24,351,6,381,1917
VERACRUZ,ORIZABA,25,382,4,411,1916
VERACRUZ,ORIZABA,18,310,6,334,1365
VERACRUZ,ORIZABA,16,328,4,348,1364
VERACRUZ,ORIZABA,18,408,2,428,1492
VERACRUZ,ORIZABA,12,398,5,415,1491
VERACRUZ,ORIZABA,19,403,1,423,1491
VERACRUZ,ORIZABA,24,396,9,429,1739
VERACRUZ,ORIZABA,21,383,12,416,1739
VERACRUZ,ORIZABA,12,365,6,383,1739
VERACRUZ,ORIZABA,15,458,5,478,1968
VERACRUZ,ORIZABA,16,426,2,444,1967
VERACRUZ,ORIZABA,19,548,4,571,1934
VERACRUZ,ORIZABA,29,535,3,567,1934
VERACRUZ,ORIZABA,28,469,7,504,1894
VERACRUZ,ORIZABA,23,471,2,496,1893
VERACRUZ,ORIZABA,14,461,5,480,1837
VERACRUZ,ORIZABA,15,435,9,459,1836
VERACRUZ,ORIZABA,20,398,7,425,1675
VERACRUZ,ORIZABA,20,398,8,426,1675
VERACRUZ,ORIZABA,16,410,4,430,1674
VERACRUZ,ORIZABA,14,399,4,417,1919
VERACRUZ,ORIZABA,36,390,4,430,1918
VERACRUZ,ORIZABA,17,454,2,473,1920
VERACRUZ,ORIZABA,25,425,2,452,1920
VERACRUZ,ORIZABA,99,1536,12,1647,0
VERACRUZ,ORIZABA,21,396,8,425,1949
VERACRUZ,ORIZABA,20,351,6,377,1949
VERACRUZ,ORIZABA,13,379,7,399,1803
VERACRUZ,ORIZABA,13,387,8,408,1803
VERACRUZ,ORIZABA,24,385,7,416,1802
VERACRUZ,ORIZABA,16,247,1,264,1338
VERACRUZ,ORIZABA,219,116,3,338,1338
VERACRUZ,ORIZABA,12,239,4,255,1338
VERACRUZ,ORIZABA,30,406,2,438,1933
VERACRUZ,ORIZABA,20,390,4,414,1857
VERACRUZ,ORIZABA,21,408,1,430,1857
VERACRUZ,ORIZABA,31,437,6,474,1916
VERACRUZ,ORIZABA,26,461,8,495,1916
VERACRUZ,ORIZABA,21,450,3,474,1732
VERACRUZ,ORIZABA,28,409,0,437,1731
VERACRUZ,ORIZABA,20,433,3,456,1621
VERACRUZ,ORIZABA,9,391,5,405,1620
VERACRUZ,ORIZABA,27,389,6,422,1711
VERACRUZ,ORIZABA,22,381,5,408,1710
VERACRUZ,ORIZABA,23,380,5,408,1362
VERACRUZ,ORIZABA,19,364,4,387,1361
VERACRUZ,ORIZABA,19,360,10,389,1591
VERACRUZ,ORIZABA,18,312,5,335,1591
VERACRUZ,ORIZABA,19,304,5,328,1223
VERACRUZ,ORIZABA,8,304,6,318,1223
VERACRUZ,ORIZABA,21,422,9,452,1781
VERACRUZ,ORIZABA,26,368,9,403,1781
VERACRUZ,ORIZABA,19,133,9,161,1858
VERACRUZ,ORIZABA,14,162,1,177,1858
VERACRUZ,ORIZABA,31,44,16,91,1119
VERACRUZ,ORIZABA,43,79,22,144,1119
VERACRUZ,ORIZABA,19,89,7,115,1337
VERACRUZ,ORIZABA,22,107,22,151,1336
VERACRUZ,ORIZABA,22,108,6,136,1336
VERACRUZ,ORIZABA,20,76,10,106,1643
VERACRUZ,ORIZABA,26,89,12,127,1643
VERACRUZ,ORIZABA,15,100,8,123,1643
VERACRUZ,ORIZABA,44,111,10,165,1646
VERACRUZ,ORIZABA,23,445,14,482,1772
VERACRUZ,ORIZABA,23,464,8,495,1772
VERACRUZ,ORIZABA,22,549,1,572,1750
VERACRUZ,ORIZABA,29,521,3,553,1749
VERACRUZ,ORIZABA,14,473,9,496,1878
VERACRUZ,ORIZABA,17,473,4,494,1878
VERACRUZ,ORIZABA,15,407,3,425,1462
VERACRUZ,ORIZABA,27,389,4,420,1462
VERACRUZ,ORIZABA,24,357,3,384,1514
VERACRUZ,ORIZABA,16,314,7,337,1514
VERACRUZ,ORIZABA,19,334,5,358,1561
VERACRUZ,ORIZABA,14,368,4,386,1561
VERACRUZ,ORIZABA,21,353,4,378,1561
VERACRUZ,ORIZABA,12,408,2,422,1422
VERACRUZ,ORIZABA,14,364,5,383,1421
VERACRUZ,ORIZABA,23,482,6,511,1780
VERACRUZ,ORIZABA,21,464,5,490,1780
VERACRUZ,ORIZABA,26,559,10,595,1907
VERACRUZ,ORIZABA,24,549,4,577,1906
VERACRUZ,ORIZABA,13,534,2,549,1445
VERACRUZ,ORIZABA,14,408,5,427,1445
VERACRUZ,CORDOBA,7,462,9,478,1857
VERACRUZ,CORDOBA,10,487,14,511,1856
VERACRUZ,CORDOBA,8,474,10,492,1812
VERACRUZ,CORDOBA,16,448,4,468,1812
VERACRUZ,CORDOBA,12,374,13,399,1357
VERACRUZ,CORDOBA,19,381,10,410,1357
VERACRUZ,CORDOBA,22,476,12,510,1477
VERACRUZ,CORDOBA,19,436,11,466,1871
VERACRUZ,CORDOBA,21,460,7,488,1871
VERACRUZ,CORDOBA,13,414,20,447,1871
VERACRUZ,CORDOBA,16,343,9,368,1354
VERACRUZ,CORDOBA,15,334,9,358,1354
VERACRUZ,CORDOBA,8,342,5,355,1353
VERACRUZ,CORDOBA,14,374,9,397,1191
VERACRUZ,CORDOBA,11,395,5,411,1190
VERACRUZ,CORDOBA,20,453,9,482,1545
VERACRUZ,CORDOBA,20,460,12,492,1412
VERACRUZ,CORDOBA,17,472,13,502,1411
VERACRUZ,CORDOBA,19,618,24,661,1941
VERACRUZ,CORDOBA,13,575,9,597,1940
VERACRUZ,CORDOBA,11,403,6,420,1372
VERACRUZ,CORDOBA,14,376,9,399,1372
VERACRUZ,CORDOBA,4,378,2,384,1372
VERACRUZ,CORDOBA,19,264,17,300,1070
VERACRUZ,CORDOBA,13,260,22,295,1069
VERACRUZ,CORDOBA,17,542,12,571,1784
VERACRUZ,CORDOBA,5,520,5,530,1784
VERACRUZ,CORDOBA,11,535,5,551,1973
VERACRUZ,CORDOBA,3,542,6,551,1973
VERACRUZ,CORDOBA,13,558,2,573,1972
VERACRUZ,CORDOBA,7,420,8,435,1130
VERACRUZ,CORDOBA,13,343,8,364,1538
VERACRUZ,CORDOBA,10,344,8,362,1538
VERACRUZ,CORDOBA,12,334,4,350,1538
VERACRUZ,CORDOBA,9,328,7,344,1538
VERACRUZ,CORDOBA,25,514,7,546,2040
VERACRUZ,CORDOBA,17,467,7,491,2039
VERACRUZ,CORDOBA,18,451,7,476,2039
VERACRUZ,CORDOBA,17,368,4,389,1457
VERACRUZ,CORDOBA,11,368,11,390,1457
VERACRUZ,CORDOBA,13,353,7,373,1456
VERACRUZ,CORDOBA,9,290,6,305,1442
VERACRUZ,CORDOBA,10,349,3,362,1442
VERACRUZ,CORDOBA,11,292,2,305,1442
VERACRUZ,CORDOBA,17,449,17,483,1940
VERACRUZ,CORDOBA,18,422,6,446,1939
VERACRUZ,CORDOBA,17,431,5,453,1849
VERACRUZ,CORDOBA,18,410,2,430,1849
VERACRUZ,CORDOBA,22,433,10,465,1848
VERACRUZ,CORDOBA,24,253,3,280,1755
VERACRUZ,CORDOBA,24,242,5,271,1755
VERACRUZ,CORDOBA,22,360,5,387,1436
VERACRUZ,CORDOBA,17,363,3,383,1435
VERACRUZ,CORDOBA,20,398,9,427,1963
VERACRUZ,CORDOBA,35,411,10,456,1899
VERACRUZ,CORDOBA,10,298,4,312,1416
VERACRUZ,CORDOBA,17,335,0,352,1416
VERACRUZ,CORDOBA,23,275,6,304,1609
VERACRUZ,CORDOBA,14,288,3,305,1608
VERACRUZ,CORDOBA,113,1592,25,1730,0
VERACRUZ,CORDOBA,15,214,2,231,1048
VERACRUZ,CORDOBA,13,208,1,222,1048
VERACRUZ,CORDOBA,9,303,5,317,1553
VERACRUZ,CORDOBA,12,325,2,339,1552
VERACRUZ,CORDOBA,10,287,3,300,1552
VERACRUZ,CORDOBA,10,323,2,335,1552
VERACRUZ,CORDOBA,15,365,5,385,1545
VERACRUZ,CORDOBA,16,368,9,393,1544
VERACRUZ,CORDOBA,11,289,4,304,1091
VERACRUZ,CORDOBA,10,272,7,289,1091
VERACRUZ,CORDOBA,13,374,5,392,1722
VERACRUZ,CORDOBA,5,381,6,392,1721
VERACRUZ,CORDOBA,34,363,2,399,1988
VERACRUZ,CORDOBA,21,312,4,337,1456
VERACRUZ,CORDOBA,18,316,5,339,1456
VERACRUZ,CORDOBA,15,326,2,343,1455
VERACRUZ,CORDOBA,27,336,4,367,1720
VERACRUZ,CORDOBA,18,362,2,382,1720
VERACRUZ,CORDOBA,24,345,4,373,1719
VERACRUZ,CORDOBA,16,301,9,326,1545
VERACRUZ,CORDOBA,14,337,6,357,1545
VERACRUZ,CORDOBA,27,316,1,344,1544
VERACRUZ,CORDOBA,14,226,2,242,1331
VERACRUZ,CORDOBA,15,248,2,265,1331
VERACRUZ,CORDOBA,10,419,2,431,1821
VERACRUZ,CORDOBA,10,441,5,456,1820
VERACRUZ,CORDOBA,21,409,5,435,1906
VERACRUZ,CORDOBA,25,411,4,440,1906
VERACRUZ,CORDOBA,9,338,4,351,1436
VERACRUZ,CORDOBA,12,344,4,360,1436
VERACRUZ,CORDOBA,23,381,5,409,1924
VERACRUZ,CORDOBA,16,365,10,391,1923
VERACRUZ,CORDOBA,13,268,3,284,1364
VERACRUZ,CORDOBA,23,254,2,279,1363
VERACRUZ,CORDOBA,17,354,4,375,2062
VERACRUZ,CORDOBA,27,333,8,368,2061
VERACRUZ,CORDOBA,32,343,4,379,2061
VERACRUZ,CORDOBA,24,338,4,366,1549
VERACRUZ,CORDOBA,26,350,0,376,1549
VERACRUZ,CORDOBA,15,342,1,358,1549
VERACRUZ,CORDOBA,17,315,2,334,1548
VERACRUZ,CORDOBA,23,607,11,641,1986
VERACRUZ,CORDOBA,26,431,15,472,1742
VERACRUZ,CORDOBA,24,435,7,466,1741
VERACRUZ,CORDOBA,22,436,13,471,1741
VERACRUZ,CORDOBA,27,361,11,399,1599
VERACRUZ,CORDOBA,15,412,3,430,1599
VERACRUZ,CORDOBA,12,379,5,396,1599
VERACRUZ,CORDOBA,11,391,7,409,1598
VERACRUZ,CORDOBA,35,483,7,525,2100
VERACRUZ,CORDOBA,30,430,10,470,2100
VERACRUZ,CORDOBA,11,558,17,586,2024
VERACRUZ,CORDOBA,22,527,19,568,2024
VERACRUZ,CORDOBA,18,370,8,396,1967
VERACRUZ,CORDOBA,11,307,14,332,1967
VERACRUZ,CORDOBA,10,336,8,354,1967
VERACRUZ,CORDOBA,20,323,10,353,1967
VERACRUZ,CORDOBA,16,346,9,371,1967
VERACRUZ,CORDOBA,11,340,13,364,1966
VERACRUZ,CORDOBA,23,341,8,372,1568
VERACRUZ,CORDOBA,8,343,6,357,1568
VERACRUZ,CORDOBA,13,352,2,367,1567
VERACRUZ,CORDOBA,25,371,6,402,1827
VERACRUZ,CORDOBA,24,389,6,419,1826
VERACRUZ,CORDOBA,16,391,5,412,1826
VERACRUZ,CORDOBA,13,247,7,267,1514
VERACRUZ,CORDOBA,10,276,4,290,1513
VERACRUZ,CORDOBA,9,267,0,276,1513
VERACRUZ,CORDOBA,33,384,17,434,1911
VERACRUZ,CORDOBA,26,346,16,388,1616
VERACRUZ,CORDOBA,24,379,10,413,1616
VERACRUZ,CORDOBA,27,374,7,408,1616
VERACRUZ,CORDOBA,31,364,24,419,1876
VERACRUZ,CORDOBA,31,315,8,354,1875
VERACRUZ,CORDOBA,18,435,13,466,1362
VERACRUZ,CORDOBA,48,198,19,265,1135
VERACRUZ,CORDOBA,51,211,14,276,1134
VERACRUZ,CORDOBA,8,269,5,282,1228
VERACRUZ,CORDOBA,12,275,3,290,1228
VERACRUZ,CORDOBA,35,391,7,433,1831
VERACRUZ,CORDOBA,20,375,6,401,1831
VERACRUZ,CORDOBA,19,306,3,328,1529
VERACRUZ,CORDOBA,17,305,6,328,1528
VERACRUZ,CORDOBA,23,338,3,364,1427
VERACRUZ,CORDOBA,23,262,1,286,1427
VERACRUZ,CORDOBA,25,314,5,344,1665
VERACRUZ,CORDOBA,20,303,1,324,1664
VERACRUZ,CORDOBA,14,575,7,596,1812
VERACRUZ,CORDOBA,22,567,19,608,1811
VERACRUZ,CORDOBA,20,581,11,612,1811
VERACRUZ,CORDOBA,26,506,5,537,1811
VERACRUZ,CORDOBA,32,430,7,469,1636
VERACRUZ,CORDOBA,20,380,7,407,1764
VERACRUZ,CORDOBA,12,415,11,438,1764
VERACRUZ,CORDOBA,34,487,9,530,2081
VERACRUZ,CORDOBA,16,308,8,332,1716
VERACRUZ,CORDOBA,8,339,2,349,1716
VERACRUZ,CORDOBA,18,325,5,348,1716
VERACRUZ,CORDOBA,14,317,0,331,1716
VERACRUZ,CORDOBA,15,301,6,322,1716
VERACRUZ,CORDOBA,21,324,0,345,1716
VERACRUZ,CORDOBA,37,347,3,387,1620
VERACRUZ,CORDOBA,12,326,2,340,1857
VERACRUZ,CORDOBA,25,318,3,346,1857
VERACRUZ,CORDOBA,16,316,3,335,1857
VERACRUZ,CORDOBA,16,356,6,378,1213
VERACRUZ,CORDOBA,6,336,6,348,1213
VERACRUZ,CORDOBA,22,445,18,485,1788
VERACRUZ,CORDOBA,22,448,14,484,1787
VERACRUZ,CORDOBA,16,408,25,449,1787
VERACRUZ,CORDOBA,40,530,19,589,1976
VERACRUZ,CORDOBA,20,282,12,314,1082
VERACRUZ,CORDOBA,22,284,5,311,1081
VERACRUZ,CORDOBA,26,400,9,435,1362
VERACRUZ,CORDOBA,43,325,12,380,1362
VERACRUZ,CORDOBA,19,379,18,416,1361
VERACRUZ,CORDOBA,24,457,19,500,1497
VERACRUZ,CORDOBA,27,405,20,452,1497
VERACRUZ,CORDOBA,12,317,6,335,1385
VERACRUZ,CORDOBA,15,331,4,350,1385
VERACRUZ,CORDOBA,20,310,12,342,1385
VERACRUZ,CORDOBA,24,342,21,387,1240
VERACRUZ,CORDOBA,16,320,17,353,1240
VERACRUZ,CORDOBA,21,529,15,565,1816
VERACRUZ,CORDOBA,35,520,13,568,1815
VERACRUZ,CORDOBA,18,524,17,559,1821
VERACRUZ,CORDOBA,23,364,8,395,1318
VERACRUZ,CORDOBA,23,350,4,377,1317
VERACRUZ,CORDOBA,13,336,4,353,1317
VERACRUZ,CORDOBA,25,410,12,447,1746
VERACRUZ,CORDOBA,12,452,10,474,1745
VERACRUZ,CORDOBA,17,491,7,515,1673
VERACRUZ,CORDOBA,22,359,5,386,1089
VERACRUZ,CORDOBA,15,422,3,440,1088
VERACRUZ,CORDOBA,19,451,7,477,1216
VERACRUZ,CORDOBA,21,455,16,492,1215
VERACRUZ,COSAMALOAPAN,69,1084,9,1162,1916
VERACRUZ,COSAMALOAPAN,86,1191,10,1287,1915
VERACRUZ,COSAMALOAPAN,7,479,7,493,1493
VERACRUZ,COSAMALOAPAN,14,489,7,510,1492
VERACRUZ,COSAMALOAPAN,29,614,6,649,1927
VERACRUZ,COSAMALOAPAN,28,616,3,647,1927
VERACRUZ,COSAMALOAPAN,92,1078,12,1182,1963
VERACRUZ,COSAMALOAPAN,32,1250,18,1300,1963
VERACRUZ,COSAMALOAPAN,22,550,7,579,1891
VERACRUZ,COSAMALOAPAN,12,570,2,584,1891
VERACRUZ,COSAMALOAPAN,5,374,5,384,1170
VERACRUZ,COSAMALOAPAN,14,339,7,360,1169
VERACRUZ,COSAMALOAPAN,19,514,11,544,1866
VERACRUZ,COSAMALOAPAN,15,468,9,492,1865
VERACRUZ,COSAMALOAPAN,9,411,4,424,1305
VERACRUZ,COSAMALOAPAN,8,436,5,449,1305
VERACRUZ,COSAMALOAPAN,15,684,3,702,1496
VERACRUZ,COSAMALOAPAN,22,479,5,506,1496
VERACRUZ,COSAMALOAPAN,17,736,8,761,1537
VERACRUZ,COSAMALOAPAN,10,776,9,795,1537
VERACRUZ,COSAMALOAPAN,31,551,4,586,1878
VERACRUZ,COSAMALOAPAN,20,623,13,656,1877
VERACRUZ,COSAMALOAPAN,10,493,9,512,1580
VERACRUZ,COSAMALOAPAN,14,458,4,476,1579
VERACRUZ,COSAMALOAPAN,11,549,17,577,1753
VERACRUZ,COSAMALOAPAN,13,633,22,668,1753
VERACRUZ,COSAMALOAPAN,32,719,8,759,1556
VERACRUZ,COSAMALOAPAN,23,492,22,537,1555
VERACRUZ,COSAMALOAPAN,76,453,21,550,1708
VERACRUZ,COSAMALOAPAN,63,475,45,583,1707
VERACRUZ,COSAMALOAPAN,55,478,14,547,1473
VERACRUZ,COSAMALOAPAN,61,480,18,559,1472
VERACRUZ,COSAMALOAPAN,39,367,15,421,1060
VERACRUZ,COSAMALOAPAN,40,383,4,427,1060
VERACRUZ,COSAMALOAPAN,68,895,12,975,1165
VERACRUZ,COSAMALOAPAN,48,816,9,873,1164
VERACRUZ,COSAMALOAPAN,20,468,9,497,1507
VERACRUZ,COSAMALOAPAN,21,453,2,476,1507
VERACRUZ,COSAMALOAPAN,12,420,12,444,1277
VERACRUZ,COSAMALOAPAN,11,525,7,543,1276
VERACRUZ,COSAMALOAPAN,19,544,12,575,2013
VERACRUZ,COSAMALOAPAN,14,570,0,584,2012
VERACRUZ,COSAMALOAPAN,7,537,8,552,1926
VERACRUZ,COSAMALOAPAN,21,534,15,570,1925
VERACRUZ,COSAMALOAPAN,18,488,8,514,1971
VERACRUZ,COSAMALOAPAN,16,509,17,542,1971
VERACRUZ,COSAMALOAPAN,13,556,10,579,1967
VERACRUZ,COSAMALOAPAN,17,536,4,557,1967
VERACRUZ,COSAMALOAPAN,10,384,6,400,1871
VERACRUZ,COSAMALOAPAN,15,368,2,385,1871
VERACRUZ,COSAMALOAPAN,36,1099,24,1159,0
VERACRUZ,COSAMALOAPAN,12,1006,14,1032,1799
VERACRUZ,COSAMALOAPAN,32,1105,107,1244,1798
VERACRUZ,COSAMALOAPAN,10,635,11,656,1574
VERACRUZ,COSAMALOAPAN,17,675,5,697,1573
VERACRUZ,COSAMALOAPAN,9,368,5,382,1152
VERACRUZ,COSAMALOAPAN,3,362,5,370,1151
VERACRUZ,COSAMALOAPAN,11,450,5,466,1599
VERACRUZ,COSAMALOAPAN,8,422,8,438,1598
VERACRUZ,COSAMALOAPAN,8,646,4,658,1986
VERACRUZ,COSAMALOAPAN,14,614,10,638,1985
VERACRUZ,COSAMALOAPAN,10,1037,12,1059,1736
VERACRUZ,COSAMALOAPAN,10,581,7,598,1736
VERACRUZ,COSAMALOAPAN,5,370,10,385,1130
VERACRUZ,COSAMALOAPAN,4,303,3,310,1129
VERACRUZ,COSAMALOAPAN,18,992,6,1016,1372
VERACRUZ,COSAMALOAPAN,7,1122,2,1131,1372
VERACRUZ,COSAMALOAPAN,20,1550,8,1578,1780
VERACRUZ,COSAMALOAPAN,19,1050,15,1084,1780
VERACRUZ,COSAMALOAPAN,9,1064,25,1098,1801
VERACRUZ,COSAMALOAPAN,12,1007,16,1035,1800
VERACRUZ,COSAMALOAPAN,18,449,0,467,1432
VERACRUZ,COSAMALOAPAN,13,449,16,478,1432
VERACRUZ,COSAMALOAPAN,5,583,0,588,1432
VERACRUZ,COSAMALOAPAN,17,934,9,960,1530
VERACRUZ,COSAMALOAPAN,5,1138,8,1151,1530
VERACRUZ,COSAMALOAPAN,13,908,23,944,1900
VERACRUZ,COSAMALOAPAN,30,846,17,893,1900
VERACRUZ,COSAMALOAPAN,5,909,10,924,1610
VERACRUZ,COSAMALOAPAN,10,626,11,647,1246
VERACRUZ,COSAMALOAPAN,9,264,5,278,1205
VERACRUZ,COSAMALOAPAN,9,216,3,228,1205
VERACRUZ,COSAMALOAPAN,12,327,3,342,1522
VERACRUZ,COSAMALOAPAN,9,345,5,359,1522
VERACRUZ,COSAMALOAPAN,5,596,5,606,2033
VERACRUZ,COSAMALOAPAN,11,678,5,694,2033
VERACRUZ,COSAMALOAPAN,14,987,3,1004,1974
VERACRUZ,COSAMALOAPAN,18,769,0,787,1973
VERACRUZ,COSAMALOAPAN,10,773,5,788,1767
VERACRUZ,COSAMALOAPAN,14,591,4,609,1766
VERACRUZ,COSAMALOAPAN,8,619,9,636,2036
VERACRUZ,COSAMALOAPAN,24,340,13,377,1538
VERACRUZ,COSAMALOAPAN,32,414,4,450,1538
VERACRUZ,COSAMALOAPAN,13,444,3,460,1441
VERACRUZ,COSAMALOAPAN,10,430,7,447,1440
VERACRUZ,COSAMALOAPAN,5,315,7,327,1186
VERACRUZ,COSAMALOAPAN,11,373,10,394,1185
VERACRUZ,COSAMALOAPAN,5,770,2,777,1246
VERACRUZ,COSAMALOAPAN,19,696,7,722,1246
VERACRUZ,COSAMALOAPAN,14,487,7,508,1198
VERACRUZ,COSAMALOAPAN,18,453,7,478,1197
VERACRUZ,COSAMALOAPAN,3,534,19,556,1163
VERACRUZ,COSAMALOAPAN,16,503,6,525,1163
VERACRUZ,COSAMALOAPAN,6,204,5,215,1177
VERACRUZ,COSAMALOAPAN,10,235,5,250,1176
VERACRUZ,COSAMALOAPAN,8,336,11,355,1970
VERACRUZ,COSAMALOAPAN,10,317,16,343,1590
VERACRUZ,COSAMALOAPAN,9,267,13,289,1589
VERACRUZ,COSAMALOAPAN,2,305,1,308,1366
VERACRUZ,COSAMALOAPAN,11,267,1,279,1366
VERACRUZ,COSAMALOAPAN,9,418,10,437,1736
VERACRUZ,COSAMALOAPAN,8,417,11,436,1736
VERACRUZ,COSAMALOAPAN,13,428,13,454,1844
VERACRUZ,COSAMALOAPAN,17,517,8,542,1843
VERACRUZ,COSAMALOAPAN,16,563,21,600,1760
VERACRUZ,COSAMALOAPAN,11,430,15,456,1759
VERACRUZ,COSAMALOAPAN,14,356,11,381,1921
VERACRUZ,COSAMALOAPAN,13,407,9,429,1921
VERACRUZ,COSAMALOAPAN,15,802,13,830,1996
VERACRUZ,COSAMALOAPAN,21,764,35,820,1996
VERACRUZ,COSAMALOAPAN,2,611,7,620,1857
VERACRUZ,COSAMALOAPAN,5,267,1,273,1857
VERACRUZ,COSAMALOAPAN,6,323,6,335,1730
VERACRUZ,COSAMALOAPAN,8,329,2,339,1730
VERACRUZ,COSAMALOAPAN,8,345,9,362,1239
VERACRUZ,COSAMALOAPAN,8,325,10,343,1238
VERACRUZ,COSAMALOAPAN,3,221,4,228,1386
VERACRUZ,COSAMALOAPAN,8,269,6,283,1385
VERACRUZ,COSAMALOAPAN,9,783,7,799,1184
VERACRUZ,COSAMALOAPAN,10,856,6,872,1932
VERACRUZ,COSAMALOAPAN,16,916,13,945,1932
VERACRUZ,COSAMALOAPAN,13,1155,18,1186,1415
VERACRUZ,COSAMALOAPAN,7,1073,14,1094,1414
VERACRUZ,COSAMALOAPAN,16,369,14,399,1500
VERACRUZ,COSAMALOAPAN,12,336,26,374,1500
VERACRUZ,COSAMALOAPAN,6,689,5,700,1945
VERACRUZ,COSAMALOAPAN,9,686,1,696,1944
VERACRUZ,COSAMALOAPAN,12,537,2,551,1441
VERACRUZ,COSAMALOAPAN,10,958,26,994,1254
VERACRUZ,COSAMALOAPAN,15,698,15,728,1518
VERACRUZ,COSAMALOAPAN,20,1053,54,1127,1518
VERACRUZ,COSAMALOAPAN,18,1102,10,1130,1263
VERACRUZ,COSAMALOAPAN,18,1226,15,1259,1263
VERACRUZ,COSAMALOAPAN,12,267,7,286,1077
VERACRUZ,COSAMALOAPAN,6,228,10,244,1077
VERACRUZ,COSAMALOAPAN,15,488,7,510,1908
VERACRUZ,COSAMALOAPAN,18,652,7,677,1907
VERACRUZ,COSAMALOAPAN,14,1447,5,1466,1728
VERACRUZ,COSAMALOAPAN,9,1205,9,1223,1728
VERACRUZ,COSAMALOAPAN,22,490,13,525,1259
VERACRUZ,COSAMALOAPAN,12,459,22,493,1259
VERACRUZ,COSAMALOAPAN,12,490,19,521,1922
VERACRUZ,COSAMALOAPAN,13,892,14,919,1921
VERACRUZ,COSAMALOAPAN,2,1572,9,1583,1933
VERACRUZ,COSAMALOAPAN,9,1437,13,1459,1932
VERACRUZ,COSAMALOAPAN,17,529,8,554,1605
VERACRUZ,COSAMALOAPAN,12,529,9,550,1605
VERACRUZ,COSAMALOAPAN,15,559,11,585,1722
VERACRUZ,COSAMALOAPAN,2,587,20,609,1721
VERACRUZ,COSAMALOAPAN,2,1030,13,1045,1519
VERACRUZ,COSAMALOAPAN,13,1052,6,1071,1519
VERACRUZ,COSAMALOAPAN,3,375,4,382,1689
VERACRUZ,COSAMALOAPAN,14,421,6,441,1688
VERACRUZ,COSAMALOAPAN,13,334,5,352,1280
VERACRUZ,COSAMALOAPAN,9,312,16,337,1280
VERACRUZ,COSAMALOAPAN,17,399,13,429,2072
VERACRUZ,COSAMALOAPAN,8,289,7,304,1322
VERACRUZ,COSAMALOAPAN,11,301,13,325,1321
VERACRUZ,COSAMALOAPAN,13,306,1,320,1323
VERACRUZ,COSAMALOAPAN,7,325,8,340,1323
VERACRUZ,COSAMALOAPAN,13,286,5,304,1383
VERACRUZ,COSAMALOAPAN,7,319,9,335,1383
VERACRUZ,COSAMALOAPAN,19,388,6,413,1820
VERACRUZ,COSAMALOAPAN,15,389,8,412,1819
VERACRUZ,COSAMALOAPAN,5,412,19,436,1708
VERACRUZ,COSAMALOAPAN,12,437,5,454,1707
VERACRUZ,COSAMALOAPAN,18,459,5,482,1596
VERACRUZ,COSAMALOAPAN,22,554,7,583,1596
VERACRUZ,COSAMALOAPAN,9,478,9,496,1433
VERACRUZ,COSAMALOAPAN,11,477,10,498,1433
VERACRUZ,ZONGOLICA,12,497,19,528,1673
VERACRUZ,ZONGOLICA,18,391,23,432,1673
VERACRUZ,ZONGOLICA,13,418,5,436,1673
VERACRUZ,ZONGOLICA,10,328,10,348,1782
VERACRUZ,ZONGOLICA,13,393,13,419,1781
VERACRUZ,ZONGOLICA,12,264,4,280,1570
VERACRUZ,ZONGOLICA,8,247,6,261,1570
VERACRUZ,ZONGOLICA,5,348,8,361,1570
VERACRUZ,ZONGOLICA,11,248,5,264,1569
VERACRUZ,ZONGOLICA,26,326,15,367,1717
VERACRUZ,ZONGOLICA,27,309,17,353,1717
VERACRUZ,ZONGOLICA,55,297,29,381,1645
VERACRUZ,ZONGOLICA,47,345,25,417,1645
VERACRUZ,ZONGOLICA,42,398,33,473,1645
VERACRUZ,ZONGOLICA,15,299,22,336,1353
VERACRUZ,ZONGOLICA,23,249,12,284,1352
VERACRUZ,ZONGOLICA,29,252,38,319,1352
VERACRUZ,ZONGOLICA,38,258,27,323,1487
VERACRUZ,ZONGOLICA,63,298,36,397,1945
VERACRUZ,ZONGOLICA,19,545,13,577,1942
VERACRUZ,ZONGOLICA,27,525,14,566,1942
VERACRUZ,ZONGOLICA,23,539,3,565,1847
VERACRUZ,ZONGOLICA,22,527,5,554,1846
VERACRUZ,ZONGOLICA,24,430,8,462,1651
VERACRUZ,ZONGOLICA,27,519,4,550,1651
VERACRUZ,ZONGOLICA,8,630,8,646,2005
VERACRUZ,ZONGOLICA,16,368,8,392,1839
VERACRUZ,ZONGOLICA,14,387,8,409,1839
VERACRUZ,ZONGOLICA,16,559,4,579,1814
VERACRUZ,ZONGOLICA,22,517,7,546,1814
VERACRUZ,ZONGOLICA,22,49,13,84,1290
VERACRUZ,ZONGOLICA,11,44,16,71,1290
VERACRUZ,ZONGOLICA,13,448,11,472,1140
VERACRUZ,ZONGOLICA,14,415,9,438,1139
VERACRUZ,ZONGOLICA,21,456,17,494,1995
VERACRUZ,ZONGOLICA,14,318,14,346,1995
VERACRUZ,ZONGOLICA,13,325,22,360,1596
VERACRUZ,ZONGOLICA,27,403,12,442,1595
VERACRUZ,ZONGOLICA,0,530,5,535,1618
VERACRUZ,ZONGOLICA,20,480,0,500,1617
VERACRUZ,ZONGOLICA,15,514,9,538,1617
VERACRUZ,ZONGOLICA,13,382,10,405,1623
VERACRUZ,ZONGOLICA,13,380,4,397,1622
VERACRUZ,ZONGOLICA,56,411,21,488,1323
VERACRUZ,ZONGOLICA,49,495,33,577,1323
VERACRUZ,ZONGOLICA,11,344,9,364,1759
VERACRUZ,ZONGOLICA,19,327,15,361,1759
VERACRUZ,ZONGOLICA,15,325,13,353,1759
VERACRUZ,ZONGOLICA,11,224,12,247,1178
VERACRUZ,ZONGOLICA,9,235,4,248,1177
VERACRUZ,ZONGOLICA,40,403,33,476,1527
VERACRUZ,ZONGOLICA,59,380,39,478,1526
VERACRUZ,ZONGOLICA,116,80,46,242,1831
VERACRUZ,ZONGOLICA,112,93,43,248,1830
VERACRUZ,ZONGOLICA,91,162,60,313,1262
VERACRUZ,ZONGOLICA,96,109,71,276,1262
VERACRUZ,ZONGOLICA,271,157,79,507,2006
VERACRUZ,ZONGOLICA,24,314,14,352,1714
VERACRUZ,ZONGOLICA,28,317,13,358,1714
VERACRUZ,ZONGOLICA,20,766,3,789,1497
VERACRUZ,ZONGOLICA,16,607,12,635,1496
VERACRUZ,ZONGOLICA,23,484,7,514,1496
VERACRUZ,ZONGOLICA,25,475,9,509,1714
VERACRUZ,ZONGOLICA,20,511,9,540,1714
VERACRUZ,ZONGOLICA,23,569,7,599,2036
VERACRUZ,ZONGOLICA,27,552,6,585,2035
VERACRUZ,ZONGOLICA,1,462,6,469,1819
VERACRUZ,ZONGOLICA,14,419,3,436,1819
VERACRUZ,ZONGOLICA,26,574,6,606,1930
VERACRUZ,ZONGOLICA,19,589,6,614,1929
VERACRUZ,ZONGOLICA,13,264,13,290,1377
VERACRUZ,ZONGOLICA,23,299,6,328,1377
VERACRUZ,ZONGOLICA,16,261,17,294,1376
VERACRUZ,ZONGOLICA,12,384,5,401,1468
VERACRUZ,ZONGOLICA,13,355,10,378,1468
VERACRUZ,ZONGOLICA,7,417,10,434,1716
VERACRUZ,ZONGOLICA,23,413,9,445,1716
VERACRUZ,ZONGOLICA,15,419,35,469,1715
VERACRUZ,ZONGOLICA,14,256,4,274,1928
VERACRUZ,ZONGOLICA,10,251,13,274,1928
VERACRUZ,ZONGOLICA,29,453,11,493,1678
VERACRUZ,ZONGOLICA,15,488,5,508,1678
VERACRUZ,ZONGOLICA,19,451,14,484,1678
VERACRUZ,ZONGOLICA,19,472,12,503,1677
VERACRUZ,ZONGOLICA,26,453,28,507,1677
VERACRUZ,ZONGOLICA,12,464,15,491,1519
VERACRUZ,ZONGOLICA,20,443,5,468,1519
VERACRUZ,ZONGOLICA,30,443,10,483,1519
VERACRUZ,ZONGOLICA,11,277,15,303,1799
VERACRUZ,ZONGOLICA,22,253,13,288,1799
VERACRUZ,ZONGOLICA,21,302,6,329,1465
VERACRUZ,ZONGOLICA,24,318,9,351,1465
VERACRUZ,ZONGOLICA,19,281,7,307,1464
VERACRUZ,ZONGOLICA,21,489,10,520,1957
VERACRUZ,ZONGOLICA,15,302,7,324,1397
VERACRUZ,ZONGOLICA,13,324,3,340,1396
VERACRUZ,ZONGOLICA,16,301,8,325,1171
VERACRUZ,ZONGOLICA,10,234,2,246,1170
VERACRUZ,ZONGOLICA,35,221,30,286,1351
VERACRUZ,ZONGOLICA,37,263,25,325,1351
VERACRUZ,ZONGOLICA,21,218,25,264,1351
VERACRUZ,ZONGOLICA,27,195,17,239,1704
VERACRUZ,ZONGOLICA,44,77,20,141,1795
VERACRUZ,ZONGOLICA,51,115,16,182,1795
VERACRUZ,ZONGOLICA,35,110,21,166,1795
VERACRUZ,ZONGOLICA,37,147,11,195,2027
VERACRUZ,ZONGOLICA,28,159,9,196,1903
VERACRUZ,ZONGOLICA,25,158,13,196,1902
VERACRUZ,ZONGOLICA,78,134,30,242,1703
VERACRUZ,ZONGOLICA,42,215,14,271,1221
VERACRUZ,ZONGOLICA,29,226,23,278,1220
VERACRUZ,ZONGOLICA,33,105,58,196,1391
VERACRUZ,ZONGOLICA,36,131,37,204,1391
VERACRUZ,ZONGOLICA,27,76,45,148,1390
VERACRUZ,ZONGOLICA,37,148,30,215,1582
VERACRUZ,ZONGOLICA,27,144,21,192,1582
VERACRUZ,ZONGOLICA,29,147,34,210,1581
VERACRUZ,ZONGOLICA,29,134,76,239,1587
VERACRUZ,ZONGOLICA,52,133,23,208,1586
VERACRUZ,ZONGOLICA,38,128,120,286,1800
VERACRUZ,ZONGOLICA,80,121,23,224,1981
VERACRUZ,ZONGOLICA,70,117,22,209,1981
VERACRUZ,ZONGOLICA,38,254,24,316,1221
VERACRUZ,ZONGOLICA,21,256,22,299,1221
VERACRUZ,ZONGOLICA,51,443,33,527,1856
VERACRUZ,ZONGOLICA,54,448,25,527,1856
VERACRUZ,ZONGOLICA,51,396,43,490,1561
VERACRUZ,ZONGOLICA,65,415,47,527,1560
VERACRUZ,ZONGOLICA,37,450,18,505,1880
VERACRUZ,ZONGOLICA,39,438,53,530,1880
VERACRUZ,ZONGOLICA,7,420,7,434,1709
VERACRUZ,ZONGOLICA,14,426,15,455,1708
VERACRUZ,ZONGOLICA,14,375,3,392,1385
VERACRUZ,ZONGOLICA,14,351,3,368,1385
VERACRUZ,ZONGOLICA,16,344,10,370,1474
VERACRUZ,ZONGOLICA,13,342,8,363,1474
VERACRUZ,ZONGOLICA,18,482,22,522,1836
VERACRUZ,ZONGOLICA,32,479,27,538,1836
VERACRUZ,ZONGOLICA,8,466,9,483,1464
VERACRUZ,ZONGOLICA,15,454,9,478,1464
VERACRUZ,ZONGOLICA,9,537,6,552,1463
VERACRUZ,ZONGOLICA,31,273,19,323,1504
VERACRUZ,ZONGOLICA,16,267,17,300,1504
VERACRUZ,ZONGOLICA,25,284,20,329,1503
VERACRUZ,ZONGOLICA,19,468,13,500,1753
VERACRUZ,ZONGOLICA,13,522,14,549,1753
VERACRUZ,ZONGOLICA,41,266,14,321,1753
VERACRUZ,ZONGOLICA,33,272,22,327,1752
VERACRUZ,ZONGOLICA,25,481,15,521,1903
VERACRUZ,ZONGOLICA,14,539,14,567,1903
VERACRUZ,ZONGOLICA,20,417,18,455,1430
VERACRUZ,ZONGOLICA,26,411,6,443,1430
VERACRUZ,ZONGOLICA,19,328,16,363,1341
VERACRUZ,ZONGOLICA,11,294,8,313,1340
VERACRUZ,ZONGOLICA,39,329,17,385,1822
VERACRUZ,ZONGOLICA,46,284,42,372,1821
VERACRUZ,ZONGOLICA,34,270,45,349,1821
VERACRUZ,ZONGOLICA,29,451,9,489,1920
VERACRUZ,ZONGOLICA,13,532,7,552,1920
VERACRUZ,ZONGOLICA,56,560,68,684,1950
VERACRUZ,ZONGOLICA,64,533,66,663,1949
VERACRUZ,ZONGOLICA,31,347,6,384,1675
VERACRUZ,ZONGOLICA,30,293,9,332,1674
VERACRUZ,ZONGOLICA,45,473,16,534,1905
VERACRUZ,ZONGOLICA,53,424,24,501,1904
VERACRUZ,ZONGOLICA,90,548,58,696,0
VERACRUZ,ZONGOLICA,56,532,40,628,1665
VERACRUZ,ZONGOLICA,56,506,45,607,1665
VERACRUZ,ZONGOLICA,63,455,46,564,1775
VERACRUZ,ZONGOLICA,32,326,28,386,1115
VERACRUZ,ZONGOLICA,43,365,28,436,1792
VERACRUZ,ZONGOLICA,45,257,49,351,1792
VERACRUZ,ZONGOLICA,49,296,46,391,1792
VERACRUZ,ZONGOLICA,42,457,25,524,1939
VERACRUZ,ZONGOLICA,37,369,15,421,1737
VERACRUZ,ZONGOLICA,36,379,23,438,1737
VERACRUZ,ZONGOLICA,51,320,42,413,1737
VERACRUZ,ZONGOLICA,46,268,35,349,1736
VERACRUZ,ZONGOLICA,38,305,46,389,1760
VERACRUZ,ZONGOLICA,28,279,49,356,1760
VERACRUZ,ZONGOLICA,54,279,57,390,1586
VERACRUZ,ZONGOLICA,67,217,56,340,1585
VERACRUZ,SAN ANDRES TUXTLA,8,687,12,707,1554
VERACRUZ,SAN ANDRES TUXTLA,19,1095,75,1189,1553
VERACRUZ,SAN ANDRES TUXTLA,6,321,4,331,1356
VERACRUZ,SAN ANDRES TUXTLA,4,311,7,322,1356
VERACRUZ,SAN ANDRES TUXTLA,5,305,5,315,1355
VERACRUZ,SAN ANDRES TUXTLA,13,454,9,476,1801
VERACRUZ,SAN ANDRES TUXTLA,13,420,6,439,1801
VERACRUZ,SAN ANDRES TUXTLA,8,326,3,337,1566
VERACRUZ,SAN ANDRES TUXTLA,4,341,1,346,1565
VERACRUZ,SAN ANDRES TUXTLA,12,321,3,336,1565
VERACRUZ,SAN ANDRES TUXTLA,12,457,5,474,1905
VERACRUZ,SAN ANDRES TUXTLA,10,446,20,476,1905
VERACRUZ,SAN ANDRES TUXTLA,15,327,2,344,1390
VERACRUZ,SAN ANDRES TUXTLA,13,341,3,357,1390
VERACRUZ,SAN ANDRES TUXTLA,23,133,3,159,1744
VERACRUZ,SAN ANDRES TUXTLA,17,142,1,160,1744
VERACRUZ,SAN ANDRES TUXTLA,24,200,4,228,1884
VERACRUZ,SAN ANDRES TUXTLA,19,166,2,187,1883
VERACRUZ,SAN ANDRES TUXTLA,20,273,6,299,1962
VERACRUZ,SAN ANDRES TUXTLA,18,249,2,269,1961
VERACRUZ,SAN ANDRES TUXTLA,6,212,5,223,1596
VERACRUZ,SAN ANDRES TUXTLA,5,215,3,223,1595
VERACRUZ,SAN ANDRES TUXTLA,11,224,7,242,1422
VERACRUZ,SAN ANDRES TUXTLA,7,305,7,319,1422
VERACRUZ,SAN ANDRES TUXTLA,12,280,8,300,1422
VERACRUZ,SAN ANDRES TUXTLA,8,434,6,448,1299
VERACRUZ,SAN ANDRES TUXTLA,5,404,7,416,1298
VERACRUZ,SAN ANDRES TUXTLA,7,405,8,420,1505
VERACRUZ,SAN ANDRES TUXTLA,8,554,4,566,1620
VERACRUZ,SAN ANDRES TUXTLA,15,596,7,618,1620
VERACRUZ,SAN ANDRES TUXTLA,3,412,0,415,1675
VERACRUZ,SAN ANDRES TUXTLA,4,397,0,401,1675
VERACRUZ,SAN ANDRES TUXTLA,7,457,2,466,1678
VERACRUZ,SAN ANDRES TUXTLA,7,492,6,505,1677
VERACRUZ,SAN ANDRES TUXTLA,10,1189,8,1207,1904
VERACRUZ,SAN ANDRES TUXTLA,1,1010,8,1019,1903
VERACRUZ,SAN ANDRES TUXTLA,8,459,0,467,1792
VERACRUZ,SAN ANDRES TUXTLA,9,552,4,565,1792
VERACRUZ,SAN ANDRES TUXTLA,10,460,8,478,1882
VERACRUZ,SAN ANDRES TUXTLA,6,530,2,538,1882
VERACRUZ,SAN ANDRES TUXTLA,11,402,5,418,1341
VERACRUZ,SAN ANDRES TUXTLA,8,341,8,357,1340
VERACRUZ,SAN ANDRES TUXTLA,8,443,8,459,1340
VERACRUZ,SAN ANDRES TUXTLA,12,440,7,459,1505
VERACRUZ,SAN ANDRES TUXTLA,9,472,9,490,1505
VERACRUZ,SAN ANDRES TUXTLA,10,489,4,503,1505
VERACRUZ,SAN ANDRES TUXTLA,6,467,7,480,1946
VERACRUZ,SAN ANDRES TUXTLA,11,451,12,474,1945
VERACRUZ,SAN ANDRES TUXTLA,25,581,24,630,1765
VERACRUZ,SAN ANDRES TUXTLA,17,547,14,578,1764
VERACRUZ,SAN ANDRES TUXTLA,14,328,7,349,1412
VERACRUZ,SAN ANDRES TUXTLA,18,358,14,390,1412
VERACRUZ,SAN ANDRES TUXTLA,14,378,8,400,1519
VERACRUZ,SAN ANDRES TUXTLA,11,378,9,398,1519
VERACRUZ,SAN ANDRES TUXTLA,22,352,8,382,1519
VERACRUZ,SAN ANDRES TUXTLA,13,514,12,539,1898
VERACRUZ,SAN ANDRES TUXTLA,22,605,8,635,1898
VERACRUZ,SAN ANDRES TUXTLA,19,490,12,521,1927
VERACRUZ,SAN ANDRES TUXTLA,14,420,5,439,1927
VERACRUZ,SAN ANDRES TUXTLA,15,360,6,381,1354
VERACRUZ,SAN ANDRES TUXTLA,9,369,9,387,1354
VERACRUZ,SAN ANDRES TUXTLA,23,511,10,544,1637
VERACRUZ,SAN ANDRES TUXTLA,22,410,23,455,1636
VERACRUZ,SAN ANDRES TUXTLA,16,302,7,325,1227
VERACRUZ,SAN ANDRES TUXTLA,15,296,7,318,1227
VERACRUZ,SAN ANDRES TUXTLA,12,616,18,646,1911
VERACRUZ,SAN ANDRES TUXTLA,14,605,14,633,1910
VERACRUZ,SAN ANDRES TUXTLA,20,380,17,417,1392
VERACRUZ,SAN ANDRES TUXTLA,26,429,23,478,1392
VERACRUZ,SAN ANDRES TUXTLA,14,324,12,350,1391
VERACRUZ,SAN ANDRES TUXTLA,2,298,6,306,1014
VERACRUZ,SAN ANDRES TUXTLA,1,306,2,309,1013
VERACRUZ,SAN ANDRES TUXTLA,15,535,3,553,1857
VERACRUZ,SAN ANDRES TUXTLA,10,548,1,559,1857
VERACRUZ,SAN ANDRES TUXTLA,17,710,13,740,2014
VERACRUZ,SAN ANDRES TUXTLA,16,460,0,476,1499
VERACRUZ,SAN ANDRES TUXTLA,14,468,12,494,1498
VERACRUZ,SAN ANDRES TUXTLA,11,503,525,1039,1778
VERACRUZ,SAN ANDRES TUXTLA,5,500,10,515,1778
VERACRUZ,SAN ANDRES TUXTLA,2,281,4,287,1046
VERACRUZ,SAN ANDRES TUXTLA,11,313,7,331,1046
VERACRUZ,SAN ANDRES TUXTLA,9,340,8,357,1030
VERACRUZ,SAN ANDRES TUXTLA,10,382,5,397,1029
VERACRUZ,SAN ANDRES TUXTLA,10,323,11,344,1896
VERACRUZ,SAN ANDRES TUXTLA,14,294,12,320,1896
VERACRUZ,SAN ANDRES TUXTLA,15,320,10,345,1901
VERACRUZ,SAN ANDRES TUXTLA,16,314,8,338,1901
VERACRUZ,SAN ANDRES TUXTLA,25,384,6,415,1752
VERACRUZ,SAN ANDRES TUXTLA,21,377,5,403,1751
VERACRUZ,SAN ANDRES TUXTLA,25,432,9,466,1810
VERACRUZ,SAN ANDRES TUXTLA,27,401,10,438,1810
VERACRUZ,SAN ANDRES TUXTLA,12,307,1,320,1586
VERACRUZ,SAN ANDRES TUXTLA,16,283,6,305,1585
VERACRUZ,SAN ANDRES TUXTLA,11,196,5,212,1316
VERACRUZ,SAN ANDRES TUXTLA,7,184,4,195,1315
VERACRUZ,SAN ANDRES TUXTLA,19,347,5,371,1712
VERACRUZ,SAN ANDRES TUXTLA,20,364,5,389,1712
VERACRUZ,SAN ANDRES TUXTLA,19,342,4,365,1563
VERACRUZ,SAN ANDRES TUXTLA,18,319,11,348,1562
VERACRUZ,SAN ANDRES TUXTLA,54,780,9,843,0
VERACRUZ,SAN ANDRES TUXTLA,22,373,4,399,1772
VERACRUZ,SAN ANDRES TUXTLA,14,495,6,515,1772
VERACRUZ,SAN ANDRES TUXTLA,16,400,3,419,1486
VERACRUZ,SAN ANDRES TUXTLA,20,321,6,347,1486
VERACRUZ,SAN ANDRES TUXTLA,14,352,10,376,1485
VERACRUZ,SAN ANDRES TUXTLA,10,412,13,435,1893
VERACRUZ,SAN ANDRES TUXTLA,23,372,6,401,1893
VERACRUZ,SAN ANDRES TUXTLA,7,426,6,439,1788
VERACRUZ,SAN ANDRES TUXTLA,13,430,4,447,1788
VERACRUZ,SAN ANDRES TUXTLA,19,274,2,295,1190
VERACRUZ,SAN ANDRES TUXTLA,26,254,2,282,1190
VERACRUZ,SAN ANDRES TUXTLA,18,449,3,470,2020
VERACRUZ,SAN ANDRES TUXTLA,14,522,13,549,1951
VERACRUZ,SAN ANDRES TUXTLA,21,486,17,524,1951
VERACRUZ,SAN ANDRES TUXTLA,26,95,17,138,1495
VERACRUZ,SAN ANDRES TUXTLA,18,92,16,126,1494
VERACRUZ,SAN ANDRES TUXTLA,8,272,5,285,1235
VERACRUZ,SAN ANDRES TUXTLA,7,229,7,243,1235
VERACRUZ,SAN ANDRES TUXTLA,19,479,11,509,1675
VERACRUZ,SAN ANDRES TUXTLA,25,540,8,573,1674
VERACRUZ,SAN ANDRES TUXTLA,17,371,12,400,1799
VERACRUZ,SAN ANDRES TUXTLA,20,711,8,739,1798
VERACRUZ,SAN ANDRES TUXTLA,12,171,8,191,2011
VERACRUZ,SAN ANDRES TUXTLA,22,262,26,310,2010
VERACRUZ,SAN ANDRES TUXTLA,14,78,6,98,1572
VERACRUZ,SAN ANDRES TUXTLA,20,102,7,129,1572
VERACRUZ,SAN ANDRES TUXTLA,13,423,10,446,1692
VERACRUZ,SAN ANDRES TUXTLA,9,375,6,390,1692
VERACRUZ,SAN ANDRES TUXTLA,15,270,9,294,1819
VERACRUZ,SAN ANDRES TUXTLA,11,228,7,246,1818
VERACRUZ,SAN ANDRES TUXTLA,8,273,4,285,1153
VERACRUZ,SAN ANDRES TUXTLA,6,257,13,276,1152
VERACRUZ,SAN ANDRES TUXTLA,13,350,14,377,1916
VERACRUZ,SAN ANDRES TUXTLA,20,412,11,443,1916
VERACRUZ,SAN ANDRES TUXTLA,11,180,4,195,1037
VERACRUZ,SAN ANDRES TUXTLA,9,216,5,230,1036
VERACRUZ,SAN ANDRES TUXTLA,10,138,11,159,1828
VERACRUZ,SAN ANDRES TUXTLA,9,128,23,160,1827
VERACRUZ,SAN ANDRES TUXTLA,18,258,11,287,1660
VERACRUZ,SAN ANDRES TUXTLA,13,271,13,297,1660
VERACRUZ,SAN ANDRES TUXTLA,40,257,18,315,1718
VERACRUZ,SAN ANDRES TUXTLA,26,299,13,338,1718
VERACRUZ,SAN ANDRES TUXTLA,25,369,23,417,1689
VERACRUZ,SAN ANDRES TUXTLA,29,631,9,669,1688
VERACRUZ,SAN ANDRES TUXTLA,13,315,9,337,1821
VERACRUZ,SAN ANDRES TUXTLA,5,270,11,286,1820
VERACRUZ,SAN ANDRES TUXTLA,10,107,14,131,1626
VERACRUZ,SAN ANDRES TUXTLA,10,95,7,112,1625
VERACRUZ,SAN ANDRES TUXTLA,12,191,11,214,1166
VERACRUZ,SAN ANDRES TUXTLA,10,140,11,161,1166
VERACRUZ,SAN ANDRES TUXTLA,20,537,5,562,1612
VERACRUZ,SAN ANDRES TUXTLA,3,522,6,531,1612
VERACRUZ,SAN ANDRES TUXTLA,5,395,3,403,1773
VERACRUZ,SAN ANDRES TUXTLA,7,395,9,411,1773
VERACRUZ,SAN ANDRES TUXTLA,14,313,7,334,1405
VERACRUZ,SAN ANDRES TUXTLA,6,290,4,300,1404
VERACRUZ,SAN ANDRES TUXTLA,13,337,1,351,1404
VERACRUZ,SAN ANDRES TUXTLA,17,410,5,432,1859
VERACRUZ,SAN ANDRES TUXTLA,17,431,1,449,1858
VERACRUZ,SAN ANDRES TUXTLA,14,287,6,307,1733
VERACRUZ,SAN ANDRES TUXTLA,9,305,3,317,1732
VERACRUZ,SAN ANDRES TUXTLA,9,309,10,328,1880
VERACRUZ,SAN ANDRES TUXTLA,12,315,13,340,1879
VERACRUZ,SAN ANDRES TUXTLA,7,282,7,296,1645
VERACRUZ,SAN ANDRES TUXTLA,7,400,9,416,1645
VERACRUZ,SAN ANDRES TUXTLA,2,255,4,261,1644
VERACRUZ,SAN ANDRES TUXTLA,12,571,10,593,1475
VERACRUZ,SAN ANDRES TUXTLA,8,603,7,618,1474
VERACRUZ,SAN ANDRES TUXTLA,0,361,1,362,1202
VERACRUZ,SAN ANDRES TUXTLA,0,400,0,400,1202
VERACRUZ,SAN ANDRES TUXTLA,21,572,19,612,1686
VERACRUZ,SAN ANDRES TUXTLA,13,496,18,527,1685
VERACRUZ,SAN ANDRES TUXTLA,12,470,23,505,1874
VERACRUZ,SAN ANDRES TUXTLA,4,409,34,447,1873
VERACRUZ,SAN ANDRES TUXTLA,15,436,13,464,1945
VERACRUZ,SAN ANDRES TUXTLA,10,472,9,491,1945
VERACRUZ,SAN ANDRES TUXTLA,11,321,5,337,1276
VERACRUZ,SAN ANDRES TUXTLA,9,318,11,338,1275
VERACRUZ,SAN ANDRES TUXTLA,12,507,7,526,1798
VERACRUZ,SAN ANDRES TUXTLA,23,462,10,495,1798
VERACRUZ,SAN ANDRES TUXTLA,2,351,7,360,1403
VERACRUZ,SAN ANDRES TUXTLA,11,348,1,360,1403
VERACRUZ,SAN ANDRES TUXTLA,16,253,6,275,1204
VERACRUZ,SAN ANDRES TUXTLA,12,248,6,266,1203
VERACRUZ,SAN ANDRES TUXTLA,14,260,9,283,1737
VERACRUZ,SAN ANDRES TUXTLA,11,274,10,295,1736
VERACRUZ,SAN ANDRES TUXTLA,17,154,6,177,1114
VERACRUZ,SAN ANDRES TUXTLA,15,180,3,198,1113
VERACRUZ,SAN ANDRES TUXTLA,9,122,13,144,1211
VERACRUZ,SAN ANDRES TUXTLA,6,157,14,177,1211
VERACRUZ,SAN ANDRES TUXTLA,17,264,18,299,1992
VERACRUZ,SAN ANDRES TUXTLA,28,277,9,314,1992
VERACRUZ,SAN ANDRES TUXTLA,13,273,6,292,1991
VERACRUZ,COSOLEACAQUE,5,531,4,540,1815
VERACRUZ,COSOLEACAQUE,11,585,7,603,1815
VERACRUZ,COSOLEACAQUE,8,337,17,362,1405
VERACRUZ,COSOLEACAQUE,9,374,12,395,1404
VERACRUZ,COSOLEACAQUE,5,358,9,372,1404
VERACRUZ,COSOLEACAQUE,8,467,4,479,1658
VERACRUZ,COSOLEACAQUE,4,449,11,464,1658
VERACRUZ,COSOLEACAQUE,8,362,2,372,1234
VERACRUZ,COSOLEACAQUE,4,408,3,415,1233
VERACRUZ,COSOLEACAQUE,7,444,1,452,1942
VERACRUZ,COSOLEACAQUE,8,465,5,478,1941
VERACRUZ,COSOLEACAQUE,51,881,7,939,0
VERACRUZ,COSOLEACAQUE,10,450,6,466,1947
VERACRUZ,COSOLEACAQUE,17,483,5,505,1946
VERACRUZ,COSOLEACAQUE,5,402,6,413,1274
VERACRUZ,COSOLEACAQUE,7,409,7,423,1273
VERACRUZ,COSOLEACAQUE,6,490,3,499,1728
VERACRUZ,COSOLEACAQUE,15,440,6,461,1727
VERACRUZ,COSOLEACAQUE,7,432,0,439,1727
VERACRUZ,COSOLEACAQUE,3,499,13,515,1647
VERACRUZ,COSOLEACAQUE,12,524,4,540,1647
VERACRUZ,COSOLEACAQUE,15,486,6,507,1647
VERACRUZ,COSOLEACAQUE,6,498,7,511,1865
VERACRUZ,COSOLEACAQUE,7,560,5,572,1865
VERACRUZ,COSOLEACAQUE,5,427,5,437,1562
VERACRUZ,COSOLEACAQUE,2,456,1,459,1562
VERACRUZ,COSOLEACAQUE,3,445,11,459,1562
VERACRUZ,COSOLEACAQUE,8,608,4,620,1766
VERACRUZ,COSOLEACAQUE,8,622,6,636,1765
VERACRUZ,COSOLEACAQUE,14,589,6,609,1867
VERACRUZ,COSOLEACAQUE,8,574,5,587,1867
VERACRUZ,COSOLEACAQUE,7,566,7,580,1865
VERACRUZ,COSOLEACAQUE,5,571,4,580,1865
VERACRUZ,COSOLEACAQUE,5,391,2,398,1249
VERACRUZ,COSOLEACAQUE,10,430,3,443,1248
VERACRUZ,COSOLEACAQUE,5,409,10,424,1247
VERACRUZ,COSOLEACAQUE,9,396,10,415,1247
VERACRUZ,COSOLEACAQUE,10,557,10,577,1959
VERACRUZ,COSOLEACAQUE,4,546,10,560,1958
VERACRUZ,COSOLEACAQUE,8,500,10,518,1847
VERACRUZ,COSOLEACAQUE,10,436,11,457,1847
VERACRUZ,COSOLEACAQUE,6,395,4,405,2039
VERACRUZ,COSOLEACAQUE,2,420,2,424,2039
VERACRUZ,COSOLEACAQUE,4,397,2,403,1446
VERACRUZ,COSOLEACAQUE,6,361,17,384,1446
VERACRUZ,COSOLEACAQUE,6,636,0,642,1803
VERACRUZ,COSOLEACAQUE,16,548,7,571,1803
VERACRUZ,COSOLEACAQUE,17,351,10,378,1212
VERACRUZ,COSOLEACAQUE,7,371,9,387,1211
VERACRUZ,COSOLEACAQUE,20,390,16,426,1581
VERACRUZ,COSOLEACAQUE,14,386,18,418,1580
VERACRUZ,COSOLEACAQUE,10,490,8,508,1607
VERACRUZ,COSOLEACAQUE,11,464,12,487,1606
VERACRUZ,COSOLEACAQUE,8,606,11,625,1814
VERACRUZ,COSOLEACAQUE,22,543,9,574,1813
VERACRUZ,COSOLEACAQUE,12,454,4,470,1430
VERACRUZ,COSOLEACAQUE,11,557,6,574,1430
VERACRUZ,COSOLEACAQUE,13,1650,7,1670,1871
VERACRUZ,COSOLEACAQUE,7,1743,0,1750,1871
VERACRUZ,COSOLEACAQUE,63,1158,18,1239,1682
VERACRUZ,COSOLEACAQUE,37,1284,20,1341,1682
VERACRUZ,COSOLEACAQUE,40,1395,12,1447,1682
VERACRUZ,COSOLEACAQUE,8,868,1,877,1130
VERACRUZ,COSOLEACAQUE,6,924,2,932,1130
VERACRUZ,COSOLEACAQUE,8,1088,6,1102,1538
VERACRUZ,COSOLEACAQUE,3,1002,1,1006,1538
VERACRUZ,COSOLEACAQUE,7,1143,5,1155,1537
VERACRUZ,COSOLEACAQUE,5,1383,4,1392,1787
VERACRUZ,COSOLEACAQUE,7,1291,1,1299,1786
VERACRUZ,COSOLEACAQUE,8,1324,25,1357,1603
VERACRUZ,COSOLEACAQUE,26,1483,10,1519,1603
VERACRUZ,COSOLEACAQUE,91,1285,20,1396,1868
VERACRUZ,COSOLEACAQUE,77,1150,16,1243,1867
VERACRUZ,COSOLEACAQUE,6,1370,2,1378,1721
VERACRUZ,COSOLEACAQUE,8,1123,6,1137,1721
VERACRUZ,COSOLEACAQUE,6,560,9,575,1685
VERACRUZ,COSOLEACAQUE,6,565,4,575,1684
VERACRUZ,COSOLEACAQUE,11,538,7,556,1684
VERACRUZ,COSOLEACAQUE,22,413,3,438,1230
VERACRUZ,COSOLEACAQUE,14,419,7,440,1229
VERACRUZ,COSOLEACAQUE,25,630,5,660,1867
VERACRUZ,COSOLEACAQUE,18,607,3,628,1866
VERACRUZ,COSOLEACAQUE,18,473,6,497,1596
VERACRUZ,COSOLEACAQUE,7,489,6,502,1595
VERACRUZ,COSOLEACAQUE,7,344,3,354,1085
VERACRUZ,COSOLEACAQUE,5,385,3,393,1085
VERACRUZ,COSOLEACAQUE,12,599,21,632,1848
VERACRUZ,COSOLEACAQUE,9,653,4,666,1848
VERACRUZ,COSOLEACAQUE,12,463,5,480,1910
VERACRUZ,COSOLEACAQUE,10,448,7,465,1909
VERACRUZ,COSOLEACAQUE,10,485,6,501,1909
VERACRUZ,COSOLEACAQUE,7,594,4,605,1537
VERACRUZ,COSOLEACAQUE,7,565,7,579,1536
VERACRUZ,COSOLEACAQUE,22,377,6,405,1360
VERACRUZ,COSOLEACAQUE,13,379,17,409,1359
VERACRUZ,COSOLEACAQUE,12,210,12,234,1116
VERACRUZ,COSOLEACAQUE,17,261,5,283,1116
VERACRUZ,COSOLEACAQUE,30,405,13,448,1366
VERACRUZ,COSOLEACAQUE,34,346,21,401,1366
VERACRUZ,COSOLEACAQUE,38,405,11,454,1582
VERACRUZ,COSOLEACAQUE,34,401,18,453,1582
VERACRUZ,COSOLEACAQUE,36,405,19,460,1582
VERACRUZ,COSOLEACAQUE,24,350,7,381,1556
VERACRUZ,COSOLEACAQUE,24,331,4,359,1555
VERACRUZ,COSOLEACAQUE,23,382,1,406,1223
VERACRUZ,COSOLEACAQUE,21,339,6,366,1222
VERACRUZ,COSOLEACAQUE,12,530,11,553,1645
VERACRUZ,COSOLEACAQUE,7,420,2,429,1644
VERACRUZ,COSOLEACAQUE,15,482,6,503,1701
VERACRUZ,COSOLEACAQUE,11,443,11,465,1700
VERACRUZ,COSOLEACAQUE,10,521,12,543,1531
VERACRUZ,COSOLEACAQUE,12,478,9,499,1531
VERACRUZ,COSOLEACAQUE,12,568,4,584,1726
VERACRUZ,COSOLEACAQUE,11,507,11,529,1725
VERACRUZ,COSOLEACAQUE,8,411,7,426,1253
VERACRUZ,COSOLEACAQUE,7,410,9,426,1253
VERACRUZ,COSOLEACAQUE,5,270,10,285,1505
VERACRUZ,COSOLEACAQUE,8,313,3,324,1505
VERACRUZ,COSOLEACAQUE,11,352,2,365,1709
VERACRUZ,COSOLEACAQUE,16,330,0,346,1709
VERACRUZ,COSOLEACAQUE,5,446,4,455,1901
VERACRUZ,COSOLEACAQUE,6,398,2,406,1900
VERACRUZ,COSOLEACAQUE,11,347,14,372,1824
VERACRUZ,COSOLEACAQUE,6,372,5,383,1824
VERACRUZ,COSOLEACAQUE,11,501,5,517,1706
VERACRUZ,COSOLEACAQUE,19,443,32,494,1706
VERACRUZ,COSOLEACAQUE,10,430,9,449,1706
VERACRUZ,COSOLEACAQUE,20,463,17,500,1712
VERACRUZ,COSOLEACAQUE,32,477,22,531,1711
VERACRUZ,COSOLEACAQUE,20,266,8,294,1059
VERACRUZ,COSOLEACAQUE,16,275,8,299,1059
VERACRUZ,COSOLEACAQUE,14,1015,14,1043,1458
VERACRUZ,COSOLEACAQUE,17,513,15,545,1457
VERACRUZ,COSOLEACAQUE,12,1189,3,1204,1457
VERACRUZ,COSOLEACAQUE,20,1164,2,1186,1691
VERACRUZ,COSOLEACAQUE,13,1373,7,1393,1690
VERACRUZ,COSOLEACAQUE,8,1266,3,1277,1690
VERACRUZ,COSOLEACAQUE,19,514,7,540,1954
VERACRUZ,COSOLEACAQUE,20,568,16,604,1953
VERACRUZ,COSOLEACAQUE,34,354,17,405,1716
VERACRUZ,COSOLEACAQUE,34,369,8,411,1715
VERACRUZ,COSOLEACAQUE,41,286,11,338,1489
VERACRUZ,COSOLEACAQUE,39,250,18,307,1488
VERACRUZ,COSOLEACAQUE,35,486,26,547,1870
VERACRUZ,COSOLEACAQUE,53,464,24,541,1870
VERACRUZ,COSOLEACAQUE,29,499,22,550,1870
VERACRUZ,COSOLEACAQUE,37,200,35,272,1296
VERACRUZ,COSOLEACAQUE,44,232,38,314,1295
VERACRUZ,COSOLEACAQUE,59,302,6,367,1144
VERACRUZ,COSOLEACAQUE,53,333,6,392,1144
VERACRUZ,COSOLEACAQUE,151,370,43,564,1659
VERACRUZ,COSOLEACAQUE,122,371,27,520,1659
VERACRUZ,COSOLEACAQUE,144,404,21,569,1371
VERACRUZ,COSOLEACAQUE,104,462,15,581,1370
VERACRUZ,COSOLEACAQUE,65,236,12,313,1052
VERACRUZ,COSOLEACAQUE,38,231,11,280,1051
VERACRUZ,COSOLEACAQUE,46,487,27,560,1928
VERACRUZ,COSOLEACAQUE,32,448,19,499,1928
VERACRUZ,COSOLEACAQUE,6,561,8,575,1406
VERACRUZ,COSOLEACAQUE,4,620,6,630,1405
VERACRUZ,COSOLEACAQUE,18,571,0,589,1405
VERACRUZ,COSOLEACAQUE,11,625,11,647,1604
VERACRUZ,COSOLEACAQUE,4,607,8,619,1603
VERACRUZ,COSOLEACAQUE,10,594,8,612,1603
VERACRUZ,COSOLEACAQUE,6,883,1,890,1840
VERACRUZ,COSOLEACAQUE,3,874,3,880,1839
VERACRUZ,COSOLEACAQUE,2,549,0,551,1057
VERACRUZ,COSOLEACAQUE,15,567,5,587,1057
VERACRUZ,COSOLEACAQUE,10,653,13,676,2000
VERACRUZ,COSOLEACAQUE,7,622,2,631,1999
VERACRUZ,COSOLEACAQUE,9,593,4,606,1694
VERACRUZ,COSOLEACAQUE,6,535,2,543,1693
VERACRUZ,COSOLEACAQUE,4,553,2,559,1856
VERACRUZ,COSOLEACAQUE,8,605,1,614,1856
VERACRUZ,COSOLEACAQUE,8,464,2,474,1608
VERACRUZ,COSOLEACAQUE,12,505,13,530,1607
VERACRUZ,COSOLEACAQUE,10,470,7,487,1607
VERACRUZ,COSOLEACAQUE,7,453,2,462,1375
VERACRUZ,COSOLEACAQUE,8,464,1,473,1375
VERACRUZ,COSOLEACAQUE,13,483,6,502,1685
VERACRUZ,COSOLEACAQUE,9,509,5,523,1684
VERACRUZ,COSOLEACAQUE,10,495,2,507,1595
VERACRUZ,COSOLEACAQUE,13,468,4,485,1594
VERACRUZ,COSOLEACAQUE,18,535,2,555,1594
VERACRUZ,COSOLEACAQUE,6,298,5,309,1020
VERACRUZ,COSOLEACAQUE,9,344,2,355,1019
VERACRUZ,COSOLEACAQUE,11,430,6,447,1677
VERACRUZ,COSOLEACAQUE,7,450,7,464,1676
VERACRUZ,COSOLEACAQUE,11,449,11,471,1390
VERACRUZ,COSOLEACAQUE,3,266,111,380,1389
YUCATÁN,VALLADOLID,7,441,3,451,1567
YUCATÁN,VALLADOLID,7,350,5,362,1567
YUCATÁN,VALLADOLID,1,372,9,382,1567
YUCATÁN,VALLADOLID,6,346,4,356,1566
YUCATÁN,VALLADOLID,5,551,8,564,1744
YUCATÁN,VALLADOLID,10,517,7,534,1744
YUCATÁN,VALLADOLID,5,419,8,432,1584
YUCATÁN,VALLADOLID,7,446,9,462,1584
YUCATÁN,VALLADOLID,7,509,5,521,1584
YUCATÁN,VALLADOLID,11,387,9,407,1526
YUCATÁN,VALLADOLID,10,376,5,391,1526
YUCATÁN,VALLADOLID,10,357,10,377,1526
YUCATÁN,VALLADOLID,6,375,13,394,1526
YUCATÁN,VALLADOLID,7,342,8,357,1335
YUCATÁN,VALLADOLID,9,299,7,315,1335
YUCATÁN,VALLADOLID,8,332,9,349,1736
YUCATÁN,VALLADOLID,15,320,11,346,1735
YUCATÁN,VALLADOLID,8,344,0,352,1916
YUCATÁN,VALLADOLID,11,348,6,365,1916
YUCATÁN,VALLADOLID,4,204,2,210,1058
YUCATÁN,VALLADOLID,5,189,5,199,1057
YUCATÁN,VALLADOLID,3,281,4,288,1555
YUCATÁN,VALLADOLID,5,246,8,259,1555
YUCATÁN,VALLADOLID,8,195,5,208,1613
YUCATÁN,VALLADOLID,6,178,6,190,1613
YUCATÁN,VALLADOLID,3,142,7,152,1232
YUCATÁN,VALLADOLID,12,175,6,193,1232
YUCATÁN,VALLADOLID,5,265,9,279,1286
YUCATÁN,VALLADOLID,27,335,9,371,1285
YUCATÁN,VALLADOLID,25,225,11,261,1604
YUCATÁN,VALLADOLID,5,198,6,209,1604
YUCATÁN,VALLADOLID,17,338,7,362,1722
YUCATÁN,VALLADOLID,2,383,14,399,1722
YUCATÁN,VALLADOLID,8,324,7,339,1952
YUCATÁN,VALLADOLID,6,367,8,381,1952
YUCATÁN,VALLADOLID,27,517,8,552,1534
YUCATÁN,VALLADOLID,25,494,12,531,1533
YUCATÁN,VALLADOLID,26,483,7,516,1533
YUCATÁN,VALLADOLID,4,625,8,637,1886
YUCATÁN,VALLADOLID,13,599,9,621,1886
YUCATÁN,VALLADOLID,6,481,8,495,1383
YUCATÁN,VALLADOLID,11,483,7,501,1383
YUCATÁN,VALLADOLID,2,390,2,394,1155
YUCATÁN,VALLADOLID,7,424,3,434,1155
YUCATÁN,VALLADOLID,7,534,0,541,1689
YUCATÁN,VALLADOLID,17,507,11,535,1688
YUCATÁN,VALLADOLID,10,573,10,593,1688
YUCATÁN,VALLADOLID,8,491,11,510,1545
YUCATÁN,VALLADOLID,5,527,7,539,1544
YUCATÁN,VALLADOLID,12,526,3,541,1544
YUCATÁN,VALLADOLID,4,318,10,332,1688
YUCATÁN,VALLADOLID,9,297,10,316,1688
YUCATÁN,VALLADOLID,6,363,10,379,1688
YUCATÁN,VALLADOLID,11,337,7,355,1687
YUCATÁN,VALLADOLID,7,396,9,412,1903
YUCATÁN,VALLADOLID,14,446,20,480,1903
YUCATÁN,VALLADOLID,7,422,10,439,1903
YUCATÁN,VALLADOLID,5,589,10,604,1882
YUCATÁN,VALLADOLID,6,594,6,606,1882
YUCATÁN,VALLADOLID,8,567,15,590,1882
YUCATÁN,VALLADOLID,8,493,12,513,1494
YUCATÁN,VALLADOLID,9,492,7,508,1494
YUCATÁN,VALLADOLID,8,511,12,531,1516
YUCATÁN,VALLADOLID,6,586,10,602,1515
YUCATÁN,VALLADOLID,9,475,8,492,1587
YUCATÁN,VALLADOLID,5,425,6,436,1586
YUCATÁN,VALLADOLID,6,476,4,486,1586
YUCATÁN,VALLADOLID,4,507,5,516,1518
YUCATÁN,VALLADOLID,14,578,5,597,1518
YUCATÁN,VALLADOLID,10,345,7,362,1299
YUCATÁN,VALLADOLID,7,329,12,348,1299
YUCATÁN,VALLADOLID,12,359,11,382,1858
YUCATÁN,VALLADOLID,17,397,19,433,1857
YUCATÁN,VALLADOLID,2,461,10,473,1217
YUCATÁN,VALLADOLID,3,497,7,507,1216
YUCATÁN,VALLADOLID,14,339,8,361,1500
YUCATÁN,VALLADOLID,14,358,4,376,1500
YUCATÁN,VALLADOLID,6,410,1,417,1500
YUCATÁN,VALLADOLID,18,441,11,470,1767
YUCATÁN,VALLADOLID,9,388,4,401,1767
YUCATÁN,VALLADOLID,8,402,12,422,1766
YUCATÁN,VALLADOLID,8,480,2,490,1480
YUCATÁN,VALLADOLID,5,501,3,509,1479
YUCATÁN,VALLADOLID,5,319,9,333,1665
YUCATÁN,VALLADOLID,5,408,7,420,1665
YUCATÁN,VALLADOLID,6,372,5,383,1664
YUCATÁN,VALLADOLID,4,428,6,438,1664
YUCATÁN,VALLADOLID,8,379,9,396,1173
YUCATÁN,VALLADOLID,11,337,9,357,1173
YUCATÁN,VALLADOLID,8,429,16,453,1346
YUCATÁN,VALLADOLID,9,457,10,476,1346
YUCATÁN,VALLADOLID,2,402,9,413,1138
YUCATÁN,VALLADOLID,10,352,3,365,1138
YUCATÁN,VALLADOLID,15,695,6,716,1932
YUCATÁN,VALLADOLID,24,646,10,680,1931
YUCATÁN,VALLADOLID,12,337,7,356,1747
YUCATÁN,VALLADOLID,17,475,5,497,1747
YUCATÁN,VALLADOLID,12,260,4,276,1334
YUCATÁN,VALLADOLID,7,282,5,294,1334
YUCATÁN,VALLADOLID,11,309,9,329,1334
YUCATÁN,VALLADOLID,30,677,24,731,1847
YUCATÁN,VALLADOLID,21,692,13,726,1846
YUCATÁN,VALLADOLID,7,369,14,390,1033
YUCATÁN,VALLADOLID,5,430,9,444,1033
YUCATÁN,VALLADOLID,3,354,4,361,1270
YUCATÁN,VALLADOLID,4,314,5,323,1269
YUCATÁN,VALLADOLID,7,292,3,302,1794
YUCATÁN,VALLADOLID,11,330,3,344,1794
YUCATÁN,VALLADOLID,19,409,8,436,0
YUCATÁN,VALLADOLID,7,499,13,519,1408
YUCATÁN,VALLADOLID,14,461,13,488,1407
YUCATÁN,VALLADOLID,7,197,12,216,1364
YUCATÁN,VALLADOLID,10,237,7,254,1363
YUCATÁN,VALLADOLID,6,257,5,268,1363
YUCATÁN,VALLADOLID,7,269,7,283,1505
YUCATÁN,VALLADOLID,11,261,4,276,1504
YUCATÁN,VALLADOLID,10,339,3,352,1655
YUCATÁN,VALLADOLID,9,314,2,325,1655
YUCATÁN,VALLADOLID,14,296,6,316,1638
YUCATÁN,VALLADOLID,19,280,5,304,1637
YUCATÁN,VALLADOLID,10,315,3,328,1632
YUCATÁN,VALLADOLID,8,308,6,322,1632
YUCATÁN,VALLADOLID,11,314,7,332,1614
YUCATÁN,VALLADOLID,15,295,7,317,1614
YUCATÁN,VALLADOLID,11,299,9,319,1650
YUCATÁN,VALLADOLID,17,275,6,298,1649
YUCATÁN,VALLADOLID,6,310,0,316,1477
YUCATÁN,VALLADOLID,4,333,2,339,1476
YUCATÁN,VALLADOLID,15,335,6,356,1835
YUCATÁN,VALLADOLID,7,390,6,403,1834
YUCATÁN,VALLADOLID,21,234,6,261,1620
YUCATÁN,VALLADOLID,6,222,3,231,1620
YUCATÁN,VALLADOLID,5,230,4,239,1620
YUCATÁN,VALLADOLID,10,279,13,302,1715
YUCATÁN,VALLADOLID,8,250,8,266,1714
YUCATÁN,VALLADOLID,15,392,7,414,1420
YUCATÁN,VALLADOLID,9,360,13,382,1419
YUCATÁN,VALLADOLID,17,473,14,504,1948
YUCATÁN,VALLADOLID,11,471,14,496,1947
YUCATÁN,VALLADOLID,13,379,14,406,1610
YUCATÁN,VALLADOLID,15,386,13,414,1610
YUCATÁN,VALLADOLID,20,258,21,299,1346
YUCATÁN,VALLADOLID,18,294,24,336,1345
YUCATÁN,VALLADOLID,18,299,4,321,1345
YUCATÁN,VALLADOLID,11,261,7,279,1420
YUCATÁN,VALLADOLID,5,336,4,345,1419
YUCATÁN,VALLADOLID,1,603,2,606,1307
YUCATÁN,VALLADOLID,4,563,10,577,1306
YUCATÁN,VALLADOLID,5,585,11,601,1306
YUCATÁN,VALLADOLID,5,305,4,314,1284
YUCATÁN,VALLADOLID,7,302,8,317,1284
YUCATÁN,VALLADOLID,9,335,5,349,1498
YUCATÁN,VALLADOLID,4,340,2,346,1497
YUCATÁN,VALLADOLID,12,359,5,376,1430
YUCATÁN,VALLADOLID,7,344,2,353,1429
YUCATÁN,VALLADOLID,8,276,6,290,1361
YUCATÁN,VALLADOLID,10,249,4,263,1361
YUCATÁN,VALLADOLID,8,236,12,256,1360
YUCATÁN,VALLADOLID,2,329,4,335,1612
YUCATÁN,VALLADOLID,11,293,6,310,1612
YUCATÁN,VALLADOLID,6,286,4,296,1612
YUCATÁN,VALLADOLID,6,437,6,449,1932
YUCATÁN,VALLADOLID,10,423,3,436,1931
YUCATÁN,VALLADOLID,8,408,1,417,1975
YUCATÁN,VALLADOLID,11,374,8,393,1975
YUCATÁN,VALLADOLID,10,311,6,327,1582
YUCATÁN,VALLADOLID,13,339,2,354,1581
YUCATÁN,VALLADOLID,6,352,9,367,1491
YUCATÁN,VALLADOLID,5,324,4,333,1491
YUCATÁN,VALLADOLID,7,372,4,383,1751
YUCATÁN,VALLADOLID,6,355,5,366,1750
YUCATÁN,VALLADOLID,7,271,4,282,1110
YUCATÁN,VALLADOLID,6,252,5,263,1110
YUCATÁN,VALLADOLID,10,440,7,457,1655
YUCATÁN,VALLADOLID,6,424,8,438,1654
YUCATÁN,VALLADOLID,21,241,9,271,1181
YUCATÁN,VALLADOLID,20,267,8,295,1181
YUCATÁN,VALLADOLID,61,310,14,385,1706
YUCATÁN,VALLADOLID,69,338,23,430,1705
YUCATÁN,VALLADOLID,31,212,2,245,1067
YUCATÁN,VALLADOLID,9,212,4,225,1067
YUCATÁN,VALLADOLID,27,344,24,395,1581
YUCATÁN,VALLADOLID,29,340,17,386,1580
YUCATÁN,VALLADOLID,12,405,15,432,1584
YUCATÁN,VALLADOLID,27,412,18,457,1584
YUCATÁN,VALLADOLID,11,373,13,397,1583
YUCATÁN,VALLADOLID,9,488,10,507,1954
YUCATÁN,VALLADOLID,8,425,5,438,1954
YUCATÁN,VALLADOLID,8,190,7,205,1910
YUCATÁN,VALLADOLID,5,192,7,204,1909
YUCATÁN,VALLADOLID,42,366,8,416,1936
YUCATÁN,VALLADOLID,28,397,7,432,1936
YUCATÁN,PROGRESO,7,462,12,481,1450
YUCATÁN,PROGRESO,2,478,1,481,1450
YUCATÁN,PROGRESO,9,518,6,533,1702
YUCATÁN,PROGRESO,3,485,5,493,1701
YUCATÁN,PROGRESO,8,551,6,565,1378
YUCATÁN,PROGRESO,10,508,7,525,1377
YUCATÁN,PROGRESO,12,512,3,527,1545
YUCATÁN,PROGRESO,6,583,6,595,1544
YUCATÁN,PROGRESO,12,446,6,464,1109
YUCATÁN,PROGRESO,4,396,2,402,1108
YUCATÁN,PROGRESO,11,448,6,465,1229
YUCATÁN,PROGRESO,13,474,8,495,1228
YUCATÁN,PROGRESO,17,661,9,687,1947
YUCATÁN,PROGRESO,6,625,11,642,1947
YUCATÁN,PROGRESO,8,653,10,671,1951
YUCATÁN,PROGRESO,8,729,6,743,1951
YUCATÁN,PROGRESO,5,674,9,688,1901
YUCATÁN,PROGRESO,11,663,5,679,1900
YUCATÁN,PROGRESO,5,449,9,463,1236
YUCATÁN,PROGRESO,6,436,9,451,1235
YUCATÁN,PROGRESO,3,576,4,583,1679
YUCATÁN,PROGRESO,8,600,6,614,1679
YUCATÁN,PROGRESO,10,256,4,270,1461
YUCATÁN,PROGRESO,6,220,3,229,1461
YUCATÁN,PROGRESO,14,300,6,320,1942
YUCATÁN,PROGRESO,15,307,2,324,1942
YUCATÁN,PROGRESO,9,183,1,193,1347
YUCATÁN,PROGRESO,22,135,0,157,1347
YUCATÁN,PROGRESO,15,184,1,200,1347
YUCATÁN,PROGRESO,9,282,3,294,1733
YUCATÁN,PROGRESO,9,322,4,335,1732
YUCATÁN,PROGRESO,14,759,6,779,1581
YUCATÁN,PROGRESO,19,668,12,699,1581
YUCATÁN,PROGRESO,4,416,8,428,1575
YUCATÁN,PROGRESO,5,447,5,457,1574
YUCATÁN,PROGRESO,4,469,9,482,1574
YUCATÁN,PROGRESO,12,397,72,481,1668
YUCATÁN,PROGRESO,19,453,13,485,1668
YUCATÁN,PROGRESO,12,517,7,536,1668
YUCATÁN,PROGRESO,8,325,8,341,1323
YUCATÁN,PROGRESO,12,295,1,308,1323
YUCATÁN,PROGRESO,10,294,8,312,1322
YUCATÁN,PROGRESO,9,296,9,314,1335
YUCATÁN,PROGRESO,2,287,14,303,1334
YUCATÁN,PROGRESO,4,286,2,292,1334
YUCATÁN,PROGRESO,12,418,4,434,1764
YUCATÁN,PROGRESO,10,474,8,492,1763
YUCATÁN,PROGRESO,9,439,15,463,1860
YUCATÁN,PROGRESO,17,411,10,438,1860
YUCATÁN,PROGRESO,4,350,5,359,1684
YUCATÁN,PROGRESO,9,359,10,378,1683
YUCATÁN,PROGRESO,9,455,10,474,1812
YUCATÁN,PROGRESO,7,400,4,411,1812
YUCATÁN,PROGRESO,25,422,23,470,1598
YUCATÁN,PROGRESO,27,399,18,444,1598
YUCATÁN,PROGRESO,21,481,7,509,1609
YUCATÁN,PROGRESO,4,473,8,485,1608
YUCATÁN,PROGRESO,9,381,9,399,1624
YUCATÁN,PROGRESO,6,391,3,400,1623
YUCATÁN,PROGRESO,8,320,8,336,1514
YUCATÁN,PROGRESO,11,299,8,318,1514
YUCATÁN,PROGRESO,6,324,14,344,1514
YUCATÁN,PROGRESO,7,281,0,288,1670
YUCATÁN,PROGRESO,6,275,7,288,1670
YUCATÁN,PROGRESO,5,225,5,235,1670
YUCATÁN,PROGRESO,2,198,3,203,1670
YUCATÁN,PROGRESO,7,200,1,208,1670
YUCATÁN,PROGRESO,4,250,2,256,1670
YUCATÁN,PROGRESO,3,288,7,298,1181
YUCATÁN,PROGRESO,5,278,2,285,1180
YUCATÁN,PROGRESO,10,306,7,323,1328
YUCATÁN,PROGRESO,10,388,1,399,1328
YUCATÁN,PROGRESO,7,265,7,279,1327
YUCATÁN,PROGRESO,5,303,4,312,1679
YUCATÁN,PROGRESO,10,329,13,352,1678
YUCATÁN,PROGRESO,11,226,0,237,1596
YUCATÁN,PROGRESO,6,235,0,241,1595
YUCATÁN,PROGRESO,3,329,6,338,1594
YUCATÁN,PROGRESO,9,249,3,261,1594
YUCATÁN,PROGRESO,4,278,4,286,1594
YUCATÁN,PROGRESO,5,278,3,286,1411
YUCATÁN,PROGRESO,7,303,2,312,1410
YUCATÁN,PROGRESO,10,296,13,319,1783
YUCATÁN,PROGRESO,8,321,7,336,1783
YUCATÁN,PROGRESO,7,237,4,248,1915
YUCATÁN,PROGRESO,4,251,1,256,1915
YUCATÁN,PROGRESO,5,293,5,303,1914
YUCATÁN,PROGRESO,10,310,0,320,1914
YUCATÁN,PROGRESO,10,269,4,283,1862
YUCATÁN,PROGRESO,5,284,7,296,1861
YUCATÁN,PROGRESO,5,295,7,307,1861
YUCATÁN,PROGRESO,10,252,27,289,1582
YUCATÁN,PROGRESO,8,237,14,259,1581
YUCATÁN,PROGRESO,9,231,7,247,1581
YUCATÁN,PROGRESO,7,179,0,186,1788
YUCATÁN,PROGRESO,2,197,5,204,1788
YUCATÁN,PROGRESO,5,158,1,164,1788
YUCATÁN,PROGRESO,3,199,1,203,1787
YUCATÁN,PROGRESO,6,186,3,195,1787
YUCATÁN,PROGRESO,2,207,5,214,1787
YUCATÁN,PROGRESO,10,205,4,219,1787
YUCATÁN,PROGRESO,10,188,3,201,1478
YUCATÁN,PROGRESO,0,190,3,193,1478
YUCATÁN,PROGRESO,7,183,4,194,1477
YUCATÁN,PROGRESO,7,548,8,563,1450
YUCATÁN,PROGRESO,10,519,13,542,1449
YUCATÁN,PROGRESO,7,462,12,481,1211
YUCATÁN,PROGRESO,4,431,7,442,1211
YUCATÁN,PROGRESO,4,309,3,316,1433
YUCATÁN,PROGRESO,8,271,5,284,1433
YUCATÁN,PROGRESO,14,592,7,613,1920
YUCATÁN,PROGRESO,6,528,7,541,1919
YUCATÁN,PROGRESO,9,426,3,438,1309
YUCATÁN,PROGRESO,9,427,6,442,1309
YUCATÁN,PROGRESO,15,443,9,467,1308
YUCATÁN,PROGRESO,12,542,15,569,1953
YUCATÁN,PROGRESO,13,560,18,591,1952
YUCATÁN,PROGRESO,11,520,13,544,1332
YUCATÁN,PROGRESO,8,482,5,495,1331
YUCATÁN,PROGRESO,13,483,15,511,1331
YUCATÁN,PROGRESO,14,552,8,574,1861
YUCATÁN,PROGRESO,12,547,8,567,1861
YUCATÁN,PROGRESO,7,570,13,590,1862
YUCATÁN,PROGRESO,11,581,5,597,1861
YUCATÁN,PROGRESO,15,716,10,741,1895
YUCATÁN,PROGRESO,16,708,9,733,1894
YUCATÁN,PROGRESO,5,610,3,618,1187
YUCATÁN,PROGRESO,6,611,8,625,1187
YUCATÁN,PROGRESO,11,378,2,391,1976
YUCATÁN,PROGRESO,10,383,9,402,1975
YUCATÁN,PROGRESO,5,388,2,395,1974
YUCATÁN,PROGRESO,6,391,2,399,1974
YUCATÁN,PROGRESO,49,908,4,961,0
YUCATÁN,PROGRESO,3,254,0,257,1354
YUCATÁN,PROGRESO,4,242,12,258,1353
YUCATÁN,PROGRESO,7,248,1,256,1353
YUCATÁN,PROGRESO,13,339,4,356,1330
YUCATÁN,PROGRESO,18,295,4,317,1330
YUCATÁN,PROGRESO,5,371,1,377,1329
YUCATÁN,PROGRESO,8,236,7,251,1352
YUCATÁN,PROGRESO,6,261,6,273,1351
YUCATÁN,PROGRESO,2,259,3,264,1351
YUCATÁN,PROGRESO,8,267,2,277,1333
YUCATÁN,PROGRESO,8,289,4,301,1332
YUCATÁN,PROGRESO,6,299,2,307,1332
YUCATÁN,PROGRESO,12,422,11,445,1952
YUCATÁN,PROGRESO,8,444,2,454,1952
YUCATÁN,PROGRESO,8,417,9,434,1924
YUCATÁN,PROGRESO,12,424,3,439,1923
YUCATÁN,PROGRESO,7,412,10,429,1972
YUCATÁN,PROGRESO,4,383,2,389,1971
YUCATÁN,PROGRESO,10,346,4,360,1388
YUCATÁN,PROGRESO,9,312,4,325,1388
YUCATÁN,PROGRESO,4,252,5,261,1342
YUCATÁN,PROGRESO,5,210,2,217,1341
YUCATÁN,PROGRESO,1,221,3,225,1341
YUCATÁN,PROGRESO,10,371,3,384,1972
YUCATÁN,PROGRESO,12,396,2,410,1971
YUCATÁN,PROGRESO,10,511,5,526,1394
YUCATÁN,PROGRESO,5,537,5,547,1393
YUCATÁN,PROGRESO,11,583,3,597,1393
YUCATÁN,PROGRESO,2,364,8,374,1333
YUCATÁN,PROGRESO,6,367,8,381,1333
YUCATÁN,PROGRESO,4,357,2,363,1333
YUCATÁN,PROGRESO,6,528,14,548,1782
YUCATÁN,PROGRESO,14,533,10,557,1782
YUCATÁN,PROGRESO,8,444,10,462,1332
YUCATÁN,PROGRESO,13,470,3,486,1331
YUCATÁN,PROGRESO,16,581,9,606,1579
YUCATÁN,PROGRESO,4,644,5,653,1579
YUCATÁN,PROGRESO,4,562,8,574,1604
YUCATÁN,PROGRESO,14,588,6,608,1603
YUCATÁN,PROGRESO,39,562,10,611,1439
YUCATÁN,PROGRESO,43,555,12,610,1439
YUCATÁN,PROGRESO,6,398,4,408,1930
YUCATÁN,PROGRESO,16,566,7,589,1951
YUCATÁN,PROGRESO,11,583,16,610,1950
YUCATÁN,PROGRESO,4,630,29,663,1715
YUCATÁN,PROGRESO,0,583,10,593,1714
YUCATÁN,PROGRESO,8,343,2,353,1843
YUCATÁN,PROGRESO,15,373,12,400,1842
YUCATÁN,PROGRESO,27,447,16,490,1842
YUCATÁN,PROGRESO,11,423,6,440,1340
YUCATÁN,PROGRESO,6,388,4,398,1340
YUCATÁN,PROGRESO,3,392,7,402,1339
YUCATÁN,PROGRESO,12,517,7,536,1793
YUCATÁN,PROGRESO,7,516,3,526,1792
YUCATÁN,PROGRESO,15,461,3,479,1288
YUCATÁN,PROGRESO,4,459,2,465,1288
YUCATÁN,PROGRESO,12,689,8,709,1966
YUCATÁN,PROGRESO,15,691,7,713,1966
YUCATÁN,PROGRESO,11,496,8,515,1486
YUCATÁN,PROGRESO,12,486,7,505,1486
YUCATÁN,PROGRESO,7,502,11,520,1485
YUCATÁN,PROGRESO,10,334,6,350,1527
YUCATÁN,PROGRESO,5,351,2,358,1527
YUCATÁN,PROGRESO,7,522,5,534,1351
YUCATÁN,PROGRESO,2,516,12,530,1350
YUCATÁN,PROGRESO,7,459,5,471,1307
YUCATÁN,PROGRESO,5,435,1,441,1306
YUCATÁN,PROGRESO,13,441,5,459,1022
YUCATÁN,PROGRESO,12,456,10,478,1022
YUCATÁN,MERIDA,10,197,0,207,1629
YUCATÁN,MERIDA,23,171,4,198,1629
YUCATÁN,MERIDA,11,185,1,197,1628
YUCATÁN,MERIDA,13,209,3,225,1628
YUCATÁN,MERIDA,17,202,1,220,1628
YUCATÁN,MERIDA,17,244,3,264,1583
YUCATÁN,MERIDA,9,221,2,232,1582
YUCATÁN,MERIDA,21,186,6,213,1598
YUCATÁN,MERIDA,16,181,0,197,1597
YUCATÁN,MERIDA,24,195,2,221,1495
YUCATÁN,MERIDA,22,187,5,214,1495
YUCATÁN,MERIDA,25,201,2,228,1494
YUCATÁN,MERIDA,20,213,1,234,1395
YUCATÁN,MERIDA,24,196,1,221,1394
YUCATÁN,MERIDA,33,192,6,231,1789
YUCATÁN,MERIDA,23,201,1,225,1789
YUCATÁN,MERIDA,19,202,0,221,1420
YUCATÁN,MERIDA,19,192,2,213,1419
YUCATÁN,MERIDA,23,210,1,234,1419
YUCATÁN,MERIDA,5,190,3,198,1030
YUCATÁN,MERIDA,8,180,4,192,1029
YUCATÁN,MERIDA,28,236,1,265,1827
YUCATÁN,MERIDA,26,204,0,230,1826
YUCATÁN,MERIDA,17,265,2,284,1788
YUCATÁN,MERIDA,16,250,2,268,1788
YUCATÁN,MERIDA,24,186,4,214,1624
YUCATÁN,MERIDA,27,177,0,204,1623
YUCATÁN,MERIDA,22,207,1,230,1623
YUCATÁN,MERIDA,13,203,4,220,1799
YUCATÁN,MERIDA,8,205,1,214,1798
YUCATÁN,MERIDA,11,184,3,198,1798
YUCATÁN,MERIDA,18,197,1,216,1798
YUCATÁN,MERIDA,12,196,0,208,1798
YUCATÁN,MERIDA,10,179,0,189,1798
YUCATÁN,MERIDA,24,238,1,263,1697
YUCATÁN,MERIDA,18,250,5,273,1696
YUCATÁN,MERIDA,5,259,4,268,1557
YUCATÁN,MERIDA,21,236,1,258,1556
YUCATÁN,MERIDA,28,209,1,238,1495
YUCATÁN,MERIDA,24,224,2,250,1494
YUCATÁN,MERIDA,227,28,0,255,1743
YUCATÁN,MERIDA,20,259,1,280,1742
YUCATÁN,MERIDA,9,200,0,209,1334
YUCATÁN,MERIDA,11,178,4,193,1333
YUCATÁN,MERIDA,16,178,4,198,1333
YUCATÁN,MERIDA,20,233,2,255,1887
YUCATÁN,MERIDA,23,241,2,266,1887
YUCATÁN,MERIDA,15,225,0,240,1590
YUCATÁN,MERIDA,14,237,8,259,1590
YUCATÁN,MERIDA,15,212,2,229,1589
YUCATÁN,MERIDA,11,347,9,367,1850
YUCATÁN,MERIDA,20,320,4,344,1849
YUCATÁN,MERIDA,6,214,1,221,1120
YUCATÁN,MERIDA,11,186,3,200,1120
YUCATÁN,MERIDA,14,257,4,275,1677
YUCATÁN,MERIDA,6,248,2,256,1677
YUCATÁN,MERIDA,9,261,1,271,1676
YUCATÁN,MERIDA,11,283,3,297,1814
YUCATÁN,MERIDA,11,252,1,264,1813
YUCATÁN,MERIDA,16,213,3,232,1753
YUCATÁN,MERIDA,7,181,3,191,1753
YUCATÁN,MERIDA,4,200,0,204,1753
YUCATÁN,MERIDA,4,197,2,203,1753
YUCATÁN,MERIDA,11,199,2,212,1753
YUCATÁN,MERIDA,12,181,2,195,1753
YUCATÁN,MERIDA,9,191,2,202,1752
YUCATÁN,MERIDA,9,187,3,199,1958
YUCATÁN,MERIDA,10,208,2,220,1958
YUCATÁN,MERIDA,14,213,0,227,1958
YUCATÁN,MERIDA,6,248,2,256,1958
YUCATÁN,MERIDA,3,220,2,225,1957
YUCATÁN,MERIDA,11,246,2,259,1957
YUCATÁN,MERIDA,8,195,2,205,1957
YUCATÁN,MERIDA,4,245,1,250,1957
YUCATÁN,MERIDA,10,228,0,238,1957
YUCATÁN,MERIDA,11,215,3,229,1957
YUCATÁN,MERIDA,10,228,1,239,1558
YUCATÁN,MERIDA,15,218,0,233,1557
YUCATÁN,MERIDA,7,284,23,314,1556
YUCATÁN,MERIDA,4,289,7,300,1555
YUCATÁN,MERIDA,11,262,6,279,1576
YUCATÁN,MERIDA,8,283,0,291,1575
YUCATÁN,MERIDA,13,303,6,322,1737
YUCATÁN,MERIDA,18,268,4,290,1737
YUCATÁN,MERIDA,19,245,3,267,1772
YUCATÁN,MERIDA,13,262,5,280,1771
YUCATÁN,MERIDA,13,276,3,292,1544
YUCATÁN,MERIDA,18,284,1,303,1543
YUCATÁN,MERIDA,14,354,4,372,1883
YUCATÁN,MERIDA,15,323,0,338,1883
YUCATÁN,MERIDA,22,339,4,365,1893
YUCATÁN,MERIDA,14,329,4,347,1892
YUCATÁN,MERIDA,11,219,7,237,1455
YUCATÁN,MERIDA,21,274,4,299,1455
YUCATÁN,MERIDA,10,246,5,261,1455
YUCATÁN,MERIDA,20,315,6,341,1525
YUCATÁN,MERIDA,6,297,3,306,1525
YUCATÁN,MERIDA,8,318,4,330,1588
YUCATÁN,MERIDA,12,307,2,321,1587
YUCATÁN,MERIDA,15,264,10,289,1927
YUCATÁN,MERIDA,18,286,2,306,1927
YUCATÁN,MERIDA,16,282,4,302,1927
YUCATÁN,MERIDA,3,173,4,180,1017
YUCATÁN,MERIDA,8,175,0,183,1016
YUCATÁN,MERIDA,13,274,1,288,1807
YUCATÁN,MERIDA,8,259,5,272,1807
YUCATÁN,MERIDA,13,318,2,333,1894
YUCATÁN,MERIDA,16,293,3,312,1894
YUCATÁN,MERIDA,15,298,2,315,1894
YUCATÁN,MERIDA,8,274,0,282,1893
YUCATÁN,MERIDA,12,146,4,162,1019
YUCATÁN,MERIDA,9,127,0,136,1019
YUCATÁN,MERIDA,7,188,0,195,1912
YUCATÁN,MERIDA,7,195,2,204,1912
YUCATÁN,MERIDA,15,256,1,272,1952
YUCATÁN,MERIDA,18,248,3,269,1952
YUCATÁN,MERIDA,13,172,5,190,1023
YUCATÁN,MERIDA,9,167,2,178,1022
YUCATÁN,MERIDA,81,1598,11,1690,0
YUCATÁN,MERIDA,6,229,5,240,1590
YUCATÁN,MERIDA,7,248,3,258,1589
YUCATÁN,MERIDA,11,303,7,321,1633
YUCATÁN,MERIDA,16,296,1,313,1633
YUCATÁN,MERIDA,5,230,3,238,1658
YUCATÁN,MERIDA,3,258,4,265,1658
YUCATÁN,MERIDA,5,227,1,233,1361
YUCATÁN,MERIDA,6,206,1,213,1360
YUCATÁN,MERIDA,5,255,3,263,1515
YUCATÁN,MERIDA,9,266,1,276,1514
YUCATÁN,MERIDA,4,284,9,297,1514
YUCATÁN,MERIDA,21,292,2,315,1867
YUCATÁN,MERIDA,13,307,2,322,1866
YUCATÁN,MERIDA,20,301,3,324,1924
YUCATÁN,MERIDA,8,312,1,321,1923
YUCATÁN,MERIDA,13,221,6,240,1516
YUCATÁN,MERIDA,7,226,2,235,1516
YUCATÁN,MERIDA,5,188,3,196,1515
YUCATÁN,MERIDA,3,190,1,194,1515
YUCATÁN,MERIDA,11,244,4,259,1446
YUCATÁN,MERIDA,14,216,2,232,1446
YUCATÁN,MERIDA,11,315,4,330,1845
YUCATÁN,MERIDA,10,326,4,340,1845
YUCATÁN,MERIDA,11,235,2,248,1454
YUCATÁN,MERIDA,9,256,19,284,1453
YUCATÁN,MERIDA,16,260,1,277,1807
YUCATÁN,MERIDA,5,281,3,289,1806
YUCATÁN,MERIDA,10,277,8,295,1948
YUCATÁN,MERIDA,19,277,3,299,1947
YUCATÁN,MERIDA,2,175,3,180,1807
YUCATÁN,MERIDA,4,160,3,167,1807
YUCATÁN,MERIDA,4,153,0,157,1807
YUCATÁN,MERIDA,6,140,1,147,1807
YUCATÁN,MERIDA,7,179,3,189,1807
YUCATÁN,MERIDA,7,151,2,160,1806
YUCATÁN,MERIDA,6,160,1,167,1806
YUCATÁN,MERIDA,9,164,0,173,1806
YUCATÁN,MERIDA,10,224,1,235,1458
YUCATÁN,MERIDA,7,202,4,213,1458
YUCATÁN,MERIDA,8,210,3,221,1458
YUCATÁN,MERIDA,9,274,3,286,1392
YUCATÁN,MERIDA,13,284,3,300,1391
YUCATÁN,MERIDA,7,203,3,213,1850
YUCATÁN,MERIDA,6,218,5,229,1850
YUCATÁN,MERIDA,4,195,5,204,1850
YUCATÁN,MERIDA,3,167,1,171,1850
YUCATÁN,MERIDA,4,182,1,187,1403
YUCATÁN,MERIDA,3,193,2,198,1403
YUCATÁN,MERIDA,12,163,1,176,1403
YUCATÁN,MERIDA,5,192,2,199,1709
YUCATÁN,MERIDA,8,169,4,181,1709
YUCATÁN,MERIDA,6,170,3,179,1709
YUCATÁN,MERIDA,4,157,1,162,1708
YUCATÁN,MERIDA,0,203,3,206,1708
YUCATÁN,MERIDA,3,225,2,230,1665
YUCATÁN,MERIDA,3,237,3,243,1665
YUCATÁN,MERIDA,6,197,2,205,1665
YUCATÁN,MERIDA,4,230,1,235,1665
YUCATÁN,MERIDA,3,178,1,182,1664
YUCATÁN,MERIDA,11,312,7,330,1235
YUCATÁN,MERIDA,10,341,6,357,1234
YUCATÁN,MERIDA,11,285,11,307,1669
YUCATÁN,MERIDA,5,279,9,293,1668
YUCATÁN,MERIDA,16,256,0,272,1351
YUCATÁN,MERIDA,9,232,9,250,1351
YUCATÁN,MERIDA,9,246,6,261,1351
YUCATÁN,MERIDA,10,202,0,212,1658
YUCATÁN,MERIDA,14,205,1,220,1658
YUCATÁN,MERIDA,5,180,1,186,1658
YUCATÁN,MERIDA,6,185,0,191,1657
YUCATÁN,MERIDA,11,180,2,193,1252
YUCATÁN,MERIDA,9,178,1,188,1252
YUCATÁN,MERIDA,9,271,0,280,1744
YUCATÁN,MERIDA,24,277,1,302,1743
YUCATÁN,MERIDA,17,243,4,264,1758
YUCATÁN,MERIDA,13,242,2,257,1758
YUCATÁN,MERIDA,7,134,1,142,1114
YUCATÁN,MERIDA,9,156,1,166,1113
YUCATÁN,MERIDA,3,170,4,177,1171
YUCATÁN,MERIDA,2,231,7,240,1171
YUCATÁN,MERIDA,33,212,0,245,1639
YUCATÁN,MERIDA,36,226,0,262,1638
YUCATÁN,MERIDA,29,193,0,222,1638
YUCATÁN,MERIDA,13,134,3,150,1175
YUCATÁN,MERIDA,20,127,2,149,1175
YUCATÁN,MERIDA,15,147,0,162,1478
YUCATÁN,MERIDA,9,175,0,184,1478
YUCATÁN,MERIDA,14,154,0,168,1477
YUCATÁN,MERIDA,10,211,2,223,1560
YUCATÁN,MERIDA,11,208,0,219,1560
YUCATÁN,MERIDA,11,211,0,222,1894
YUCATÁN,MERIDA,13,212,0,225,1894
YUCATÁN,MERIDA,14,242,1,257,1894
YUCATÁN,MERIDA,11,207,3,221,1938
YUCATÁN,MERIDA,10,195,0,205,1937
YUCATÁN,MERIDA,10,147,1,158,1444
YUCATÁN,MERIDA,14,145,0,159,1444
YUCATÁN,MERIDA,14,173,2,189,1444
YUCATÁN,MERIDA,16,203,0,219,1691
YUCATÁN,MERIDA,17,240,0,257,1691
YUCATÁN,MERIDA,14,190,1,205,1359
YUCATÁN,MERIDA,9,189,0,198,1358
YUCATÁN,MERIDA,20,151,1,172,1358
YUCATÁN,MERIDA,22,174,3,199,1604
YUCATÁN,MERIDA,26,200,1,227,1603
YUCATÁN,MERIDA,14,179,1,194,1538
YUCATÁN,MERIDA,22,170,0,192,1538
YUCATÁN,MERIDA,15,187,0,202,1537
YUCATÁN,MERIDA,13,179,3,195,1368
YUCATÁN,MERIDA,13,189,3,205,1368
YUCATÁN,MERIDA,7,158,0,165,1367
YUCATÁN,MERIDA,16,186,3,205,1750
YUCATÁN,MERIDA,14,187,1,202,1750
YUCATÁN,MERIDA,17,182,1,200,1749
YUCATÁN,MERIDA,11,160,1,172,1749
YUCATÁN,MERIDA,23,206,0,229,1749
YUCATÁN,MERIDA,22,174,1,197,1749
YUCATÁN,MERIDA,24,163,1,188,1749
YUCATÁN,MERIDA,170,1735,7,1912,0
YUCATÁN,MERIDA,16,212,5,233,1591
YUCATÁN,MERIDA,16,227,1,244,1591
YUCATÁN,MERIDA,26,62,1,89,1544
YUCATÁN,MERIDA,25,58,0,83,1544
YUCATÁN,MERIDA,32,161,1,194,1596
YUCATÁN,MERIDA,34,190,4,228,1596
YUCATÁN,MERIDA,29,86,0,115,1193
YUCATÁN,MERIDA,28,114,0,142,1193
YUCATÁN,MERIDA,36,83,2,121,1941
YUCATÁN,MERIDA,52,86,2,140,1940
YUCATÁN,MERIDA,24,130,1,155,1464
YUCATÁN,MERIDA,21,143,1,165,1464
YUCATÁN,MERIDA,33,136,1,170,1463
YUCATÁN,MERIDA,30,153,3,186,1895
YUCATÁN,MERIDA,28,164,2,194,1895
YUCATÁN,MERIDA,28,169,6,203,1895
YUCATÁN,MERIDA,37,185,3,225,1895
YUCATÁN,MERIDA,29,184,2,215,1894
YUCATÁN,MERIDA,15,117,0,132,1627
YUCATÁN,MERIDA,14,118,0,132,1627
YUCATÁN,MERIDA,28,102,0,130,1627
YUCATÁN,MERIDA,25,167,3,195,1355
YUCATÁN,MERIDA,20,160,3,183,1355
YUCATÁN,MERIDA,19,174,0,193,1355
YUCATÁN,MERIDA,42,223,5,270,1448
YUCATÁN,MERIDA,30,178,4,212,1448
YUCATÁN,MERIDA,49,85,5,139,1610
YUCATÁN,MERIDA,45,82,1,128,1610
YUCATÁN,MERIDA,28,62,2,92,1917
YUCATÁN,MERIDA,42,75,2,119,1916
YUCATÁN,MERIDA,21,143,11,175,1794
YUCATÁN,MERIDA,26,156,0,182,1794
YUCATÁN,MERIDA,31,159,1,191,1793
YUCATÁN,MERIDA,12,219,0,231,1626
YUCATÁN,MERIDA,12,199,1,212,1626
YUCATÁN,MERIDA,16,185,1,202,1625
YUCATÁN,MERIDA,11,208,2,221,1625
YUCATÁN,MERIDA,22,163,2,187,1593
YUCATÁN,MERIDA,33,148,1,182,1592
YUCATÁN,MERIDA,28,148,3,179,1592
YUCATÁN,MERIDA,21,202,2,225,1664
YUCATÁN,MERIDA,35,210,0,245,1664
YUCATÁN,MERIDA,22,178,0,200,1770
YUCATÁN,MERIDA,23,220,2,245,1770
YUCATÁN,MERIDA,14,240,3,257,1911
YUCATÁN,MERIDA,24,243,5,272,1911
YUCATÁN,MERIDA,20,136,3,159,1563
YUCATÁN,MERIDA,19,166,0,185,1562
YUCATÁN,MERIDA,12,179,2,193,1427
YUCATÁN,MERIDA,28,163,0,191,1427
YUCATÁN,MERIDA,18,184,1,203,1426
YUCATÁN,MERIDA,33,163,2,198,1723
YUCATÁN,MERIDA,39,168,3,210,1723
YUCATÁN,MERIDA,33,153,2,188,1693
YUCATÁN,MERIDA,34,147,3,184,1693
YUCATÁN,MERIDA,23,76,1,100,1092
YUCATÁN,MERIDA,18,81,0,99,1092
YUCATÁN,MERIDA,21,215,1,237,1932
YUCATÁN,MERIDA,28,205,0,233,1932
YUCATÁN,MERIDA,24,123,0,147,1802
YUCATÁN,MERIDA,36,176,1,213,1802
YUCATÁN,MERIDA,18,180,5,203,1595
YUCATÁN,MERIDA,16,181,2,199,1594
YUCATÁN,MERIDA,17,174,1,192,1594
YUCATÁN,MERIDA,185,15,0,200,1594
YUCATÁN,MERIDA,16,169,2,187,1594
YUCATÁN,MERIDA,33,96,2,131,1826
YUCATÁN,MERIDA,23,93,1,117,1826
YUCATÁN,MERIDA,41,204,2,247,1823
YUCATÁN,MERIDA,36,171,4,211,1823
YUCATÁN,MERIDA,44,213,1,258,1892
YUCATÁN,MERIDA,32,214,1,247,1891
YUCATÁN,MERIDA,38,259,1,298,1957
YUCATÁN,MERIDA,17,302,5,324,1976
YUCATÁN,MERIDA,13,354,4,371,1975
YUCATÁN,MERIDA,26,116,1,143,1346
YUCATÁN,MERIDA,11,109,2,122,1346
YUCATÁN,MERIDA,31,129,2,162,1346
YUCATÁN,MERIDA,19,249,4,272,1830
YUCATÁN,MERIDA,25,216,4,245,1829
YUCATÁN,MERIDA,15,240,2,257,1385
YUCATÁN,MERIDA,18,210,3,231,1385
YUCATÁN,MERIDA,25,215,1,241,1384
YUCATÁN,MERIDA,13,179,2,194,1383
YUCATÁN,MERIDA,12,181,3,196,1383
YUCATÁN,MERIDA,14,221,4,239,1383
YUCATÁN,MERIDA,16,208,3,227,1806
YUCATÁN,MERIDA,24,212,1,237,1806
YUCATÁN,MERIDA,17,294,5,316,1934
YUCATÁN,MERIDA,19,284,4,307,1933
YUCATÁN,MERIDA,9,251,2,262,1290
YUCATÁN,MERIDA,9,219,11,239,1290
YUCATÁN,MERIDA,23,309,1,333,1828
YUCATÁN,MERIDA,26,291,8,325,1827
YUCATÁN,MERIDA,22,279,4,305,1647
YUCATÁN,MERIDA,17,305,1,323,1647
YUCATÁN,MERIDA,20,352,7,379,1904
YUCATÁN,MERIDA,23,320,3,346,1904
YUCATÁN,MERIDA,26,335,3,364,1861
YUCATÁN,MERIDA,20,331,5,356,1860
YUCATÁN,MERIDA,15,366,7,388,1834
YUCATÁN,MERIDA,11,332,2,345,1834
YUCATÁN,MERIDA,10,253,2,265,1337
YUCATÁN,MERIDA,7,208,2,217,1337
YUCATÁN,MERIDA,10,222,7,239,1337
YUCATÁN,MERIDA,13,293,7,313,1474
YUCATÁN,MERIDA,6,287,4,297,1474
YUCATÁN,MERIDA,7,330,3,340,1755
YUCATÁN,MERIDA,17,335,3,355,1754
YUCATÁN,MERIDA,21,275,6,302,1749
YUCATÁN,MERIDA,17,286,4,307,1749
YUCATÁN,MERIDA,15,263,1,279,1749
YUCATÁN,MERIDA,20,251,1,272,1740
YUCATÁN,MERIDA,16,299,5,320,1740
YUCATÁN,MERIDA,28,292,3,323,1725
YUCATÁN,MERIDA,25,296,6,327,1724
YUCATÁN,MERIDA,15,375,1,391,1757
YUCATÁN,MERIDA,14,347,3,364,1756
YUCATÁN,MERIDA,17,321,0,338,1634
YUCATÁN,MERIDA,13,274,2,289,1633
YUCATÁN,MERIDA,20,284,6,310,1719
YUCATÁN,MERIDA,16,281,6,303,1719
YUCATÁN,MERIDA,20,273,2,295,1718
YUCATÁN,MERIDA,11,251,2,264,1581
YUCATÁN,MERIDA,12,280,5,297,1581
YUCATÁN,MERIDA,20,261,0,281,1907
YUCATÁN,MERIDA,20,259,5,284,1907
YUCATÁN,MERIDA,10,223,3,236,1746
YUCATÁN,MERIDA,9,208,7,224,1746
YUCATÁN,MERIDA,16,193,3,212,1746
YUCATÁN,MERIDA,5,223,3,231,1746
YUCATÁN,MERIDA,15,251,1,267,1745
YUCATÁN,MERIDA,12,215,1,228,1745
YUCATÁN,MERIDA,8,195,1,204,1208
YUCATÁN,MERIDA,5,205,2,212,1207
YUCATÁN,MERIDA,21,259,1,281,1688
YUCATÁN,MERIDA,13,220,3,236,1688
YUCATÁN,MERIDA,15,268,1,284,1576
YUCATÁN,MERIDA,7,286,2,295,1576
YUCATÁN,MERIDA,14,250,4,268,1589
YUCATÁN,MERIDA,18,267,1,286,1589
YUCATÁN,MERIDA,15,246,3,264,1589
YUCATÁN,MERIDA,16,299,16,331,1670
YUCATÁN,MERIDA,9,333,1,343,1670
YUCATÁN,MERIDA,4,243,2,249,1201
YUCATÁN,MERIDA,5,215,1,221,1201
YUCATÁN,MERIDA,15,332,4,351,1878
YUCATÁN,MERIDA,9,360,3,372,1877
YUCATÁN,MERIDA,25,293,7,325,1949
YUCATÁN,MERIDA,15,303,2,320,1949
YUCATÁN,MERIDA,12,354,0,366,1845
YUCATÁN,MERIDA,10,329,9,348,1845
YUCATÁN,MERIDA,17,214,2,233,1204
YUCATÁN,MERIDA,8,202,2,212,1204
YUCATÁN,MERIDA,15,382,2,399,1933
YUCATÁN,MERIDA,17,399,4,420,1932
YUCATÁN,MERIDA,4,176,2,182,1002
YUCATÁN,MERIDA,13,166,2,181,1002
YUCATÁN,MERIDA,10,206,4,220,1124
YUCATÁN,MERIDA,11,210,6,227,1124
YUCATÁN,MERIDA,15,238,3,256,1949
YUCATÁN,MERIDA,6,239,5,250,1948
YUCATÁN,MERIDA,17,171,0,188,1485
YUCATÁN,MERIDA,8,119,2,129,1485
YUCATÁN,MERIDA,13,380,8,401,1708
YUCATÁN,MERIDA,15,337,6,358,1708
YUCATÁN,MERIDA,12,338,6,356,1834
YUCATÁN,MERIDA,8,376,8,392,1834
YUCATÁN,MERIDA,10,197,2,209,1635
YUCATÁN,MERIDA,13,196,5,214,1635
YUCATÁN,MERIDA,18,128,0,146,1693
YUCATÁN,MERIDA,138,24,1,163,1693
YUCATÁN,MERIDA,22,165,0,187,1693
YUCATÁN,MERIDA,23,142,0,165,1693
YUCATÁN,MERIDA,17,132,1,150,1692
YUCATÁN,MERIDA,25,140,1,166,1692
YUCATÁN,MERIDA,21,149,0,170,1714
YUCATÁN,MERIDA,14,136,3,153,1714
YUCATÁN,MERIDA,17,148,0,165,1714
YUCATÁN,MERIDA,24,157,0,181,1714
YUCATÁN,MERIDA,33,125,1,159,1713
YUCATÁN,MERIDA,24,150,0,174,1713
YUCATÁN,MERIDA,23,171,0,194,1713
YUCATÁN,MERIDA,16,108,2,126,1566
YUCATÁN,MERIDA,23,119,0,142,1566
YUCATÁN,MERIDA,19,197,5,221,1923
YUCATÁN,MERIDA,21,209,2,232,1923
YUCATÁN,MERIDA,30,201,3,234,1972
YUCATÁN,MERIDA,27,219,3,249,1971
YUCATÁN,MERIDA,23,183,1,207,1971
YUCATÁN,MERIDA,24,195,2,221,1971
YUCATÁN,MERIDA,19,181,4,204,1801
YUCATÁN,MERIDA,20,188,1,209,1800
YUCATÁN,MERIDA,21,215,3,239,1800
YUCATÁN,MERIDA,27,229,1,257,1800
YUCATÁN,MERIDA,25,265,3,293,1800
YUCATÁN,MERIDA,9,207,3,219,1457
YUCATÁN,MERIDA,15,168,3,186,1457
YUCATÁN,MERIDA,20,194,0,214,1680
YUCATÁN,MERIDA,18,183,1,202,1680
YUCATÁN,MERIDA,24,185,1,210,1679
YUCATÁN,MERIDA,36,186,1,223,1837
YUCATÁN,MERIDA,24,199,0,223,1837
YUCATÁN,MERIDA,38,221,4,263,1807
YUCATÁN,MERIDA,37,204,5,246,1807
YUCATÁN,MERIDA,22,222,0,244,1833
YUCATÁN,MERIDA,31,245,1,277,1832
YUCATÁN,MERIDA,19,213,2,234,1889
YUCATÁN,MERIDA,14,210,2,226,1889
YUCATÁN,TICUL,7,287,1,295,1551
YUCATÁN,TICUL,8,276,1,285,1550
YUCATÁN,TICUL,6,333,9,348,1550
YUCATÁN,TICUL,6,274,10,290,1550
YUCATÁN,TICUL,6,487,8,501,1784
YUCATÁN,TICUL,9,454,10,473,1784
YUCATÁN,TICUL,6,532,5,543,1649
YUCATÁN,TICUL,10,522,5,537,1649
YUCATÁN,TICUL,2,499,4,505,1648
YUCATÁN,TICUL,11,440,9,460,1646
YUCATÁN,TICUL,11,526,8,545,1645
YUCATÁN,TICUL,12,474,11,497,1444
YUCATÁN,TICUL,4,417,6,427,1444
YUCATÁN,TICUL,11,465,10,486,1443
YUCATÁN,TICUL,11,542,1,554,1502
YUCATÁN,TICUL,11,492,3,506,1502
YUCATÁN,TICUL,3,386,9,398,1558
YUCATÁN,TICUL,2,365,3,370,1557
YUCATÁN,TICUL,12,512,6,530,1557
YUCATÁN,TICUL,6,409,13,428,1272
YUCATÁN,TICUL,15,396,10,421,1272
YUCATÁN,TICUL,7,380,5,392,1792
YUCATÁN,TICUL,7,460,3,470,1792
YUCATÁN,TICUL,6,351,5,362,1792
YUCATÁN,TICUL,5,354,4,363,1921
YUCATÁN,TICUL,8,486,4,498,1921
YUCATÁN,TICUL,4,323,1,328,1072
YUCATÁN,TICUL,3,328,3,334,1072
YUCATÁN,TICUL,10,549,8,567,1539
YUCATÁN,TICUL,10,574,1,585,1539
YUCATÁN,TICUL,7,555,10,572,1586
YUCATÁN,TICUL,10,575,10,595,1586
YUCATÁN,TICUL,11,616,16,643,1407
YUCATÁN,TICUL,13,606,83,702,1406
YUCATÁN,TICUL,14,567,8,589,1536
YUCATÁN,TICUL,10,631,2,643,1536
YUCATÁN,TICUL,7,420,11,438,1303
YUCATÁN,TICUL,2,379,7,388,1303
YUCATÁN,TICUL,0,419,5,424,1326
YUCATÁN,TICUL,6,349,12,367,1326
YUCATÁN,TICUL,6,391,6,403,1901
YUCATÁN,TICUL,5,366,12,383,1901
YUCATÁN,TICUL,3,462,1,466,1901
YUCATÁN,TICUL,7,429,4,440,1901
YUCATÁN,TICUL,6,350,9,365,1901
YUCATÁN,TICUL,3,497,6,506,1561
YUCATÁN,TICUL,11,431,14,456,1561
YUCATÁN,TICUL,19,518,8,545,1792
YUCATÁN,TICUL,15,556,17,588,1792
YUCATÁN,TICUL,7,503,3,513,1792
YUCATÁN,TICUL,6,554,4,564,1765
YUCATÁN,TICUL,4,555,12,571,1765
YUCATÁN,TICUL,5,489,6,500,1563
YUCATÁN,TICUL,8,475,4,487,1563
YUCATÁN,TICUL,10,467,7,484,1563
YUCATÁN,TICUL,13,559,13,585,1737
YUCATÁN,TICUL,7,525,4,536,1737
YUCATÁN,TICUL,10,588,13,611,1677
YUCATÁN,TICUL,7,555,11,573,1676
YUCATÁN,TICUL,8,424,7,439,1487
YUCATÁN,TICUL,3,449,12,464,1486
YUCATÁN,TICUL,12,371,13,396,1486
YUCATÁN,TICUL,5,280,11,296,1328
YUCATÁN,TICUL,8,291,6,305,1327
YUCATÁN,TICUL,6,329,1,336,1327
YUCATÁN,TICUL,11,379,2,392,1199
YUCATÁN,TICUL,7,374,6,387,1198
YUCATÁN,TICUL,8,354,7,369,1103
YUCATÁN,TICUL,0,352,4,356,1102
YUCATÁN,TICUL,7,466,16,489,1677
YUCATÁN,TICUL,9,476,2,487,1677
YUCATÁN,TICUL,2,460,3,465,1677
YUCATÁN,TICUL,2,446,7,455,1676
YUCATÁN,TICUL,0,555,11,566,1766
YUCATÁN,TICUL,13,499,6,518,1766
YUCATÁN,TICUL,4,320,1,325,1015
YUCATÁN,TICUL,10,355,5,370,1015
YUCATÁN,TICUL,13,362,6,381,1733
YUCATÁN,TICUL,8,399,5,412,1732
YUCATÁN,TICUL,11,383,3,397,1581
YUCATÁN,TICUL,9,385,7,401,1580
YUCATÁN,TICUL,10,383,11,404,1740
YUCATÁN,TICUL,7,358,3,368,1740
YUCATÁN,TICUL,7,252,4,263,1116
YUCATÁN,TICUL,6,257,4,267,1116
YUCATÁN,TICUL,5,375,2,382,1419
YUCATÁN,TICUL,7,371,3,381,1419
YUCATÁN,TICUL,5,365,7,377,1525
YUCATÁN,TICUL,6,344,7,357,1525
YUCATÁN,TICUL,6,200,1,207,1358
YUCATÁN,TICUL,10,200,6,216,1357
YUCATÁN,TICUL,3,228,5,236,1357
YUCATÁN,TICUL,18,486,14,518,1442
YUCATÁN,TICUL,13,462,6,481,1442
YUCATÁN,TICUL,13,454,14,481,1442
YUCATÁN,TICUL,11,585,10,606,1734
YUCATÁN,TICUL,8,541,7,556,1733
YUCATÁN,TICUL,8,492,4,504,1306
YUCATÁN,TICUL,7,475,7,489,1306
YUCATÁN,TICUL,9,449,5,463,1306
YUCATÁN,TICUL,9,461,12,482,1562
YUCATÁN,TICUL,11,464,5,480,1562
YUCATÁN,TICUL,9,524,2,535,1659
YUCATÁN,TICUL,10,550,1,561,1658
YUCATÁN,TICUL,2,421,4,427,1746
YUCATÁN,TICUL,10,406,4,420,1745
YUCATÁN,TICUL,13,452,9,474,1837
YUCATÁN,TICUL,18,486,2,506,1836
YUCATÁN,TICUL,17,510,9,536,1795
YUCATÁN,TICUL,8,546,8,562,1794
YUCATÁN,TICUL,11,384,4,399,1489
YUCATÁN,TICUL,14,393,0,407,1488
YUCATÁN,TICUL,10,478,5,493,1890
YUCATÁN,TICUL,14,449,12,475,1889
YUCATÁN,TICUL,17,178,22,217,1611
YUCATÁN,TICUL,17,478,10,505,1611
YUCATÁN,TICUL,12,472,7,491,1610
YUCATÁN,TICUL,10,387,10,407,1477
YUCATÁN,TICUL,18,362,8,388,1476
YUCATÁN,TICUL,8,343,13,364,1513
YUCATÁN,TICUL,1,333,4,338,1513
YUCATÁN,TICUL,18,505,13,536,1958
YUCATÁN,TICUL,9,530,12,551,1958
YUCATÁN,TICUL,7,405,4,416,1247
YUCATÁN,TICUL,4,411,6,421,1247
YUCATÁN,TICUL,13,433,5,451,1662
YUCATÁN,TICUL,6,431,0,437,1661
YUCATÁN,TICUL,7,559,8,574,1813
YUCATÁN,TICUL,7,488,15,510,1812
YUCATÁN,TICUL,6,604,9,619,1942
YUCATÁN,TICUL,12,584,6,602,1942
YUCATÁN,TICUL,24,357,11,392,1767
YUCATÁN,TICUL,11,379,3,393,1767
YUCATÁN,TICUL,9,278,18,305,1325
YUCATÁN,TICUL,20,235,20,275,1325
YUCATÁN,TICUL,12,310,13,335,1324
YUCATÁN,TICUL,3,385,6,394,1490
YUCATÁN,TICUL,5,375,3,383,1490
YUCATÁN,TICUL,15,587,17,619,1529
YUCATÁN,TICUL,15,577,10,602,1528
YUCATÁN,TICUL,19,521,14,554,1528
YUCATÁN,TICUL,14,390,4,408,1301
YUCATÁN,TICUL,5,407,4,416,1301
YUCATÁN,TICUL,7,557,11,575,1854
YUCATÁN,TICUL,8,567,11,586,1853
YUCATÁN,TICUL,6,519,6,531,1536
YUCATÁN,TICUL,5,469,7,481,1535
YUCATÁN,TICUL,2,543,4,549,1635
YUCATÁN,TICUL,11,534,3,548,1634
YUCATÁN,TICUL,1,486,4,491,1403
YUCATÁN,TICUL,5,506,4,515,1402
YUCATÁN,TICUL,6,452,5,463,1402
YUCATÁN,TICUL,7,512,5,524,1464
YUCATÁN,TICUL,10,489,1,500,1464
YUCATÁN,TICUL,9,513,8,530,1407
YUCATÁN,TICUL,8,520,5,533,1406
YUCATÁN,TICUL,5,596,2,603,1675
YUCATÁN,TICUL,19,588,10,617,1674
YUCATÁN,TICUL,26,809,6,841,0
YUCATÁN,TICUL,6,460,4,470,1834
YUCATÁN,TICUL,16,541,5,562,1834
YUCATÁN,TICUL,6,295,3,304,1091
YUCATÁN,TICUL,18,365,5,388,1091
YUCATÁN,TICUL,5,394,7,406,1085
YUCATÁN,TICUL,4,351,5,360,1085
YUCATÁN,TICUL,5,425,6,436,1336
YUCATÁN,TICUL,7,441,3,451,1336
YUCATÁN,TICUL,5,460,9,474,1336
YUCATÁN,TICUL,4,381,5,390,1057
YUCATÁN,TICUL,10,371,1,382,1057
YUCATÁN,TICUL,10,484,4,498,1800
YUCATÁN,TICUL,6,538,5,549,1799
YUCATÁN,TICUL,4,338,7,349,1906
YUCATÁN,TICUL,8,357,3,368,1905
YUCATÁN,TICUL,4,265,11,280,1410
YUCATÁN,TICUL,5,293,3,301,1409
YUCATÁN,TICUL,12,276,6,294,1409
YUCATÁN,TICUL,4,353,2,359,1647
YUCATÁN,TICUL,5,367,3,375,1647
YUCATÁN,TICUL,5,255,3,263,1334
YUCATÁN,TICUL,11,232,5,248,1333
YUCATÁN,TICUL,12,347,5,364,1964
YUCATÁN,TICUL,12,297,1,310,1964
YUCATÁN,TICUL,8,224,8,240,1642
YUCATÁN,TICUL,5,298,5,308,1642
YUCATÁN,TICUL,9,265,5,279,1480
YUCATÁN,TICUL,12,255,7,274,1480
YUCATÁN,TICUL,11,336,3,350,1549
YUCATÁN,TICUL,9,337,8,354,1549
YUCATÁN,TICUL,9,330,3,342,1549
YUCATÁN,TICUL,8,240,7,255,1363
YUCATÁN,TICUL,9,204,0,213,1363
YUCATÁN,TICUL,7,200,1,208,1363
YUCATÁN,TICUL,7,174,3,184,1560
YUCATÁN,TICUL,3,171,3,177,1559
YUCATÁN,TICUL,17,216,2,235,1559
YUCATÁN,TICUL,7,222,3,232,1559
YUCATÁN,TICUL,12,272,14,298,1371
YUCATÁN,TICUL,2,259,9,270,1371
YUCATÁN,TICUL,15,373,17,405,1631
YUCATÁN,TICUL,17,347,10,374,1630
ZACATECAS,FRESNILLO,14,137,1,152,1874
ZACATECAS,FRESNILLO,9,126,0,135,1874
ZACATECAS,FRESNILLO,8,104,1,113,1399
ZACATECAS,FRESNILLO,13,93,1,107,1398
ZACATECAS,FRESNILLO,13,96,2,111,1584
ZACATECAS,FRESNILLO,12,74,1,87,1584
ZACATECAS,FRESNILLO,11,83,0,94,1452
ZACATECAS,FRESNILLO,13,111,0,124,1452
ZACATECAS,FRESNILLO,10,79,1,90,1451
ZACATECAS,FRESNILLO,15,80,0,95,1026
ZACATECAS,FRESNILLO,3,91,0,94,1026
ZACATECAS,FRESNILLO,6,88,0,94,1394
ZACATECAS,FRESNILLO,11,98,5,114,1394
ZACATECAS,FRESNILLO,19,152,0,171,1888
ZACATECAS,FRESNILLO,25,150,1,176,1888
ZACATECAS,FRESNILLO,17,97,0,114,1968
ZACATECAS,FRESNILLO,6,107,4,117,1968
ZACATECAS,FRESNILLO,29,134,6,169,1341
ZACATECAS,FRESNILLO,26,140,1,167,1341
ZACATECAS,FRESNILLO,16,116,2,134,1341
ZACATECAS,FRESNILLO,16,342,10,368,1507
ZACATECAS,FRESNILLO,23,326,12,361,1507
ZACATECAS,FRESNILLO,25,309,13,347,1507
ZACATECAS,FRESNILLO,18,324,13,355,1506
ZACATECAS,FRESNILLO,12,189,4,205,1544
ZACATECAS,FRESNILLO,16,171,5,192,1543
ZACATECAS,FRESNILLO,10,197,7,214,1543
ZACATECAS,FRESNILLO,18,243,3,264,1543
ZACATECAS,FRESNILLO,30,111,5,146,1561
ZACATECAS,FRESNILLO,17,144,0,161,1560
ZACATECAS,FRESNILLO,12,111,1,124,1451
ZACATECAS,FRESNILLO,19,129,1,149,1451
ZACATECAS,FRESNILLO,22,133,1,156,1656
ZACATECAS,FRESNILLO,16,141,0,157,1656
ZACATECAS,FRESNILLO,21,132,3,156,1655
ZACATECAS,FRESNILLO,16,164,5,185,1727
ZACATECAS,FRESNILLO,14,160,2,176,1727
ZACATECAS,FRESNILLO,17,139,1,157,1557
ZACATECAS,FRESNILLO,3,132,1,136,1557
ZACATECAS,FRESNILLO,23,122,0,145,1556
ZACATECAS,FRESNILLO,23,110,2,135,1556
ZACATECAS,FRESNILLO,28,91,2,121,1510
ZACATECAS,FRESNILLO,16,128,1,145,1509
ZACATECAS,FRESNILLO,13,85,0,98,1509
ZACATECAS,FRESNILLO,16,105,4,125,1509
ZACATECAS,FRESNILLO,26,180,0,206,1800
ZACATECAS,FRESNILLO,18,183,0,201,1800
ZACATECAS,FRESNILLO,26,208,3,237,1858
ZACATECAS,FRESNILLO,27,254,5,286,1858
ZACATECAS,FRESNILLO,23,198,3,224,1858
ZACATECAS,FRESNILLO,24,185,2,211,1814
ZACATECAS,FRESNILLO,26,178,1,205,1813
ZACATECAS,FRESNILLO,26,145,3,174,1468
ZACATECAS,FRESNILLO,24,142,2,168,1468
ZACATECAS,FRESNILLO,11,148,3,162,1468
ZACATECAS,FRESNILLO,15,120,1,136,1819
ZACATECAS,FRESNILLO,128,16,1,145,1819
ZACATECAS,FRESNILLO,18,165,1,184,1482
ZACATECAS,FRESNILLO,12,160,2,174,1481
ZACATECAS,FRESNILLO,20,151,1,172,1481
ZACATECAS,FRESNILLO,13,142,1,156,1757
ZACATECAS,FRESNILLO,12,131,1,144,1756
ZACATECAS,FRESNILLO,22,172,1,195,1780
ZACATECAS,FRESNILLO,30,195,1,226,1779
ZACATECAS,FRESNILLO,17,133,1,151,1387
ZACATECAS,FRESNILLO,13,126,0,139,1387
ZACATECAS,FRESNILLO,6,125,4,135,1386
ZACATECAS,FRESNILLO,11,110,1,122,1554
ZACATECAS,FRESNILLO,12,132,0,144,1554
ZACATECAS,FRESNILLO,9,123,4,136,1553
ZACATECAS,FRESNILLO,74,563,8,645,0
ZACATECAS,FRESNILLO,16,166,1,183,1614
ZACATECAS,FRESNILLO,23,173,4,200,1614
ZACATECAS,FRESNILLO,16,165,2,183,1614
ZACATECAS,FRESNILLO,25,135,3,163,1857
ZACATECAS,FRESNILLO,35,136,1,172,1856
ZACATECAS,FRESNILLO,27,126,0,153,1856
ZACATECAS,FRESNILLO,24,128,3,155,1856
ZACATECAS,FRESNILLO,30,147,0,177,1779
ZACATECAS,FRESNILLO,18,128,8,154,1779
ZACATECAS,FRESNILLO,29,143,1,173,1779
ZACATECAS,FRESNILLO,25,172,0,197,1469
ZACATECAS,FRESNILLO,25,131,1,157,1468
ZACATECAS,FRESNILLO,18,159,2,179,1383
ZACATECAS,FRESNILLO,21,137,3,161,1383
ZACATECAS,FRESNILLO,16,146,2,164,1383
ZACATECAS,FRESNILLO,30,149,1,180,1655
ZACATECAS,FRESNILLO,14,168,6,188,1654
ZACATECAS,FRESNILLO,26,121,2,149,1776
ZACATECAS,FRESNILLO,23,149,1,173,1775
ZACATECAS,FRESNILLO,22,187,1,210,1567
ZACATECAS,FRESNILLO,23,157,0,180,1566
ZACATECAS,FRESNILLO,25,166,3,194,1541
ZACATECAS,FRESNILLO,23,154,2,179,1540
ZACATECAS,FRESNILLO,21,125,0,146,1540
ZACATECAS,FRESNILLO,30,170,6,206,1429
ZACATECAS,FRESNILLO,38,145,3,186,1429
ZACATECAS,FRESNILLO,24,135,1,160,1428
ZACATECAS,FRESNILLO,21,118,3,142,1333
ZACATECAS,FRESNILLO,23,110,3,136,1333
ZACATECAS,FRESNILLO,23,74,4,101,1695
ZACATECAS,FRESNILLO,18,105,5,128,1694
ZACATECAS,FRESNILLO,0,70,2,72,1694
ZACATECAS,FRESNILLO,14,105,4,123,1694
ZACATECAS,FRESNILLO,18,122,7,147,1192
ZACATECAS,FRESNILLO,24,147,5,176,1191
ZACATECAS,FRESNILLO,43,208,10,261,1182
ZACATECAS,FRESNILLO,27,183,2,212,1181
ZACATECAS,FRESNILLO,6,88,2,96,1546
ZACATECAS,FRESNILLO,8,90,2,100,1545
ZACATECAS,FRESNILLO,12,81,2,95,1545
ZACATECAS,FRESNILLO,24,148,7,179,1541
ZACATECAS,FRESNILLO,25,143,3,171,1541
ZACATECAS,FRESNILLO,24,174,2,200,1856
ZACATECAS,FRESNILLO,13,172,3,188,1856
ZACATECAS,FRESNILLO,10,88,2,100,1471
ZACATECAS,FRESNILLO,6,85,4,95,1470
ZACATECAS,FRESNILLO,15,124,1,140,1704
ZACATECAS,FRESNILLO,17,118,0,135,1704
ZACATECAS,FRESNILLO,15,81,2,98,1703
ZACATECAS,FRESNILLO,34,155,7,196,1933
ZACATECAS,FRESNILLO,37,141,3,181,1932
ZACATECAS,FRESNILLO,28,173,5,206,1902
ZACATECAS,FRESNILLO,28,143,3,174,1902
ZACATECAS,FRESNILLO,29,106,1,136,1196
ZACATECAS,FRESNILLO,26,107,3,136,1195
ZACATECAS,FRESNILLO,37,132,9,178,1896
ZACATECAS,FRESNILLO,34,113,2,149,1896
ZACATECAS,FRESNILLO,27,142,3,172,1397
ZACATECAS,FRESNILLO,24,134,3,161,1396
ZACATECAS,FRESNILLO,15,177,3,195,1396
ZACATECAS,FRESNILLO,16,150,2,168,1618
ZACATECAS,FRESNILLO,30,152,8,190,1617
ZACATECAS,FRESNILLO,17,103,1,121,1620
ZACATECAS,FRESNILLO,17,82,1,100,1620
ZACATECAS,FRESNILLO,13,94,4,111,1619
ZACATECAS,FRESNILLO,19,304,11,334,1833
ZACATECAS,FRESNILLO,19,296,4,319,1833
ZACATECAS,FRESNILLO,21,276,10,307,1832
ZACATECAS,FRESNILLO,15,244,1,260,1767
ZACATECAS,FRESNILLO,19,181,2,202,1767
ZACATECAS,FRESNILLO,42,311,27,380,1632
ZACATECAS,FRESNILLO,41,289,7,337,1632
ZACATECAS,FRESNILLO,49,319,18,386,1632
ZACATECAS,FRESNILLO,21,151,11,183,1323
ZACATECAS,FRESNILLO,33,168,13,214,1322
ZACATECAS,FRESNILLO,31,274,12,317,1986
ZACATECAS,FRESNILLO,36,295,7,338,1986
ZACATECAS,FRESNILLO,31,286,17,334,1985
ZACATECAS,FRESNILLO,12,172,1,185,1748
ZACATECAS,FRESNILLO,14,193,4,211,1748
ZACATECAS,FRESNILLO,21,132,5,158,1824
ZACATECAS,FRESNILLO,14,160,2,176,1823
ZACATECAS,FRESNILLO,10,156,2,168,1985
ZACATECAS,FRESNILLO,20,160,4,184,1985
ZACATECAS,FRESNILLO,13,140,4,157,1985
ZACATECAS,FRESNILLO,21,185,3,209,1925
ZACATECAS,FRESNILLO,20,192,5,217,1924
ZACATECAS,FRESNILLO,21,186,9,216,1974
ZACATECAS,FRESNILLO,15,175,4,194,1974
ZACATECAS,FRESNILLO,11,162,4,177,1973
ZACATECAS,FRESNILLO,23,217,6,246,1498
ZACATECAS,FRESNILLO,28,203,5,236,1498
ZACATECAS,FRESNILLO,26,211,6,243,1498
ZACATECAS,FRESNILLO,22,296,13,331,1796
ZACATECAS,FRESNILLO,23,212,16,251,1796
ZACATECAS,FRESNILLO,17,251,20,288,1795
ZACATECAS,FRESNILLO,14,233,12,259,1827
ZACATECAS,FRESNILLO,8,258,12,278,1827
ZACATECAS,FRESNILLO,22,131,0,153,1606
ZACATECAS,FRESNILLO,20,125,5,150,1606
ZACATECAS,FRESNILLO,12,114,1,127,1605
ZACATECAS,FRESNILLO,7,157,4,168,1533
ZACATECAS,FRESNILLO,24,179,7,210,1533
ZACATECAS,FRESNILLO,12,171,4,187,1533
ZACATECAS,FRESNILLO,8,158,3,169,1533
ZACATECAS,JEREZ DE GARCIA SALINAS,10,228,4,242,1334
ZACATECAS,JEREZ DE GARCIA SALINAS,4,183,7,194,1334
ZACATECAS,JEREZ DE GARCIA SALINAS,14,200,7,221,1333
ZACATECAS,JEREZ DE GARCIA SALINAS,19,267,13,299,1535
ZACATECAS,JEREZ DE GARCIA SALINAS,15,302,5,322,1535
ZACATECAS,JEREZ DE GARCIA SALINAS,4,177,4,185,1022
ZACATECAS,JEREZ DE GARCIA SALINAS,12,180,5,197,1021
ZACATECAS,JEREZ DE GARCIA SALINAS,16,230,1,247,1539
ZACATECAS,JEREZ DE GARCIA SALINAS,17,269,4,290,1539
ZACATECAS,JEREZ DE GARCIA SALINAS,15,256,8,279,1539
ZACATECAS,JEREZ DE GARCIA SALINAS,0,287,6,293,1538
ZACATECAS,JEREZ DE GARCIA SALINAS,24,144,6,174,1716
ZACATECAS,JEREZ DE GARCIA SALINAS,24,145,9,178,1715
ZACATECAS,JEREZ DE GARCIA SALINAS,26,155,10,191,1715
ZACATECAS,JEREZ DE GARCIA SALINAS,15,167,8,190,1336
ZACATECAS,JEREZ DE GARCIA SALINAS,11,145,5,161,1336
ZACATECAS,JEREZ DE GARCIA SALINAS,31,190,6,227,1701
ZACATECAS,JEREZ DE GARCIA SALINAS,12,165,8,185,1701
ZACATECAS,JEREZ DE GARCIA SALINAS,19,229,2,250,1910
ZACATECAS,JEREZ DE GARCIA SALINAS,11,241,3,255,1910
ZACATECAS,JEREZ DE GARCIA SALINAS,10,209,3,222,1910
ZACATECAS,JEREZ DE GARCIA SALINAS,14,243,5,262,1646
ZACATECAS,JEREZ DE GARCIA SALINAS,15,261,3,279,1645
ZACATECAS,JEREZ DE GARCIA SALINAS,13,221,3,237,1645
ZACATECAS,JEREZ DE GARCIA SALINAS,18,235,4,257,1795
ZACATECAS,JEREZ DE GARCIA SALINAS,23,215,6,244,1794
ZACATECAS,JEREZ DE GARCIA SALINAS,16,215,2,233,1794
ZACATECAS,JEREZ DE GARCIA SALINAS,13,203,5,221,1768
ZACATECAS,JEREZ DE GARCIA SALINAS,11,159,4,174,1768
ZACATECAS,JEREZ DE GARCIA SALINAS,11,190,3,204,1768
ZACATECAS,JEREZ DE GARCIA SALINAS,16,167,2,185,1768
ZACATECAS,JEREZ DE GARCIA SALINAS,12,197,2,211,1768
ZACATECAS,JEREZ DE GARCIA SALINAS,16,200,2,218,1882
ZACATECAS,JEREZ DE GARCIA SALINAS,16,186,6,208,1882
ZACATECAS,JEREZ DE GARCIA SALINAS,12,223,6,241,1882
ZACATECAS,JEREZ DE GARCIA SALINAS,12,181,8,201,1882
ZACATECAS,JEREZ DE GARCIA SALINAS,12,120,4,136,1584
ZACATECAS,JEREZ DE GARCIA SALINAS,17,138,3,158,1584
ZACATECAS,JEREZ DE GARCIA SALINAS,13,135,2,150,1583
ZACATECAS,JEREZ DE GARCIA SALINAS,16,133,0,149,1583
ZACATECAS,JEREZ DE GARCIA SALINAS,17,167,2,186,1447
ZACATECAS,JEREZ DE GARCIA SALINAS,12,145,4,161,1446
ZACATECAS,JEREZ DE GARCIA SALINAS,9,111,0,120,1446
ZACATECAS,JEREZ DE GARCIA SALINAS,76,382,15,473,0
ZACATECAS,JEREZ DE GARCIA SALINAS,22,166,3,191,1335
ZACATECAS,JEREZ DE GARCIA SALINAS,17,203,1,221,1335
ZACATECAS,JEREZ DE GARCIA SALINAS,11,136,4,151,1503
ZACATECAS,JEREZ DE GARCIA SALINAS,26,139,3,168,1503
ZACATECAS,JEREZ DE GARCIA SALINAS,22,169,2,193,1563
ZACATECAS,JEREZ DE GARCIA SALINAS,21,196,1,218,1563
ZACATECAS,JEREZ DE GARCIA SALINAS,20,159,0,179,1563
ZACATECAS,JEREZ DE GARCIA SALINAS,19,153,5,177,1438
ZACATECAS,JEREZ DE GARCIA SALINAS,17,173,3,193,1437
ZACATECAS,JEREZ DE GARCIA SALINAS,16,129,3,148,1230
ZACATECAS,JEREZ DE GARCIA SALINAS,12,124,4,140,1230
ZACATECAS,JEREZ DE GARCIA SALINAS,13,110,5,128,1016
ZACATECAS,JEREZ DE GARCIA SALINAS,11,101,1,113,1015
ZACATECAS,JEREZ DE GARCIA SALINAS,15,133,4,152,1582
ZACATECAS,JEREZ DE GARCIA SALINAS,18,140,4,162,1581
ZACATECAS,JEREZ DE GARCIA SALINAS,23,126,4,153,1581
ZACATECAS,JEREZ DE GARCIA SALINAS,19,122,1,142,1581
ZACATECAS,JEREZ DE GARCIA SALINAS,17,139,2,158,1687
ZACATECAS,JEREZ DE GARCIA SALINAS,12,118,7,137,1687
ZACATECAS,JEREZ DE GARCIA SALINAS,12,146,5,163,1686
ZACATECAS,JEREZ DE GARCIA SALINAS,9,172,5,186,1891
ZACATECAS,JEREZ DE GARCIA SALINAS,21,143,4,168,1890
ZACATECAS,JEREZ DE GARCIA SALINAS,15,129,3,147,1767
ZACATECAS,JEREZ DE GARCIA SALINAS,6,160,4,170,1767
ZACATECAS,JEREZ DE GARCIA SALINAS,3,122,0,125,1767
ZACATECAS,JEREZ DE GARCIA SALINAS,11,146,6,163,1767
ZACATECAS,JEREZ DE GARCIA SALINAS,7,140,3,150,1767
ZACATECAS,JEREZ DE GARCIA SALINAS,17,313,7,337,1886
ZACATECAS,JEREZ DE GARCIA SALINAS,16,300,6,322,1885
ZACATECAS,JEREZ DE GARCIA SALINAS,17,248,8,273,1857
ZACATECAS,JEREZ DE GARCIA SALINAS,9,229,6,244,1857
ZACATECAS,JEREZ DE GARCIA SALINAS,10,225,5,240,1517
ZACATECAS,JEREZ DE GARCIA SALINAS,9,204,7,220,1516
ZACATECAS,JEREZ DE GARCIA SALINAS,6,82,1,89,1415
ZACATECAS,JEREZ DE GARCIA SALINAS,4,146,2,152,1415
ZACATECAS,JEREZ DE GARCIA SALINAS,4,104,3,111,1415
ZACATECAS,JEREZ DE GARCIA SALINAS,15,315,2,332,1563
ZACATECAS,JEREZ DE GARCIA SALINAS,11,330,4,345,1563
ZACATECAS,JEREZ DE GARCIA SALINAS,20,286,10,316,1425
ZACATECAS,JEREZ DE GARCIA SALINAS,10,349,4,363,1424
ZACATECAS,JEREZ DE GARCIA SALINAS,13,345,3,361,1758
ZACATECAS,JEREZ DE GARCIA SALINAS,14,337,3,354,1758
ZACATECAS,JEREZ DE GARCIA SALINAS,5,107,4,116,1771
ZACATECAS,JEREZ DE GARCIA SALINAS,5,119,3,127,1771
ZACATECAS,JEREZ DE GARCIA SALINAS,8,102,4,114,1770
ZACATECAS,JEREZ DE GARCIA SALINAS,20,131,1,152,1960
ZACATECAS,JEREZ DE GARCIA SALINAS,16,156,7,179,1960
ZACATECAS,JEREZ DE GARCIA SALINAS,14,176,3,193,1960
ZACATECAS,JEREZ DE GARCIA SALINAS,8,154,6,168,1960
ZACATECAS,JEREZ DE GARCIA SALINAS,10,160,2,172,1960
ZACATECAS,JEREZ DE GARCIA SALINAS,16,142,12,170,1786
ZACATECAS,JEREZ DE GARCIA SALINAS,17,145,2,164,1786
ZACATECAS,JEREZ DE GARCIA SALINAS,19,147,5,171,1785
ZACATECAS,JEREZ DE GARCIA SALINAS,28,162,7,197,1785
ZACATECAS,JEREZ DE GARCIA SALINAS,20,182,6,208,1785
ZACATECAS,JEREZ DE GARCIA SALINAS,14,198,3,215,1570
ZACATECAS,JEREZ DE GARCIA SALINAS,13,208,5,226,1569
ZACATECAS,JEREZ DE GARCIA SALINAS,17,192,2,211,1761
ZACATECAS,JEREZ DE GARCIA SALINAS,11,173,8,192,1760
ZACATECAS,JEREZ DE GARCIA SALINAS,8,162,1,171,1760
ZACATECAS,JEREZ DE GARCIA SALINAS,17,210,6,233,1903
ZACATECAS,JEREZ DE GARCIA SALINAS,17,214,13,244,1903
ZACATECAS,JEREZ DE GARCIA SALINAS,14,211,3,228,1654
ZACATECAS,JEREZ DE GARCIA SALINAS,13,225,7,245,1653
ZACATECAS,JEREZ DE GARCIA SALINAS,24,244,4,272,1793
ZACATECAS,JEREZ DE GARCIA SALINAS,12,237,3,252,1793
ZACATECAS,JEREZ DE GARCIA SALINAS,16,209,6,231,1792
ZACATECAS,JEREZ DE GARCIA SALINAS,9,157,2,168,1386
ZACATECAS,JEREZ DE GARCIA SALINAS,8,162,5,175,1386
ZACATECAS,JEREZ DE GARCIA SALINAS,11,139,4,154,1385
ZACATECAS,JEREZ DE GARCIA SALINAS,27,246,5,278,1769
ZACATECAS,JEREZ DE GARCIA SALINAS,28,235,2,265,1768
ZACATECAS,JEREZ DE GARCIA SALINAS,20,167,3,190,1754
ZACATECAS,JEREZ DE GARCIA SALINAS,16,203,4,223,1754
ZACATECAS,JEREZ DE GARCIA SALINAS,19,194,4,217,1839
ZACATECAS,JEREZ DE GARCIA SALINAS,9,228,0,237,1838
ZACATECAS,JEREZ DE GARCIA SALINAS,27,270,8,305,1800
ZACATECAS,JEREZ DE GARCIA SALINAS,24,360,7,391,1799
ZACATECAS,JEREZ DE GARCIA SALINAS,15,142,12,169,1456
ZACATECAS,JEREZ DE GARCIA SALINAS,25,170,12,207,1456
ZACATECAS,JEREZ DE GARCIA SALINAS,23,175,4,202,1455
ZACATECAS,JEREZ DE GARCIA SALINAS,14,195,4,213,1512
ZACATECAS,JEREZ DE GARCIA SALINAS,21,176,4,201,1511
ZACATECAS,JEREZ DE GARCIA SALINAS,15,214,0,229,1511
ZACATECAS,JEREZ DE GARCIA SALINAS,7,172,5,184,1442
ZACATECAS,JEREZ DE GARCIA SALINAS,12,192,9,213,1441
ZACATECAS,JEREZ DE GARCIA SALINAS,15,306,9,330,1763
ZACATECAS,JEREZ DE GARCIA SALINAS,22,332,4,358,1762
ZACATECAS,JEREZ DE GARCIA SALINAS,17,254,6,277,1961
ZACATECAS,JEREZ DE GARCIA SALINAS,18,238,6,262,1961
ZACATECAS,JEREZ DE GARCIA SALINAS,16,228,5,249,1666
ZACATECAS,JEREZ DE GARCIA SALINAS,11,224,4,239,1666
ZACATECAS,JEREZ DE GARCIA SALINAS,13,277,6,296,1848
ZACATECAS,JEREZ DE GARCIA SALINAS,10,230,8,248,1848
ZACATECAS,JEREZ DE GARCIA SALINAS,7,240,4,251,1848
ZACATECAS,JEREZ DE GARCIA SALINAS,12,268,9,289,1847
ZACATECAS,JEREZ DE GARCIA SALINAS,20,251,5,276,1847
ZACATECAS,JEREZ DE GARCIA SALINAS,10,209,1,220,1659
ZACATECAS,JEREZ DE GARCIA SALINAS,13,231,2,246,1658
ZACATECAS,JEREZ DE GARCIA SALINAS,14,226,7,247,1658
ZACATECAS,JEREZ DE GARCIA SALINAS,21,237,4,262,1888
ZACATECAS,JEREZ DE GARCIA SALINAS,18,208,4,230,1888
ZACATECAS,JEREZ DE GARCIA SALINAS,16,240,5,261,1888
ZACATECAS,JEREZ DE GARCIA SALINAS,17,236,6,259,1888
ZACATECAS,JEREZ DE GARCIA SALINAS,14,242,9,265,1888
ZACATECAS,JEREZ DE GARCIA SALINAS,11,244,5,260,1142
ZACATECAS,JEREZ DE GARCIA SALINAS,8,202,8,218,1141
ZACATECAS,JEREZ DE GARCIA SALINAS,17,243,10,270,1492
ZACATECAS,JEREZ DE GARCIA SALINAS,17,235,5,257,1492
ZACATECAS,JEREZ DE GARCIA SALINAS,14,244,6,264,1491
ZACATECAS,JEREZ DE GARCIA SALINAS,19,284,4,307,1938
ZACATECAS,JEREZ DE GARCIA SALINAS,16,305,5,326,1937
ZACATECAS,JEREZ DE GARCIA SALINAS,26,296,8,330,1950
ZACATECAS,JEREZ DE GARCIA SALINAS,18,320,7,345,1949
ZACATECAS,JEREZ DE GARCIA SALINAS,13,248,5,266,1068
ZACATECAS,JEREZ DE GARCIA SALINAS,10,223,4,237,1067
ZACATECAS,JEREZ DE GARCIA SALINAS,10,107,4,121,1494
ZACATECAS,JEREZ DE GARCIA SALINAS,14,133,3,150,1494
ZACATECAS,JEREZ DE GARCIA SALINAS,9,123,1,133,1493
ZACATECAS,JEREZ DE GARCIA SALINAS,14,79,1,94,1625
ZACATECAS,JEREZ DE GARCIA SALINAS,7,75,0,82,1625
ZACATECAS,JEREZ DE GARCIA SALINAS,12,48,1,61,1625
ZACATECAS,JEREZ DE GARCIA SALINAS,5,68,2,75,1624
ZACATECAS,JEREZ DE GARCIA SALINAS,8,98,2,108,1624
ZACATECAS,JEREZ DE GARCIA SALINAS,24,147,4,175,1826
ZACATECAS,JEREZ DE GARCIA SALINAS,15,135,3,153,1826
ZACATECAS,JEREZ DE GARCIA SALINAS,16,156,2,174,1825
ZACATECAS,JEREZ DE GARCIA SALINAS,4,128,1,133,1825
ZACATECAS,JEREZ DE GARCIA SALINAS,8,68,0,76,1896
ZACATECAS,JEREZ DE GARCIA SALINAS,9,50,0,59,1896
ZACATECAS,JEREZ DE GARCIA SALINAS,6,38,2,46,1896
ZACATECAS,JEREZ DE GARCIA SALINAS,3,62,0,65,1896
ZACATECAS,JEREZ DE GARCIA SALINAS,20,189,4,213,1514
ZACATECAS,JEREZ DE GARCIA SALINAS,10,195,2,207,1513
ZACATECAS,JEREZ DE GARCIA SALINAS,20,196,1,217,1513
ZACATECAS,JEREZ DE GARCIA SALINAS,6,203,1,210,1335
ZACATECAS,JEREZ DE GARCIA SALINAS,12,185,4,201,1334
ZACATECAS,JEREZ DE GARCIA SALINAS,13,183,7,203,1334
ZACATECAS,JEREZ DE GARCIA SALINAS,13,190,4,207,1534
ZACATECAS,JEREZ DE GARCIA SALINAS,19,195,4,218,1534
ZACATECAS,JEREZ DE GARCIA SALINAS,13,208,3,224,1534
ZACATECAS,JEREZ DE GARCIA SALINAS,16,193,3,212,1534
ZACATECAS,JEREZ DE GARCIA SALINAS,35,293,7,335,1903
ZACATECAS,JEREZ DE GARCIA SALINAS,33,340,8,381,1903
ZACATECAS,JEREZ DE GARCIA SALINAS,6,177,1,184,1730
ZACATECAS,JEREZ DE GARCIA SALINAS,13,210,6,229,1729
ZACATECAS,JEREZ DE GARCIA SALINAS,15,148,7,170,1371
ZACATECAS,JEREZ DE GARCIA SALINAS,22,222,7,251,1371
ZACATECAS,JEREZ DE GARCIA SALINAS,12,216,8,236,1371
ZACATECAS,ZACATECAS,8,247,3,258,1933
ZACATECAS,ZACATECAS,7,256,3,266,1933
ZACATECAS,ZACATECAS,6,260,4,270,1933
ZACATECAS,ZACATECAS,13,276,5,294,1933
ZACATECAS,ZACATECAS,13,388,3,404,1932
ZACATECAS,ZACATECAS,22,387,8,417,1821
ZACATECAS,ZACATECAS,32,435,20,487,1821
ZACATECAS,ZACATECAS,27,388,14,429,1821
ZACATECAS,ZACATECAS,29,369,10,408,1947
ZACATECAS,ZACATECAS,25,328,21,374,1947
ZACATECAS,ZACATECAS,21,335,4,360,1920
ZACATECAS,ZACATECAS,22,341,15,378,1920
ZACATECAS,ZACATECAS,9,172,5,186,1458
ZACATECAS,ZACATECAS,11,221,1,233,1458
ZACATECAS,ZACATECAS,7,205,2,214,1457
ZACATECAS,ZACATECAS,13,258,6,277,1918
ZACATECAS,ZACATECAS,10,253,7,270,1918
ZACATECAS,ZACATECAS,15,231,4,250,1498
ZACATECAS,ZACATECAS,19,226,6,251,1497
ZACATECAS,ZACATECAS,10,199,4,213,1463
ZACATECAS,ZACATECAS,9,230,1,240,1463
ZACATECAS,ZACATECAS,9,210,2,221,1462
ZACATECAS,ZACATECAS,8,217,0,225,1776
ZACATECAS,ZACATECAS,5,210,7,222,1776
ZACATECAS,ZACATECAS,8,275,8,291,1775
ZACATECAS,ZACATECAS,14,70,1,85,1965
ZACATECAS,ZACATECAS,12,123,3,138,1964
ZACATECAS,ZACATECAS,3,109,3,115,1942
ZACATECAS,ZACATECAS,2,107,2,111,1941
ZACATECAS,ZACATECAS,7,98,0,105,1941
ZACATECAS,ZACATECAS,1,92,1,94,1941
ZACATECAS,ZACATECAS,3,166,3,172,1509
ZACATECAS,ZACATECAS,6,160,3,169,1509
ZACATECAS,ZACATECAS,7,178,2,187,1508
ZACATECAS,ZACATECAS,7,185,1,193,1508
ZACATECAS,ZACATECAS,7,173,5,185,1623
ZACATECAS,ZACATECAS,5,103,7,115,1623
ZACATECAS,ZACATECAS,5,131,1,137,1623
ZACATECAS,ZACATECAS,4,142,0,146,1622
ZACATECAS,ZACATECAS,7,128,5,140,1622
ZACATECAS,ZACATECAS,13,201,3,217,1314
ZACATECAS,ZACATECAS,10,199,3,212,1314
ZACATECAS,ZACATECAS,9,192,2,203,1313
ZACATECAS,ZACATECAS,19,334,7,360,1722
ZACATECAS,ZACATECAS,8,277,5,290,1722
ZACATECAS,ZACATECAS,8,271,7,286,1722
ZACATECAS,ZACATECAS,21,299,8,328,1023
ZACATECAS,ZACATECAS,7,291,11,309,1023
ZACATECAS,ZACATECAS,34,264,9,307,1818
ZACATECAS,ZACATECAS,23,229,3,255,1817
ZACATECAS,ZACATECAS,24,155,4,183,1646
ZACATECAS,ZACATECAS,19,146,1,166,1645
ZACATECAS,ZACATECAS,28,243,7,278,1899
ZACATECAS,ZACATECAS,21,315,6,342,1899
ZACATECAS,ZACATECAS,11,314,4,329,1287
ZACATECAS,ZACATECAS,9,172,1,182,1286
ZACATECAS,ZACATECAS,8,588,15,611,1528
ZACATECAS,ZACATECAS,15,190,2,207,1528
ZACATECAS,ZACATECAS,14,159,4,177,1299
ZACATECAS,ZACATECAS,9,156,4,169,1299
ZACATECAS,ZACATECAS,18,264,11,293,1952
ZACATECAS,ZACATECAS,19,279,12,310,1951
ZACATECAS,ZACATECAS,9,164,7,180,1640
ZACATECAS,ZACATECAS,25,200,6,231,1640
ZACATECAS,ZACATECAS,12,190,1,203,1639
ZACATECAS,ZACATECAS,35,314,4,353,1861
ZACATECAS,ZACATECAS,26,302,8,336,1860
ZACATECAS,ZACATECAS,24,137,6,167,1109
ZACATECAS,ZACATECAS,18,135,5,158,1109
ZACATECAS,ZACATECAS,23,203,5,231,1333
ZACATECAS,ZACATECAS,10,218,1,229,1332
ZACATECAS,ZACATECAS,17,149,5,171,1332
ZACATECAS,ZACATECAS,23,219,6,248,1681
ZACATECAS,ZACATECAS,25,226,3,254,1681
ZACATECAS,ZACATECAS,23,288,3,314,1335
ZACATECAS,ZACATECAS,12,277,1,290,1334
ZACATECAS,ZACATECAS,16,260,10,286,1334
ZACATECAS,ZACATECAS,23,440,17,480,1969
ZACATECAS,ZACATECAS,22,368,17,407,1968
ZACATECAS,ZACATECAS,20,201,0,221,1325
ZACATECAS,ZACATECAS,13,220,4,237,1325
ZACATECAS,ZACATECAS,21,229,5,255,1325
ZACATECAS,ZACATECAS,17,371,14,402,1705
ZACATECAS,ZACATECAS,27,356,11,394,1705
ZACATECAS,ZACATECAS,9,325,17,351,1705
ZACATECAS,ZACATECAS,19,264,17,300,1678
ZACATECAS,ZACATECAS,33,277,17,327,1677
ZACATECAS,ZACATECAS,22,273,4,299,1074
ZACATECAS,ZACATECAS,34,275,16,325,1073
ZACATECAS,ZACATECAS,5,185,3,193,1565
ZACATECAS,ZACATECAS,11,145,2,158,1564
ZACATECAS,ZACATECAS,17,174,3,194,1695
ZACATECAS,ZACATECAS,12,191,5,208,1694
ZACATECAS,ZACATECAS,14,262,8,284,1781
ZACATECAS,ZACATECAS,16,261,0,277,1781
ZACATECAS,ZACATECAS,30,237,6,273,1897
ZACATECAS,ZACATECAS,16,216,7,239,1896
ZACATECAS,ZACATECAS,15,94,5,114,1507
ZACATECAS,ZACATECAS,9,81,2,92,1507
ZACATECAS,ZACATECAS,23,93,3,119,1507
ZACATECAS,ZACATECAS,25,100,5,130,1364
ZACATECAS,ZACATECAS,20,90,2,112,1363
ZACATECAS,ZACATECAS,18,198,2,218,1198
ZACATECAS,ZACATECAS,25,195,10,230,1197
ZACATECAS,ZACATECAS,14,125,3,142,1626
ZACATECAS,ZACATECAS,12,141,7,160,1626
ZACATECAS,ZACATECAS,16,164,4,184,1625
ZACATECAS,ZACATECAS,32,117,3,152,1890
ZACATECAS,ZACATECAS,19,111,0,130,1889
ZACATECAS,ZACATECAS,20,118,0,138,1889
ZACATECAS,ZACATECAS,24,226,2,252,1821
ZACATECAS,ZACATECAS,22,259,7,288,1821
ZACATECAS,ZACATECAS,26,265,10,301,1966
ZACATECAS,ZACATECAS,34,242,6,282,1965
ZACATECAS,ZACATECAS,24,180,2,206,1584
ZACATECAS,ZACATECAS,22,220,3,245,1584
ZACATECAS,ZACATECAS,14,129,3,146,1073
ZACATECAS,ZACATECAS,18,146,1,165,1072
ZACATECAS,ZACATECAS,21,259,7,287,1833
ZACATECAS,ZACATECAS,27,232,7,266,1833
ZACATECAS,ZACATECAS,30,248,6,284,1644
ZACATECAS,ZACATECAS,19,259,5,283,1643
ZACATECAS,ZACATECAS,30,270,1,301,1962
ZACATECAS,ZACATECAS,39,272,8,319,1962
ZACATECAS,ZACATECAS,22,179,3,204,1474
ZACATECAS,ZACATECAS,26,218,4,248,1474
ZACATECAS,ZACATECAS,25,183,2,210,1473
ZACATECAS,ZACATECAS,17,177,5,199,1160
ZACATECAS,ZACATECAS,22,141,0,163,1160
ZACATECAS,ZACATECAS,15,173,2,190,1584
ZACATECAS,ZACATECAS,18,166,8,192,1584
ZACATECAS,ZACATECAS,30,147,3,180,1460
ZACATECAS,ZACATECAS,24,177,0,201,1459
ZACATECAS,ZACATECAS,27,191,4,222,1459
ZACATECAS,ZACATECAS,25,210,3,238,1438
ZACATECAS,ZACATECAS,11,198,3,212,1438
ZACATECAS,ZACATECAS,34,249,5,288,1689
ZACATECAS,ZACATECAS,38,303,7,348,1688
ZACATECAS,ZACATECAS,34,216,3,253,1706
ZACATECAS,ZACATECAS,27,220,2,249,1706
ZACATECAS,ZACATECAS,17,152,1,170,1430
ZACATECAS,ZACATECAS,16,129,2,147,1429
ZACATECAS,ZACATECAS,33,160,2,195,1883
ZACATECAS,ZACATECAS,21,151,2,174,1883
ZACATECAS,ZACATECAS,25,157,0,182,1883
ZACATECAS,ZACATECAS,15,161,1,177,1153
ZACATECAS,ZACATECAS,14,146,2,162,1153
ZACATECAS,ZACATECAS,33,232,2,267,1692
ZACATECAS,ZACATECAS,32,213,2,247,1692
ZACATECAS,ZACATECAS,24,230,7,261,1876
ZACATECAS,ZACATECAS,25,248,7,280,1875
ZACATECAS,ZACATECAS,24,223,2,249,1881
ZACATECAS,ZACATECAS,19,237,3,259,1880
ZACATECAS,ZACATECAS,13,178,8,199,1348
ZACATECAS,ZACATECAS,24,167,1,192,1348
ZACATECAS,ZACATECAS,28,225,1,254,1713
ZACATECAS,ZACATECAS,38,198,2,238,1713
ZACATECAS,ZACATECAS,23,259,3,285,1829
ZACATECAS,ZACATECAS,26,284,1,311,1829
ZACATECAS,ZACATECAS,24,177,2,203,1431
ZACATECAS,ZACATECAS,21,183,0,204,1431
ZACATECAS,ZACATECAS,20,205,4,229,1899
ZACATECAS,ZACATECAS,18,189,4,211,1899
ZACATECAS,ZACATECAS,34,187,0,221,1898
ZACATECAS,ZACATECAS,15,191,3,209,1898
ZACATECAS,ZACATECAS,20,191,4,215,1898
ZACATECAS,ZACATECAS,16,163,7,186,1898
ZACATECAS,ZACATECAS,30,181,1,212,1867
ZACATECAS,ZACATECAS,32,180,2,214,1867
ZACATECAS,ZACATECAS,23,178,1,202,1867
ZACATECAS,ZACATECAS,30,205,1,236,1867
ZACATECAS,ZACATECAS,25,169,4,198,1866
ZACATECAS,ZACATECAS,71,626,4,701,0
ZACATECAS,ZACATECAS,18,109,5,132,1591
ZACATECAS,ZACATECAS,14,142,3,159,1591
ZACATECAS,ZACATECAS,22,127,1,150,1591
ZACATECAS,ZACATECAS,11,136,5,152,1464
ZACATECAS,ZACATECAS,8,126,5,139,1464
ZACATECAS,ZACATECAS,5,139,0,144,1464
ZACATECAS,ZACATECAS,16,240,5,261,1797
ZACATECAS,ZACATECAS,12,217,5,234,1796
ZACATECAS,ZACATECAS,15,220,5,240,1720
ZACATECAS,ZACATECAS,24,209,1,234,1720
ZACATECAS,GUADALUPE,14,297,15,326,1669
ZACATECAS,GUADALUPE,11,305,5,321,1668
ZACATECAS,GUADALUPE,23,272,9,304,1668
ZACATECAS,GUADALUPE,21,319,16,356,1447
ZACATECAS,GUADALUPE,14,308,14,336,1447
ZACATECAS,GUADALUPE,16,326,6,348,1742
ZACATECAS,GUADALUPE,12,326,6,344,1741
ZACATECAS,GUADALUPE,7,206,5,218,1316
ZACATECAS,GUADALUPE,11,168,3,182,1315
ZACATECAS,GUADALUPE,11,272,7,290,1747
ZACATECAS,GUADALUPE,6,279,10,295,1747
ZACATECAS,GUADALUPE,25,285,1,311,1869
ZACATECAS,GUADALUPE,26,143,4,173,1609
ZACATECAS,GUADALUPE,27,158,4,189,1609
ZACATECAS,GUADALUPE,19,162,3,184,1608
ZACATECAS,GUADALUPE,9,148,3,160,1608
ZACATECAS,GUADALUPE,27,176,1,204,1955
ZACATECAS,GUADALUPE,57,150,2,209,1955
ZACATECAS,GUADALUPE,24,145,3,172,1339
ZACATECAS,GUADALUPE,23,144,1,168,1339
ZACATECAS,GUADALUPE,28,211,2,241,1814
ZACATECAS,GUADALUPE,27,203,4,234,1813
ZACATECAS,GUADALUPE,20,176,1,197,1889
ZACATECAS,GUADALUPE,20,174,3,197,1889
ZACATECAS,GUADALUPE,21,169,3,193,1889
ZACATECAS,GUADALUPE,20,177,3,200,1889
ZACATECAS,GUADALUPE,12,155,5,172,1889
ZACATECAS,GUADALUPE,21,167,1,189,1889
ZACATECAS,GUADALUPE,16,145,1,162,1889
ZACATECAS,GUADALUPE,30,144,3,177,1889
ZACATECAS,GUADALUPE,66,510,5,581,0
ZACATECAS,GUADALUPE,16,145,72,233,1713
ZACATECAS,GUADALUPE,39,158,4,201,1713
ZACATECAS,GUADALUPE,36,199,1,236,1713
ZACATECAS,GUADALUPE,15,170,4,189,1383
ZACATECAS,GUADALUPE,18,163,3,184,1383
ZACATECAS,GUADALUPE,16,139,4,159,1382
ZACATECAS,GUADALUPE,13,123,4,140,1096
ZACATECAS,GUADALUPE,24,135,0,159,1095
ZACATECAS,GUADALUPE,13,111,1,125,1344
ZACATECAS,GUADALUPE,14,135,2,151,1343
ZACATECAS,GUADALUPE,19,119,3,141,1343
ZACATECAS,GUADALUPE,31,223,1,255,1845
ZACATECAS,GUADALUPE,32,205,0,237,1844
ZACATECAS,GUADALUPE,35,188,1,224,1603
ZACATECAS,GUADALUPE,24,213,6,243,1603
ZACATECAS,GUADALUPE,31,197,4,232,1602
ZACATECAS,GUADALUPE,32,244,3,279,1704
ZACATECAS,GUADALUPE,51,185,0,236,1703
ZACATECAS,GUADALUPE,30,160,2,192,1362
ZACATECAS,GUADALUPE,24,165,2,191,1362
ZACATECAS,GUADALUPE,17,199,0,216,1952
ZACATECAS,GUADALUPE,25,168,1,194,1817
ZACATECAS,GUADALUPE,29,167,8,204,1817
ZACATECAS,GUADALUPE,30,193,2,225,1816
ZACATECAS,GUADALUPE,22,197,5,224,1816
ZACATECAS,GUADALUPE,15,164,5,184,1138
ZACATECAS,GUADALUPE,21,137,3,161,1138
ZACATECAS,GUADALUPE,21,159,2,182,1488
ZACATECAS,GUADALUPE,32,138,1,171,1488
ZACATECAS,GUADALUPE,48,414,15,477,1644
ZACATECAS,GUADALUPE,45,383,8,436,1644
ZACATECAS,GUADALUPE,26,312,9,347,1882
ZACATECAS,GUADALUPE,25,334,7,366,1881
ZACATECAS,GUADALUPE,38,269,11,318,1881
ZACATECAS,GUADALUPE,35,263,8,306,1799
ZACATECAS,GUADALUPE,33,260,6,299,1799
ZACATECAS,GUADALUPE,24,305,5,334,1350
ZACATECAS,GUADALUPE,23,315,1,339,1349
ZACATECAS,GUADALUPE,16,301,5,322,1349
ZACATECAS,GUADALUPE,26,258,6,290,1368
ZACATECAS,GUADALUPE,22,232,5,259,1367
ZACATECAS,GUADALUPE,26,254,12,292,1608
ZACATECAS,GUADALUPE,23,250,5,278,1608
ZACATECAS,GUADALUPE,20,295,11,326,1607
ZACATECAS,GUADALUPE,22,272,10,304,1692
ZACATECAS,GUADALUPE,34,267,11,312,1692
ZACATECAS,GUADALUPE,20,231,8,259,1157
ZACATECAS,GUADALUPE,19,216,5,240,1156
ZACATECAS,GUADALUPE,23,202,3,228,1928
ZACATECAS,GUADALUPE,17,218,7,242,1927
ZACATECAS,GUADALUPE,16,153,3,172,1636
ZACATECAS,GUADALUPE,15,168,1,184,1635
ZACATECAS,GUADALUPE,21,181,2,204,1635
ZACATECAS,GUADALUPE,30,199,4,233,1355
ZACATECAS,GUADALUPE,54,273,14,341,1798
ZACATECAS,GUADALUPE,66,305,15,386,1798
ZACATECAS,GUADALUPE,23,129,2,154,1913
ZACATECAS,GUADALUPE,16,149,0,165,1913
ZACATECAS,GUADALUPE,27,163,2,192,1913
ZACATECAS,GUADALUPE,30,133,15,178,1912
ZACATECAS,GUADALUPE,53,207,11,271,1762
ZACATECAS,GUADALUPE,38,209,6,253,1761
ZACATECAS,GUADALUPE,13,348,3,364,1865
ZACATECAS,GUADALUPE,15,346,2,363,1864
ZACATECAS,GUADALUPE,7,307,4,318,1864
ZACATECAS,GUADALUPE,10,288,3,301,1849
ZACATECAS,GUADALUPE,10,329,3,342,1849
ZACATECAS,GUADALUPE,16,346,1,363,1667
ZACATECAS,GUADALUPE,8,361,3,372,1667
ZACATECAS,GUADALUPE,17,216,13,246,1252
ZACATECAS,GUADALUPE,16,212,6,234,1251
ZACATECAS,GUADALUPE,10,233,4,247,1511
ZACATECAS,GUADALUPE,12,253,1,266,1511
ZACATECAS,GUADALUPE,8,213,5,226,1511
ZACATECAS,GUADALUPE,14,273,1,288,1664
ZACATECAS,GUADALUPE,9,249,13,271,1664
ZACATECAS,GUADALUPE,4,295,10,309,1663
ZACATECAS,GUADALUPE,3,313,7,323,1663
ZACATECAS,GUADALUPE,7,349,12,368,1716
ZACATECAS,GUADALUPE,7,373,3,383,1715
ZACATECAS,GUADALUPE,11,291,9,311,1715
ZACATECAS,GUADALUPE,6,203,3,212,1337
ZACATECAS,GUADALUPE,11,178,2,191,1336
ZACATECAS,GUADALUPE,10,253,0,263,1336
ZACATECAS,GUADALUPE,6,387,3,396,1656
ZACATECAS,GUADALUPE,19,469,5,493,1656
ZACATECAS,GUADALUPE,15,415,7,437,1913
ZACATECAS,GUADALUPE,18,443,9,470,1913
ZACATECAS,GUADALUPE,8,249,3,260,1166
ZACATECAS,GUADALUPE,2,201,6,209,1165
ZACATECAS,GUADALUPE,12,360,4,376,1495
ZACATECAS,GUADALUPE,10,335,11,356,1494
ZACATECAS,GUADALUPE,10,227,9,246,1833
ZACATECAS,GUADALUPE,11,202,4,217,1832
ZACATECAS,GUADALUPE,10,250,1,261,1832
ZACATECAS,GUADALUPE,36,284,16,336,1587
ZACATECAS,GUADALUPE,29,253,21,303,1586
ZACATECAS,GUADALUPE,35,259,36,330,1586
ZACATECAS,GUADALUPE,24,225,7,256,1671
ZACATECAS,GUADALUPE,26,248,16,290,1671
ZACATECAS,GUADALUPE,36,269,14,319,1671
ZACATECAS,GUADALUPE,24,273,10,307,1670
ZACATECAS,GUADALUPE,26,232,22,280,1670
ZACATECAS,GUADALUPE,41,226,11,278,1405
ZACATECAS,GUADALUPE,12,384,13,409,1958
ZACATECAS,GUADALUPE,10,339,12,361,1958
ZACATECAS,GUADALUPE,20,342,8,370,1958
ZACATECAS,GUADALUPE,12,379,8,399,1489
ZACATECAS,GUADALUPE,14,351,8,373,1489
ZACATECAS,GUADALUPE,16,333,8,357,1488
ZACATECAS,GUADALUPE,24,404,18,446,1284
ZACATECAS,GUADALUPE,37,370,16,423,1283
ZACATECAS,GUADALUPE,39,509,6,554,1981
ZACATECAS,GUADALUPE,15,449,22,486,1980
ZACATECAS,GUADALUPE,17,375,14,406,1554
ZACATECAS,GUADALUPE,13,338,18,369,1554
ZACATECAS,GUADALUPE,18,372,13,403,1554
ZACATECAS,GUADALUPE,20,392,10,422,1553
ZACATECAS,GUADALUPE,26,530,3,559,1455
ZACATECAS,GUADALUPE,42,524,10,576,1455
ZACATECAS,GUADALUPE,41,497,8,546,1455
ZACATECAS,GUADALUPE,45,386,12,443,1609
ZACATECAS,GUADALUPE,45,353,16,414,1609
ZACATECAS,GUADALUPE,16,312,3,331,1859
ZACATECAS,GUADALUPE,8,329,5,342,1859
ZACATECAS,GUADALUPE,11,370,3,384,1859
ZACATECAS,GUADALUPE,14,278,4,296,1624
ZACATECAS,GUADALUPE,14,278,3,295,1623
ZACATECAS,GUADALUPE,15,311,12,338,1528
ZACATECAS,GUADALUPE,17,313,4,334,1527
ZACATECAS,GUADALUPE,4,254,6,264,1724
ZACATECAS,GUADALUPE,8,337,1,346,1724
ZACATECAS,GUADALUPE,8,362,6,376,1724
ZACATECAS,GUADALUPE,2,333,5,340,1724
ZACATECAS,GUADALUPE,9,312,5,326,1724
ZACATECAS,GUADALUPE,13,394,11,418,1716
ZACATECAS,GUADALUPE,11,406,5,422,1716
ZACATECAS,GUADALUPE,8,380,9,397,1715
ZACATECAS,GUADALUPE,10,406,3,419,1715
ZACATECAS,GUADALUPE,16,239,3,258,1324
ZACATECAS,GUADALUPE,18,307,7,332,1324
ZACATECAS,GUADALUPE,3,373,9,385,1476
ZACATECAS,GUADALUPE,11,387,3,401,1476
ZACATECAS,GUADALUPE,18,140,3,161,1712
ZACATECAS,GUADALUPE,21,167,1,189,1712
ZACATECAS,GUADALUPE,33,199,3,235,1915
ZACATECAS,GUADALUPE,24,191,2,217,1915
ZACATECAS,GUADALUPE,18,127,3,148,1160
ZACATECAS,GUADALUPE,18,135,1,154,1159
ZACATECAS,GUADALUPE,28,146,2,176,1372
ZACATECAS,GUADALUPE,27,148,0,175,1372
ZACATECAS,GUADALUPE,30,154,0,184,1372
ZACATECAS,GUADALUPE,32,189,2,223,1912
ZACATECAS,GUADALUPE,30,229,1,260,1912
ZACATECAS,GUADALUPE,28,198,2,228,1604
ZACATECAS,GUADALUPE,31,185,1,217,1603
